"","X","ast","blk","dreb","fg3a","fg3m","fga","fgm","fta","ftm","min","oreb","pf","pts","reb","stl","turnover","game.id","game.date","player.id","team.id","player_full_name","blk_stl","pts_rebs","pts_rebs_ast","pts_ast","rebs_ast","fantasy"
"1",1,6,1,7,6,1,17,8,0,0,35,0,2,17,7,0,3,3277498,"2023-11-24T00:00:00.000Z",17896026,22,"Franz Wagner",1,24,30,23,13,34.4
"2",2,5,0,7,6,2,16,10,2,1,35,1,4,23,8,0,3,3277498,"2023-11-24T00:00:00.000Z",38017683,22,"Paolo Banchero",0,31,36,28,13,37.1
"3",3,3,1,3,0,0,5,3,0,0,19,2,5,6,5,1,0,3277498,"2023-11-24T00:00:00.000Z",666442,22,"Goga Bitadze",2,11,14,9,8,22.5
"4",4,1,0,4,4,3,8,3,2,1,28,0,2,10,4,1,3,3277498,"2023-11-24T00:00:00.000Z",17896073,22,"Jalen Suggs",1,14,15,11,5,16.3
"5",5,0,0,1,0,0,1,0,0,0,6,0,1,0,1,0,1,3277498,"2023-11-24T00:00:00.000Z",56677827,22,"Anthony Black",0,1,1,0,1,0.2
"6",6,6,1,2,4,2,17,6,4,2,28,1,4,16,3,2,3,3277498,"2023-11-24T00:00:00.000Z",3547251,22,"Cole Anthony",3,19,25,22,9,34.6
"7",7,0,0,1,3,1,3,1,1,1,19,2,1,4,3,0,2,3277498,"2023-11-24T00:00:00.000Z",196,22,"Gary Harris",0,7,7,4,3,5.6
"8",8,0,0,0,0,0,0,0,0,0,0,0,0,0,0,0,0,3277498,"2023-11-24T00:00:00.000Z",338,2,"Svi Mykhailiuk",0,0,0,0,0,0
"9",9,0,0,1,0,0,0,0,0,0,9,1,0,0,2,1,0,3277498,"2023-11-24T00:00:00.000Z",38017724,22,"Caleb Houstan",1,2,2,0,2,5.4
"10",10,0,0,0,0,0,0,0,0,0,0,0,0,0,0,0,0,3277498,"2023-11-24T00:00:00.000Z",56677839,22,"Jett Howard",0,0,0,0,0,0
"11",11,2,0,4,1,1,3,2,0,0,21,1,1,5,5,0,2,3277498,"2023-11-24T00:00:00.000Z",226,22,"Joe Ingles",0,10,12,7,7,12
"12",12,0,0,4,1,0,2,1,4,3,16,3,3,5,7,0,0,3277498,"2023-11-24T00:00:00.000Z",229,22,"Jonathan Isaac",0,12,12,5,7,13.4
"13",13,0,0,0,0,0,0,0,0,0,0,0,0,0,0,0,0,3277498,"2023-11-24T00:00:00.000Z",666818,22,"Chuma Okeke",0,0,0,0,0,0
"14",14,0,0,0,0,0,0,0,0,0,0,0,0,0,0,0,0,3277498,"2023-11-24T00:00:00.000Z",666885,22,"Admiral Schofield",0,0,0,0,0,0
"15",15,0,0,1,3,1,13,9,9,8,24,2,5,27,3,0,1,3277498,"2023-11-24T00:00:00.000Z",462,22,"Moritz Wagner",0,30,30,27,3,29.6
"16",16,0,0,0,0,0,0,0,0,0,0,0,0,0,0,0,0,3277498,"2023-11-24T00:00:00.000Z",85,22,"Wendell Carter Jr.",0,0,0,0,0,0
"17",17,0,0,0,0,0,0,0,0,0,0,0,0,0,0,0,0,3277498,"2023-11-24T00:00:00.000Z",165,22,"Markelle Fultz",0,0,0,0,0,0
"18",18,0,0,0,0,0,0,0,0,0,0,0,0,0,0,0,0,3277498,"2023-11-24T00:00:00.000Z",38017607,22,"Kevon Harris",0,0,0,0,0,0
"19",19,0,0,0,0,0,0,0,0,0,0,0,0,0,0,0,0,3277498,"2023-11-24T00:00:00.000Z",17553983,22,"Trevelin Queen",0,0,0,0,0,0
"20",20,3,0,5,3,0,16,7,13,12,39,0,3,26,5,2,2,3277498,"2023-11-24T00:00:00.000Z",434,2,"Jayson Tatum",2,31,34,29,8,40.5
"21",21,3,0,5,5,1,5,1,0,0,33,0,4,3,5,0,1,3277498,"2023-11-24T00:00:00.000Z",219,2,"Al Horford",0,8,11,6,8,12.5
"22",22,2,0,3,4,1,9,4,1,0,22,1,3,9,4,2,2,3277498,"2023-11-24T00:00:00.000Z",378,2,"Kristaps Porzingis",2,13,15,11,6,20.8
"23",23,2,1,3,8,2,22,6,7,4,39,0,3,18,3,3,3,3277498,"2023-11-24T00:00:00.000Z",70,2,"Jaylen Brown",4,21,23,20,5,33.6
"24",24,4,1,5,5,1,9,3,12,9,37,0,1,16,5,1,3,3277498,"2023-11-24T00:00:00.000Z",473,2,"Derrick White",2,21,25,20,9,31
"25",25,0,0,0,0,0,1,0,0,0,1,0,0,0,0,0,0,3277498,"2023-11-24T00:00:00.000Z",17896094,2,"Dalano Banton",0,0,0,0,0,0
"26",26,0,0,0,0,0,0,0,2,0,5,0,2,0,0,0,0,3277498,"2023-11-24T00:00:00.000Z",666468,2,"Oshae Brissett",0,0,0,0,0,0
"27",27,0,0,1,4,2,6,4,0,0,25,1,0,10,2,0,1,3277498,"2023-11-24T00:00:00.000Z",17896060,2,"Sam Hauser",0,12,12,10,2,11.4
"28",28,1,2,4,0,0,6,5,2,2,25,2,2,12,6,2,1,3277498,"2023-11-24T00:00:00.000Z",261,2,"Luke Kornet",4,18,19,13,7,31.7
"29",29,2,0,1,0,0,2,1,0,0,13,0,0,2,1,0,1,3277498,"2023-11-24T00:00:00.000Z",3547276,2,"Payton Pritchard",0,3,5,4,3,5.2
"30",30,0,0,0,0,0,0,0,0,0,1,0,0,0,0,0,0,3277498,"2023-11-24T00:00:00.000Z",3547279,2,"Lamar Stevens",0,0,0,0,0,0
"31",31,0,0,0,0,0,0,0,0,0,0,0,0,0,0,0,0,3277498,"2023-11-24T00:00:00.000Z",38017707,2,"JD Davison",0,0,0,0,0,0
"32",32,0,0,0,0,0,0,0,0,0,0,0,0,0,0,0,0,3277498,"2023-11-24T00:00:00.000Z",214,2,"Jrue Holiday",0,0,0,0,0,0
"33",33,0,0,0,0,0,0,0,0,0,0,0,0,0,0,0,0,3277498,"2023-11-24T00:00:00.000Z",3547295,2,"Nathan Knight",0,0,0,0,0,0
"34",34,0,0,0,0,0,0,0,0,0,0,0,0,0,0,0,0,3277498,"2023-11-24T00:00:00.000Z",17553967,2,"Neemias Queta",0,0,0,0,0,0
"35",35,0,0,0,0,0,0,0,0,0,0,0,0,0,0,0,0,3277498,"2023-11-24T00:00:00.000Z",56677864,2,"Jordan Walsh",0,0,0,0,0,0
"36",36,2,0,2,4,1,18,8,1,0,31,2,2,17,4,3,0,3277479,"2023-11-21T00:00:00.000Z",17896026,22,"Franz Wagner",3,21,23,19,6,33.8
"37",37,3,1,4,3,2,20,10,3,3,32,1,2,25,5,0,3,3277479,"2023-11-21T00:00:00.000Z",38017683,22,"Paolo Banchero",1,30,33,28,8,35.5
"38",38,6,5,4,0,0,6,2,4,1,31,3,1,5,7,2,1,3277479,"2023-11-21T00:00:00.000Z",666442,22,"Goga Bitadze",7,12,18,11,13,42.4
"39",39,4,0,2,4,2,10,6,4,4,21,1,3,18,3,2,2,3277479,"2023-11-21T00:00:00.000Z",17896073,22,"Jalen Suggs",2,21,25,22,7,31.6
"40",40,1,0,3,3,0,7,2,2,1,23,2,3,5,5,1,0,3277479,"2023-11-21T00:00:00.000Z",56677827,22,"Anthony Black",1,10,11,6,6,15.5
"41",41,10,0,3,4,2,10,5,3,3,29,2,3,15,5,0,2,3277479,"2023-11-21T00:00:00.000Z",3547251,22,"Cole Anthony",0,20,30,25,15,34
"42",42,1,0,1,5,2,7,4,0,0,23,0,3,10,1,1,0,3277479,"2023-11-21T00:00:00.000Z",196,22,"Gary Harris",1,11,12,11,2,15.7
"43",43,1,0,1,1,0,1,0,0,0,4,0,0,0,1,1,0,3277479,"2023-11-21T00:00:00.000Z",38017724,22,"Caleb Houstan",1,1,2,1,2,5.7
"44",44,1,0,1,2,1,3,2,1,1,13,1,2,6,2,0,1,3277479,"2023-11-21T00:00:00.000Z",226,22,"Joe Ingles",0,8,9,7,3,8.9
"45",45,0,2,2,2,0,6,4,2,1,12,1,0,9,3,1,2,3277479,"2023-11-21T00:00:00.000Z",229,22,"Jonathan Isaac",3,12,12,9,3,19.6
"46",46,0,0,0,0,0,0,0,0,0,0,0,0,0,0,0,0,3277479,"2023-11-21T00:00:00.000Z",85,22,"Wendell Carter Jr.",0,0,0,0,0,0
"47",47,0,0,0,0,0,0,0,0,0,0,0,0,0,0,0,0,3277479,"2023-11-21T00:00:00.000Z",165,22,"Markelle Fultz",0,0,0,0,0,0
"48",48,0,0,0,0,0,0,0,0,0,0,0,0,0,0,0,0,3277479,"2023-11-21T00:00:00.000Z",38017607,22,"Kevon Harris",0,0,0,0,0,0
"49",49,0,0,0,0,0,0,0,0,0,0,0,0,0,0,0,0,3277479,"2023-11-21T00:00:00.000Z",56677839,22,"Jett Howard",0,0,0,0,0,0
"50",50,0,0,0,0,0,0,0,0,0,0,0,0,0,0,0,0,3277479,"2023-11-21T00:00:00.000Z",17553983,22,"Trevelin Queen",0,0,0,0,0,0
"51",51,4,3,1,5,3,8,4,0,0,30,0,0,11,1,0,4,3277479,"2023-11-21T00:00:00.000Z",18,28,"OG Anunoby",3,12,16,15,5,23.2
"52",52,8,0,2,2,0,10,5,8,6,30,0,1,16,2,1,2,3277479,"2023-11-21T00:00:00.000Z",416,28,"Pascal Siakam",1,18,26,24,10,31.4
"53",53,1,1,9,0,0,7,5,0,0,23,1,6,10,10,0,4,3277479,"2023-11-21T00:00:00.000Z",373,28,"Jakob Poeltl",1,20,21,11,11,22.5
"54",54,4,0,8,4,1,11,5,4,3,30,0,1,14,8,3,5,3277479,"2023-11-21T00:00:00.000Z",17896055,28,"Scottie Barnes",3,22,26,18,12,33.6
"55",55,1,0,1,4,4,13,8,4,4,27,0,2,24,1,0,2,3277479,"2023-11-21T00:00:00.000Z",409,28,"Dennis Schroder",0,25,26,25,2,24.7
"56",56,4,0,4,1,0,4,2,2,1,15,2,3,5,6,1,3,3277479,"2023-11-21T00:00:00.000Z",3547249,28,"Precious Achiuwa",1,11,15,9,10,18.2
"57",57,0,1,2,3,1,4,1,0,0,18,0,3,3,2,0,0,3277479,"2023-11-21T00:00:00.000Z",58,28,"Chris Boucher",1,5,5,3,2,8.4
"58",58,2,0,2,3,1,4,1,0,0,12,0,0,3,2,0,0,3277479,"2023-11-21T00:00:00.000Z",56677828,28,"Gradey Dick",0,5,7,5,4,8.4
"59",59,1,1,3,2,1,4,2,2,1,19,0,1,6,3,1,1,3277479,"2023-11-21T00:00:00.000Z",3547275,28,"Malachi Flynn",2,9,10,7,4,16.1
"60",60,1,0,0,1,1,1,1,2,2,7,1,1,5,1,0,1,3277479,"2023-11-21T00:00:00.000Z",666762,28,"Jalen McDaniels",0,6,7,6,2,6.7
"61",61,0,0,1,1,1,2,2,0,0,4,1,1,5,2,0,1,3277479,"2023-11-21T00:00:00.000Z",376,28,"Otto Porter Jr.",0,7,7,5,2,6.4
"62",62,2,0,0,0,0,1,1,0,0,4,0,0,2,0,0,0,3277479,"2023-11-21T00:00:00.000Z",436,28,"Garrett Temple",0,2,4,4,2,5
"63",63,1,0,0,2,1,6,1,0,0,21,0,1,3,0,0,0,3277479,"2023-11-21T00:00:00.000Z",3089,28,"Gary Trent Jr.",0,3,4,4,1,4.5
"64",64,0,0,0,0,0,0,0,0,0,0,0,0,0,0,0,0,3277479,"2023-11-21T00:00:00.000Z",56677805,28,"Javon Freeman-Liberty",0,0,0,0,0,0
"65",65,0,0,0,0,0,0,0,0,0,0,0,0,0,0,0,0,3277479,"2023-11-21T00:00:00.000Z",38017717,28,"Ron Harper Jr.",0,0,0,0,0,0
"66",66,0,0,0,0,0,0,0,0,0,0,0,0,0,0,0,0,3277479,"2023-11-21T00:00:00.000Z",38017710,28,"Christian Koloko",0,0,0,0,0,0
"67",67,0,0,0,0,0,0,0,0,0,0,0,0,0,0,0,0,3277479,"2023-11-21T00:00:00.000Z",56677869,28,"Markquis Nowell",0,0,0,0,0,0
"68",68,0,0,0,0,0,0,0,0,0,0,0,0,0,0,0,0,3277479,"2023-11-21T00:00:00.000Z",489,28,"Thaddeus Young",0,0,0,0,0,0
"69",69,0,0,0,3,2,3,2,0,0,4,0,0,6,0,0,0,3277479,"2023-11-21T00:00:00.000Z",666818,22,"Chuma Okeke",0,6,6,6,0,6
"70",70,0,0,0,0,0,0,0,0,0,2,0,0,0,0,0,0,3277479,"2023-11-21T00:00:00.000Z",666885,22,"Admiral Schofield",0,0,0,0,0,0
"71",71,2,0,2,0,0,9,5,0,0,15,2,0,10,4,1,1,3277479,"2023-11-21T00:00:00.000Z",462,22,"Moritz Wagner",1,14,16,12,6,19.8
"72",72,2,1,4,4,2,11,7,2,2,32,0,4,18,4,1,3,3277446,"2023-11-17T00:00:00.000Z",3547242,30,"Deni Avdija",2,22,24,20,6,28.8
"73",73,5,0,4,8,3,21,8,0,0,32,0,3,19,4,0,2,3277446,"2023-11-17T00:00:00.000Z",265,30,"Kyle Kuzma",0,23,28,24,9,29.3
"74",74,0,0,3,0,0,8,4,2,2,28,4,4,10,7,1,1,3277446,"2023-11-17T00:00:00.000Z",666577,30,"Daniel Gafford",1,17,17,10,7,20.4
"75",75,5,0,3,2,1,7,4,2,2,30,0,0,11,3,1,1,3277446,"2023-11-17T00:00:00.000Z",249,30,"Tyus Jones",1,14,19,16,8,24.1
"76",76,4,0,1,6,0,11,2,4,4,29,0,2,8,1,0,5,3277446,"2023-11-17T00:00:00.000Z",666848,30,"Jordan Poole",0,9,13,12,5,10.2
"77",77,0,0,0,0,0,0,0,0,0,2,0,0,0,0,0,0,3277446,"2023-11-17T00:00:00.000Z",18677954,30,"Jared Butler",0,0,0,0,0,0
"78",78,4,1,3,3,0,7,2,3,2,31,0,1,6,3,0,2,3277446,"2023-11-17T00:00:00.000Z",56677844,30,"Bilal Coulibaly",1,9,13,10,7,16.6
"79",79,0,0,0,0,0,0,0,0,0,2,0,0,0,0,0,0,3277446,"2023-11-17T00:00:00.000Z",38017687,30,"Johnny Davis",0,0,0,0,0,0
"80",80,1,2,5,3,1,7,3,0,0,17,1,3,7,6,0,0,3277446,"2023-11-17T00:00:00.000Z",167,30,"Danilo Gallinari",2,13,14,8,7,21.7
"81",81,1,0,1,0,0,0,0,2,2,2,0,0,2,1,0,0,3277446,"2023-11-17T00:00:00.000Z",3547302,30,"Anthony Gill",0,3,4,3,2,4.7
"82",82,1,0,1,3,1,5,3,1,1,26,2,1,8,3,1,0,3277446,"2023-11-17T00:00:00.000Z",17896045,30,"Corey Kispert",1,11,12,9,4,16.1
"83",83,0,0,0,0,0,0,0,0,0,0,0,0,0,0,0,0,3277446,"2023-11-17T00:00:00.000Z",337,30,"Mike Muscala",0,0,0,0,0,0
"84",84,0,0,0,1,1,2,2,0,0,2,0,0,5,0,0,0,3277446,"2023-11-17T00:00:00.000Z",17896106,30,"Eugene Omoruyi",0,5,5,5,0,5
"85",85,2,0,0,2,1,3,2,0,0,7,0,0,5,0,0,0,3277446,"2023-11-17T00:00:00.000Z",414,30,"Landry Shamet",0,5,7,7,2,8
"86",86,0,0,0,0,0,0,0,0,0,0,0,0,0,0,0,0,3277446,"2023-11-17T00:00:00.000Z",38017704,30,"Patrick Baldwin Jr.",0,0,0,0,0,0
"87",87,0,0,0,0,0,0,0,0,0,0,0,0,0,0,0,0,3277446,"2023-11-17T00:00:00.000Z",38124126,30,"John Butler Jr.",0,0,0,0,0,0
"88",88,0,0,0,0,0,0,0,0,0,0,0,0,0,0,0,0,3277446,"2023-11-17T00:00:00.000Z",38017712,30,"Ryan Rollins",0,0,0,0,0,0
"89",89,0,0,0,0,0,0,0,0,0,0,0,0,0,0,0,0,3277446,"2023-11-17T00:00:00.000Z",487,30,"Delon Wright",0,0,0,0,0,0
"90",90,2,2,4,2,1,7,4,0,0,32,1,1,9,5,0,1,3277446,"2023-11-17T00:00:00.000Z",202,20,"Josh Hart",2,14,16,11,7,23
"91",91,8,2,6,5,1,18,9,6,3,35,1,3,22,7,1,6,3277446,"2023-11-17T00:00:00.000Z",387,20,"Julius Randle",3,29,37,30,15,45.4
"92",92,1,1,5,0,0,4,3,1,0,27,3,1,6,8,0,0,3277446,"2023-11-17T00:00:00.000Z",399,20,"Mitchell Robinson",1,14,15,7,9,20.1
"93",93,1,0,2,8,4,9,5,0,0,25,2,1,14,4,0,1,3277446,"2023-11-17T00:00:00.000Z",131,20,"Donte DiVincenzo",0,18,19,15,5,19.3
"94",94,7,0,4,10,6,23,10,6,6,34,3,2,32,7,0,0,3277446,"2023-11-17T00:00:00.000Z",73,20,"Jalen Brunson",0,39,46,39,14,50.9
"95",95,0,0,0,0,0,0,0,0,0,1,0,0,0,0,0,0,3277446,"2023-11-17T00:00:00.000Z",19,20,"Ryan Arcidiacono",0,0,0,0,0,0
"96",96,1,0,1,4,0,6,1,0,0,16,0,2,2,1,1,0,3277446,"2023-11-17T00:00:00.000Z",160,20,"Evan Fournier",1,3,4,3,2,7.7
"97",97,2,1,5,0,0,3,1,2,1,20,3,4,3,8,1,1,3277446,"2023-11-17T00:00:00.000Z",201,20,"Isaiah Hartenstein",2,11,13,5,10,20.6
"98",98,0,0,0,0,0,0,0,0,0,2,0,0,0,0,0,0,3277446,"2023-11-17T00:00:00.000Z",666675,20,"DaQuan Jeffries",0,0,0,0,0,0
"99",99,0,0,0,2,1,3,2,0,0,14,1,2,5,1,1,0,3277446,"2023-11-17T00:00:00.000Z",17896033,20,"Miles McBride",1,6,6,5,1,9.2
"100",100,4,0,6,7,3,18,10,5,4,33,0,5,27,6,1,1,3277446,"2023-11-17T00:00:00.000Z",3547269,20,"Immanuel Quickley",1,33,37,31,10,42.2
"101",101,0,0,1,0,0,0,0,0,0,1,0,0,0,1,0,0,3277446,"2023-11-17T00:00:00.000Z",17896063,20,"Jericho Sims",0,1,1,0,1,1.2
"102",102,0,0,0,0,0,0,0,0,0,0,0,0,0,0,0,0,3277446,"2023-11-17T00:00:00.000Z",666423,20,"RJ Barrett",0,0,0,0,0,0
"103",103,0,0,0,0,0,0,0,0,0,0,0,0,0,0,0,0,3277446,"2023-11-17T00:00:00.000Z",666474,20,"Charles Brown",0,0,0,0,0,0
"104",104,0,0,0,0,0,0,0,0,0,0,0,0,0,0,0,0,3277446,"2023-11-17T00:00:00.000Z",17895858,20,"Quentin Grimes",0,0,0,0,0,0
"105",105,0,0,0,0,0,0,0,0,0,0,0,0,0,0,0,0,3277446,"2023-11-17T00:00:00.000Z",56677795,20,"Jacob Toppin",0,0,0,0,0,0
"106",106,0,0,0,0,0,0,0,0,0,0,0,0,0,0,0,0,3277446,"2023-11-17T00:00:00.000Z",17896089,20,"Duane Washington Jr.",0,0,0,0,0,0
"107",107,0,0,0,0,0,0,0,0,0,0,0,0,0,0,0,0,3277446,"2023-11-17T00:00:00.000Z",666971,20,"Dylan Windler",0,0,0,0,0,0
"108",108,3,1,7,7,1,17,8,4,3,34,1,0,20,8,1,1,3277507,"2023-11-24T00:00:00.000Z",274,13,"Kawhi Leonard",2,28,31,23,11,39.1
"109",109,2,0,7,12,4,30,14,3,2,39,1,3,34,8,0,2,3277507,"2023-11-24T00:00:00.000Z",172,13,"Paul George",0,42,44,36,10,44.6
"110",110,0,1,2,0,0,6,5,1,1,21,3,4,11,5,0,4,3277507,"2023-11-24T00:00:00.000Z",493,13,"Ivica Zubac",1,16,16,11,5,16
"111",111,5,1,2,1,1,4,3,0,0,24,0,5,7,2,2,0,3277507,"2023-11-24T00:00:00.000Z",666743,13,"Terance Mann",3,9,14,12,7,25.9
"112",112,10,1,5,6,1,8,2,6,3,37,0,3,8,5,4,3,3277507,"2023-11-24T00:00:00.000Z",192,13,"James Harden",5,13,23,18,15,41
"113",113,0,0,1,5,3,14,8,1,1,28,0,1,20,1,3,0,3277507,"2023-11-24T00:00:00.000Z",380,13,"Norman Powell",3,21,21,20,1,30.2
"114",114,2,3,4,2,1,3,1,0,0,21,0,2,3,4,0,1,3277507,"2023-11-24T00:00:00.000Z",439,13,"Daniel Theis",3,7,9,5,6,18.8
"115",115,2,1,3,2,0,8,1,2,1,14,1,2,3,4,0,0,3277507,"2023-11-24T00:00:00.000Z",472,13,"Russell Westbrook",1,7,9,5,6,13.8
"116",116,0,0,0,0,0,0,0,0,0,0,0,0,0,0,0,0,3277507,"2023-11-24T00:00:00.000Z",3547260,19,"Kira Lewis Jr.",0,0,0,0,0,0
"117",117,1,0,6,3,0,7,0,6,5,27,2,1,5,8,0,0,3277507,"2023-11-24T00:00:00.000Z",3547293,19,"Naji Marshall",0,13,14,6,9,16.1
"118",118,0,3,1,1,0,4,2,0,0,20,1,1,4,2,0,1,3277507,"2023-11-24T00:00:00.000Z",340,19,"Larry Nance Jr.",3,6,6,4,2,14.4
"119",119,0,0,0,0,0,0,0,0,0,0,0,0,0,0,0,0,3277507,"2023-11-24T00:00:00.000Z",17896021,19,"Jeremiah Robinson-Earl",0,0,0,0,0,0
"120",120,0,0,0,0,0,0,0,0,0,0,0,0,0,0,0,0,3277507,"2023-11-24T00:00:00.000Z",491,19,"Cody Zeller",0,0,0,0,0,0
"121",121,0,0,0,0,0,0,0,0,0,0,0,0,0,0,0,0,3277507,"2023-11-24T00:00:00.000Z",38017663,19,"E.J. Liddell",0,0,0,0,0,0
"122",122,0,0,0,0,0,0,0,0,0,0,0,0,0,0,0,0,3277507,"2023-11-24T00:00:00.000Z",303,19,"CJ McCollum",0,0,0,0,0,0
"123",123,0,0,0,0,0,0,0,0,0,0,0,0,0,0,0,0,3277507,"2023-11-24T00:00:00.000Z",18677986,19,"Trey Murphy III",0,0,0,0,0,0
"124",124,0,0,0,0,0,0,0,0,0,0,0,0,0,0,0,0,3277507,"2023-11-24T00:00:00.000Z",56677856,13,"Jordan Miller",0,0,0,0,0,0
"125",125,0,0,0,0,0,0,0,0,0,0,0,0,0,0,0,0,3277507,"2023-11-24T00:00:00.000Z",24417679,13,"Xavier Moon",0,0,0,0,0,0
"126",126,0,0,0,0,0,0,0,0,0,0,0,0,0,0,0,0,3277507,"2023-11-24T00:00:00.000Z",371,13,"Mason Plumlee",0,0,0,0,0,0
"127",127,0,0,0,0,0,0,0,0,0,0,0,0,0,0,0,0,3277507,"2023-11-24T00:00:00.000Z",17896051,13,"Joshua Primo",0,0,0,0,0,0
"128",128,5,0,4,5,2,21,12,6,4,35,0,3,30,4,0,3,3277507,"2023-11-24T00:00:00.000Z",227,19,"Brandon Ingram",0,34,39,35,9,39.3
"129",129,5,0,4,1,0,25,13,9,6,34,2,2,32,6,2,5,3277507,"2023-11-24T00:00:00.000Z",666969,19,"Zion Williamson",2,38,43,37,11,47.7
"130",130,4,0,6,2,2,6,4,2,2,28,2,4,12,8,1,1,3277507,"2023-11-24T00:00:00.000Z",455,19,"Jonas Valanciunas",1,20,24,16,12,29.6
"131",131,4,1,2,4,3,7,5,2,1,24,2,5,14,4,1,3,3277507,"2023-11-24T00:00:00.000Z",17896024,19,"Herbert Jones",2,18,22,18,8,27.8
"132",132,5,1,6,2,1,7,3,0,0,36,2,2,7,8,1,1,3277507,"2023-11-24T00:00:00.000Z",38017677,19,"Dyson Daniels",2,15,20,12,13,29.1
"133",133,1,0,4,2,0,6,1,2,2,16,1,0,4,5,1,1,3277507,"2023-11-24T00:00:00.000Z",17896097,19,"Jose Alvarado",1,9,10,5,6,13.5
"134",134,1,0,4,4,2,5,3,0,0,20,0,1,8,4,0,0,3277507,"2023-11-24T00:00:00.000Z",56677837,19,"Jordan Hawkins",0,12,13,9,5,14.3
"135",135,3,0,0,2,0,2,0,0,0,22,2,4,0,2,1,0,3277507,"2023-11-24T00:00:00.000Z",450,13,"PJ Tucker",1,2,5,3,5,9.9
"136",136,0,0,0,0,0,0,0,0,0,0,0,0,0,0,0,0,3277507,"2023-11-24T00:00:00.000Z",56677849,13,"Kobe Brown",0,0,0,0,0,0
"137",137,0,0,0,0,0,0,0,0,0,0,0,0,0,0,0,0,3277507,"2023-11-24T00:00:00.000Z",666511,13,"Amir Coffey",0,0,0,0,0,0
"138",138,0,0,0,0,0,0,0,0,0,0,0,0,0,0,0,0,3277507,"2023-11-24T00:00:00.000Z",38017725,13,"Moussa Diabate",0,0,0,0,0,0
"139",139,0,0,0,0,0,0,0,0,0,0,0,0,0,0,0,0,3277507,"2023-11-24T00:00:00.000Z",17896031,13,"Nah'Shon Hyland",0,0,0,0,0,0
"140",140,0,0,0,0,0,0,0,0,0,0,0,0,0,0,0,0,3277507,"2023-11-24T00:00:00.000Z",17896022,13,"Brandon Boston Jr.",0,0,0,0,0,0
"141",141,0,0,0,0,0,0,0,0,0,0,0,0,0,0,0,0,3277507,"2023-11-24T00:00:00.000Z",17896017,19,"Matt Ryan",0,0,0,0,0,0
"142",142,0,0,0,0,0,0,0,0,0,0,0,0,0,0,0,0,3277507,"2023-11-24T00:00:00.000Z",38017726,19,"Dereon Seabron",0,0,0,0,0,0
"143",143,8,0,2,4,2,19,9,1,1,38,1,3,21,3,1,2,3277452,"2023-11-17T00:00:00.000Z",227,19,"Brandon Ingram",1,24,32,29,11,37.6
"144",144,6,2,4,1,1,17,10,11,5,33,0,3,26,4,0,4,3277452,"2023-11-17T00:00:00.000Z",666969,19,"Zion Williamson",2,30,36,32,10,41.8
"145",145,3,1,6,3,1,18,10,3,1,34,2,4,22,8,0,0,3277452,"2023-11-17T00:00:00.000Z",455,19,"Jonas Valanciunas",1,30,33,25,11,39.1
"146",146,4,1,5,1,0,8,3,2,2,37,0,2,8,5,3,1,3277452,"2023-11-17T00:00:00.000Z",17896024,19,"Herbert Jones",4,13,17,12,9,31
"147",147,7,0,7,1,0,6,4,3,2,33,1,1,10,8,3,0,3277452,"2023-11-17T00:00:00.000Z",38017677,19,"Dyson Daniels",3,18,25,17,15,39.1
"148",148,0,0,0,0,0,0,0,0,0,0,0,0,0,0,0,0,3277452,"2023-11-17T00:00:00.000Z",17896097,19,"Jose Alvarado",0,0,0,0,0,0
"149",149,4,0,5,3,1,7,3,0,0,26,0,0,7,5,0,0,3277452,"2023-11-17T00:00:00.000Z",56677837,19,"Jordan Hawkins",0,12,16,11,9,19
"150",150,0,0,0,0,0,0,0,0,0,0,0,0,0,0,0,0,3277452,"2023-11-17T00:00:00.000Z",3547260,19,"Kira Lewis Jr.",0,0,0,0,0,0
"151",151,1,0,5,5,4,6,4,0,0,18,0,0,12,5,1,2,3277452,"2023-11-17T00:00:00.000Z",3547293,19,"Naji Marshall",1,17,18,13,6,20.5
"152",152,0,0,0,0,0,0,0,0,0,1,0,0,0,0,0,0,3277452,"2023-11-17T00:00:00.000Z",17896021,19,"Jeremiah Robinson-Earl",0,0,0,0,0,0
"153",153,0,0,0,5,3,7,3,1,0,19,0,0,9,0,0,0,3277452,"2023-11-17T00:00:00.000Z",17896017,19,"Matt Ryan",0,9,9,9,0,9
"154",154,0,0,0,0,0,0,0,0,0,0,0,0,0,0,0,0,3277452,"2023-11-17T00:00:00.000Z",250,8,"DeAndre Jordan",0,0,0,0,0,0
"155",155,0,0,0,0,0,0,0,0,0,0,0,0,0,0,0,0,3277452,"2023-11-17T00:00:00.000Z",17896007,8,"Braxton Key",0,0,0,0,0,0
"156",156,3,0,7,5,3,19,11,1,0,30,2,1,25,9,0,0,3277452,"2023-11-17T00:00:00.000Z",38017709,8,"Christian Braun",0,34,37,28,12,40.3
"157",157,0,0,0,0,0,0,0,0,0,0,0,0,0,0,0,0,3277452,"2023-11-17T00:00:00.000Z",38017727,8,"Collin Gillespie",0,0,0,0,0,0
"158",158,0,0,0,0,0,0,0,0,0,0,0,0,0,0,0,0,3277452,"2023-11-17T00:00:00.000Z",215,8,"Justin Holiday",0,0,0,0,0,0
"159",159,0,0,0,0,0,1,0,0,0,4,0,2,0,0,0,2,3277452,"2023-11-17T00:00:00.000Z",3547268,8,"Zeke Nnaji",0,0,0,0,0,-2
"160",160,1,0,1,2,0,2,0,0,0,10,0,2,0,1,0,1,3277452,"2023-11-17T00:00:00.000Z",56677582,8,"Jalen Pickett",0,1,2,1,2,1.7
"161",161,1,0,0,3,0,4,1,0,0,9,0,2,2,0,1,0,3277452,"2023-11-17T00:00:00.000Z",56677776,8,"Julian Strawther",1,2,3,3,1,6.5
"162",162,1,0,1,1,0,3,1,2,1,11,2,2,3,3,0,2,3277452,"2023-11-17T00:00:00.000Z",38017721,8,"Peyton Watson",0,6,7,4,4,6.1
"163",163,0,1,1,0,0,0,0,0,0,1,0,0,0,1,0,0,3277452,"2023-11-17T00:00:00.000Z",491,19,"Cody Zeller",1,1,1,0,1,4.2
"164",164,0,0,0,0,0,0,0,0,0,0,0,0,0,0,0,0,3277452,"2023-11-17T00:00:00.000Z",38017663,19,"E.J. Liddell",0,0,0,0,0,0
"165",165,0,0,0,0,0,0,0,0,0,0,0,0,0,0,0,0,3277452,"2023-11-17T00:00:00.000Z",303,19,"CJ McCollum",0,0,0,0,0,0
"166",166,0,0,0,0,0,0,0,0,0,0,0,0,0,0,0,0,3277452,"2023-11-17T00:00:00.000Z",18677986,19,"Trey Murphy III",0,0,0,0,0,0
"167",167,0,0,0,0,0,0,0,0,0,0,0,0,0,0,0,0,3277452,"2023-11-17T00:00:00.000Z",340,19,"Larry Nance Jr.",0,0,0,0,0,0
"168",168,0,0,0,0,0,0,0,0,0,0,0,0,0,0,0,0,3277452,"2023-11-17T00:00:00.000Z",38017726,19,"Dereon Seabron",0,0,0,0,0,0
"169",169,0,0,8,6,2,14,8,1,0,33,3,3,18,11,0,0,3277452,"2023-11-17T00:00:00.000Z",375,8,"Michael Porter Jr.",0,29,29,18,11,31.2
"170",170,2,0,7,4,0,14,7,3,0,39,1,4,14,8,2,0,3277452,"2023-11-17T00:00:00.000Z",177,8,"Aaron Gordon",2,22,24,16,10,32.6
"171",171,18,1,14,8,1,20,10,5,5,36,2,2,26,16,0,4,3277452,"2023-11-17T00:00:00.000Z",246,8,"Nikola Jokic",1,42,60,44,34,71.2
"172",172,8,2,1,4,2,7,3,0,0,35,0,0,8,1,1,0,3277452,"2023-11-17T00:00:00.000Z",81,8,"Kentavious Caldwell-Pope",3,9,17,16,9,30.2
"173",173,3,0,1,7,2,12,6,0,0,33,1,2,14,2,0,4,3277452,"2023-11-17T00:00:00.000Z",236,8,"Reggie Jackson",0,16,19,17,5,16.9
"174",174,0,0,0,0,0,0,0,0,0,0,0,0,0,0,0,0,3277452,"2023-11-17T00:00:00.000Z",666489,8,"Vlatko Cancar",0,0,0,0,0,0
"175",175,0,0,0,0,0,0,0,0,0,0,0,0,0,0,0,0,3277452,"2023-11-17T00:00:00.000Z",17896103,8,"Jay Huff",0,0,0,0,0,0
"176",176,0,0,0,0,0,0,0,0,0,0,0,0,0,0,0,0,3277452,"2023-11-17T00:00:00.000Z",335,8,"Jamal Murray",0,0,0,0,0,0
"177",177,0,0,0,0,0,0,0,0,0,0,0,0,0,0,0,0,3277452,"2023-11-17T00:00:00.000Z",56677871,8,"Hunter Tyson",0,0,0,0,0,0
"178",178,3,0,4,1,1,20,10,4,2,36,0,1,23,4,1,3,3277451,"2023-11-17T00:00:00.000Z",125,5,"DeMar DeRozan",1,27,30,26,7,32.3
"179",179,0,2,1,5,4,6,5,4,4,23,0,4,18,1,2,1,3277451,"2023-11-17T00:00:00.000Z",89,5,"Alex Caruso",4,19,19,18,1,30.2
"180",180,6,0,7,3,0,16,4,2,2,30,3,4,10,10,0,1,3277451,"2023-11-17T00:00:00.000Z",460,5,"Nikola Vucevic",0,20,26,16,16,30
"181",181,3,0,6,11,4,20,12,7,6,41,0,4,34,6,2,3,3277451,"2023-11-17T00:00:00.000Z",268,5,"Zach LaVine",2,40,43,37,9,48.7
"182",182,4,0,1,3,0,6,2,1,0,30,0,2,4,1,0,2,3277451,"2023-11-17T00:00:00.000Z",666956,5,"Coby White",0,5,9,8,5,9.2
"183",183,1,0,1,0,0,0,0,0,0,10,0,0,0,1,0,0,3277451,"2023-11-17T00:00:00.000Z",87,5,"Jevon Carter",0,1,2,1,2,2.7
"184",184,0,0,1,3,1,3,1,0,0,26,0,3,3,1,1,1,3277451,"2023-11-17T00:00:00.000Z",110,5,"Torrey Craig",1,4,4,3,1,6.2
"185",185,1,0,2,1,0,3,0,0,0,13,0,1,0,2,0,0,3277451,"2023-11-17T00:00:00.000Z",17895983,5,"Ayo Dosunmu",0,2,3,1,3,3.9
"186",186,0,1,4,1,0,2,1,4,3,18,2,1,5,6,3,2,3277451,"2023-11-17T00:00:00.000Z",137,5,"Andre Drummond",4,11,11,5,6,22.2
"187",187,0,0,0,0,0,0,0,0,0,0,0,0,0,0,0,0,3277451,"2023-11-17T00:00:00.000Z",56677857,5,"Julian Phillips",0,0,0,0,0,0
"188",188,0,0,0,0,0,0,0,0,0,0,0,0,0,0,0,0,3277451,"2023-11-17T00:00:00.000Z",17896116,5,"Terry Taylor",0,0,0,0,0,0
"189",189,1,0,2,1,0,3,0,0,0,13,0,1,0,2,1,3,3277451,"2023-11-17T00:00:00.000Z",3547248,5,"Patrick Williams",1,2,3,1,3,3.9
"190",190,0,0,0,0,0,0,0,0,0,0,0,0,0,0,0,0,3277451,"2023-11-17T00:00:00.000Z",27,5,"Lonzo Ball",0,0,0,0,0,0
"191",191,0,0,0,0,0,0,0,0,0,0,0,0,0,0,0,0,3277451,"2023-11-17T00:00:00.000Z",56677874,5,"Onuralp Bitim",0,0,0,0,0,0
"192",192,0,0,0,0,0,0,0,0,0,0,0,0,0,0,0,0,3277451,"2023-11-17T00:00:00.000Z",45969255,5,"Justin Lewis",0,0,0,0,0,0
"193",193,0,0,0,0,0,0,0,0,0,0,0,0,0,0,0,0,3277451,"2023-11-17T00:00:00.000Z",56677860,5,"Adama Sanogo",0,0,0,0,0,0
"194",194,0,0,0,0,0,0,0,0,0,0,0,0,0,0,0,0,3277451,"2023-11-17T00:00:00.000Z",38017719,5,"Dalen Terry",0,0,0,0,0,0
"195",195,2,0,4,8,2,18,9,2,1,35,0,2,21,4,2,2,3277451,"2023-11-17T00:00:00.000Z",17896026,22,"Franz Wagner",2,25,27,23,6,32.8
"196",196,0,0,0,0,0,0,0,0,0,0,0,0,0,0,0,0,3277451,"2023-11-17T00:00:00.000Z",17553983,22,"Trevelin Queen",0,0,0,0,0,0
"197",197,0,0,0,0,0,0,0,0,0,0,0,0,0,0,0,0,3277451,"2023-11-17T00:00:00.000Z",56677839,22,"Jett Howard",0,0,0,0,0,0
"198",198,0,0,0,0,0,0,0,0,0,0,0,0,0,0,0,0,3277451,"2023-11-17T00:00:00.000Z",17896073,22,"Jalen Suggs",0,0,0,0,0,0
"199",199,0,0,0,0,0,0,0,0,0,0,0,0,0,0,0,0,3277451,"2023-11-17T00:00:00.000Z",85,22,"Wendell Carter Jr.",0,0,0,0,0,0
"200",200,0,0,0,0,0,0,0,0,0,0,0,0,0,0,0,0,3277451,"2023-11-17T00:00:00.000Z",165,22,"Markelle Fultz",0,0,0,0,0,0
"201",201,0,0,0,0,0,0,0,0,0,0,0,0,0,0,0,0,3277451,"2023-11-17T00:00:00.000Z",38017607,22,"Kevon Harris",0,0,0,0,0,0
"202",202,4,1,5,1,0,14,6,4,1,32,3,3,13,8,0,7,3277451,"2023-11-17T00:00:00.000Z",38017683,22,"Paolo Banchero",1,21,25,17,12,24.6
"203",203,0,2,4,0,0,1,0,4,2,21,0,4,2,4,1,1,3277451,"2023-11-17T00:00:00.000Z",666442,22,"Goga Bitadze",3,6,6,2,4,14.8
"204",204,2,2,4,7,3,10,5,2,2,29,2,3,15,6,1,0,3277451,"2023-11-17T00:00:00.000Z",196,22,"Gary Harris",3,21,23,17,8,34.2
"205",205,0,0,0,0,0,2,1,1,0,11,0,0,2,0,0,3,3277451,"2023-11-17T00:00:00.000Z",56677827,22,"Anthony Black",0,2,2,2,0,-1
"206",206,5,0,1,7,2,8,3,0,0,26,0,1,8,1,1,1,3277451,"2023-11-17T00:00:00.000Z",226,22,"Joe Ingles",1,9,14,13,6,18.7
"207",207,7,0,6,5,1,12,3,4,4,37,2,4,11,8,1,2,3277451,"2023-11-17T00:00:00.000Z",3547251,22,"Cole Anthony",1,19,26,18,15,32.1
"208",208,1,1,6,4,2,8,6,4,4,20,3,2,18,9,1,1,3277451,"2023-11-17T00:00:00.000Z",229,22,"Jonathan Isaac",2,27,28,19,10,35.3
"209",209,3,1,4,1,0,5,4,2,2,23,0,3,10,4,0,0,3277451,"2023-11-17T00:00:00.000Z",462,22,"Moritz Wagner",1,14,17,13,7,22.3
"210",210,0,0,2,1,1,1,1,0,0,6,0,0,3,2,0,0,3277451,"2023-11-17T00:00:00.000Z",38017724,22,"Caleb Houstan",0,5,5,3,2,5.4
"211",211,0,0,0,0,0,0,0,0,0,0,0,0,0,0,0,0,3277451,"2023-11-17T00:00:00.000Z",666818,22,"Chuma Okeke",0,0,0,0,0,0
"212",212,0,0,0,0,0,0,0,0,0,0,0,0,0,0,0,0,3277451,"2023-11-17T00:00:00.000Z",666885,22,"Admiral Schofield",0,0,0,0,0,0
"213",213,0,0,1,2,1,7,4,0,0,18,0,1,9,1,0,0,3277447,"2023-11-17T00:00:00.000Z",666656,1,"De'Andre Hunter",0,10,10,9,1,10.2
"214",214,2,3,9,2,0,12,7,4,4,36,1,2,18,10,1,0,3277447,"2023-11-17T00:00:00.000Z",17896040,1,"Jalen Johnson",4,28,30,20,12,45
"215",215,2,1,3,0,0,11,7,5,3,29,8,3,17,11,0,0,3277447,"2023-11-17T00:00:00.000Z",83,1,"Clint Capela",1,28,30,19,13,36.2
"216",216,3,0,1,7,3,16,5,0,0,35,0,2,13,1,2,3,3277447,"2023-11-17T00:00:00.000Z",334,1,"Dejounte Murray",2,14,17,16,4,21.7
"217",217,13,0,2,6,2,14,5,10,10,37,0,3,22,2,1,4,3277447,"2023-11-17T00:00:00.000Z",490,1,"Trae Young",1,24,37,35,15,42.9
"218",218,1,0,4,4,2,9,6,4,3,31,3,1,17,7,1,2,3277447,"2023-11-17T00:00:00.000Z",3547256,1,"Saddiq Bey",1,24,25,18,8,27.9
"219",219,3,0,2,8,3,12,4,3,2,24,0,3,13,2,3,3,3277447,"2023-11-17T00:00:00.000Z",53,1,"Bogdan Bogdanovic",3,15,18,16,5,25.9
"220",220,0,0,0,0,0,0,0,0,0,0,0,0,0,0,0,0,3277447,"2023-11-17T00:00:00.000Z",666564,1,"Bruno Fernando",0,0,0,0,0,0
"221",221,0,0,0,0,0,0,0,0,0,0,0,0,0,0,0,0,3277447,"2023-11-17T00:00:00.000Z",3547297,1,"Trent Forrest",0,0,0,0,0,0
"222",222,0,0,0,0,0,0,0,0,0,0,0,0,0,0,0,0,3277447,"2023-11-17T00:00:00.000Z",38017689,1,"AJ Griffin",0,0,0,0,0,0
"223",223,0,0,0,0,0,0,0,0,0,0,0,0,0,0,0,0,3277447,"2023-11-17T00:00:00.000Z",666754,1,"Garrison Mathews",0,0,0,0,0,0
"224",224,0,0,0,2,0,2,0,4,2,11,0,2,2,0,0,0,3277447,"2023-11-17T00:00:00.000Z",301,1,"Wesley Matthews",0,2,2,2,0,2
"225",225,0,0,0,0,0,0,0,0,0,0,0,0,0,0,0,0,3277447,"2023-11-17T00:00:00.000Z",319,1,"Patty Mills",0,0,0,0,0,0
"226",226,0,0,3,2,1,6,2,0,0,19,2,3,5,5,0,1,3277447,"2023-11-17T00:00:00.000Z",3547244,1,"Onyeka Okongwu",0,10,10,5,5,10
"227",227,0,0,0,0,0,0,0,0,0,0,0,0,0,0,0,0,3277447,"2023-11-17T00:00:00.000Z",56677838,1,"Kobe Bufkin",0,0,0,0,0,0
"228",228,0,0,0,0,0,0,0,0,0,0,0,0,0,0,0,0,3277447,"2023-11-17T00:00:00.000Z",56677806,1,"Mouhamed Gueye",0,0,0,0,0,0
"229",229,0,0,0,0,0,0,0,0,0,0,0,0,0,0,0,0,3277447,"2023-11-17T00:00:00.000Z",56677855,1,"Seth Lundy",0,0,0,0,0,0
"230",230,0,0,0,0,0,0,0,0,0,0,0,0,0,0,0,0,3277447,"2023-11-17T00:00:00.000Z",56677875,1,"Miles Norris",0,0,0,0,0,0
"231",231,3,1,3,2,2,4,2,0,0,21,4,4,6,7,1,1,3277447,"2023-11-17T00:00:00.000Z",108,23,"Robert Covington",2,13,16,9,10,23.9
"232",232,3,0,9,5,3,20,12,2,2,38,1,1,29,10,1,1,3277447,"2023-11-17T00:00:00.000Z",200,23,"Tobias Harris",1,39,42,32,13,47.5
"233",233,8,1,5,3,1,19,10,11,11,37,2,3,32,7,2,4,3277447,"2023-11-17T00:00:00.000Z",145,23,"Joel Embiid",3,39,47,40,15,57.4
"234",234,5,1,3,7,3,13,5,2,1,36,1,2,14,4,1,3,3277447,"2023-11-17T00:00:00.000Z",313,23,"De'Anthony Melton",2,18,23,19,9,29.3
"235",235,8,0,4,6,3,13,5,6,6,40,0,1,19,4,2,2,3277447,"2023-11-17T00:00:00.000Z",3547254,23,"Tyrese Maxey",2,23,31,27,12,39.8
"236",236,0,0,0,0,0,0,0,0,0,0,0,0,0,0,0,0,3277447,"2023-11-17T00:00:00.000Z",28,23,"Mo Bamba",0,0,0,0,0,0
"237",237,1,0,2,1,0,1,0,2,2,14,0,3,2,2,0,0,3277447,"2023-11-17T00:00:00.000Z",45,23,"Patrick Beverley",0,4,5,3,3,5.9
"238",238,1,0,2,4,1,8,5,3,3,18,1,1,14,3,0,1,3277447,"2023-11-17T00:00:00.000Z",2175,23,"Danuel House Jr.",0,17,18,15,4,18.1
"239",239,0,0,0,0,0,0,0,0,0,0,0,0,0,0,0,0,3277447,"2023-11-17T00:00:00.000Z",260,23,"Furkan Korkmaz",0,0,0,0,0,0
"240",240,0,0,0,0,0,0,0,0,0,0,0,0,0,0,0,0,3277447,"2023-11-17T00:00:00.000Z",3547294,23,"Kenyon Martin Jr.",0,0,0,0,0,0
"241",241,0,0,1,0,0,0,0,0,0,2,0,1,0,1,0,0,3277447,"2023-11-17T00:00:00.000Z",328,23,"Marcus Morris",0,1,1,0,1,1.2
"242",242,0,0,1,0,0,3,1,0,0,12,1,1,2,2,0,0,3277447,"2023-11-17T00:00:00.000Z",3547270,23,"Paul Reed",0,4,4,2,2,4.4
"243",243,2,2,0,2,0,7,3,2,2,22,3,3,8,3,2,3,3277447,"2023-11-17T00:00:00.000Z",17896025,23,"Jaden Springer",4,11,13,10,5,23.6
"244",244,0,0,0,0,0,0,0,0,0,0,0,0,0,0,0,0,3277447,"2023-11-17T00:00:00.000Z",33,23,"Nicolas Batum",0,0,0,0,0,0
"245",245,0,0,0,0,0,0,0,0,0,0,0,0,0,0,0,0,3277447,"2023-11-17T00:00:00.000Z",56913527,23,"Ricky Council IV",0,0,0,0,0,0
"246",246,0,0,0,0,0,0,0,0,0,0,0,0,0,0,0,0,3277447,"2023-11-17T00:00:00.000Z",360,23,"Kelly Oubre Jr.",0,0,0,0,0,0
"247",247,0,0,0,0,0,0,0,0,0,0,0,0,0,0,0,0,3277447,"2023-11-17T00:00:00.000Z",17554001,23,"Javonte Smart",0,0,0,0,0,0
"248",248,0,0,0,0,0,0,0,0,0,0,0,0,0,0,0,0,3277447,"2023-11-17T00:00:00.000Z",56677788,23,"Terquavion Smith",0,0,0,0,0,0
"249",249,1,0,7,5,1,14,7,3,3,34,0,2,18,7,0,3,3277500,"2023-11-24T00:00:00.000Z",666423,20,"RJ Barrett",0,25,26,19,8,24.9
"250",250,7,0,8,4,1,12,5,2,2,35,0,0,13,8,0,6,3277500,"2023-11-24T00:00:00.000Z",387,20,"Julius Randle",0,21,28,20,15,27.1
"251",251,0,0,4,0,0,4,2,4,1,20,3,2,5,7,2,0,3277500,"2023-11-24T00:00:00.000Z",399,20,"Mitchell Robinson",2,12,12,5,7,19.4
"252",252,3,0,3,4,1,16,10,5,3,34,0,1,24,3,0,2,3277500,"2023-11-24T00:00:00.000Z",73,20,"Jalen Brunson",0,27,30,27,6,30.1
"253",253,2,0,0,3,1,4,1,0,0,21,0,3,3,0,1,0,3277500,"2023-11-24T00:00:00.000Z",17895858,20,"Quentin Grimes",1,3,5,5,2,9
"254",254,1,0,3,2,1,4,1,3,2,16,1,1,5,4,1,3,3277500,"2023-11-24T00:00:00.000Z",131,20,"Donte DiVincenzo",1,9,10,6,5,11.3
"255",255,4,0,7,3,1,7,4,1,1,26,1,1,10,8,1,1,3277500,"2023-11-24T00:00:00.000Z",202,20,"Josh Hart",1,18,22,14,12,27.6
"256",256,1,1,4,0,0,3,1,0,0,28,1,3,2,5,2,1,3277500,"2023-11-24T00:00:00.000Z",201,20,"Isaiah Hartenstein",3,7,8,3,6,17.5
"257",257,2,1,4,8,4,17,8,0,0,26,0,1,20,4,0,2,3277500,"2023-11-24T00:00:00.000Z",3547269,20,"Immanuel Quickley",1,24,26,22,6,28.8
"258",258,0,0,0,0,0,0,0,0,0,0,0,0,0,0,0,0,3277500,"2023-11-24T00:00:00.000Z",666971,20,"Dylan Windler",0,0,0,0,0,0
"259",259,3,0,2,5,3,14,7,6,6,37,0,1,23,2,1,2,3277500,"2023-11-24T00:00:00.000Z",79,16,"Jimmy Butler",1,25,28,26,5,30.9
"260",260,3,0,3,5,1,6,1,2,2,24,0,1,5,3,2,2,3277500,"2023-11-24T00:00:00.000Z",3092,16,"Haywood Highsmith",2,8,11,8,6,17.1
"261",261,2,0,10,1,0,16,8,6,5,35,2,4,21,12,2,2,3277500,"2023-11-24T00:00:00.000Z",4,16,"Bam Adebayo",2,33,35,23,14,42.4
"262",262,2,0,5,5,2,9,4,0,0,33,3,3,10,8,2,1,3277500,"2023-11-24T00:00:00.000Z",286,16,"Kyle Lowry",2,18,20,12,10,27.6
"263",263,2,0,1,4,2,10,5,3,3,34,1,3,15,2,2,2,3277500,"2023-11-24T00:00:00.000Z",391,16,"Josh Richardson",2,17,19,17,4,24.4
"264",264,0,0,0,0,0,0,0,0,0,0,0,0,0,0,0,0,3277500,"2023-11-24T00:00:00.000Z",74,16,"Thomas Bryant",0,0,0,0,0,0
"265",265,0,0,0,0,0,0,0,0,0,0,0,0,0,0,0,0,3277500,"2023-11-24T00:00:00.000Z",38017734,16,"Jamal Cain",0,0,0,0,0,0
"266",266,1,0,5,6,1,7,2,2,2,18,1,1,7,6,0,2,3277500,"2023-11-24T00:00:00.000Z",285,16,"Kevin Love",0,13,14,8,7,13.7
"267",267,1,0,3,3,0,5,1,0,0,18,0,3,2,3,1,0,3277500,"2023-11-24T00:00:00.000Z",666747,16,"Caleb Martin",1,5,6,3,4,10.1
"268",268,2,0,0,2,0,3,0,0,0,6,0,0,0,0,0,0,3277500,"2023-11-24T00:00:00.000Z",38017736,16,"Cole Swider",0,0,2,2,2,3
"269",269,0,0,0,0,0,0,0,0,0,0,0,0,0,0,0,0,3277500,"2023-11-24T00:00:00.000Z",3547257,16,"R.J. Hampton",0,0,0,0,0,0
"270",270,0,0,0,0,0,0,0,0,0,0,0,0,0,0,0,0,3277500,"2023-11-24T00:00:00.000Z",666633,16,"Tyler Herro",0,0,0,0,0,0
"271",271,0,0,0,0,0,0,0,0,0,0,0,0,0,0,0,0,3277500,"2023-11-24T00:00:00.000Z",38017696,16,"Nikola Jovic",0,0,0,0,0,0
"272",272,0,0,0,0,0,0,0,0,0,0,0,0,0,0,0,0,3277500,"2023-11-24T00:00:00.000Z",397,16,"Duncan Robinson",0,0,0,0,0,0
"273",273,0,0,0,0,0,0,0,0,0,0,0,0,0,0,0,0,3277500,"2023-11-24T00:00:00.000Z",39398582,16,"Orlando Robinson",0,0,0,0,0,0
"274",274,0,0,0,0,0,0,0,0,0,0,0,0,0,0,0,0,3277500,"2023-11-24T00:00:00.000Z",19465585,16,"Dru Smith",0,0,0,0,0,0
"275",275,4,0,2,6,1,17,6,2,2,35,3,3,15,5,1,0,3277500,"2023-11-24T00:00:00.000Z",56677785,16,"Jaime Jaquez Jr.",1,20,24,19,9,30
"276",276,0,0,0,0,0,0,0,0,0,0,0,0,0,0,0,0,3277500,"2023-11-24T00:00:00.000Z",19,20,"Ryan Arcidiacono",0,0,0,0,0,0
"277",277,0,0,0,0,0,0,0,0,0,0,0,0,0,0,0,0,3277500,"2023-11-24T00:00:00.000Z",160,20,"Evan Fournier",0,0,0,0,0,0
"278",278,0,0,0,0,0,0,0,0,0,0,0,0,0,0,0,0,3277500,"2023-11-24T00:00:00.000Z",666675,20,"DaQuan Jeffries",0,0,0,0,0,0
"279",279,0,0,0,0,0,0,0,0,0,0,0,0,0,0,0,0,3277500,"2023-11-24T00:00:00.000Z",17896033,20,"Miles McBride",0,0,0,0,0,0
"280",280,0,0,0,0,0,0,0,0,0,0,0,0,0,0,0,0,3277500,"2023-11-24T00:00:00.000Z",17896063,20,"Jericho Sims",0,0,0,0,0,0
"281",281,0,0,0,0,0,0,0,0,0,0,0,0,0,0,0,0,3277500,"2023-11-24T00:00:00.000Z",666474,20,"Charles Brown",0,0,0,0,0,0
"282",282,0,0,0,0,0,0,0,0,0,0,0,0,0,0,0,0,3277500,"2023-11-24T00:00:00.000Z",56677795,20,"Jacob Toppin",0,0,0,0,0,0
"283",283,0,0,0,0,0,0,0,0,0,0,0,0,0,0,0,0,3277500,"2023-11-24T00:00:00.000Z",17896089,20,"Duane Washington Jr.",0,0,0,0,0,0
"284",284,1,3,2,1,0,8,3,2,2,19,4,4,8,6,0,1,3277502,"2023-11-24T00:00:00.000Z",17896035,12,"Isaiah Jackson",3,14,15,9,7,24.7
"285",285,4,0,0,3,1,13,6,1,0,20,3,1,13,3,1,2,3277502,"2023-11-24T00:00:00.000Z",38017507,12,"Andrew Nembhard",1,16,20,17,7,23.6
"286",286,0,0,0,0,0,0,0,0,0,0,0,0,0,0,0,0,3277502,"2023-11-24T00:00:00.000Z",304,12,"T.J. McConnell",0,0,0,0,0,0
"287",287,0,0,0,0,0,0,0,0,0,0,0,0,0,0,0,0,3277502,"2023-11-24T00:00:00.000Z",3547207,12,"Jordan Nwora",0,0,0,0,0,0
"288",288,0,0,0,0,0,0,0,0,0,1,0,0,0,0,0,0,3277502,"2023-11-24T00:00:00.000Z",56677861,12,"Ben Sheppard",0,0,0,0,0,0
"289",289,0,0,0,0,0,0,0,0,0,0,0,0,0,0,0,0,3277502,"2023-11-24T00:00:00.000Z",3547240,9,"James Wiseman",0,0,0,0,0,0
"290",290,0,0,0,0,0,0,0,0,0,0,0,0,0,0,0,0,3277502,"2023-11-24T00:00:00.000Z",54,9,"Bojan Bogdanovic",0,0,0,0,0,0
"291",291,0,0,0,0,0,0,0,0,0,0,0,0,0,0,0,0,3277502,"2023-11-24T00:00:00.000Z",56677729,9,"Malcolm Cazalon",0,0,0,0,0,0
"292",292,0,0,0,0,0,0,0,0,0,0,0,0,0,0,0,0,3277502,"2023-11-24T00:00:00.000Z",197,9,"Joe Harris",0,0,0,0,0,0
"293",293,0,0,0,0,0,0,0,0,0,0,0,0,0,0,0,0,3277502,"2023-11-24T00:00:00.000Z",330,9,"Monte Morris",0,0,0,0,0,0
"294",294,0,0,0,0,0,0,0,0,0,0,0,0,0,0,0,0,3277502,"2023-11-24T00:00:00.000Z",42097199,9,"Jared Rhoden",0,0,0,0,0,0
"295",295,0,0,4,6,3,10,6,3,3,28,0,2,18,4,0,0,3277502,"2023-11-24T00:00:00.000Z",210,12,"Buddy Hield",0,22,22,18,4,22.8
"296",296,2,0,2,5,3,8,6,0,0,24,1,1,15,3,0,0,3277502,"2023-11-24T00:00:00.000Z",3547243,12,"Obi Toppin",0,18,20,17,5,21.6
"297",297,2,5,5,3,1,14,8,6,6,27,5,5,23,10,1,2,3277502,"2023-11-24T00:00:00.000Z",452,12,"Myles Turner",6,33,35,25,12,54
"298",298,5,0,4,3,0,10,3,5,4,37,0,3,10,4,3,0,3277502,"2023-11-24T00:00:00.000Z",69,12,"Bruce Brown",3,14,19,15,9,31.3
"299",299,10,0,2,13,5,23,9,3,3,32,0,0,26,2,0,1,3277502,"2023-11-24T00:00:00.000Z",3547245,12,"Tyrese Haliburton",0,28,38,36,12,42.4
"300",300,0,0,1,2,1,12,6,2,2,31,1,4,15,2,1,1,3277502,"2023-11-24T00:00:00.000Z",38017686,12,"Bennedict Mathurin",1,17,17,15,2,19.4
"301",301,0,0,5,2,2,3,2,2,2,21,1,1,8,6,1,1,3277502,"2023-11-24T00:00:00.000Z",3547264,12,"Jalen Smith",1,14,14,8,6,17.2
"302",302,0,0,0,0,0,0,0,0,0,0,0,0,0,0,0,0,3277502,"2023-11-24T00:00:00.000Z",56677832,12,"Jarace Walker",0,0,0,0,0,0
"303",303,0,0,0,0,0,0,0,0,0,0,0,0,0,0,0,0,3277502,"2023-11-24T00:00:00.000Z",38017701,12,"Kendall Brown",0,0,0,0,0,0
"304",304,0,0,0,0,0,0,0,0,0,0,0,0,0,0,0,0,3277502,"2023-11-24T00:00:00.000Z",3547250,12,"Aaron Nesmith",0,0,0,0,0,0
"305",305,0,0,0,0,0,0,0,0,0,0,0,0,0,0,0,0,3277502,"2023-11-24T00:00:00.000Z",56677778,12,"Oscar Tshiebwe",0,0,0,0,0,0
"306",306,0,0,0,0,0,0,0,0,0,0,0,0,0,0,0,0,3277502,"2023-11-24T00:00:00.000Z",56677794,12,"Isaiah Wong",0,0,0,0,0,0
"307",307,3,1,5,0,0,5,4,0,0,30,1,2,8,6,0,1,3277502,"2023-11-24T00:00:00.000Z",56677826,9,"Ausar Thompson",1,14,17,11,9,21.7
"308",308,1,1,3,0,0,8,4,2,2,27,3,1,10,6,2,0,3277502,"2023-11-24T00:00:00.000Z",3547267,9,"Isaiah Stewart",3,16,17,11,7,27.7
"309",309,2,3,3,0,0,6,3,0,0,14,3,1,6,6,0,1,3277502,"2023-11-24T00:00:00.000Z",24,9,"Marvin Bagley III",3,12,14,8,8,24.2
"310",310,3,1,0,6,1,16,9,9,6,32,2,3,25,2,1,3,3277502,"2023-11-24T00:00:00.000Z",38017682,9,"Jaden Ivey",2,27,30,28,5,34.9
"311",311,5,0,3,4,2,26,10,9,9,38,0,0,31,3,0,4,3277502,"2023-11-24T00:00:00.000Z",17896075,9,"Cade Cunningham",0,34,39,36,8,38.1
"312",312,4,1,9,1,0,10,5,4,3,29,4,5,13,13,1,2,3277502,"2023-11-24T00:00:00.000Z",38017694,9,"Jalen Duren",2,26,30,17,17,38.6
"313",313,0,0,2,4,2,5,3,0,0,26,0,2,8,2,0,0,3277502,"2023-11-24T00:00:00.000Z",17896071,9,"Isaiah Livers",0,10,10,8,2,10.4
"314",314,1,1,2,3,2,6,2,0,0,14,0,1,6,2,1,2,3277502,"2023-11-24T00:00:00.000Z",77,9,"Alec Burks",2,8,9,7,3,13.9
"315",315,3,0,1,0,0,6,3,0,0,17,0,0,6,1,0,0,3277502,"2023-11-24T00:00:00.000Z",3547241,9,"Killian Hayes",0,7,10,9,4,11.7
"316",316,0,2,1,0,0,1,0,0,0,8,1,3,0,2,1,1,3277502,"2023-11-24T00:00:00.000Z",44477024,9,"Stanley Umude",3,2,2,0,2,10.4
"317",317,0,0,0,0,0,0,0,0,0,0,0,0,0,0,0,0,3277502,"2023-11-24T00:00:00.000Z",259,9,"Kevin Knox",0,0,0,0,0,0
"318",318,0,0,0,0,0,1,0,0,0,5,0,0,0,0,0,0,3277502,"2023-11-24T00:00:00.000Z",56677792,9,"Marcus Sasser",0,0,0,0,0,0
"319",319,0,0,0,0,0,0,0,0,0,0,0,0,0,0,0,0,3277453,"2023-11-17T00:00:00.000Z",666451,24,"Bol Bol",0,0,0,0,0,0
"320",320,0,0,4,1,1,5,5,0,0,21,0,2,11,4,0,0,3277453,"2023-11-17T00:00:00.000Z",147,24,"Drew Eubanks",0,15,15,11,4,15.8
"321",321,4,0,2,4,1,6,1,0,0,14,0,2,3,2,1,0,3277453,"2023-11-17T00:00:00.000Z",18678058,24,"Jordan Goodwin",1,5,9,7,6,14.4
"322",322,0,0,0,0,0,0,0,0,0,0,0,0,0,0,0,0,3277453,"2023-11-17T00:00:00.000Z",3547298,24,"Saben Lee",0,0,0,0,0,0
"323",323,1,0,1,2,1,3,2,0,0,11,0,0,5,1,0,0,3277453,"2023-11-17T00:00:00.000Z",666729,24,"Nassir Little",0,6,7,6,2,7.7
"324",324,0,0,0,0,0,0,0,0,0,0,0,0,0,0,0,0,3277453,"2023-11-17T00:00:00.000Z",314,24,"Chimezie Metu",0,0,0,0,0,0
"325",325,0,0,0,0,0,1,0,2,1,13,1,2,1,1,0,1,3277453,"2023-11-17T00:00:00.000Z",356,24,"Josh Okogie",0,2,2,1,1,1.2
"326",326,0,0,1,2,1,3,1,0,0,10,1,1,3,2,0,0,3277453,"2023-11-17T00:00:00.000Z",470,24,"Yuta Watanabe",0,5,5,3,2,5.4
"327",327,0,0,0,0,0,0,0,0,0,0,0,0,0,0,0,0,3277453,"2023-11-17T00:00:00.000Z",37,24,"Bradley Beal",0,0,0,0,0,0
"328",328,0,0,0,0,0,0,0,0,0,0,0,0,0,0,0,0,3277453,"2023-11-17T00:00:00.000Z",272,24,"Damion Lee",0,0,0,0,0,0
"329",329,0,3,3,2,2,4,3,0,0,25,2,3,8,5,0,0,3277453,"2023-11-17T00:00:00.000Z",38017620,29,"Ochai Agbaji",3,13,13,8,5,23
"330",330,1,2,10,2,1,10,5,6,4,35,4,6,15,14,0,0,3277453,"2023-11-17T00:00:00.000Z",101,29,"John Collins",2,29,30,16,15,39.3
"331",331,0,2,2,4,1,12,5,12,10,40,0,1,21,2,1,0,3277453,"2023-11-17T00:00:00.000Z",297,29,"Lauri Markkanen",3,23,23,21,2,32.4
"332",332,5,0,2,10,5,26,14,4,4,36,1,0,37,3,1,0,3277453,"2023-11-17T00:00:00.000Z",100,29,"Jordan Clarkson",1,40,45,42,8,51.1
"333",333,6,0,3,6,3,11,5,3,2,29,0,2,15,3,1,3,3277453,"2023-11-17T00:00:00.000Z",56677834,29,"Keyonte George",1,18,24,21,9,27.6
"334",334,0,0,0,0,0,0,0,0,0,1,0,0,0,0,0,0,3277453,"2023-11-17T00:00:00.000Z",139,29,"Kris Dunn",0,0,0,0,0,0
"335",335,0,0,1,4,2,5,3,0,0,15,0,2,8,1,0,1,3277453,"2023-11-17T00:00:00.000Z",38017739,29,"Simone Fontecchio",0,9,9,8,1,8.2
"336",336,0,0,0,0,0,0,0,0,0,0,0,0,0,0,0,0,3277453,"2023-11-17T00:00:00.000Z",56677824,29,"Taylor Hendricks",0,0,0,0,0,0
"337",337,4,2,2,2,0,8,3,2,2,20,2,3,8,4,0,0,3277453,"2023-11-17T00:00:00.000Z",413,29,"Collin Sexton",2,12,16,12,8,24.8
"338",338,0,0,0,0,0,0,0,0,0,0,0,0,0,0,0,0,3277453,"2023-11-17T00:00:00.000Z",11891374,29,"Omer Yurtseven",0,0,0,0,0,0
"339",339,0,0,0,0,0,0,0,0,0,0,0,0,0,0,0,0,3277453,"2023-11-17T00:00:00.000Z",17896023,29,"Josh Christopher",0,0,0,0,0,0
"340",340,0,0,0,0,0,0,0,0,0,0,0,0,0,0,0,0,3277453,"2023-11-17T00:00:00.000Z",38017630,29,"Johnny Juzang",0,0,0,0,0,0
"341",341,0,0,0,0,0,0,0,0,0,0,0,0,0,0,0,0,3277453,"2023-11-17T00:00:00.000Z",38017705,29,"Walker Kessler",0,0,0,0,0,0
"342",342,0,0,0,0,0,0,0,0,0,0,0,0,0,0,0,0,3277453,"2023-11-17T00:00:00.000Z",19465584,29,"Micah Potter",0,0,0,0,0,0
"343",343,1,1,2,8,4,12,5,0,0,33,0,2,14,2,1,1,3277453,"2023-11-17T00:00:00.000Z",178,24,"Eric Gordon",2,16,17,15,3,22.9
"344",344,9,0,9,8,6,22,15,2,2,33,0,1,38,9,0,1,3277453,"2023-11-17T00:00:00.000Z",140,24,"Kevin Durant",0,47,56,47,18,61.3
"345",345,4,0,5,1,0,7,4,7,7,23,2,4,15,7,1,4,3277453,"2023-11-17T00:00:00.000Z",349,24,"Jusuf Nurkic",1,22,26,19,11,28.4
"346",346,1,0,1,4,2,8,3,2,2,30,0,1,10,1,0,0,3277453,"2023-11-17T00:00:00.000Z",8,24,"Grayson Allen",0,11,12,11,2,12.7
"347",347,15,0,4,3,2,15,7,10,8,32,0,3,24,4,0,1,3277453,"2023-11-17T00:00:00.000Z",57,24,"Devin Booker",0,28,43,39,19,50.3
"348",348,0,0,0,0,0,0,0,0,0,0,0,0,0,0,0,0,3277453,"2023-11-17T00:00:00.000Z",3547095,24,"Udoka Azubuike",0,0,0,0,0,0
"349",349,0,3,2,0,0,4,2,3,3,20,1,4,7,3,2,0,3277453,"2023-11-17T00:00:00.000Z",32,24,"Keita Bates-Diop",5,10,10,7,3,25.6
"350",350,4,1,3,4,1,5,2,4,4,19,0,4,9,3,0,3,3277453,"2023-11-17T00:00:00.000Z",666650,29,"Talen Horton-Tucker",1,12,16,13,7,18.6
"351",351,7,0,3,2,1,4,3,0,0,20,1,2,7,4,0,1,3277453,"2023-11-17T00:00:00.000Z",358,29,"Kelly Olynyk",0,11,18,14,11,21.3
"352",352,0,0,0,0,0,0,0,0,0,0,0,0,0,0,0,0,3277453,"2023-11-17T00:00:00.000Z",666881,29,"Luka Samanic",0,0,0,0,0,0
"353",353,0,0,0,0,0,0,0,0,0,0,0,0,0,0,0,0,3277453,"2023-11-17T00:00:00.000Z",56677842,29,"Brice Sensabaugh",0,0,0,0,0,0
"354",354,2,0,1,3,2,8,2,2,2,30,1,4,8,2,0,2,3277503,"2023-11-24T00:00:00.000Z",66,11,"Dillon Brooks",0,10,12,10,4,11.4
"355",355,1,1,11,3,2,9,6,2,2,38,3,2,16,14,1,1,3277503,"2023-11-24T00:00:00.000Z",38017684,11,"Jabari Smith Jr.",2,30,31,17,15,39.3
"356",356,8,1,13,4,0,19,8,6,5,43,1,4,21,14,2,5,3277503,"2023-11-24T00:00:00.000Z",17896062,11,"Alperen Sengun",3,35,43,29,22,53.8
"357",357,2,0,6,8,3,18,10,3,2,36,0,0,25,6,2,3,3277503,"2023-11-24T00:00:00.000Z",17895966,11,"Jalen Green",2,31,33,27,8,38.2
"358",358,11,2,6,5,3,12,6,2,2,39,0,3,17,6,1,1,3277503,"2023-11-24T00:00:00.000Z",458,11,"Fred VanVleet",3,23,34,28,17,48.7
"359",359,0,0,0,0,0,0,0,0,0,0,0,0,0,0,0,0,3277503,"2023-11-24T00:00:00.000Z",75,11,"Reggie Bullock",0,0,0,0,0,0
"360",360,1,0,3,2,1,6,3,0,0,16,1,2,7,4,1,0,3277503,"2023-11-24T00:00:00.000Z",38017695,11,"Tari Eason",1,11,12,8,5,16.3
"361",361,0,3,0,2,0,2,0,0,0,8,0,0,0,0,0,0,3277503,"2023-11-24T00:00:00.000Z",188,11,"Jeff Green",3,0,0,0,0,9
"362",362,0,1,0,1,1,4,3,0,0,14,0,2,7,0,1,0,3277503,"2023-11-24T00:00:00.000Z",213,11,"Aaron Holiday",2,7,7,7,0,13
"363",363,0,0,0,0,0,0,0,0,0,0,0,0,0,0,0,0,3277503,"2023-11-24T00:00:00.000Z",19465326,11,"Jock Landale",0,0,0,0,0,0
"364",364,0,0,0,0,0,0,0,0,0,0,0,0,0,0,0,0,3277503,"2023-11-24T00:00:00.000Z",296,11,"Boban Marjanovic",0,0,0,0,0,0
"365",365,0,1,3,1,0,4,2,0,0,16,0,4,4,3,0,1,3277503,"2023-11-24T00:00:00.000Z",3547301,11,"Jae'Sean Tate",1,7,7,4,3,9.6
"366",366,0,0,0,0,0,0,0,0,0,0,0,0,0,0,0,0,3277503,"2023-11-24T00:00:00.000Z",47738533,11,"Jeenathan Williams",0,0,0,0,0,0
"367",367,0,0,0,0,0,0,0,0,0,0,0,0,0,0,0,0,3277503,"2023-11-24T00:00:00.000Z",3547281,11,"Nate Hinton",0,0,0,0,0,0
"368",368,0,0,0,0,0,0,0,0,0,0,0,0,0,0,0,0,3277503,"2023-11-24T00:00:00.000Z",357,11,"Victor Oladipo",0,0,0,0,0,0
"369",369,0,0,0,0,0,0,0,0,0,0,0,0,0,0,0,0,3277503,"2023-11-24T00:00:00.000Z",56677809,11,"Jermaine Samuels Jr.",0,0,0,0,0,0
"370",370,0,0,0,0,0,0,0,0,0,0,0,0,0,0,0,0,3277503,"2023-11-24T00:00:00.000Z",56677825,11,"Amen Thompson",0,0,0,0,0,0
"371",371,0,0,0,0,0,0,0,0,0,0,0,0,0,0,0,0,3277503,"2023-11-24T00:00:00.000Z",56677831,11,"Cam Whitmore",0,0,0,0,0,0
"372",372,1,2,6,8,2,14,6,0,0,37,1,1,14,7,1,1,3277503,"2023-11-24T00:00:00.000Z",375,8,"Michael Porter Jr.",3,21,22,15,8,31.9
"373",373,2,0,4,4,0,12,0,4,2,39,3,1,2,7,0,1,3277503,"2023-11-24T00:00:00.000Z",177,8,"Aaron Gordon",0,9,11,4,9,12.4
"374",374,8,0,13,8,3,31,14,11,7,42,6,3,38,19,2,3,3277503,"2023-11-24T00:00:00.000Z",246,8,"Nikola Jokic",2,57,65,46,27,75.8
"375",375,3,0,2,5,1,15,7,5,5,39,3,4,20,5,3,2,3277503,"2023-11-24T00:00:00.000Z",81,8,"Kentavious Caldwell-Pope",3,25,28,23,8,37.5
"376",376,3,1,2,2,0,8,1,0,0,25,2,0,2,4,0,5,3277503,"2023-11-24T00:00:00.000Z",236,8,"Reggie Jackson",1,6,9,5,7,9.3
"377",377,0,0,3,0,0,9,3,1,1,26,0,1,7,3,0,0,3277503,"2023-11-24T00:00:00.000Z",38017709,8,"Christian Braun",0,10,10,7,3,10.6
"378",378,0,0,0,0,0,0,0,0,0,3,0,0,0,0,0,1,3277503,"2023-11-24T00:00:00.000Z",38017727,8,"Collin Gillespie",0,0,0,0,0,-1
"379",379,0,0,0,2,1,2,1,0,0,13,0,2,3,0,1,0,3277503,"2023-11-24T00:00:00.000Z",215,8,"Justin Holiday",1,3,3,3,0,6
"380",380,0,0,0,0,0,0,0,0,0,0,0,0,0,0,0,0,3277503,"2023-11-24T00:00:00.000Z",250,8,"DeAndre Jordan",0,0,0,0,0,0
"381",381,0,0,0,0,0,0,0,0,0,0,0,0,0,0,0,0,3277503,"2023-11-24T00:00:00.000Z",17896007,8,"Braxton Key",0,0,0,0,0,0
"382",382,0,0,0,0,0,1,0,0,0,4,0,0,0,0,0,1,3277503,"2023-11-24T00:00:00.000Z",3547268,8,"Zeke Nnaji",0,0,0,0,0,-1
"383",383,0,0,0,0,0,0,0,0,0,0,0,0,0,0,0,0,3277503,"2023-11-24T00:00:00.000Z",56677582,8,"Jalen Pickett",0,0,0,0,0,0
"384",384,0,0,0,0,0,0,0,0,0,6,0,1,0,0,0,0,3277503,"2023-11-24T00:00:00.000Z",56677776,8,"Julian Strawther",0,0,0,0,0,0
"385",385,0,0,0,0,0,0,0,0,0,0,0,0,0,0,0,0,3277503,"2023-11-24T00:00:00.000Z",56677871,8,"Hunter Tyson",0,0,0,0,0,0
"386",386,0,1,0,1,0,3,0,0,0,6,1,1,0,1,0,0,3277503,"2023-11-24T00:00:00.000Z",38017721,8,"Peyton Watson",1,1,1,0,1,4.2
"387",387,0,0,0,0,0,0,0,0,0,0,0,0,0,0,0,0,3277503,"2023-11-24T00:00:00.000Z",666489,8,"Vlatko Cancar",0,0,0,0,0,0
"388",388,0,0,0,0,0,0,0,0,0,0,0,0,0,0,0,0,3277503,"2023-11-24T00:00:00.000Z",17896103,8,"Jay Huff",0,0,0,0,0,0
"389",389,0,0,0,0,0,0,0,0,0,0,0,0,0,0,0,0,3277503,"2023-11-24T00:00:00.000Z",335,8,"Jamal Murray",0,0,0,0,0,0
"390",390,0,0,4,10,3,20,9,0,0,36,1,2,21,5,0,0,3277499,"2023-11-24T00:00:00.000Z",17896067,15,"Santi Aldama",0,26,26,21,5,27
"391",391,2,0,3,4,1,13,5,4,2,29,4,5,13,7,1,3,3277499,"2023-11-24T00:00:00.000Z",231,15,"Jaren Jackson Jr.",1,20,22,15,9,24.4
"392",392,1,1,3,0,0,5,3,0,0,29,1,3,6,4,0,1,3277499,"2023-11-24T00:00:00.000Z",48,15,"Bismack Biyombo",1,10,11,7,5,14.3
"393",393,10,0,5,5,0,12,3,0,0,34,0,3,6,5,1,3,3277499,"2023-11-24T00:00:00.000Z",3547287,15,"Desmond Bane",1,11,21,16,15,27
"394",394,5,0,0,4,1,5,2,1,1,23,0,2,6,0,0,2,3277499,"2023-11-24T00:00:00.000Z",48248287,15,"Jacob Gilyard",0,6,11,11,5,11.5
"395",395,0,0,0,0,0,0,0,0,0,2,0,0,0,0,0,0,3277499,"2023-11-24T00:00:00.000Z",199,15,"Shaquille Harrison",0,0,0,0,0,0
"396",396,0,0,0,1,0,1,0,0,0,1,0,0,0,0,1,1,3277499,"2023-11-24T00:00:00.000Z",56677830,15,"GG Jackson",1,0,0,0,0,2
"397",397,1,0,3,1,0,2,0,2,1,18,0,1,1,3,0,0,3277499,"2023-11-24T00:00:00.000Z",666703,15,"John Konchar",0,4,5,2,4,6.1
"398",398,0,0,0,0,0,1,1,0,0,2,0,1,2,0,0,0,3277499,"2023-11-24T00:00:00.000Z",38017732,15,"Kenneth Lofton Jr.",0,2,2,2,0,2
"399",399,0,0,0,0,0,0,0,0,0,2,0,0,0,0,0,0,3277499,"2023-11-24T00:00:00.000Z",666809,15,"Jaylen Nowell",0,0,0,0,0,0
"400",400,0,1,4,4,2,9,5,3,2,27,0,0,14,4,2,2,3277499,"2023-11-24T00:00:00.000Z",38017729,15,"David Roddy",3,18,18,14,4,25.8
"401",401,1,0,2,1,1,9,8,0,0,21,0,0,17,2,1,1,3277499,"2023-11-24T00:00:00.000Z",401,15,"Derrick Rose",1,19,20,18,3,22.9
"402",402,1,0,5,2,1,2,1,0,0,14,0,4,3,5,0,0,3277499,"2023-11-24T00:00:00.000Z",38017731,15,"Vince Williams Jr.",0,8,9,4,6,10.5
"403",403,1,0,0,1,0,1,0,0,0,2,0,1,0,0,0,0,3277499,"2023-11-24T00:00:00.000Z",17896027,15,"Ziaire Williams",0,0,1,1,1,1.5
"404",404,0,0,0,0,0,0,0,0,0,0,0,0,0,0,0,0,3277499,"2023-11-24T00:00:00.000Z",3,15,"Steven Adams",0,0,0,0,0,0
"405",405,0,0,0,0,0,0,0,0,0,0,0,0,0,0,0,0,3277499,"2023-11-24T00:00:00.000Z",666505,15,"Brandon Clarke",0,0,0,0,0,0
"406",406,0,0,0,0,0,0,0,0,0,0,0,0,0,0,0,0,3277499,"2023-11-24T00:00:00.000Z",254,15,"Luke Kennard",0,0,0,0,0,0
"407",407,0,0,0,0,0,0,0,0,0,0,0,0,0,0,0,0,3277499,"2023-11-24T00:00:00.000Z",38017728,15,"Jake LaRavia",0,0,0,0,0,0
"408",408,3,0,6,4,1,9,2,1,0,28,1,1,5,7,1,0,3277499,"2023-11-24T00:00:00.000Z",356,24,"Josh Okogie",1,12,15,8,10,20.9
"409",409,0,0,0,0,0,0,0,0,0,0,0,0,0,0,0,0,3277499,"2023-11-24T00:00:00.000Z",666786,15,"Ja Morant",0,0,0,0,0,0
"410",410,0,0,0,0,0,0,0,0,0,0,0,0,0,0,0,0,3277499,"2023-11-24T00:00:00.000Z",420,15,"Marcus Smart",0,0,0,0,0,0
"411",411,0,0,0,0,0,0,0,0,0,0,0,0,0,0,0,0,3277499,"2023-11-24T00:00:00.000Z",3547285,15,"Xavier Tillman",0,0,0,0,0,0
"412",412,2,0,1,11,4,15,6,4,4,34,0,0,20,1,0,2,3277499,"2023-11-24T00:00:00.000Z",178,24,"Eric Gordon",0,21,23,22,3,22.2
"413",413,1,2,3,1,0,5,2,2,2,24,1,0,6,4,1,0,3277499,"2023-11-24T00:00:00.000Z",32,24,"Keita Bates-Diop",3,10,11,7,5,21.3
"414",414,6,2,9,2,0,4,2,4,2,33,1,2,6,10,2,2,3277499,"2023-11-24T00:00:00.000Z",349,24,"Jusuf Nurkic",4,16,22,12,16,37
"415",415,3,1,2,4,2,9,5,3,2,37,0,2,14,2,0,1,3277499,"2023-11-24T00:00:00.000Z",8,24,"Grayson Allen",1,16,19,17,5,22.9
"416",416,4,1,4,4,3,21,15,9,7,33,1,3,40,5,4,5,3277499,"2023-11-24T00:00:00.000Z",57,24,"Devin Booker",5,45,49,44,9,62
"417",417,1,0,2,1,0,3,1,2,1,15,0,2,3,2,0,0,3277499,"2023-11-24T00:00:00.000Z",314,24,"Chimezie Metu",0,5,6,4,3,6.9
"418",418,0,0,4,1,0,1,0,2,2,16,0,2,2,4,1,1,3277499,"2023-11-24T00:00:00.000Z",666729,24,"Nassir Little",1,6,6,2,4,8.8
"419",419,2,0,3,3,1,8,6,1,1,20,2,0,14,5,1,1,3277499,"2023-11-24T00:00:00.000Z",18678058,24,"Jordan Goodwin",1,19,21,16,7,25
"420",420,0,0,0,0,0,0,0,0,0,0,0,0,0,0,0,0,3277499,"2023-11-24T00:00:00.000Z",3547095,24,"Udoka Azubuike",0,0,0,0,0,0
"421",421,0,0,0,0,0,0,0,0,0,0,0,0,0,0,0,0,3277499,"2023-11-24T00:00:00.000Z",666451,24,"Bol Bol",0,0,0,0,0,0
"422",422,0,0,0,0,0,0,0,0,0,0,0,0,0,0,0,0,3277499,"2023-11-24T00:00:00.000Z",3547298,24,"Saben Lee",0,0,0,0,0,0
"423",423,0,0,0,0,0,0,0,0,0,0,0,0,0,0,0,0,3277499,"2023-11-24T00:00:00.000Z",37,24,"Bradley Beal",0,0,0,0,0,0
"424",424,0,0,0,0,0,0,0,0,0,0,0,0,0,0,0,0,3277499,"2023-11-24T00:00:00.000Z",140,24,"Kevin Durant",0,0,0,0,0,0
"425",425,0,0,0,0,0,0,0,0,0,0,0,0,0,0,0,0,3277499,"2023-11-24T00:00:00.000Z",147,24,"Drew Eubanks",0,0,0,0,0,0
"426",426,0,0,0,0,0,0,0,0,0,0,0,0,0,0,0,0,3277499,"2023-11-24T00:00:00.000Z",272,24,"Damion Lee",0,0,0,0,0,0
"427",427,0,0,0,0,0,0,0,0,0,0,0,0,0,0,0,0,3277499,"2023-11-24T00:00:00.000Z",470,24,"Yuta Watanabe",0,0,0,0,0,0
"428",428,12,0,5,7,3,32,14,6,5,37,2,3,36,7,1,2,3277505,"2023-11-24T00:00:00.000Z",161,26,"De'Aaron Fox",1,43,55,48,19,63.4
"429",429,0,0,2,6,3,14,6,2,2,30,0,2,17,2,1,3,3277505,"2023-11-24T00:00:00.000Z",324,26,"Malik Monk",1,19,19,17,2,19.4
"430",430,1,0,0,1,1,2,2,0,0,9,0,1,5,0,0,1,3277505,"2023-11-24T00:00:00.000Z",17553994,26,"Davion Mitchell",0,5,6,6,1,5.5
"431",431,1,0,1,3,2,7,4,0,0,18,1,1,10,2,1,0,3277505,"2023-11-24T00:00:00.000Z",17896044,26,"Kessler Edwards",1,12,13,11,3,16.9
"432",432,1,0,4,0,0,2,2,0,0,8,2,1,4,6,0,0,3277505,"2023-11-24T00:00:00.000Z",306,26,"JaVale McGee",0,10,11,5,7,12.7
"433",433,0,0,6,6,3,6,3,0,0,19,1,1,9,7,0,1,3277505,"2023-11-24T00:00:00.000Z",290,26,"Trey Lyles",0,16,16,9,7,16.4
"434",434,0,0,0,0,0,0,0,0,0,0,0,0,0,0,0,0,3277505,"2023-11-24T00:00:00.000Z",56677845,26,"Colby Jones",0,0,0,0,0,0
"435",435,0,0,0,0,0,0,0,0,0,0,0,0,0,0,0,0,3277505,"2023-11-24T00:00:00.000Z",17895941,26,"Filip Petrusev",0,0,0,0,0,0
"436",436,2,1,0,7,2,8,2,0,0,22,1,4,6,1,2,0,3277505,"2023-11-24T00:00:00.000Z",666400,18,"Nickeil Alexander-Walker",3,7,9,8,3,19.2
"437",437,4,0,10,5,4,15,9,5,5,38,1,3,27,11,0,4,3277505,"2023-11-24T00:00:00.000Z",447,18,"Karl-Anthony Towns",0,38,42,31,15,42.2
"438",438,0,2,8,0,0,8,5,2,2,36,3,5,12,11,0,3,3277505,"2023-11-24T00:00:00.000Z",176,18,"Rudy Gobert",2,23,23,12,11,28.2
"439",439,5,2,7,9,2,21,8,18,17,40,0,2,35,7,2,4,3277505,"2023-11-24T00:00:00.000Z",3547238,18,"Anthony Edwards",4,42,47,40,12,58.9
"440",440,8,0,2,3,2,7,2,0,0,30,1,1,6,3,1,1,3277505,"2023-11-24T00:00:00.000Z",104,18,"Mike Conley",1,9,17,14,11,23.6
"441",441,4,0,1,0,0,2,1,2,2,18,0,1,4,1,0,0,3277505,"2023-11-24T00:00:00.000Z",12,18,"Kyle Anderson",0,5,9,8,5,11.2
"442",442,0,1,4,5,1,8,4,2,1,25,3,1,10,7,0,0,3277505,"2023-11-24T00:00:00.000Z",68,18,"Troy Brown Jr.",1,17,17,10,7,21.4
"443",443,0,0,0,0,0,0,0,0,0,0,0,0,0,0,0,0,3277505,"2023-11-24T00:00:00.000Z",56677782,18,"Leonard Miller",0,0,0,0,0,0
"444",444,1,1,1,1,0,6,1,0,0,13,1,1,2,2,1,3,3277505,"2023-11-24T00:00:00.000Z",320,18,"Shake Milton",2,4,5,3,3,8.9
"445",445,0,0,0,0,0,0,0,0,0,0,0,0,0,0,0,0,3277505,"2023-11-24T00:00:00.000Z",38017715,18,"Josh Minott",0,0,0,0,0,0
"446",446,0,0,0,0,0,0,0,0,0,0,0,0,0,0,0,0,3277505,"2023-11-24T00:00:00.000Z",17895968,18,"Daishen Nix",0,0,0,0,0,0
"447",447,0,1,1,3,1,7,4,0,0,18,0,0,9,1,0,3,3277505,"2023-11-24T00:00:00.000Z",667378,18,"Naz Reid",1,10,10,9,1,10.2
"448",448,0,0,0,0,0,0,0,0,0,0,0,0,0,0,0,0,3277505,"2023-11-24T00:00:00.000Z",56677851,18,"Jaylen Clark",0,0,0,0,0,0
"449",449,0,0,0,0,0,0,0,0,0,0,0,0,0,0,0,0,3277505,"2023-11-24T00:00:00.000Z",17896056,18,"Luka Garza",0,0,0,0,0,0
"450",450,0,0,0,0,0,0,0,0,0,0,0,0,0,0,0,0,3277505,"2023-11-24T00:00:00.000Z",3547259,18,"Jaden McDaniels",0,0,0,0,0,0
"451",451,0,0,0,0,0,0,0,0,0,0,0,0,0,0,0,0,3277505,"2023-11-24T00:00:00.000Z",666767,18,"Jordan McLaughlin",0,0,0,0,0,0
"452",452,0,0,0,0,0,0,0,0,0,0,0,0,0,0,0,0,3277505,"2023-11-24T00:00:00.000Z",38017700,18,"Wendell Moore Jr.",0,0,0,0,0,0
"453",453,0,0,0,0,0,0,0,0,0,0,0,0,0,0,0,0,3277505,"2023-11-24T00:00:00.000Z",4197162,26,"Aleksandar Vezenkov",0,0,0,0,0,0
"454",454,0,0,0,0,0,0,0,0,0,0,0,0,0,0,0,0,3277505,"2023-11-24T00:00:00.000Z",38017714,26,"Keon Ellis",0,0,0,0,0,0
"455",455,0,0,0,0,0,0,0,0,0,0,0,0,0,0,0,0,3277505,"2023-11-24T00:00:00.000Z",17895990,26,"Jordan Ford",0,0,0,0,0,0
"456",456,0,0,0,0,0,0,0,0,0,0,0,0,0,0,0,0,3277505,"2023-11-24T00:00:00.000Z",273,26,"Alex Len",0,0,0,0,0,0
"457",457,0,0,0,0,0,0,0,0,0,0,0,0,0,0,0,0,3277505,"2023-11-24T00:00:00.000Z",38017688,26,"Keegan Murray",0,0,0,0,0,0
"458",458,0,0,0,0,0,0,0,0,0,0,0,0,0,0,0,0,3277505,"2023-11-24T00:00:00.000Z",56677862,26,"Jalen Slawson",0,0,0,0,0,0
"459",459,3,1,1,5,2,8,4,0,0,25,1,1,10,2,0,0,3277505,"2023-11-24T00:00:00.000Z",221,26,"Kevin Huerter",1,12,15,13,5,19.9
"460",460,2,0,4,4,2,11,7,2,2,33,0,0,18,4,0,2,3277505,"2023-11-24T00:00:00.000Z",30,26,"Harrison Barnes",0,22,24,20,6,23.8
"461",461,5,3,6,1,1,15,7,1,0,39,5,6,15,11,3,2,3277505,"2023-11-24T00:00:00.000Z",406,26,"Domantas Sabonis",6,26,31,20,16,51.7
"462",462,0,0,3,2,0,3,0,0,0,22,2,3,0,5,1,2,3277505,"2023-11-24T00:00:00.000Z",17896030,26,"Chris Duarte",1,5,5,0,5,7
"463",463,1,0,2,2,1,7,3,0,0,27,2,2,7,4,1,3,3277480,"2023-11-21T00:00:00.000Z",666656,1,"De'Andre Hunter",1,11,12,8,5,13.3
"464",464,6,1,6,2,0,12,6,5,5,33,1,2,17,7,2,1,3277480,"2023-11-21T00:00:00.000Z",17896040,1,"Jalen Johnson",3,24,30,23,13,42.4
"465",465,1,2,2,0,0,9,6,3,2,19,3,4,14,5,0,1,3277480,"2023-11-21T00:00:00.000Z",83,1,"Clint Capela",2,19,20,15,6,26.5
"466",466,5,0,2,6,4,20,11,2,2,34,1,3,28,3,2,5,3277480,"2023-11-21T00:00:00.000Z",334,1,"Dejounte Murray",2,31,36,33,8,40.1
"467",467,8,0,1,8,5,17,13,8,7,39,0,3,38,1,3,3,3277480,"2023-11-21T00:00:00.000Z",490,1,"Trae Young",3,39,47,46,9,57.2
"468",468,2,0,9,4,2,7,4,5,2,31,2,0,12,11,0,0,3277480,"2023-11-21T00:00:00.000Z",3547256,1,"Saddiq Bey",0,23,25,14,13,28.2
"469",469,0,0,2,5,2,15,10,4,4,26,0,4,26,2,0,0,3277480,"2023-11-21T00:00:00.000Z",53,1,"Bogdan Bogdanovic",0,28,28,26,2,28.4
"470",470,1,4,8,2,0,7,4,4,3,25,1,3,11,9,0,1,3277480,"2023-11-21T00:00:00.000Z",452,12,"Myles Turner",4,20,21,12,10,34.3
"471",471,3,0,0,5,2,10,5,2,1,30,0,4,13,0,2,2,3277480,"2023-11-21T00:00:00.000Z",69,12,"Bruce Brown",2,13,16,16,3,21.5
"472",472,16,1,4,15,9,18,11,7,6,39,1,0,37,5,3,6,3277480,"2023-11-21T00:00:00.000Z",3547245,12,"Tyrese Haliburton",4,42,58,53,21,73
"473",473,1,4,4,0,0,1,1,0,0,12,1,5,2,5,0,1,3277480,"2023-11-21T00:00:00.000Z",17896035,12,"Isaiah Jackson",4,7,8,3,6,20.5
"474",474,1,0,2,4,2,10,7,4,3,20,0,2,19,2,0,0,3277480,"2023-11-21T00:00:00.000Z",38017686,12,"Bennedict Mathurin",0,21,22,20,3,22.9
"475",475,4,0,0,0,0,5,1,0,0,14,0,1,2,0,0,0,3277480,"2023-11-21T00:00:00.000Z",304,12,"T.J. McConnell",0,2,6,6,4,8
"476",476,0,0,0,0,0,0,0,0,0,0,0,0,0,0,0,0,3277480,"2023-11-21T00:00:00.000Z",3547207,12,"Jordan Nwora",0,0,0,0,0,0
"477",477,1,0,1,4,1,5,2,0,0,5,0,0,5,1,0,0,3277480,"2023-11-21T00:00:00.000Z",56677861,12,"Ben Sheppard",0,6,7,6,2,7.7
"478",478,0,0,1,0,0,2,2,4,2,5,2,0,6,3,0,0,3277480,"2023-11-21T00:00:00.000Z",3547264,12,"Jalen Smith",0,9,9,6,3,9.6
"479",479,6,1,1,6,1,16,9,2,2,34,0,3,21,1,1,2,3277480,"2023-11-21T00:00:00.000Z",3547243,12,"Obi Toppin",2,22,28,27,7,35.2
"480",480,0,0,0,0,0,0,0,0,0,0,0,0,0,0,0,0,3277480,"2023-11-21T00:00:00.000Z",56677832,12,"Jarace Walker",0,0,0,0,0,0
"481",481,0,0,0,0,0,0,0,0,0,0,0,0,0,0,0,0,3277480,"2023-11-21T00:00:00.000Z",38017701,12,"Kendall Brown",0,0,0,0,0,0
"482",482,0,0,0,0,0,0,0,0,0,0,0,0,0,0,0,0,3277480,"2023-11-21T00:00:00.000Z",38017507,12,"Andrew Nembhard",0,0,0,0,0,0
"483",483,0,0,0,0,0,0,0,0,0,0,0,0,0,0,0,0,3277480,"2023-11-21T00:00:00.000Z",56677778,12,"Oscar Tshiebwe",0,0,0,0,0,0
"484",484,0,0,0,0,0,0,0,0,0,0,0,0,0,0,0,0,3277480,"2023-11-21T00:00:00.000Z",56677794,12,"Isaiah Wong",0,0,0,0,0,0
"485",485,4,1,2,2,0,7,3,1,1,22,4,2,7,6,0,1,3277480,"2023-11-21T00:00:00.000Z",3547244,1,"Onyeka Okongwu",1,13,17,11,10,22.2
"486",486,1,0,1,2,1,2,1,0,0,9,0,3,3,1,0,1,3277480,"2023-11-21T00:00:00.000Z",301,1,"Wesley Matthews",0,4,5,4,2,4.7
"487",487,0,0,0,0,0,0,0,0,0,0,0,0,0,0,0,0,3277480,"2023-11-21T00:00:00.000Z",666564,1,"Bruno Fernando",0,0,0,0,0,0
"488",488,0,0,0,0,0,0,0,0,0,0,0,0,0,0,0,0,3277480,"2023-11-21T00:00:00.000Z",3547297,1,"Trent Forrest",0,0,0,0,0,0
"489",489,0,0,0,0,0,0,0,0,0,0,0,0,0,0,0,0,3277480,"2023-11-21T00:00:00.000Z",666754,1,"Garrison Mathews",0,0,0,0,0,0
"490",490,0,0,0,0,0,0,0,0,0,0,0,0,0,0,0,0,3277480,"2023-11-21T00:00:00.000Z",319,1,"Patty Mills",0,0,0,0,0,0
"491",491,0,0,0,0,0,0,0,0,0,0,0,0,0,0,0,0,3277480,"2023-11-21T00:00:00.000Z",56677838,1,"Kobe Bufkin",0,0,0,0,0,0
"492",492,0,0,0,0,0,0,0,0,0,0,0,0,0,0,0,0,3277480,"2023-11-21T00:00:00.000Z",38017689,1,"AJ Griffin",0,0,0,0,0,0
"493",493,0,0,0,0,0,0,0,0,0,0,0,0,0,0,0,0,3277480,"2023-11-21T00:00:00.000Z",56677806,1,"Mouhamed Gueye",0,0,0,0,0,0
"494",494,0,0,0,0,0,0,0,0,0,0,0,0,0,0,0,0,3277480,"2023-11-21T00:00:00.000Z",56677855,1,"Seth Lundy",0,0,0,0,0,0
"495",495,0,0,0,0,0,0,0,0,0,0,0,0,0,0,0,0,3277480,"2023-11-21T00:00:00.000Z",56677875,1,"Miles Norris",0,0,0,0,0,0
"496",496,1,1,1,6,6,11,9,0,0,31,1,3,24,2,0,1,3277480,"2023-11-21T00:00:00.000Z",210,12,"Buddy Hield",1,26,27,25,3,29.9
"497",497,1,1,0,3,1,9,6,5,4,25,1,4,17,1,1,0,3277480,"2023-11-21T00:00:00.000Z",3547250,12,"Aaron Nesmith",2,18,19,18,2,25.7
"498",498,4,1,2,0,0,14,9,0,0,31,6,1,18,8,1,2,3277482,"2023-11-21T00:00:00.000Z",22,25,"Deandre Ayton",2,26,30,22,12,37.6
"499",499,0,0,2,5,0,13,3,4,4,32,1,3,10,3,1,4,3277482,"2023-11-21T00:00:00.000Z",38017690,25,"Shaedon Sharpe",1,13,13,10,3,12.6
"500",500,5,0,0,5,4,14,6,4,3,25,1,2,19,1,0,2,3277482,"2023-11-21T00:00:00.000Z",65,25,"Malcolm Brogdon",0,20,25,24,6,25.7
"501",501,3,0,2,3,2,5,2,0,0,21,0,2,6,2,0,1,3277482,"2023-11-21T00:00:00.000Z",3547289,25,"Skylar Mays",0,8,11,9,5,11.9
"502",502,4,1,2,3,2,5,4,0,0,36,0,2,10,2,1,2,3277482,"2023-11-21T00:00:00.000Z",178,24,"Eric Gordon",2,12,16,14,6,22.4
"503",503,9,1,4,2,2,21,13,3,3,37,0,4,31,4,0,3,3277482,"2023-11-21T00:00:00.000Z",140,24,"Kevin Durant",1,35,44,40,13,49.3
"504",504,0,4,6,4,2,11,7,2,2,29,6,4,18,12,1,3,3277482,"2023-11-21T00:00:00.000Z",349,24,"Jusuf Nurkic",5,30,30,18,12,44.4
"505",505,5,0,6,1,0,5,4,0,0,35,0,1,8,6,2,1,3277482,"2023-11-21T00:00:00.000Z",8,24,"Grayson Allen",2,14,19,13,11,27.7
"506",506,6,1,3,3,0,20,9,10,10,34,0,1,28,3,1,1,3277482,"2023-11-21T00:00:00.000Z",57,24,"Devin Booker",2,31,37,34,9,45.6
"507",507,0,0,0,0,0,4,1,5,5,13,2,4,7,2,0,2,3277482,"2023-11-21T00:00:00.000Z",147,24,"Drew Eubanks",0,9,9,7,2,7.4
"508",508,0,1,3,3,1,6,4,4,4,22,2,1,13,5,1,0,3277482,"2023-11-21T00:00:00.000Z",666729,24,"Nassir Little",2,18,18,13,5,25
"509",509,1,0,2,0,0,0,0,2,2,13,1,0,2,3,1,1,3277482,"2023-11-21T00:00:00.000Z",356,24,"Josh Okogie",1,5,6,3,4,9.1
"510",510,0,0,0,0,0,1,0,0,0,2,1,0,0,1,0,0,3277482,"2023-11-21T00:00:00.000Z",666476,25,"Moses Brown",0,1,1,0,1,1.2
"511",511,0,0,1,0,0,0,0,0,0,2,0,0,0,1,0,1,3277482,"2023-11-21T00:00:00.000Z",44477062,25,"Jamaree Bouyea",0,1,1,0,1,0.2
"512",512,0,0,0,1,1,2,1,0,0,2,0,0,3,0,0,0,3277482,"2023-11-21T00:00:00.000Z",56677791,25,"Kris Murray",0,3,3,3,0,3
"513",513,1,0,0,3,2,6,4,0,0,13,1,1,10,1,2,0,3277482,"2023-11-21T00:00:00.000Z",56783340,25,"Duop Reath",2,11,12,11,2,18.7
"514",514,1,0,0,0,0,1,0,0,0,2,0,0,0,0,1,0,3277482,"2023-11-21T00:00:00.000Z",56677829,25,"Rayan Rupert",1,0,1,1,1,4.5
"515",515,0,1,1,2,0,2,0,0,0,22,1,1,0,2,1,0,3277482,"2023-11-21T00:00:00.000Z",666923,25,"Matisse Thybulle",2,2,2,0,2,8.4
"516",516,0,0,3,2,0,6,3,2,2,14,0,5,8,3,0,1,3277482,"2023-11-21T00:00:00.000Z",38017711,25,"Jabari Walker",0,11,11,8,3,10.6
"517",517,0,0,0,0,0,0,0,0,0,0,0,0,0,0,0,0,3277482,"2023-11-21T00:00:00.000Z",56677747,25,"Scoot Henderson",0,0,0,0,0,0
"518",518,0,0,0,0,0,0,0,0,0,0,0,0,0,0,0,0,3277482,"2023-11-21T00:00:00.000Z",47957121,25,"Justin Minaya",0,0,0,0,0,0
"519",519,0,0,0,0,0,0,0,0,0,0,0,0,0,0,0,0,3277482,"2023-11-21T00:00:00.000Z",419,25,"Anfernee Simons",0,0,0,0,0,0
"520",520,0,0,0,0,0,0,0,0,0,0,0,0,0,0,0,0,3277482,"2023-11-21T00:00:00.000Z",17896120,25,"Ish Wainright",0,0,0,0,0,0
"521",521,0,0,0,0,0,0,0,0,0,0,0,0,0,0,0,0,3277482,"2023-11-21T00:00:00.000Z",476,25,"Robert Williams III",0,0,0,0,0,0
"522",522,0,0,1,0,0,1,0,2,1,10,0,0,1,1,0,0,3277482,"2023-11-21T00:00:00.000Z",32,24,"Keita Bates-Diop",0,2,2,1,1,2.2
"523",523,0,0,0,1,0,3,1,0,0,5,0,0,2,0,0,0,3277482,"2023-11-21T00:00:00.000Z",18678058,24,"Jordan Goodwin",0,2,2,2,0,2
"524",524,0,0,0,0,0,0,0,0,0,0,0,0,0,0,0,0,3277482,"2023-11-21T00:00:00.000Z",3547095,24,"Udoka Azubuike",0,0,0,0,0,0
"525",525,0,0,0,0,0,0,0,0,0,0,0,0,0,0,0,0,3277482,"2023-11-21T00:00:00.000Z",666451,24,"Bol Bol",0,0,0,0,0,0
"526",526,0,0,0,0,0,0,0,0,0,0,0,0,0,0,0,0,3277482,"2023-11-21T00:00:00.000Z",3547298,24,"Saben Lee",0,0,0,0,0,0
"527",527,1,0,0,0,0,0,0,0,0,6,0,1,0,0,1,0,3277482,"2023-11-21T00:00:00.000Z",314,24,"Chimezie Metu",1,0,1,1,1,4.5
"528",528,0,0,0,0,0,0,0,0,0,0,0,0,0,0,0,0,3277482,"2023-11-21T00:00:00.000Z",37,24,"Bradley Beal",0,0,0,0,0,0
"529",529,0,0,0,0,0,0,0,0,0,0,0,0,0,0,0,0,3277482,"2023-11-21T00:00:00.000Z",272,24,"Damion Lee",0,0,0,0,0,0
"530",530,0,0,0,0,0,0,0,0,0,0,0,0,0,0,0,0,3277482,"2023-11-21T00:00:00.000Z",470,24,"Yuta Watanabe",0,0,0,0,0,0
"531",531,0,0,4,2,0,4,2,4,3,38,0,4,7,4,1,1,3277482,"2023-11-21T00:00:00.000Z",56677850,25,"Toumani Camara",1,11,11,7,4,13.8
"532",532,6,1,3,8,5,19,8,6,5,36,1,1,26,4,1,1,3277482,"2023-11-21T00:00:00.000Z",182,25,"Jerami Grant",2,30,36,32,10,44.8
"533",533,0,0,0,0,0,0,0,0,0,0,0,0,0,0,0,0,3277483,"2023-11-21T00:00:00.000Z",56677835,14,"Jalen Hood-Schifino",0,0,0,0,0,0
"534",534,0,0,0,0,0,0,0,0,0,0,0,0,0,0,0,0,3277483,"2023-11-21T00:00:00.000Z",457,14,"Jarred Vanderbilt",0,0,0,0,0,0
"535",535,2,1,7,2,1,7,6,3,3,27,1,5,16,8,0,2,3277483,"2023-11-21T00:00:00.000Z",486,14,"Christian Wood",1,24,26,18,10,29.6
"536",536,4,1,5,5,1,8,3,0,0,25,0,2,7,5,1,0,3277483,"2023-11-21T00:00:00.000Z",38017697,14,"Max Christie",2,12,16,11,9,25
"537",537,1,1,2,0,0,4,4,3,2,19,0,1,10,2,0,2,3277483,"2023-11-21T00:00:00.000Z",666626,14,"Jaxson Hayes",1,12,13,11,3,14.9
"538",538,0,0,0,0,0,0,0,0,0,0,0,0,0,0,0,0,3277483,"2023-11-21T00:00:00.000Z",56677738,14,"Colin Castleton",0,0,0,0,0,0
"539",539,0,0,0,0,0,0,0,0,0,0,0,0,0,0,0,0,3277483,"2023-11-21T00:00:00.000Z",56677867,14,"Alex Fudge",0,0,0,0,0,0
"540",540,0,0,0,0,0,0,0,0,0,0,0,0,0,0,0,0,3277483,"2023-11-21T00:00:00.000Z",56677868,14,"D'Moi Hodge",0,0,0,0,0,0
"541",541,0,0,0,0,0,0,0,0,0,0,0,0,0,0,0,0,3277483,"2023-11-21T00:00:00.000Z",56677836,14,"Maxwell Lewis",0,0,0,0,0,0
"542",542,0,0,0,0,0,0,0,0,0,0,0,0,0,0,0,0,3277483,"2023-11-21T00:00:00.000Z",1603383,14,"Gabe Vincent",0,0,0,0,0,0
"543",543,1,0,3,2,0,3,0,0,0,9,0,1,0,3,0,1,3277483,"2023-11-21T00:00:00.000Z",666881,29,"Luka Samanic",0,3,4,1,4,4.1
"544",544,0,0,0,0,0,0,0,0,0,0,0,0,0,0,0,0,3277483,"2023-11-21T00:00:00.000Z",17896023,29,"Josh Christopher",0,0,0,0,0,0
"545",545,0,0,0,0,0,0,0,0,0,0,0,0,0,0,0,0,3277483,"2023-11-21T00:00:00.000Z",56677824,29,"Taylor Hendricks",0,0,0,0,0,0
"546",546,0,0,0,0,0,0,0,0,0,0,0,0,0,0,0,0,3277483,"2023-11-21T00:00:00.000Z",38017630,29,"Johnny Juzang",0,0,0,0,0,0
"547",547,0,0,0,0,0,0,0,0,0,0,0,0,0,0,0,0,3277483,"2023-11-21T00:00:00.000Z",38017705,29,"Walker Kessler",0,0,0,0,0,0
"548",548,0,0,0,0,0,0,0,0,0,0,0,0,0,0,0,0,3277483,"2023-11-21T00:00:00.000Z",19465584,29,"Micah Potter",0,0,0,0,0,0
"549",549,0,0,0,0,0,0,0,0,0,0,0,0,0,0,0,0,3277483,"2023-11-21T00:00:00.000Z",56677842,29,"Brice Sensabaugh",0,0,0,0,0,0
"550",550,0,0,0,0,0,0,0,0,0,5,0,1,0,0,0,0,3277483,"2023-11-21T00:00:00.000Z",666860,14,"Cameron Reddish",0,0,0,0,0,0
"551",551,9,0,6,5,3,10,6,2,2,24,1,0,17,7,0,2,3277483,"2023-11-21T00:00:00.000Z",237,14,"LeBron James",0,24,33,26,16,36.9
"552",552,4,0,11,0,0,14,11,5,4,29,5,1,26,16,2,2,3277483,"2023-11-21T00:00:00.000Z",117,14,"Anthony Davis",2,42,46,30,20,55.2
"553",553,1,1,0,4,0,8,1,3,2,31,0,0,4,0,0,2,3277483,"2023-11-21T00:00:00.000Z",383,14,"Taurean Prince",1,4,5,5,1,6.5
"554",554,8,1,3,4,3,9,7,5,3,26,0,2,20,3,0,0,3277483,"2023-11-21T00:00:00.000Z",405,14,"D'Angelo Russell",1,23,31,28,11,38.6
"555",555,1,0,4,5,2,13,4,2,2,28,2,3,12,6,0,1,3277483,"2023-11-21T00:00:00.000Z",666609,14,"Rui Hachimura",0,18,19,13,7,19.7
"556",556,5,0,5,4,1,13,7,4,4,26,0,0,19,5,3,2,3277483,"2023-11-21T00:00:00.000Z",17553995,14,"Austin Reaves",3,24,29,24,10,39.5
"557",557,2,0,0,3,0,9,3,1,1,24,0,1,7,0,1,2,3277483,"2023-11-21T00:00:00.000Z",100,29,"Jordan Clarkson",1,7,9,9,2,11
"558",558,2,0,2,5,1,11,3,2,2,21,1,2,9,3,1,2,3277483,"2023-11-21T00:00:00.000Z",56677834,29,"Keyonte George",1,12,14,11,5,16.6
"559",559,2,0,0,1,1,4,2,0,0,8,0,1,5,0,0,2,3277483,"2023-11-21T00:00:00.000Z",139,29,"Kris Dunn",0,5,7,7,2,6
"560",560,0,1,2,5,3,6,4,0,0,27,2,3,11,4,0,1,3277483,"2023-11-21T00:00:00.000Z",38017739,29,"Simone Fontecchio",1,15,15,11,4,17.8
"561",561,7,1,3,5,0,10,1,4,4,23,0,1,6,3,2,1,3277483,"2023-11-21T00:00:00.000Z",666650,29,"Talen Horton-Tucker",3,9,16,13,10,28.1
"562",562,5,0,3,4,0,6,1,4,2,24,2,3,4,5,0,2,3277483,"2023-11-21T00:00:00.000Z",358,29,"Kelly Olynyk",0,9,14,9,10,15.5
"563",563,4,0,3,3,2,11,6,0,0,22,0,2,14,3,0,1,3277483,"2023-11-21T00:00:00.000Z",413,29,"Collin Sexton",0,17,21,18,7,22.6
"564",564,1,0,2,1,0,11,8,3,2,17,4,1,18,6,0,0,3277483,"2023-11-21T00:00:00.000Z",11891374,29,"Omer Yurtseven",0,24,25,19,7,26.7
"565",565,0,0,2,3,0,5,0,0,0,17,1,2,0,3,0,1,3277483,"2023-11-21T00:00:00.000Z",38017620,29,"Ochai Agbaji",0,3,3,0,3,2.6
"566",566,0,0,7,7,2,10,4,0,0,23,1,2,10,8,1,0,3277483,"2023-11-21T00:00:00.000Z",297,29,"Lauri Markkanen",1,18,18,10,8,22.6
"567",567,1,1,2,5,2,12,6,2,1,25,2,3,15,4,1,1,3277483,"2023-11-21T00:00:00.000Z",101,29,"John Collins",2,19,20,16,5,26.3
"568",568,4,2,7,6,1,18,8,5,5,35,2,2,22,9,1,6,3277506,"2023-11-24T00:00:00.000Z",56677822,27,"Victor Wembanyama",3,31,35,26,13,41.8
"569",569,6,0,5,7,0,12,2,2,2,31,3,3,6,8,0,3,3277506,"2023-11-24T00:00:00.000Z",102,27,"Zach Collins",0,14,20,12,14,21.6
"570",570,1,0,0,5,0,9,3,0,0,19,0,2,6,0,1,1,3277506,"2023-11-24T00:00:00.000Z",38017692,27,"Malaki Branham",1,6,7,7,1,9.5
"571",571,6,0,2,7,3,11,3,7,6,29,1,3,15,3,1,2,3277506,"2023-11-24T00:00:00.000Z",443,10,"Klay Thompson",1,18,24,21,9,28.6
"572",572,0,0,4,4,2,10,4,0,0,25,0,3,10,4,0,3,3277506,"2023-11-24T00:00:00.000Z",475,10,"Andrew Wiggins",0,14,14,10,4,11.8
"573",573,4,0,7,0,0,3,2,3,2,24,1,3,6,8,2,2,3277506,"2023-11-24T00:00:00.000Z",282,10,"Kevon Looney",2,14,18,10,12,25.6
"574",574,1,0,2,1,1,4,4,2,0,17,2,0,9,4,0,2,3277506,"2023-11-24T00:00:00.000Z",17553992,10,"Moses Moody",0,13,14,10,5,13.3
"575",575,6,0,3,13,7,20,11,6,6,35,0,2,35,3,1,6,3277506,"2023-11-24T00:00:00.000Z",115,10,"Stephen Curry",1,38,44,41,9,44.6
"576",576,0,0,0,0,0,0,0,0,0,0,0,0,0,0,0,0,3277506,"2023-11-24T00:00:00.000Z",185,10,"Draymond Green",0,0,0,0,0,0
"577",577,0,1,0,0,0,1,0,2,2,5,0,1,2,0,0,1,3277506,"2023-11-24T00:00:00.000Z",56677799,10,"Trayce Jackson-Davis",1,2,2,2,0,4
"578",578,0,0,0,0,0,0,0,0,0,0,0,0,0,0,0,0,3277506,"2023-11-24T00:00:00.000Z",251,10,"Cory Joseph",0,0,0,0,0,0
"579",579,2,0,1,2,1,7,5,2,1,20,0,0,12,1,0,1,3277506,"2023-11-24T00:00:00.000Z",17553979,10,"Jonathan Kuminga",0,13,15,14,3,15.2
"580",580,10,0,5,3,1,6,2,0,0,29,0,2,5,5,0,1,3277506,"2023-11-24T00:00:00.000Z",367,10,"Chris Paul",0,10,20,15,15,25
"581",581,0,1,3,1,0,3,2,0,0,18,0,4,4,3,1,2,3277506,"2023-11-24T00:00:00.000Z",2189,10,"Gary Payton II",2,7,7,4,3,11.6
"582",582,2,0,2,2,0,5,0,0,0,12,1,0,0,3,0,1,3277506,"2023-11-24T00:00:00.000Z",56677858,10,"Brandin Podziemski",0,3,5,2,5,5.6
"583",583,0,0,0,0,0,0,0,0,0,0,0,0,0,0,0,0,3277506,"2023-11-24T00:00:00.000Z",57875092,10,"Gui Santos",0,0,0,0,0,0
"584",584,4,0,5,7,4,11,7,2,2,26,2,3,20,7,2,3,3277506,"2023-11-24T00:00:00.000Z",407,10,"Dario Saric",2,27,31,24,11,37.4
"585",585,0,0,0,0,0,0,0,0,0,0,0,0,0,0,0,0,3277506,"2023-11-24T00:00:00.000Z",56677870,27,"Sir'Jabari Rice",0,0,0,0,0,0
"586",586,0,0,0,0,0,0,0,0,0,0,0,0,0,0,0,0,3277506,"2023-11-24T00:00:00.000Z",38017693,27,"Blake Wesley",0,0,0,0,0,0
"587",587,0,0,0,0,0,0,0,0,0,0,0,0,0,0,0,0,3277506,"2023-11-24T00:00:00.000Z",56677865,27,"Charles Bediako",0,0,0,0,0,0
"588",588,0,0,0,0,0,0,0,0,0,0,0,0,0,0,0,0,3277506,"2023-11-24T00:00:00.000Z",56677817,27,"Sidy Cissoko",0,0,0,0,0,0
"589",589,4,0,3,2,1,7,3,0,0,33,3,2,7,6,0,2,3277506,"2023-11-24T00:00:00.000Z",38017699,27,"Jeremy Sochan",0,13,17,11,10,18.2
"590",590,2,1,0,0,0,0,0,0,0,7,0,0,0,0,0,0,3277506,"2023-11-24T00:00:00.000Z",17895854,27,"Charles Bassey",1,0,2,2,2,6
"591",591,0,0,0,0,0,0,0,0,0,0,0,0,0,0,0,0,3277506,"2023-11-24T00:00:00.000Z",38017649,27,"Julian Champagnie",0,0,0,0,0,0
"592",592,0,0,0,0,0,0,0,0,0,0,0,0,0,0,0,0,3277506,"2023-11-24T00:00:00.000Z",180,27,"Devonte' Graham",0,0,0,0,0,0
"593",593,2,0,5,1,1,5,3,0,0,17,0,1,7,5,2,1,3277506,"2023-11-24T00:00:00.000Z",3547274,27,"Tre Jones",2,12,14,9,7,21
"594",594,0,0,0,0,0,0,0,0,0,0,0,0,0,0,0,0,3277506,"2023-11-24T00:00:00.000Z",17896059,27,"Sandro Mamukelashvili",0,0,0,0,0,0
"595",595,4,0,0,3,1,6,3,0,0,19,1,0,7,1,3,0,3277506,"2023-11-24T00:00:00.000Z",305,27,"Doug McDermott",3,8,12,11,5,23.2
"596",596,0,0,0,6,1,11,5,0,0,18,1,3,11,1,0,1,3277506,"2023-11-24T00:00:00.000Z",359,27,"Cedi Osman",0,12,12,11,1,11.2
"597",597,1,0,3,10,4,19,10,0,0,27,1,2,24,4,1,2,3277506,"2023-11-24T00:00:00.000Z",3547246,27,"Devin Vassell",1,28,29,25,5,31.3
"598",598,0,0,0,0,0,0,0,0,0,0,0,0,0,0,0,0,3277506,"2023-11-24T00:00:00.000Z",38017730,27,"Dominick Barlow",0,0,0,0,0,0
"599",599,0,0,0,0,0,0,0,0,0,0,0,0,0,0,0,0,3277506,"2023-11-24T00:00:00.000Z",17896070,10,"Usman Garuba",0,0,0,0,0,0
"600",600,0,0,0,0,0,0,0,0,0,0,0,0,0,0,0,0,3277506,"2023-11-24T00:00:00.000Z",45658838,10,"Lester Quinones",0,0,0,0,0,0
"601",601,0,0,0,0,0,1,0,0,0,5,0,0,0,0,0,0,3277502,"2023-11-24T00:00:00.000Z",56677792,9,"Marcus Sasser",0,0,0,0,0,0
"602",602,2,0,1,3,2,8,2,2,2,30,1,4,8,2,0,2,3277503,"2023-11-24T00:00:00.000Z",66,11,"Dillon Brooks",0,10,12,10,4,11.4
"603",603,1,1,11,3,2,9,6,2,2,38,3,2,16,14,1,1,3277503,"2023-11-24T00:00:00.000Z",38017684,11,"Jabari Smith Jr.",2,30,31,17,15,39.3
"604",604,8,1,13,4,0,19,8,6,5,43,1,4,21,14,2,5,3277503,"2023-11-24T00:00:00.000Z",17896062,11,"Alperen Sengun",3,35,43,29,22,53.8
"605",605,2,0,6,8,3,18,10,3,2,36,0,0,25,6,2,3,3277503,"2023-11-24T00:00:00.000Z",17895966,11,"Jalen Green",2,31,33,27,8,38.2
"606",606,11,2,6,5,3,12,6,2,2,39,0,3,17,6,1,1,3277503,"2023-11-24T00:00:00.000Z",458,11,"Fred VanVleet",3,23,34,28,17,48.7
"607",607,0,0,0,0,0,0,0,0,0,0,0,0,0,0,0,0,3277503,"2023-11-24T00:00:00.000Z",75,11,"Reggie Bullock",0,0,0,0,0,0
"608",608,1,0,3,2,1,6,3,0,0,16,1,2,7,4,1,0,3277503,"2023-11-24T00:00:00.000Z",38017695,11,"Tari Eason",1,11,12,8,5,16.3
"609",609,0,3,0,2,0,2,0,0,0,8,0,0,0,0,0,0,3277503,"2023-11-24T00:00:00.000Z",188,11,"Jeff Green",3,0,0,0,0,9
"610",610,0,1,0,1,1,4,3,0,0,14,0,2,7,0,1,0,3277503,"2023-11-24T00:00:00.000Z",213,11,"Aaron Holiday",2,7,7,7,0,13
"611",611,0,0,0,0,0,0,0,0,0,0,0,0,0,0,0,0,3277503,"2023-11-24T00:00:00.000Z",19465326,11,"Jock Landale",0,0,0,0,0,0
"612",612,0,0,0,0,0,0,0,0,0,0,0,0,0,0,0,0,3277503,"2023-11-24T00:00:00.000Z",296,11,"Boban Marjanovic",0,0,0,0,0,0
"613",613,0,1,3,1,0,4,2,0,0,16,0,4,4,3,0,1,3277503,"2023-11-24T00:00:00.000Z",3547301,11,"Jae'Sean Tate",1,7,7,4,3,9.6
"614",614,0,0,0,0,0,0,0,0,0,0,0,0,0,0,0,0,3277503,"2023-11-24T00:00:00.000Z",47738533,11,"Jeenathan Williams",0,0,0,0,0,0
"615",615,0,0,0,0,0,0,0,0,0,0,0,0,0,0,0,0,3277503,"2023-11-24T00:00:00.000Z",3547281,11,"Nate Hinton",0,0,0,0,0,0
"616",616,0,0,0,0,0,0,0,0,0,0,0,0,0,0,0,0,3277503,"2023-11-24T00:00:00.000Z",357,11,"Victor Oladipo",0,0,0,0,0,0
"617",617,0,0,0,0,0,0,0,0,0,0,0,0,0,0,0,0,3277503,"2023-11-24T00:00:00.000Z",56677809,11,"Jermaine Samuels Jr.",0,0,0,0,0,0
"618",618,0,0,0,0,0,0,0,0,0,0,0,0,0,0,0,0,3277503,"2023-11-24T00:00:00.000Z",56677825,11,"Amen Thompson",0,0,0,0,0,0
"619",619,0,0,0,0,0,0,0,0,0,0,0,0,0,0,0,0,3277503,"2023-11-24T00:00:00.000Z",56677831,11,"Cam Whitmore",0,0,0,0,0,0
"620",620,1,2,6,8,2,14,6,0,0,37,1,1,14,7,1,1,3277503,"2023-11-24T00:00:00.000Z",375,8,"Michael Porter Jr.",3,21,22,15,8,31.9
"621",621,2,0,4,4,0,12,0,4,2,39,3,1,2,7,0,1,3277503,"2023-11-24T00:00:00.000Z",177,8,"Aaron Gordon",0,9,11,4,9,12.4
"622",622,8,0,13,8,3,31,14,11,7,42,6,3,38,19,2,3,3277503,"2023-11-24T00:00:00.000Z",246,8,"Nikola Jokic",2,57,65,46,27,75.8
"623",623,3,0,2,5,1,15,7,5,5,39,3,4,20,5,3,2,3277503,"2023-11-24T00:00:00.000Z",81,8,"Kentavious Caldwell-Pope",3,25,28,23,8,37.5
"624",624,3,1,2,2,0,8,1,0,0,25,2,0,2,4,0,5,3277503,"2023-11-24T00:00:00.000Z",236,8,"Reggie Jackson",1,6,9,5,7,9.3
"625",625,0,0,3,0,0,9,3,1,1,26,0,1,7,3,0,0,3277503,"2023-11-24T00:00:00.000Z",38017709,8,"Christian Braun",0,10,10,7,3,10.6
"626",626,0,0,0,0,0,0,0,0,0,3,0,0,0,0,0,1,3277503,"2023-11-24T00:00:00.000Z",38017727,8,"Collin Gillespie",0,0,0,0,0,-1
"627",627,0,0,0,2,1,2,1,0,0,13,0,2,3,0,1,0,3277503,"2023-11-24T00:00:00.000Z",215,8,"Justin Holiday",1,3,3,3,0,6
"628",628,0,0,0,0,0,0,0,0,0,0,0,0,0,0,0,0,3277503,"2023-11-24T00:00:00.000Z",250,8,"DeAndre Jordan",0,0,0,0,0,0
"629",629,0,0,0,0,0,0,0,0,0,0,0,0,0,0,0,0,3277503,"2023-11-24T00:00:00.000Z",17896007,8,"Braxton Key",0,0,0,0,0,0
"630",630,0,0,0,0,0,1,0,0,0,4,0,0,0,0,0,1,3277503,"2023-11-24T00:00:00.000Z",3547268,8,"Zeke Nnaji",0,0,0,0,0,-1
"631",631,0,0,0,0,0,0,0,0,0,0,0,0,0,0,0,0,3277503,"2023-11-24T00:00:00.000Z",56677582,8,"Jalen Pickett",0,0,0,0,0,0
"632",632,0,0,0,0,0,0,0,0,0,6,0,1,0,0,0,0,3277503,"2023-11-24T00:00:00.000Z",56677776,8,"Julian Strawther",0,0,0,0,0,0
"633",633,0,0,0,0,0,0,0,0,0,0,0,0,0,0,0,0,3277503,"2023-11-24T00:00:00.000Z",56677871,8,"Hunter Tyson",0,0,0,0,0,0
"634",634,0,1,0,1,0,3,0,0,0,6,1,1,0,1,0,0,3277503,"2023-11-24T00:00:00.000Z",38017721,8,"Peyton Watson",1,1,1,0,1,4.2
"635",635,0,0,0,0,0,0,0,0,0,0,0,0,0,0,0,0,3277503,"2023-11-24T00:00:00.000Z",666489,8,"Vlatko Cancar",0,0,0,0,0,0
"636",636,0,0,0,0,0,0,0,0,0,0,0,0,0,0,0,0,3277503,"2023-11-24T00:00:00.000Z",17896103,8,"Jay Huff",0,0,0,0,0,0
"637",637,0,0,0,0,0,0,0,0,0,0,0,0,0,0,0,0,3277503,"2023-11-24T00:00:00.000Z",335,8,"Jamal Murray",0,0,0,0,0,0
"638",638,5,0,1,3,1,8,3,0,0,13,0,1,7,1,0,1,3277504,"2023-11-24T00:00:00.000Z",315,17,"Khris Middleton",0,8,13,12,6,14.7
"639",639,3,1,6,0,0,19,11,12,9,37,3,2,31,9,3,3,3277504,"2023-11-24T00:00:00.000Z",15,17,"Giannis Antetokounmpo",4,40,43,34,12,55.3
"640",640,1,3,5,7,4,17,14,7,7,32,0,2,39,5,2,1,3277504,"2023-11-24T00:00:00.000Z",283,17,"Brook Lopez",5,44,45,40,6,60.5
"641",641,1,1,7,4,1,8,4,0,0,27,4,3,9,11,0,2,3277504,"2023-11-24T00:00:00.000Z",38,17,"Malik Beasley",1,20,21,10,12,24.7
"642",642,10,0,6,5,2,18,11,8,7,37,1,1,31,7,0,1,3277504,"2023-11-24T00:00:00.000Z",278,17,"Damian Lillard",0,38,48,41,17,53.4
"643",643,0,0,0,0,0,0,0,0,0,0,0,0,0,0,0,0,3277504,"2023-11-24T00:00:00.000Z",2148,17,"Thanasis Antetokounmpo",0,0,0,0,0,0
"644",644,2,0,3,2,0,4,0,4,3,13,0,2,3,3,0,0,3277504,"2023-11-24T00:00:00.000Z",38017676,17,"MarJon Beauchamp",0,6,8,5,5,9.6
"645",645,1,0,4,3,0,5,1,2,0,26,0,1,2,4,1,1,3277504,"2023-11-24T00:00:00.000Z",105,17,"Pat Connaughton",1,6,7,3,5,10.3
"646",646,0,0,0,4,1,4,1,0,0,4,0,0,3,0,0,0,3277504,"2023-11-24T00:00:00.000Z",38017733,17,"A.J. Green",0,3,3,3,0,3
"647",647,1,0,1,0,0,0,0,0,0,9,0,4,0,1,0,0,3277504,"2023-11-24T00:00:00.000Z",56677852,17,"Andre Jackson Jr.",0,1,2,1,2,2.7
"648",648,0,0,0,0,0,0,0,0,0,0,0,0,0,0,0,0,3277504,"2023-11-24T00:00:00.000Z",56677854,17,"Chris Livingston",0,0,0,0,0,0
"649",649,0,0,0,0,0,0,0,0,0,0,0,0,0,0,0,0,3277504,"2023-11-24T00:00:00.000Z",284,17,"Robin Lopez",0,0,0,0,0,0
"650",650,3,0,3,2,0,4,2,0,0,17,0,3,4,3,0,0,3277504,"2023-11-24T00:00:00.000Z",368,17,"Cameron Payne",0,7,10,7,6,12.1
"651",651,1,1,4,1,0,5,1,0,0,25,2,3,2,6,0,0,3277504,"2023-11-24T00:00:00.000Z",377,17,"Bobby Portis",1,8,9,3,7,13.7
"652",652,0,0,0,0,0,0,0,0,0,0,0,0,0,0,0,0,3277504,"2023-11-24T00:00:00.000Z",666960,17,"Lindell Wigginton",0,0,0,0,0,0
"653",653,0,0,0,0,0,0,0,0,0,0,0,0,0,0,0,0,3277504,"2023-11-24T00:00:00.000Z",666453,17,"Marques Bolden",0,0,0,0,0,0
"654",654,0,0,0,0,0,0,0,0,0,0,0,0,0,0,0,0,3277504,"2023-11-24T00:00:00.000Z",112,17,"Jae Crowder",0,0,0,0,0,0
"655",655,0,0,0,0,0,0,0,0,0,0,0,0,0,0,0,0,3277504,"2023-11-24T00:00:00.000Z",38017691,17,"TyTy Washington Jr.",0,0,0,0,0,0
"656",656,5,0,3,0,0,6,1,0,0,28,2,3,2,5,0,0,3277504,"2023-11-24T00:00:00.000Z",3547242,30,"Deni Avdija",0,7,12,7,10,15.5
"657",657,4,2,3,8,3,22,9,1,1,31,1,3,22,4,0,1,3277504,"2023-11-24T00:00:00.000Z",265,30,"Kyle Kuzma",2,26,30,26,8,37.8
"658",658,4,2,4,0,0,6,3,3,2,29,5,5,8,9,1,1,3277504,"2023-11-24T00:00:00.000Z",666577,30,"Daniel Gafford",3,17,21,12,13,32.8
"659",659,7,0,4,6,1,20,9,9,7,34,1,5,26,5,0,2,3277504,"2023-11-24T00:00:00.000Z",666848,30,"Jordan Poole",0,31,38,33,12,40.5
"660",660,7,0,7,4,1,14,9,3,3,31,0,0,22,7,1,0,3277504,"2023-11-24T00:00:00.000Z",249,30,"Tyus Jones",1,29,36,29,14,43.9
"661",661,1,0,5,10,6,12,7,0,0,33,0,3,20,5,0,3,3277504,"2023-11-24T00:00:00.000Z",17896045,30,"Corey Kispert",0,25,26,21,6,24.5
"662",662,1,0,4,2,1,5,2,2,2,18,0,2,7,4,0,0,3277504,"2023-11-24T00:00:00.000Z",167,30,"Danilo Gallinari",0,11,12,8,5,13.3
"663",663,0,0,0,0,0,0,0,0,0,0,0,0,0,0,0,0,3277504,"2023-11-24T00:00:00.000Z",38017704,30,"Patrick Baldwin Jr.",0,0,0,0,0,0
"664",664,0,0,0,0,0,0,0,0,0,0,0,0,0,0,0,0,3277504,"2023-11-24T00:00:00.000Z",18677954,30,"Jared Butler",0,0,0,0,0,0
"665",665,0,0,0,0,0,0,0,0,0,0,0,0,0,0,0,0,3277504,"2023-11-24T00:00:00.000Z",38124126,30,"John Butler Jr.",0,0,0,0,0,0
"666",666,0,0,2,7,3,11,6,1,0,24,0,2,15,2,1,0,3277504,"2023-11-24T00:00:00.000Z",414,30,"Landry Shamet",1,17,17,15,2,20.4
"667",667,0,0,0,0,0,0,0,0,0,0,0,0,0,0,0,0,3277504,"2023-11-24T00:00:00.000Z",3547302,30,"Anthony Gill",0,0,0,0,0,0
"668",668,0,0,0,0,0,0,0,0,0,0,0,0,0,0,0,0,3277504,"2023-11-24T00:00:00.000Z",337,30,"Mike Muscala",0,0,0,0,0,0
"669",669,0,0,0,0,0,0,0,0,0,0,0,0,0,0,0,0,3277504,"2023-11-24T00:00:00.000Z",17896106,30,"Eugene Omoruyi",0,0,0,0,0,0
"670",670,0,0,0,0,0,0,0,0,0,0,0,0,0,0,0,0,3277504,"2023-11-24T00:00:00.000Z",56677844,30,"Bilal Coulibaly",0,0,0,0,0,0
"671",671,0,0,0,0,0,0,0,0,0,0,0,0,0,0,0,0,3277504,"2023-11-24T00:00:00.000Z",38017712,30,"Ryan Rollins",0,0,0,0,0,0
"672",672,0,0,0,0,0,0,0,0,0,0,0,0,0,0,0,0,3277504,"2023-11-24T00:00:00.000Z",487,30,"Delon Wright",0,0,0,0,0,0
"673",673,0,0,2,0,0,4,2,2,2,12,3,1,6,5,0,1,3277504,"2023-11-24T00:00:00.000Z",38017687,30,"Johnny Davis",0,11,11,6,5,11
"674",674,12,0,5,7,3,32,14,6,5,37,2,3,36,7,1,2,3277505,"2023-11-24T00:00:00.000Z",161,26,"De'Aaron Fox",1,43,55,48,19,63.4
"675",675,0,0,2,6,3,14,6,2,2,30,0,2,17,2,1,3,3277505,"2023-11-24T00:00:00.000Z",324,26,"Malik Monk",1,19,19,17,2,19.4
"676",676,6,0,2,5,3,15,9,6,5,34,1,2,26,3,1,3,1037611,"2023-10-27T00:00:00.000Z",666423,20,"RJ Barrett",1,29,35,32,9,38.6
"677",677,9,0,10,7,3,10,4,8,6,34,2,3,17,12,0,3,1037611,"2023-10-27T00:00:00.000Z",387,20,"Julius Randle",0,29,38,26,21,41.9
"678",678,1,1,3,1,0,5,1,0,0,13,1,1,2,4,0,1,1037612,"2023-10-27T00:00:00.000Z",74,16,"Thomas Bryant",1,6,7,3,5,10.3
"679",679,2,0,2,1,0,2,0,0,0,14,0,2,0,2,0,1,1037612,"2023-10-27T00:00:00.000Z",56677785,16,"Jaime Jaquez Jr.",0,2,4,2,4,4.4
"680",680,0,0,1,1,0,1,0,0,0,4,0,1,0,1,1,1,1037612,"2023-10-27T00:00:00.000Z",38017734,16,"Jamal Cain",1,1,1,0,1,3.2
"681",681,0,0,0,0,0,0,0,0,0,0,0,0,0,0,0,0,1037612,"2023-10-27T00:00:00.000Z",3547257,16,"R.J. Hampton",0,0,0,0,0,0
"682",682,0,0,0,0,0,0,0,0,0,0,0,0,0,0,0,0,1037612,"2023-10-27T00:00:00.000Z",38017696,16,"Nikola Jovic",0,0,0,0,0,0
"683",683,0,0,0,0,0,0,0,0,0,0,0,0,0,0,0,0,1037612,"2023-10-27T00:00:00.000Z",666747,16,"Caleb Martin",0,0,0,0,0,0
"684",684,0,0,1,1,1,4,3,2,2,19,1,0,9,2,0,0,1037613,"2023-10-27T00:00:00.000Z",56677833,21,"Cason Wallace",0,11,11,9,2,11.4
"685",685,2,0,3,7,1,10,2,1,0,22,0,1,5,3,0,1,1037613,"2023-10-27T00:00:00.000Z",3547272,21,"Isaiah Joe",0,8,10,7,5,10.6
"686",686,0,0,0,0,0,0,0,0,0,1,0,0,0,0,0,0,1037613,"2023-10-27T00:00:00.000Z",27924547,21,"Lindy Waters III",0,0,0,0,0,0
"687",687,1,1,0,0,0,0,0,0,0,12,0,0,0,0,0,1,1037613,"2023-10-27T00:00:00.000Z",17896078,21,"Aaron Wiggins",1,0,1,1,1,3.5
"688",688,1,0,0,1,1,1,1,0,0,6,0,0,3,0,0,2,1037613,"2023-10-27T00:00:00.000Z",4197029,21,"Vasilije Micic",0,3,4,4,1,2.5
"689",689,0,0,0,0,0,0,0,0,0,0,0,0,0,0,0,0,1037613,"2023-10-27T00:00:00.000Z",17896036,21,"Tre Mann",0,0,0,0,0,0
"690",690,0,0,0,0,0,0,0,0,0,0,0,0,0,0,0,0,1037613,"2023-10-27T00:00:00.000Z",3547271,21,"Aleksej Pokusevski",0,0,0,0,0,0
"691",691,0,0,0,0,0,0,0,0,0,0,0,0,0,0,0,0,1037613,"2023-10-27T00:00:00.000Z",24572055,21,"Olivier Sarr",0,0,0,0,0,0
"692",692,0,0,0,0,0,0,0,0,0,0,0,0,0,0,0,0,1037613,"2023-10-27T00:00:00.000Z",56677853,21,"Keyontae Johnson",0,0,0,0,0,0
"693",693,0,0,0,0,0,0,0,0,0,0,0,0,0,0,0,0,1037613,"2023-10-27T00:00:00.000Z",38017706,21,"Jaylin Williams",0,0,0,0,0,0
"694",694,0,0,0,0,0,0,0,0,0,0,0,0,0,0,0,0,1037613,"2023-10-27T00:00:00.000Z",480,21,"Kenrich Williams",0,0,0,0,0,0
"695",695,1,1,2,0,0,2,1,4,4,20,0,4,6,2,2,0,1037611,"2023-10-27T00:00:00.000Z",3547244,1,"Onyeka Okongwu",3,8,9,7,3,18.9
"696",696,2,2,4,0,0,24,10,9,7,35,3,1,27,7,1,3,1037612,"2023-10-27T00:00:00.000Z",4,16,"Bam Adebayo",3,34,36,29,9,44.4
"697",697,6,0,5,12,5,19,10,3,3,40,1,2,28,6,1,3,1037612,"2023-10-27T00:00:00.000Z",666633,16,"Tyler Herro",1,34,40,34,12,44.2
"698",698,5,1,7,4,3,7,5,0,0,32,1,3,13,8,0,1,1037612,"2023-10-27T00:00:00.000Z",286,16,"Kyle Lowry",1,21,26,18,13,32.1
"699",699,0,0,0,0,0,0,0,0,0,0,0,0,0,0,0,0,1037610,"2023-10-27T00:00:00.000Z",17896067,15,"Santi Aldama",0,0,0,0,0,0
"700",700,0,0,0,0,0,0,0,0,0,0,0,0,0,0,0,0,1037610,"2023-10-27T00:00:00.000Z",666505,15,"Brandon Clarke",0,0,0,0,0,0
"701",701,0,0,0,0,0,0,0,0,0,0,0,0,0,0,0,0,1037632,"2023-10-29T00:00:00.000Z",38017714,26,"Keon Ellis",0,0,0,0,0,0
"702",702,0,0,0,0,0,0,0,0,0,0,0,0,0,0,0,0,1037632,"2023-10-29T00:00:00.000Z",56677845,26,"Colby Jones",0,0,0,0,0,0
"703",703,0,0,0,0,0,0,0,0,0,0,0,0,0,0,0,0,1037632,"2023-10-29T00:00:00.000Z",273,26,"Alex Len",0,0,0,0,0,0
"704",704,1,0,3,1,0,1,0,0,0,7,1,2,0,4,1,1,1037629,"2023-10-29T00:00:00.000Z",56677852,17,"Andre Jackson Jr.",1,4,5,1,5,8.3
"705",705,2,0,0,0,0,1,1,0,0,8,0,2,2,0,1,3,1037629,"2023-10-29T00:00:00.000Z",2148,17,"Thanasis Antetokounmpo",1,2,4,4,2,5
"706",706,0,0,1,2,2,2,2,1,1,6,0,0,7,1,0,0,1037629,"2023-10-29T00:00:00.000Z",38017733,17,"A.J. Green",0,8,8,7,1,8.2
"707",707,0,0,0,0,0,0,0,0,0,0,0,0,0,0,0,0,1037629,"2023-10-29T00:00:00.000Z",56677854,17,"Chris Livingston",0,0,0,0,0,0
"708",708,2,0,4,4,2,13,7,5,4,35,1,3,20,5,0,3,1037630,"2023-10-29T00:00:00.000Z",38017690,25,"Shaedon Sharpe",0,25,27,22,7,26
"709",709,3,1,1,4,0,7,2,0,0,26,0,5,4,1,0,4,1037630,"2023-10-29T00:00:00.000Z",56677747,25,"Scoot Henderson",1,5,8,7,4,8.7
"710",710,1,1,4,3,1,9,4,3,3,24,3,4,12,7,4,2,1037630,"2023-10-29T00:00:00.000Z",38017711,25,"Jabari Walker",5,19,20,13,8,34.9
"711",711,0,0,0,0,0,0,0,0,0,0,0,0,0,0,0,0,1037630,"2023-10-29T00:00:00.000Z",47957121,25,"Justin Minaya",0,0,0,0,0,0
"712",712,0,0,0,0,0,0,0,0,0,0,0,0,0,0,0,0,1037630,"2023-10-29T00:00:00.000Z",56783340,25,"Duop Reath",0,0,0,0,0,0
"713",713,0,0,0,0,0,0,0,0,0,0,0,0,0,0,0,0,1037630,"2023-10-29T00:00:00.000Z",419,25,"Anfernee Simons",0,0,0,0,0,0
"714",714,0,0,0,0,0,0,0,0,0,0,0,0,0,0,0,0,1037630,"2023-10-29T00:00:00.000Z",17896120,25,"Ish Wainright",0,0,0,0,0,0
"715",715,2,0,0,2,0,3,1,0,0,32,0,4,2,0,1,0,1037632,"2023-10-29T00:00:00.000Z",1603383,14,"Gabe Vincent",1,2,4,4,2,8
"716",716,0,0,1,1,0,2,0,0,0,5,0,0,0,1,0,0,1037632,"2023-10-29T00:00:00.000Z",666860,14,"Cameron Reddish",0,1,1,0,1,1.2
"717",717,1,0,5,2,2,3,3,3,3,14,0,0,11,5,0,0,1037632,"2023-10-29T00:00:00.000Z",486,14,"Christian Wood",0,16,17,12,6,18.5
"718",718,0,0,0,0,0,0,0,0,0,0,0,0,0,0,0,0,1037632,"2023-10-29T00:00:00.000Z",56677738,14,"Colin Castleton",0,0,0,0,0,0
"719",719,0,0,0,0,0,0,0,0,0,0,0,0,0,0,0,0,1037632,"2023-10-29T00:00:00.000Z",56677867,14,"Alex Fudge",0,0,0,0,0,0
"720",720,0,0,0,0,0,0,0,0,0,0,0,0,0,0,0,0,1037632,"2023-10-29T00:00:00.000Z",56677868,14,"D'Moi Hodge",0,0,0,0,0,0
"721",721,0,0,0,0,0,0,0,0,0,0,0,0,0,0,0,0,1037632,"2023-10-29T00:00:00.000Z",56677835,14,"Jalen Hood-Schifino",0,0,0,0,0,0
"722",722,0,0,0,0,0,0,0,0,0,0,0,0,0,0,0,0,1037632,"2023-10-29T00:00:00.000Z",457,14,"Jarred Vanderbilt",0,0,0,0,0,0
"723",723,3,1,2,1,0,1,0,0,0,26,1,1,0,3,1,0,1037631,"2023-10-29T00:00:00.000Z",108,13,"Robert Covington",2,3,6,3,6,14.1
"724",724,4,0,3,7,3,13,6,7,6,28,0,2,21,3,2,3,1037631,"2023-10-29T00:00:00.000Z",274,13,"Kawhi Leonard",2,24,28,25,7,33.6
"725",725,0,1,6,0,0,7,6,6,4,22,2,4,16,8,0,1,1037631,"2023-10-29T00:00:00.000Z",493,13,"Ivica Zubac",1,24,24,16,8,27.6
"726",726,0,0,0,0,0,0,0,0,0,0,0,0,0,0,0,0,1037642,"2023-10-30T00:00:00.000Z",19465584,29,"Micah Potter",0,0,0,0,0,0
"727",727,1,1,0,2,0,4,1,2,2,26,0,3,4,0,0,0,1037643,"2023-10-30T00:00:00.000Z",383,14,"Taurean Prince",1,4,5,5,1,8.5
"728",728,4,1,3,6,2,17,7,4,3,33,0,0,19,3,3,5,1037643,"2023-10-30T00:00:00.000Z",237,14,"LeBron James",4,22,26,23,7,35.6
"729",729,5,3,17,1,0,18,12,3,2,38,2,3,26,19,1,1,1037643,"2023-10-30T00:00:00.000Z",117,14,"Anthony Davis",4,45,50,31,24,67.3
"730",730,3,1,3,4,1,12,5,0,0,31,0,0,11,3,0,3,1037643,"2023-10-30T00:00:00.000Z",17553995,14,"Austin Reaves",1,14,17,14,6,19.1
"731",731,8,1,2,6,3,14,10,5,5,36,0,4,28,2,1,3,1037643,"2023-10-30T00:00:00.000Z",405,14,"D'Angelo Russell",2,30,38,36,10,45.4
"732",732,0,0,0,0,0,0,0,0,0,0,0,0,0,0,0,0,1037642,"2023-10-30T00:00:00.000Z",666489,8,"Vlatko Cancar",0,0,0,0,0,0
"733",733,0,0,0,0,0,0,0,0,0,0,0,0,0,0,0,0,1037642,"2023-10-30T00:00:00.000Z",17896103,8,"Jay Huff",0,0,0,0,0,0
"734",734,2,0,0,3,1,7,4,0,0,25,0,2,9,0,1,0,1037643,"2023-10-30T00:00:00.000Z",1603383,14,"Gabe Vincent",1,9,11,11,2,15
"735",735,3,3,8,4,1,6,3,4,2,27,1,3,9,9,0,3,1037643,"2023-10-30T00:00:00.000Z",486,14,"Christian Wood",3,18,21,12,12,30.3
"736",736,0,0,0,0,0,0,0,0,0,0,0,0,0,0,0,0,1037643,"2023-10-30T00:00:00.000Z",56677867,14,"Alex Fudge",0,0,0,0,0,0
"737",737,0,0,0,0,0,0,0,0,0,0,0,0,0,0,0,0,1037643,"2023-10-30T00:00:00.000Z",666609,14,"Rui Hachimura",0,0,0,0,0,0
"738",738,0,0,0,0,0,0,0,0,0,0,0,0,0,0,0,0,1037643,"2023-10-30T00:00:00.000Z",56677835,14,"Jalen Hood-Schifino",0,0,0,0,0,0
"739",739,0,0,0,0,0,0,0,0,0,0,0,0,0,0,0,0,1037643,"2023-10-30T00:00:00.000Z",457,14,"Jarred Vanderbilt",0,0,0,0,0,0
"740",740,4,0,6,7,2,17,5,4,4,37,2,4,16,8,2,2,1037643,"2023-10-30T00:00:00.000Z",17896026,22,"Franz Wagner",2,24,28,20,12,35.6
"741",741,5,0,4,5,1,14,4,2,0,31,1,3,9,5,0,2,1037643,"2023-10-30T00:00:00.000Z",38017683,22,"Paolo Banchero",0,14,19,14,10,20.5
"742",742,1,1,6,3,1,8,4,2,1,35,2,4,10,8,0,0,1037643,"2023-10-30T00:00:00.000Z",85,22,"Wendell Carter Jr.",1,18,19,11,9,24.1
"743",743,8,2,3,1,0,16,7,0,0,33,1,2,14,4,1,1,1037643,"2023-10-30T00:00:00.000Z",165,22,"Markelle Fultz",3,18,26,22,12,38.8
"744",744,2,0,3,3,1,12,4,4,3,21,0,2,12,3,3,1,1037643,"2023-10-30T00:00:00.000Z",3547251,22,"Cole Anthony",3,15,17,14,5,26.6
"745",745,0,0,0,1,0,5,2,2,1,12,1,2,5,1,0,1,1037643,"2023-10-30T00:00:00.000Z",462,22,"Moritz Wagner",0,6,6,5,1,5.2
"746",746,0,0,3,3,1,3,1,0,0,11,0,1,3,3,1,0,1037643,"2023-10-30T00:00:00.000Z",229,22,"Jonathan Isaac",1,6,6,3,3,9.6
"747",747,3,0,0,0,0,2,1,0,0,12,1,2,2,1,2,1,1037643,"2023-10-30T00:00:00.000Z",226,22,"Joe Ingles",2,3,6,5,4,12.7
"748",748,3,0,2,5,5,6,6,0,0,21,1,0,17,3,0,3,1037643,"2023-10-30T00:00:00.000Z",196,22,"Gary Harris",0,20,23,20,6,22.1
"749",749,0,0,0,0,0,0,0,0,0,1,0,0,0,0,0,0,1037643,"2023-10-30T00:00:00.000Z",666442,22,"Goga Bitadze",0,0,0,0,0,0
"750",750,0,0,0,0,0,0,0,0,0,0,0,0,0,0,0,0,1037643,"2023-10-30T00:00:00.000Z",56677827,22,"Anthony Black",0,0,0,0,0,0
"751",751,0,0,0,0,0,0,0,0,0,0,0,0,0,0,0,0,3277349,"2023-11-03T00:00:00.000Z",56677778,12,"Oscar Tshiebwe",0,0,0,0,0,0
"752",752,0,0,0,0,0,0,0,0,0,0,0,0,0,0,0,0,3277349,"2023-11-03T00:00:00.000Z",56677794,12,"Isaiah Wong",0,0,0,0,0,0
"753",753,0,1,1,6,1,9,4,2,1,28,0,2,10,1,1,1,3277349,"2023-11-03T00:00:00.000Z",666908,6,"Max Strus",2,11,11,10,1,16.2
"754",754,5,4,8,2,0,13,7,0,0,36,2,2,14,10,3,2,3277349,"2023-11-03T00:00:00.000Z",17896076,6,"Evan Mobley",7,24,29,19,15,52.5
"755",755,0,2,5,0,0,6,4,3,2,21,2,4,10,7,1,1,3277349,"2023-11-03T00:00:00.000Z",9,6,"Jarrett Allen",3,17,17,10,7,26.4
"756",756,9,0,4,7,4,21,13,10,8,37,1,1,38,5,1,3,3277349,"2023-11-03T00:00:00.000Z",322,6,"Donovan Mitchell",1,43,52,47,14,57.5
"757",757,6,1,0,2,0,11,5,4,4,32,0,1,14,0,2,4,3277349,"2023-11-03T00:00:00.000Z",666581,6,"Darius Garland",3,14,20,20,6,28
"758",758,0,0,0,0,0,0,0,0,0,0,0,0,0,0,0,0,3277349,"2023-11-03T00:00:00.000Z",248,6,"Damian Jones",0,0,0,0,0,0
"759",759,0,0,0,0,0,0,0,0,0,0,0,0,0,0,0,0,3277349,"2023-11-03T00:00:00.000Z",3547299,6,"Sam Merrill",0,0,0,0,0,0
"760",760,4,0,0,4,2,20,9,4,4,34,1,0,24,1,0,0,3277352,"2023-11-03T00:00:00.000Z",125,5,"DeMar DeRozan",0,25,29,28,5,31.2
"761",761,4,0,6,2,1,4,1,0,0,23,0,4,3,6,1,1,3277352,"2023-11-03T00:00:00.000Z",110,5,"Torrey Craig",1,9,13,7,10,18.2
"762",762,3,0,7,1,1,13,6,0,0,36,6,1,13,13,0,0,3277352,"2023-11-03T00:00:00.000Z",460,5,"Nikola Vucevic",0,26,29,16,16,33.1
"763",763,5,1,6,6,1,21,10,4,3,39,1,2,24,7,1,2,3277352,"2023-11-03T00:00:00.000Z",268,5,"Zach LaVine",2,31,36,29,12,43.9
"764",764,2,1,2,8,2,17,7,2,2,35,1,0,18,3,0,2,3277352,"2023-11-03T00:00:00.000Z",666956,5,"Coby White",1,21,23,20,5,25.6
"765",765,0,0,1,2,1,3,2,0,0,14,0,2,5,1,1,2,3277352,"2023-11-03T00:00:00.000Z",87,5,"Jevon Carter",1,6,6,5,1,7.2
"766",766,1,0,0,5,3,6,4,6,5,26,0,0,16,0,0,1,3277353,"2023-11-03T00:00:00.000Z",3547272,21,"Isaiah Joe",0,16,17,17,1,16.5
"767",767,0,0,2,3,1,6,3,0,0,17,0,1,7,2,1,0,3277353,"2023-11-03T00:00:00.000Z",17896078,21,"Aaron Wiggins",1,9,9,7,2,12.4
"768",768,3,0,1,2,1,5,2,0,0,12,0,1,5,1,0,0,3277353,"2023-11-03T00:00:00.000Z",4197029,21,"Vasilije Micic",0,6,9,8,4,10.7
"769",769,0,0,0,0,0,0,0,0,0,0,0,0,0,0,0,0,3277353,"2023-11-03T00:00:00.000Z",17896036,21,"Tre Mann",0,0,0,0,0,0
"770",770,0,0,0,0,0,0,0,0,0,0,0,0,0,0,0,0,3277353,"2023-11-03T00:00:00.000Z",3547271,21,"Aleksej Pokusevski",0,0,0,0,0,0
"771",771,0,0,0,0,0,0,0,0,0,0,0,0,0,0,0,0,3277353,"2023-11-03T00:00:00.000Z",24572055,21,"Olivier Sarr",0,0,0,0,0,0
"772",772,0,0,0,0,0,0,0,0,0,0,0,0,0,0,0,0,3277353,"2023-11-03T00:00:00.000Z",27924547,21,"Lindy Waters III",0,0,0,0,0,0
"773",773,0,0,0,0,0,0,0,0,0,3,0,1,0,0,0,0,3277349,"2023-11-03T00:00:00.000Z",666940,6,"Dean Wade",0,0,0,0,0,0
"774",774,0,0,1,0,0,0,0,0,0,3,0,1,0,1,0,0,3277349,"2023-11-03T00:00:00.000Z",444,6,"Tristan Thompson",0,1,1,0,1,1.2
"775",775,0,0,0,0,0,0,0,0,0,0,0,0,0,0,0,0,3277349,"2023-11-03T00:00:00.000Z",56677872,6,"Craig Porter",0,0,0,0,0,0
"776",776,1,0,2,0,0,8,4,2,2,24,0,1,10,2,0,1,1037684,"2023-11-06T00:00:00.000Z",24,9,"Marvin Bagley III",0,12,13,11,3,12.9
"777",777,5,0,4,6,1,18,7,7,6,40,0,2,21,4,2,5,1037684,"2023-11-06T00:00:00.000Z",17896075,9,"Cade Cunningham",2,25,30,26,9,34.3
"778",778,7,1,4,4,3,12,8,2,2,34,0,3,21,4,1,0,1037684,"2023-11-06T00:00:00.000Z",3547241,9,"Killian Hayes",2,25,32,28,11,42.3
"779",779,0,0,0,0,0,0,0,0,0,0,0,0,0,0,0,0,1037684,"2023-11-06T00:00:00.000Z",56677729,9,"Malcolm Cazalon",0,0,0,0,0,0
"780",780,0,0,0,0,0,0,0,0,0,0,0,0,0,0,0,0,1037684,"2023-11-06T00:00:00.000Z",38017694,9,"Jalen Duren",0,0,0,0,0,0
"781",781,0,0,0,0,0,0,0,0,0,0,0,0,0,0,0,0,1037684,"2023-11-06T00:00:00.000Z",197,9,"Joe Harris",0,0,0,0,0,0
"782",782,1,0,2,3,1,11,6,6,6,27,0,3,19,2,2,1,1037685,"2023-11-06T00:00:00.000Z",3547243,12,"Obi Toppin",2,21,22,20,3,27.9
"783",783,2,1,7,1,1,7,5,4,4,21,4,3,15,11,0,0,1037685,"2023-11-06T00:00:00.000Z",452,12,"Myles Turner",1,26,28,17,13,34.2
"784",784,4,0,5,3,1,7,3,0,0,24,0,1,7,5,0,0,1037685,"2023-11-06T00:00:00.000Z",69,12,"Bruce Brown",0,12,16,11,9,19
"785",785,8,1,2,7,3,19,9,2,2,27,0,1,23,2,1,2,1037685,"2023-11-06T00:00:00.000Z",3547245,12,"Tyrese Haliburton",2,25,33,31,10,41.4
"786",786,2,0,2,6,5,8,7,0,0,21,0,1,19,2,1,4,1037685,"2023-11-06T00:00:00.000Z",210,12,"Buddy Hield",1,21,23,21,4,23.4
"787",787,2,0,1,4,3,8,5,2,2,16,1,0,15,2,2,0,1037685,"2023-11-06T00:00:00.000Z",3547250,12,"Aaron Nesmith",2,17,19,17,4,26.4
"788",788,2,0,6,1,1,4,4,0,0,12,1,3,9,7,0,1,1037685,"2023-11-06T00:00:00.000Z",3547264,12,"Jalen Smith",0,16,18,11,9,19.4
"789",789,8,0,2,5,3,7,3,0,0,16,0,3,9,2,0,2,1037685,"2023-11-06T00:00:00.000Z",38017507,12,"Andrew Nembhard",0,11,19,17,10,21.4
"790",790,1,2,1,0,0,3,3,1,1,15,2,5,7,3,0,0,1037685,"2023-11-06T00:00:00.000Z",17896035,12,"Isaiah Jackson",2,10,11,8,4,18.1
"791",791,0,0,2,4,1,7,3,0,0,12,0,1,7,2,0,0,1037685,"2023-11-06T00:00:00.000Z",56677861,12,"Ben Sheppard",0,9,9,7,2,9.4
"792",792,2,0,1,0,0,1,0,2,2,9,0,0,2,1,0,0,1037685,"2023-11-06T00:00:00.000Z",56677832,12,"Jarace Walker",0,3,5,4,3,6.2
"793",793,4,0,3,0,0,2,1,2,2,9,0,1,4,3,0,1,1037685,"2023-11-06T00:00:00.000Z",304,12,"T.J. McConnell",0,7,11,8,7,12.6
"794",794,0,0,4,2,1,3,2,2,1,9,0,0,6,4,0,2,1037685,"2023-11-06T00:00:00.000Z",3547207,12,"Jordan Nwora",0,10,10,6,4,8.8
"795",795,0,0,0,0,0,0,0,0,0,0,0,0,0,0,0,0,1037685,"2023-11-06T00:00:00.000Z",439,12,"Daniel Theis",0,0,0,0,0,0
"796",796,0,0,0,0,0,0,0,0,0,0,0,0,0,0,0,0,1037685,"2023-11-06T00:00:00.000Z",38017701,12,"Kendall Brown",0,0,0,0,0,0
"797",797,0,0,0,0,0,0,0,0,0,0,0,0,0,0,0,0,1037685,"2023-11-06T00:00:00.000Z",56677778,12,"Oscar Tshiebwe",0,0,0,0,0,0
"798",798,0,0,0,0,0,0,0,0,0,0,0,0,0,0,0,0,1037685,"2023-11-06T00:00:00.000Z",56677794,12,"Isaiah Wong",0,0,0,0,0,0
"799",799,3,0,2,0,0,12,6,5,4,23,1,1,16,3,0,1,1037685,"2023-11-06T00:00:00.000Z",666682,27,"Keldon Johnson",0,19,22,19,6,23.1
"800",800,0,2,9,5,2,12,3,6,5,21,1,1,13,10,1,2,1037685,"2023-11-06T00:00:00.000Z",56677822,27,"Victor Wembanyama",3,23,23,13,10,32
"801",801,0,0,1,3,2,5,2,0,0,17,1,1,6,2,0,0,1037701,"2023-11-08T00:00:00.000Z",18678058,24,"Jordan Goodwin",0,8,8,6,2,8.4
"802",802,0,0,0,0,0,0,0,0,0,1,0,0,0,0,0,0,1037701,"2023-11-08T00:00:00.000Z",666451,24,"Bol Bol",0,0,0,0,0,0
"803",803,0,0,0,0,0,0,0,0,0,0,0,0,0,0,0,0,1037701,"2023-11-08T00:00:00.000Z",3547095,24,"Udoka Azubuike",0,0,0,0,0,0
"804",804,4,1,9,13,8,16,9,0,0,37,0,3,26,9,1,1,1037701,"2023-11-08T00:00:00.000Z",8,24,"Grayson Allen",2,35,39,30,13,47.8
"805",805,4,2,4,6,3,12,3,4,4,24,0,0,13,4,0,2,1037701,"2023-11-08T00:00:00.000Z",37,24,"Bradley Beal",2,17,21,17,8,27.8
"806",806,1,0,0,1,0,3,1,0,0,19,0,0,2,0,0,1,1037704,"2023-11-08T00:00:00.000Z",105,17,"Pat Connaughton",0,2,3,3,1,2.5
"807",807,0,0,0,0,0,0,0,0,0,0,0,0,0,0,0,0,1037701,"2023-11-08T00:00:00.000Z",3547298,24,"Saben Lee",0,0,0,0,0,0
"808",808,0,0,0,0,0,0,0,0,0,0,0,0,0,0,0,0,1037701,"2023-11-08T00:00:00.000Z",666729,24,"Nassir Little",0,0,0,0,0,0
"809",809,1,0,4,0,0,1,0,2,0,22,0,4,0,4,0,0,1037702,"2023-11-08T00:00:00.000Z",486,14,"Christian Wood",0,4,5,1,5,6.3
"810",810,4,0,1,4,0,9,2,3,3,26,0,1,7,1,2,2,1037702,"2023-11-08T00:00:00.000Z",17553995,14,"Austin Reaves",2,8,12,11,5,18.2
"811",811,4,3,2,7,4,18,9,0,0,28,0,1,22,2,0,1,1037702,"2023-11-08T00:00:00.000Z",405,14,"D'Angelo Russell",3,24,28,26,6,38.4
"812",812,3,1,7,2,0,8,1,3,2,28,1,2,4,8,0,1,1037702,"2023-11-08T00:00:00.000Z",38017697,14,"Max Christie",1,12,15,7,11,20.1
"813",813,3,0,1,3,1,4,1,4,4,24,0,2,7,1,2,1,1037704,"2023-11-08T00:00:00.000Z",368,17,"Cameron Payne",2,8,11,10,4,17.7
"814",814,0,0,0,0,0,0,0,0,0,4,0,3,0,0,1,0,1037704,"2023-11-08T00:00:00.000Z",56677852,17,"Andre Jackson Jr.",1,0,0,0,0,3
"815",815,0,0,0,0,0,0,0,0,0,0,0,0,0,0,0,0,1037704,"2023-11-08T00:00:00.000Z",2148,17,"Thanasis Antetokounmpo",0,0,0,0,0,0
"816",816,0,0,1,3,0,7,2,4,3,25,0,0,7,1,3,0,1037702,"2023-11-08T00:00:00.000Z",666860,14,"Cameron Reddish",3,8,8,7,1,17.2
"817",817,1,1,0,2,0,3,1,2,1,10,0,1,3,0,0,1,1037702,"2023-11-08T00:00:00.000Z",56677868,14,"D'Moi Hodge",1,3,4,4,1,6.5
"818",818,0,0,1,0,0,2,0,0,0,8,0,0,0,1,0,0,1037702,"2023-11-08T00:00:00.000Z",56677836,14,"Maxwell Lewis",0,1,1,0,1,1.2
"819",819,0,0,0,0,0,0,0,0,0,0,0,0,0,0,0,0,1037702,"2023-11-08T00:00:00.000Z",56677867,14,"Alex Fudge",0,0,0,0,0,0
"820",820,0,0,0,0,0,0,0,0,0,0,0,0,0,0,0,0,1037702,"2023-11-08T00:00:00.000Z",666626,14,"Jaxson Hayes",0,0,0,0,0,0
"821",821,0,0,0,0,0,0,0,0,0,0,0,0,0,0,0,0,1037701,"2023-11-08T00:00:00.000Z",314,24,"Chimezie Metu",0,0,0,0,0,0
"822",822,0,0,0,0,0,0,0,0,0,0,0,0,0,0,0,0,1037704,"2023-11-08T00:00:00.000Z",38017733,17,"A.J. Green",0,0,0,0,0,0
"823",823,0,0,0,0,0,0,0,0,0,0,0,0,0,0,0,0,1037704,"2023-11-08T00:00:00.000Z",56677854,17,"Chris Livingston",0,0,0,0,0,0
"824",824,0,0,0,0,0,0,0,0,0,0,0,0,0,0,0,0,1037704,"2023-11-08T00:00:00.000Z",284,17,"Robin Lopez",0,0,0,0,0,0
"825",825,1,3,4,5,3,8,6,0,0,29,1,3,15,5,0,3,1037707,"2023-11-08T00:00:00.000Z",247,7,"Derrick Jones Jr.",3,20,21,16,6,28.5
"826",826,3,0,2,3,1,7,3,0,0,27,1,2,7,3,0,1,1037727,"2023-11-12T00:00:00.000Z",666743,13,"Terance Mann",0,10,13,10,6,14.1
"827",827,0,0,0,0,0,0,0,0,0,0,0,0,0,0,0,0,1037727,"2023-11-12T00:00:00.000Z",56677849,13,"Kobe Brown",0,0,0,0,0,0
"828",828,0,0,0,0,0,0,0,0,0,0,0,0,0,0,0,0,1037727,"2023-11-12T00:00:00.000Z",666511,13,"Amir Coffey",0,0,0,0,0,0
"829",829,0,0,0,0,0,0,0,0,0,0,0,0,0,0,0,0,1037727,"2023-11-12T00:00:00.000Z",17896031,13,"Nah'Shon Hyland",0,0,0,0,0,0
"830",830,0,0,0,0,0,0,0,0,0,0,0,0,0,0,0,0,1037727,"2023-11-12T00:00:00.000Z",17896022,13,"Brandon Boston Jr.",0,0,0,0,0,0
"831",831,0,0,0,0,0,0,0,0,0,0,0,0,0,0,0,0,1037727,"2023-11-12T00:00:00.000Z",56677856,13,"Jordan Miller",0,0,0,0,0,0
"832",832,0,0,0,0,0,0,0,0,0,0,0,0,0,0,0,0,1037727,"2023-11-12T00:00:00.000Z",371,13,"Mason Plumlee",0,0,0,0,0,0
"833",833,0,0,0,0,0,0,0,0,0,0,0,0,0,0,0,0,1037727,"2023-11-12T00:00:00.000Z",17896051,13,"Joshua Primo",0,0,0,0,0,0
"834",834,6,1,3,11,3,24,10,6,4,35,1,4,27,4,0,4,1037727,"2023-11-12T00:00:00.000Z",3547287,15,"Desmond Bane",1,31,37,33,10,39.8
"835",835,1,1,4,3,0,15,3,6,6,29,0,4,12,4,1,3,1037727,"2023-11-12T00:00:00.000Z",231,15,"Jaren Jackson Jr.",2,16,17,13,5,21.3
"836",836,3,2,8,0,0,6,5,7,3,36,4,3,13,12,1,1,1037727,"2023-11-12T00:00:00.000Z",48,15,"Bismack Biyombo",3,25,28,16,15,39.9
"837",837,7,0,3,7,3,12,5,4,4,36,0,3,17,3,0,5,1037727,"2023-11-12T00:00:00.000Z",420,15,"Marcus Smart",0,20,27,24,10,26.1
"838",838,3,0,4,6,2,6,2,0,0,24,1,3,6,5,3,0,1037727,"2023-11-12T00:00:00.000Z",48248287,15,"Jacob Gilyard",3,11,14,9,8,25.5
"839",839,2,1,3,4,1,8,4,0,0,21,0,1,9,3,0,2,1037727,"2023-11-12T00:00:00.000Z",17896067,15,"Santi Aldama",1,12,14,11,5,16.6
"840",840,2,0,1,5,4,5,4,1,1,24,0,1,13,1,1,0,1037727,"2023-11-12T00:00:00.000Z",254,15,"Luke Kennard",1,14,16,15,3,20.2
"841",841,0,0,2,1,0,1,0,0,0,5,0,2,0,2,0,1,1037727,"2023-11-12T00:00:00.000Z",666703,15,"John Konchar",0,2,2,0,2,1.4
"842",842,0,1,2,1,0,7,4,0,0,21,4,1,8,6,1,0,1037727,"2023-11-12T00:00:00.000Z",38017729,15,"David Roddy",2,14,14,8,6,21.2
"843",843,0,0,0,0,0,0,0,0,0,0,0,0,0,0,0,0,1037727,"2023-11-12T00:00:00.000Z",38017732,15,"Kenneth Lofton Jr.",0,0,0,0,0,0
"844",844,0,0,0,0,0,0,0,0,0,0,0,0,0,0,0,0,1037727,"2023-11-12T00:00:00.000Z",38017731,15,"Vince Williams Jr.",0,0,0,0,0,0
"845",845,0,0,0,0,0,0,0,0,0,0,0,0,0,0,0,0,1037726,"2023-11-12T00:00:00.000Z",17896048,3,"Cam Thomas",0,0,0,0,0,0
"846",846,1,0,0,3,0,4,0,0,0,9,1,1,0,1,0,0,1037727,"2023-11-12T00:00:00.000Z",17896027,15,"Ziaire Williams",0,1,2,1,2,2.7
"847",847,0,0,0,0,0,0,0,0,0,0,0,0,0,0,0,0,1037727,"2023-11-12T00:00:00.000Z",3,15,"Steven Adams",0,0,0,0,0,0
"848",848,0,0,0,0,0,0,0,0,0,0,0,0,0,0,0,0,1037727,"2023-11-12T00:00:00.000Z",666505,15,"Brandon Clarke",0,0,0,0,0,0
"849",849,0,0,0,0,0,0,0,0,0,0,0,0,0,0,0,0,1037727,"2023-11-12T00:00:00.000Z",56677830,15,"GG Jackson",0,0,0,0,0,0
"850",850,0,0,0,0,0,0,0,0,0,0,0,0,0,0,0,0,1037727,"2023-11-12T00:00:00.000Z",38017728,15,"Jake LaRavia",0,0,0,0,0,0
"851",851,0,0,0,1,0,1,0,0,0,3,0,1,0,0,1,0,3277431,"2023-11-14T00:00:00.000Z",17896120,25,"Ish Wainright",1,0,0,0,0,3
"852",852,0,0,0,0,0,2,0,2,1,2,0,0,1,0,0,0,3277431,"2023-11-14T00:00:00.000Z",56677829,25,"Rayan Rupert",0,1,1,1,0,1
"853",853,0,0,0,0,0,0,0,0,0,0,0,0,0,0,0,0,3277431,"2023-11-14T00:00:00.000Z",65,25,"Malcolm Brogdon",0,0,0,0,0,0
"854",854,0,0,0,0,0,0,0,0,0,0,0,0,0,0,0,0,3277431,"2023-11-14T00:00:00.000Z",56677747,25,"Scoot Henderson",0,0,0,0,0,0
"855",855,0,0,0,0,0,0,0,0,0,0,0,0,0,0,0,0,3277431,"2023-11-14T00:00:00.000Z",419,25,"Anfernee Simons",0,0,0,0,0,0
"856",856,0,0,0,0,0,0,0,0,0,0,0,0,0,0,0,0,3277431,"2023-11-14T00:00:00.000Z",476,25,"Robert Williams III",0,0,0,0,0,0
"857",857,2,0,1,5,3,7,3,2,1,25,0,2,10,1,0,0,3277434,"2023-11-14T00:00:00.000Z",666860,14,"Cameron Reddish",0,11,13,12,3,14.2
"858",858,6,0,9,6,3,11,6,2,1,23,0,1,16,9,1,4,3277434,"2023-11-14T00:00:00.000Z",237,14,"LeBron James",1,25,31,22,15,34.8
"859",859,5,6,7,0,0,11,7,6,5,27,4,1,19,11,0,2,3277434,"2023-11-14T00:00:00.000Z",117,14,"Anthony Davis",6,30,35,24,16,55.7
"860",860,1,0,3,5,2,6,3,0,0,29,0,3,8,3,1,0,3277434,"2023-11-14T00:00:00.000Z",383,14,"Taurean Prince",1,11,12,9,4,16.1
"861",861,5,0,3,8,6,12,8,3,2,27,0,0,24,3,0,0,3277434,"2023-11-14T00:00:00.000Z",405,14,"D'Angelo Russell",0,27,32,29,8,35.1
"862",862,0,0,3,3,3,10,8,4,4,24,0,2,23,3,0,5,3277434,"2023-11-14T00:00:00.000Z",666609,14,"Rui Hachimura",0,26,26,23,3,21.6
"863",863,1,3,0,0,0,4,4,4,3,21,1,2,11,1,1,0,3277434,"2023-11-14T00:00:00.000Z",666626,14,"Jaxson Hayes",4,12,13,12,2,25.7
"864",864,1,0,1,1,1,2,2,0,0,8,0,0,5,1,1,1,3277434,"2023-11-14T00:00:00.000Z",38017697,14,"Max Christie",1,6,7,6,2,9.7
"865",865,7,0,6,10,2,16,4,10,7,41,2,3,17,8,2,3,3277431,"2023-11-14T00:00:00.000Z",38017690,25,"Shaedon Sharpe",2,25,32,24,15,40.1
"866",866,0,0,0,0,0,0,0,0,0,0,0,0,0,0,0,0,3277432,"2023-11-14T00:00:00.000Z",17896103,8,"Jay Huff",0,0,0,0,0,0
"867",867,0,0,0,0,0,0,0,0,0,0,0,0,0,0,0,0,3277432,"2023-11-14T00:00:00.000Z",335,8,"Jamal Murray",0,0,0,0,0,0
"868",868,0,0,0,0,0,0,0,0,0,0,0,0,0,0,0,0,3277432,"2023-11-14T00:00:00.000Z",56677871,8,"Hunter Tyson",0,0,0,0,0,0
"869",869,3,0,7,11,4,26,13,5,5,40,0,4,35,7,3,1,3277432,"2023-11-14T00:00:00.000Z",172,13,"Paul George",3,42,45,38,10,55.9
"870",870,2,0,2,3,2,14,5,4,3,38,0,1,15,2,5,3,3277432,"2023-11-14T00:00:00.000Z",274,13,"Kawhi Leonard",5,17,19,17,4,32.4
"871",871,3,1,6,0,0,8,2,6,5,26,7,4,9,13,0,0,3277432,"2023-11-14T00:00:00.000Z",493,13,"Ivica Zubac",1,22,25,12,16,32.1
"872",872,4,0,2,8,3,15,7,4,4,36,0,3,21,2,0,1,3277432,"2023-11-14T00:00:00.000Z",192,13,"James Harden",0,23,27,25,6,28.4
"873",873,0,0,0,0,0,0,0,0,0,0,0,0,0,0,0,0,3277432,"2023-11-14T00:00:00.000Z",56677849,13,"Kobe Brown",0,0,0,0,0,0
"874",874,0,0,0,0,0,0,0,0,0,0,0,0,0,0,0,0,3277432,"2023-11-14T00:00:00.000Z",666511,13,"Amir Coffey",0,0,0,0,0,0
"875",875,0,0,0,0,0,0,0,0,0,0,0,0,0,0,0,0,3277432,"2023-11-14T00:00:00.000Z",38017725,13,"Moussa Diabate",0,0,0,0,0,0
"876",876,0,0,0,0,0,0,0,0,0,5,0,0,0,0,0,0,3277454,"2023-11-17T00:00:00.000Z",47957121,25,"Justin Minaya",0,0,0,0,0,0
"877",877,0,0,0,0,0,0,0,0,0,1,0,0,0,0,0,0,3277454,"2023-11-17T00:00:00.000Z",44477062,25,"Jamaree Bouyea",0,0,0,0,0,0
"878",878,0,0,0,0,0,0,0,0,0,0,0,0,0,0,0,0,3277454,"2023-11-17T00:00:00.000Z",666476,25,"Moses Brown",0,0,0,0,0,0
"879",879,0,0,0,0,0,0,0,0,0,0,0,0,0,0,0,0,3277454,"2023-11-17T00:00:00.000Z",17896120,25,"Ish Wainright",0,0,0,0,0,0
"880",880,0,0,0,0,0,0,0,0,0,0,0,0,0,0,0,0,3277454,"2023-11-17T00:00:00.000Z",65,25,"Malcolm Brogdon",0,0,0,0,0,0
"881",881,0,0,0,0,0,0,0,0,0,0,0,0,0,0,0,0,3277454,"2023-11-17T00:00:00.000Z",56677747,25,"Scoot Henderson",0,0,0,0,0,0
"882",882,0,0,0,0,0,0,0,0,0,0,0,0,0,0,0,0,3277454,"2023-11-17T00:00:00.000Z",56677829,25,"Rayan Rupert",0,0,0,0,0,0
"883",883,0,0,0,0,0,0,0,0,0,0,0,0,0,0,0,0,3277454,"2023-11-17T00:00:00.000Z",419,25,"Anfernee Simons",0,0,0,0,0,0
"884",884,0,0,0,0,0,0,0,0,0,0,0,0,0,0,0,0,3277454,"2023-11-17T00:00:00.000Z",476,25,"Robert Williams III",0,0,0,0,0,0
"885",885,1,1,1,2,1,4,2,4,3,31,1,0,8,2,3,1,3277454,"2023-11-17T00:00:00.000Z",666860,14,"Cameron Reddish",4,10,11,9,3,22.9
"886",886,9,0,5,9,5,22,13,6,4,34,0,3,35,5,2,3,3277454,"2023-11-17T00:00:00.000Z",237,14,"LeBron James",2,40,49,44,14,57.5
"887",887,2,5,10,1,0,19,8,1,0,35,4,5,16,14,3,6,3277454,"2023-11-17T00:00:00.000Z",117,14,"Anthony Davis",8,30,32,18,16,53.8
"888",888,3,0,0,5,1,7,3,3,3,35,1,5,10,1,2,0,3277454,"2023-11-17T00:00:00.000Z",383,14,"Taurean Prince",2,11,14,13,4,21.7
"889",889,6,0,2,7,4,10,5,1,0,29,1,1,14,3,0,4,3277454,"2023-11-17T00:00:00.000Z",405,14,"D'Angelo Russell",0,17,23,20,9,22.6
"890",890,2,0,4,2,1,5,3,0,0,28,1,1,7,5,0,0,3277454,"2023-11-17T00:00:00.000Z",666609,14,"Rui Hachimura",0,12,14,9,7,16
"891",891,4,0,1,1,0,4,1,6,5,18,1,0,7,2,0,3,3277454,"2023-11-17T00:00:00.000Z",17553995,14,"Austin Reaves",0,9,13,11,6,12.4
"892",892,0,0,8,3,0,9,5,0,0,20,2,1,10,10,0,0,3277454,"2023-11-17T00:00:00.000Z",486,14,"Christian Wood",0,20,20,10,10,22
"893",893,0,0,1,0,0,0,0,1,0,8,0,0,0,1,1,0,3277454,"2023-11-17T00:00:00.000Z",666626,14,"Jaxson Hayes",1,1,1,0,1,4.2
"894",894,0,0,1,0,0,1,0,0,0,1,0,0,0,1,0,1,3277454,"2023-11-17T00:00:00.000Z",38017697,14,"Max Christie",0,1,1,0,1,0.2
"895",895,0,0,0,0,0,0,0,0,0,1,0,0,0,0,0,0,3277454,"2023-11-17T00:00:00.000Z",56677836,14,"Maxwell Lewis",0,0,0,0,0,0
"896",896,0,0,0,0,0,0,0,0,0,0,0,0,0,0,0,0,3277454,"2023-11-17T00:00:00.000Z",56677835,14,"Jalen Hood-Schifino",0,0,0,0,0,0
"897",897,0,0,0,0,0,0,0,0,0,0,0,0,0,0,0,0,3277454,"2023-11-17T00:00:00.000Z",56677738,14,"Colin Castleton",0,0,0,0,0,0
"898",898,0,0,0,0,0,0,0,0,0,0,0,0,0,0,0,0,3277454,"2023-11-17T00:00:00.000Z",56677867,14,"Alex Fudge",0,0,0,0,0,0
"899",899,0,0,0,0,0,0,0,0,0,0,0,0,0,0,0,0,3277453,"2023-11-17T00:00:00.000Z",666881,29,"Luka Samanic",0,0,0,0,0,0
"900",900,0,0,4,2,1,4,2,0,0,17,0,3,5,4,0,0,3277450,"2023-11-17T00:00:00.000Z",4197162,26,"Aleksandar Vezenkov",0,9,9,5,4,9.8
"901",901,2,0,2,9,6,11,7,2,2,30,0,3,22,2,0,0,1037789,"2023-11-20T00:00:00.000Z",397,16,"Duncan Robinson",0,24,26,24,4,27.4
"902",902,6,0,4,4,2,6,3,0,0,27,1,1,8,5,0,1,1037789,"2023-11-20T00:00:00.000Z",286,16,"Kyle Lowry",0,13,19,14,11,22
"903",903,4,0,1,4,3,13,8,0,0,33,2,1,19,3,2,0,1037789,"2023-11-20T00:00:00.000Z",56677785,16,"Jaime Jaquez Jr.",2,22,26,23,7,34.6
"904",904,1,0,8,5,3,6,4,0,0,15,0,2,11,8,0,1,1037789,"2023-11-20T00:00:00.000Z",285,16,"Kevin Love",0,19,20,12,9,21.1
"905",905,1,1,2,6,2,12,4,0,0,30,2,2,10,4,0,3,1037789,"2023-11-20T00:00:00.000Z",391,16,"Josh Richardson",1,14,15,11,5,16.3
"906",906,4,0,3,2,1,2,1,0,0,27,1,1,3,4,0,0,1037788,"2023-11-20T00:00:00.000Z",105,17,"Pat Connaughton",0,7,11,7,8,13.8
"907",907,1,0,2,3,0,4,1,0,0,15,0,1,2,2,0,0,1037788,"2023-11-20T00:00:00.000Z",38017733,17,"A.J. Green",0,4,5,3,3,5.9
"908",908,2,0,2,4,2,5,2,0,0,17,0,1,6,2,1,1,1037788,"2023-11-20T00:00:00.000Z",368,17,"Cameron Payne",1,8,10,8,4,13.4
"909",909,2,0,5,3,0,6,1,0,0,21,0,1,2,5,0,0,1037789,"2023-11-20T00:00:00.000Z",666747,16,"Caleb Martin",0,7,9,4,7,11
"910",910,0,0,0,0,0,0,0,0,0,1,0,2,0,0,0,0,1037788,"2023-11-20T00:00:00.000Z",284,17,"Robin Lopez",0,0,0,0,0,0
"911",911,0,0,0,0,0,0,0,0,0,1,0,0,0,0,0,0,1037788,"2023-11-20T00:00:00.000Z",2148,17,"Thanasis Antetokounmpo",0,0,0,0,0,0
"912",912,0,0,0,0,0,0,0,0,0,1,1,0,0,1,0,0,1037788,"2023-11-20T00:00:00.000Z",56677852,17,"Andre Jackson Jr.",0,1,1,0,1,1.2
"913",913,0,0,0,0,0,0,0,0,0,0,0,0,0,0,0,0,1037788,"2023-11-20T00:00:00.000Z",38017676,17,"MarJon Beauchamp",0,0,0,0,0,0
"914",914,1,0,3,3,2,9,7,1,1,22,1,4,17,4,0,0,1037792,"2023-11-20T00:00:00.000Z",359,27,"Cedi Osman",0,21,22,18,5,23.3
"915",915,2,0,2,3,1,3,1,0,0,14,0,1,3,2,0,0,1037792,"2023-11-20T00:00:00.000Z",305,27,"Doug McDermott",0,5,7,5,4,8.4
"916",916,0,0,0,0,0,0,0,0,0,0,0,0,0,0,0,0,1037792,"2023-11-20T00:00:00.000Z",56677870,27,"Sir'Jabari Rice",0,0,0,0,0,0
"917",917,0,0,0,0,0,0,0,0,0,0,0,0,0,0,0,0,1037792,"2023-11-20T00:00:00.000Z",56677865,27,"Charles Bediako",0,0,0,0,0,0
"918",918,0,0,0,0,0,0,0,0,0,0,0,0,0,0,0,0,1037792,"2023-11-20T00:00:00.000Z",3547246,27,"Devin Vassell",0,0,0,0,0,0
"919",919,0,0,0,0,0,0,0,0,0,0,0,0,0,0,0,0,1037792,"2023-11-20T00:00:00.000Z",38017693,27,"Blake Wesley",0,0,0,0,0,0
"920",920,3,0,2,6,2,17,8,3,3,28,2,0,21,4,1,0,1037792,"2023-11-20T00:00:00.000Z",274,13,"Kawhi Leonard",1,25,28,24,7,33.3
"921",921,0,0,4,6,3,9,4,6,5,30,0,0,16,4,1,0,1037791,"2023-11-20T00:00:00.000Z",30,26,"Harrison Barnes",1,20,20,16,4,23.8
"922",922,0,1,1,2,1,4,1,2,2,16,2,2,5,3,1,0,1037791,"2023-11-20T00:00:00.000Z",38017688,26,"Keegan Murray",2,8,8,5,3,14.6
"923",923,8,0,5,0,0,8,4,3,2,31,5,4,10,10,0,5,1037791,"2023-11-20T00:00:00.000Z",406,26,"Domantas Sabonis",0,20,28,18,18,29
"924",924,3,0,0,8,2,10,4,0,0,23,0,1,10,0,0,0,1037791,"2023-11-20T00:00:00.000Z",221,26,"Kevin Huerter",0,10,13,13,3,14.5
"925",925,0,0,2,12,2,18,5,4,2,29,0,1,14,2,1,2,1037791,"2023-11-20T00:00:00.000Z",161,26,"De'Aaron Fox",1,16,16,14,2,17.4
"926",926,2,0,5,0,0,5,3,0,0,17,1,4,6,6,1,2,1037810,"2023-11-22T00:00:00.000Z",282,10,"Kevon Looney",1,12,14,8,8,17.2
"927",927,6,0,3,8,1,15,6,3,3,28,0,2,16,3,0,2,1037810,"2023-11-22T00:00:00.000Z",115,10,"Stephen Curry",0,19,25,22,9,26.6
"928",928,6,0,2,1,0,2,1,4,4,17,0,1,6,2,0,1,1037810,"2023-11-22T00:00:00.000Z",367,10,"Chris Paul",0,8,14,12,8,16.4
"929",929,1,1,8,1,0,8,4,1,0,23,1,5,8,9,0,1,1037810,"2023-11-22T00:00:00.000Z",17553992,10,"Moses Moody",1,17,18,9,10,22.3
"930",930,4,0,4,3,2,9,6,5,3,22,2,4,17,6,2,1,1037810,"2023-11-22T00:00:00.000Z",407,10,"Dario Saric",2,23,27,21,10,35.2
"931",931,2,0,1,1,0,7,3,2,1,21,0,5,7,1,1,0,1037810,"2023-11-22T00:00:00.000Z",17553979,10,"Jonathan Kuminga",1,8,10,9,3,14.2
"932",932,2,0,2,3,1,9,4,2,1,23,2,1,10,4,3,0,1037810,"2023-11-22T00:00:00.000Z",56677858,10,"Brandin Podziemski",3,14,16,12,6,26.8
"933",933,0,0,2,0,0,3,2,5,2,15,2,3,6,4,1,1,1037810,"2023-11-22T00:00:00.000Z",56677799,10,"Trayce Jackson-Davis",1,10,10,6,4,12.8
"934",934,4,0,0,2,0,3,1,2,1,16,0,3,3,0,2,1,1037810,"2023-11-22T00:00:00.000Z",251,10,"Cory Joseph",2,3,7,7,4,14
"935",935,0,0,1,0,0,1,1,0,0,8,0,2,2,1,0,2,1037810,"2023-11-22T00:00:00.000Z",57875092,10,"Gui Santos",0,3,3,2,1,1.2
"936",936,0,0,0,0,0,0,0,0,0,0,0,0,0,0,0,0,1037810,"2023-11-22T00:00:00.000Z",185,10,"Draymond Green",0,0,0,0,0,0
"937",937,0,0,0,0,0,0,0,0,0,0,0,0,0,0,0,0,1037810,"2023-11-22T00:00:00.000Z",17896070,10,"Usman Garuba",0,0,0,0,0,0
"938",938,0,0,0,0,0,0,0,0,0,0,0,0,0,0,0,0,1037810,"2023-11-22T00:00:00.000Z",2189,10,"Gary Payton II",0,0,0,0,0,0
"939",939,0,0,0,0,0,0,0,0,0,0,0,0,0,0,0,0,1037810,"2023-11-22T00:00:00.000Z",45658838,10,"Lester Quinones",0,0,0,0,0,0
"940",940,2,0,4,5,2,9,3,2,2,37,3,1,10,7,0,2,1037808,"2023-11-22T00:00:00.000Z",3547248,5,"Patrick Williams",0,17,19,12,9,19.4
"941",941,5,0,1,12,7,17,8,0,0,37,0,5,23,1,1,3,1037808,"2023-11-22T00:00:00.000Z",666956,5,"Coby White",1,24,29,28,6,31.7
"942",942,0,0,0,0,0,0,0,0,0,0,0,0,0,0,0,0,1037810,"2023-11-22T00:00:00.000Z",398,10,"Jerome Robinson",0,0,0,0,0,0
"943",943,6,1,7,6,1,17,8,0,0,35,0,2,17,7,0,3,3277498,"2023-11-24T00:00:00.000Z",17896026,22,"Franz Wagner",1,24,30,23,13,34.4
"944",944,5,0,7,6,2,16,10,2,1,35,1,4,23,8,0,3,3277498,"2023-11-24T00:00:00.000Z",38017683,22,"Paolo Banchero",0,31,36,28,13,37.1
"945",945,3,1,3,0,0,5,3,0,0,19,2,5,6,5,1,0,3277498,"2023-11-24T00:00:00.000Z",666442,22,"Goga Bitadze",2,11,14,9,8,22.5
"946",946,1,0,4,4,3,8,3,2,1,28,0,2,10,4,1,3,3277498,"2023-11-24T00:00:00.000Z",17896073,22,"Jalen Suggs",1,14,15,11,5,16.3
"947",947,0,0,1,0,0,1,0,0,0,6,0,1,0,1,0,1,3277498,"2023-11-24T00:00:00.000Z",56677827,22,"Anthony Black",0,1,1,0,1,0.2
"948",948,6,1,2,4,2,17,6,4,2,28,1,4,16,3,2,3,3277498,"2023-11-24T00:00:00.000Z",3547251,22,"Cole Anthony",3,19,25,22,9,34.6
"949",949,0,0,1,3,1,3,1,1,1,19,2,1,4,3,0,2,3277498,"2023-11-24T00:00:00.000Z",196,22,"Gary Harris",0,7,7,4,3,5.6
"950",950,0,0,0,0,0,0,0,0,0,0,0,0,0,0,0,0,1037811,"2023-11-22T00:00:00.000Z",56677842,29,"Brice Sensabaugh",0,0,0,0,0,0
"951",951,3,0,0,1,0,4,1,0,0,15,0,3,2,0,0,0,1037832,"2023-11-26T00:00:00.000Z",56677827,22,"Anthony Black",0,2,5,5,3,6.5
"952",952,1,0,2,1,0,3,0,0,0,15,0,2,0,2,1,2,1037832,"2023-11-26T00:00:00.000Z",226,22,"Joe Ingles",1,2,3,1,3,4.9
"953",953,6,0,0,5,1,6,2,0,0,24,0,2,5,0,1,0,1037832,"2023-11-26T00:00:00.000Z",196,22,"Gary Harris",1,5,11,11,6,17
"954",954,2,0,5,2,1,7,4,2,2,18,2,3,11,7,0,2,1037832,"2023-11-26T00:00:00.000Z",462,22,"Moritz Wagner",0,18,20,13,9,20.4
"955",955,7,1,6,3,1,16,9,12,11,32,1,3,30,7,2,2,1037832,"2023-11-26T00:00:00.000Z",3547251,22,"Cole Anthony",3,37,44,37,14,55.9
"956",956,0,0,1,2,1,2,1,3,3,12,1,2,6,2,0,0,1037832,"2023-11-26T00:00:00.000Z",38017724,22,"Caleb Houstan",0,8,8,6,2,8.4
"957",957,0,0,0,0,0,0,0,0,0,0,0,0,0,0,0,0,1037832,"2023-11-26T00:00:00.000Z",229,22,"Jonathan Isaac",0,0,0,0,0,0
"958",958,0,0,0,0,0,0,0,0,0,0,0,0,0,0,0,0,1037832,"2023-11-26T00:00:00.000Z",666818,22,"Chuma Okeke",0,0,0,0,0,0
"959",959,0,0,0,0,0,0,0,0,0,0,0,0,0,0,0,0,1037832,"2023-11-26T00:00:00.000Z",666885,22,"Admiral Schofield",0,0,0,0,0,0
"960",960,0,0,0,0,0,0,0,0,0,0,0,0,0,0,0,0,1037832,"2023-11-26T00:00:00.000Z",85,22,"Wendell Carter Jr.",0,0,0,0,0,0
"961",961,0,0,0,0,0,0,0,0,0,0,0,0,0,0,0,0,1037832,"2023-11-26T00:00:00.000Z",165,22,"Markelle Fultz",0,0,0,0,0,0
"962",962,0,0,0,0,0,0,0,0,0,0,0,0,0,0,0,0,1037832,"2023-11-26T00:00:00.000Z",38017607,22,"Kevon Harris",0,0,0,0,0,0
"963",963,0,0,0,0,0,0,0,0,0,0,0,0,0,0,0,0,1037832,"2023-11-26T00:00:00.000Z",56677839,22,"Jett Howard",0,0,0,0,0,0
"964",964,0,0,0,0,0,0,0,0,0,0,0,0,0,0,0,0,1037832,"2023-11-26T00:00:00.000Z",17553983,22,"Trevelin Queen",0,0,0,0,0,0
"965",965,2,1,5,4,2,11,4,2,0,33,0,1,10,5,0,3,1037832,"2023-11-26T00:00:00.000Z",204,4,"Gordon Hayward",1,15,17,12,7,19
"966",966,2,1,7,4,1,17,9,6,4,37,3,2,23,10,1,3,1037832,"2023-11-26T00:00:00.000Z",62,4,"Miles Bridges",2,33,35,25,12,41
"967",967,1,1,5,0,0,6,5,2,2,22,1,4,12,6,1,1,1037832,"2023-11-26T00:00:00.000Z",38017698,4,"Mark Williams",2,18,19,13,7,25.7
"968",968,9,1,1,4,2,15,9,4,2,37,0,4,22,1,1,5,1037832,"2023-11-26T00:00:00.000Z",403,4,"Terry Rozier",2,23,32,31,10,37.7
"969",969,2,0,1,3,1,6,3,0,0,14,0,0,7,1,0,1,1037832,"2023-11-26T00:00:00.000Z",3547239,4,"LaMelo Ball",0,8,10,9,3,10.2
"970",970,6,0,2,5,2,8,4,0,0,22,2,2,10,4,0,0,1037834,"2023-11-26T00:00:00.000Z",666679,3,"Cameron Johnson",0,14,20,16,10,23.8
"971",971,4,0,9,10,6,11,7,0,0,36,0,2,20,9,1,1,1037834,"2023-11-26T00:00:00.000Z",351,3,"Royce O'Neale",1,29,33,24,13,38.8
"972",972,1,1,4,7,3,10,3,0,0,34,0,3,9,4,2,1,1037834,"2023-11-26T00:00:00.000Z",158,3,"Dorian Finney-Smith",3,13,14,10,5,23.3
"973",973,6,0,2,6,4,7,5,2,1,36,0,0,15,2,0,2,1037834,"2023-11-26T00:00:00.000Z",61,3,"Mikal Bridges",0,17,23,21,8,24.4
"974",974,7,0,3,9,3,17,7,8,7,38,2,4,24,5,1,2,1037834,"2023-11-26T00:00:00.000Z",130,3,"Spencer Dinwiddie",1,29,36,31,12,41.5
"975",975,0,0,1,10,6,13,6,2,2,25,0,1,20,1,2,2,1037834,"2023-11-26T00:00:00.000Z",464,3,"Lonnie Walker IV",2,21,21,20,1,25.2
"976",976,1,0,1,0,0,0,0,2,1,3,0,1,1,1,0,0,1037855,"2023-11-29T00:00:00.000Z",17896007,8,"Braxton Key",0,2,3,2,2,3.7
"977",977,0,0,0,1,0,1,0,0,0,3,0,0,0,0,0,1,1037855,"2023-11-29T00:00:00.000Z",38017727,8,"Collin Gillespie",0,0,0,0,0,-1
"978",978,0,0,0,1,0,1,0,0,0,3,0,0,0,0,0,0,1037855,"2023-11-29T00:00:00.000Z",56677582,8,"Jalen Pickett",0,0,0,0,0,0
"979",979,0,0,0,0,0,0,0,0,0,0,0,0,0,0,0,0,1037855,"2023-11-29T00:00:00.000Z",38017721,8,"Peyton Watson",0,0,0,0,0,0
"980",980,0,0,0,0,0,0,0,0,0,0,0,0,0,0,0,0,1037853,"2023-11-29T00:00:00.000Z",420,15,"Marcus Smart",0,0,0,0,0,0
"981",981,0,0,0,0,0,0,0,0,0,0,0,0,0,0,0,0,1037853,"2023-11-29T00:00:00.000Z",3547285,15,"Xavier Tillman",0,0,0,0,0,0
"982",982,4,0,4,8,4,13,4,0,0,26,0,1,12,4,1,0,1037853,"2023-11-29T00:00:00.000Z",38017739,29,"Simone Fontecchio",1,16,20,16,8,25.8
"983",983,1,0,3,5,3,14,7,2,0,29,1,2,17,4,1,1,1037853,"2023-11-29T00:00:00.000Z",101,29,"John Collins",1,21,22,18,5,25.3
"984",984,1,0,2,0,0,5,2,0,0,15,2,2,4,4,1,2,1037853,"2023-11-29T00:00:00.000Z",11891374,29,"Omer Yurtseven",1,8,9,5,5,11.3
"985",985,2,0,2,4,2,6,2,2,2,24,1,0,8,3,0,2,1037853,"2023-11-29T00:00:00.000Z",56677834,29,"Keyonte George",0,11,13,10,5,12.6
"986",986,5,0,2,5,2,10,4,3,2,27,1,0,12,3,0,4,1037853,"2023-11-29T00:00:00.000Z",100,29,"Jordan Clarkson",0,15,20,17,8,19.1
"987",987,2,6,5,2,0,11,4,2,1,28,3,0,9,8,1,1,1037853,"2023-11-29T00:00:00.000Z",38017705,29,"Walker Kessler",7,17,19,11,10,41.6
"988",988,3,0,1,4,1,10,3,3,2,22,1,3,9,2,1,2,1037853,"2023-11-29T00:00:00.000Z",413,29,"Collin Sexton",1,11,14,12,5,16.9
"989",989,0,0,0,0,0,0,0,0,0,0,0,0,0,0,0,0,1037853,"2023-11-29T00:00:00.000Z",17896023,29,"Josh Christopher",0,0,0,0,0,0
"990",990,0,0,0,0,0,0,0,0,0,0,0,0,0,0,0,0,1037853,"2023-11-29T00:00:00.000Z",139,29,"Kris Dunn",0,0,0,0,0,0
"991",991,0,0,0,0,0,0,0,0,0,0,0,0,0,0,0,0,1037853,"2023-11-29T00:00:00.000Z",56677824,29,"Taylor Hendricks",0,0,0,0,0,0
"992",992,0,0,0,0,0,0,0,0,0,0,0,0,0,0,0,0,1037853,"2023-11-29T00:00:00.000Z",38017630,29,"Johnny Juzang",0,0,0,0,0,0
"993",993,0,0,0,0,0,0,0,0,0,0,0,0,0,0,0,0,1037853,"2023-11-29T00:00:00.000Z",297,29,"Lauri Markkanen",0,0,0,0,0,0
"994",994,0,0,0,3,1,7,2,1,1,10,1,1,6,1,0,0,1037850,"2023-11-29T00:00:00.000Z",77,9,"Alec Burks",0,7,7,6,1,7.2
"995",995,8,0,1,3,0,9,3,1,1,22,0,2,7,1,2,0,1037850,"2023-11-29T00:00:00.000Z",3547241,9,"Killian Hayes",2,8,16,15,9,26.2
"996",996,2,0,6,5,2,9,2,2,2,20,0,5,8,6,1,3,1037850,"2023-11-29T00:00:00.000Z",44477024,9,"Stanley Umude",1,14,16,10,8,18.2
"997",997,0,0,1,0,0,4,2,2,0,14,1,0,4,2,0,0,1037850,"2023-11-29T00:00:00.000Z",24,9,"Marvin Bagley III",0,6,6,4,2,6.4
"998",998,0,0,0,1,1,1,1,0,0,6,0,0,3,0,0,0,1037850,"2023-11-29T00:00:00.000Z",259,9,"Kevin Knox",0,3,3,3,0,3
"999",999,0,0,0,0,0,0,0,0,0,0,0,0,0,0,0,0,1037850,"2023-11-29T00:00:00.000Z",54,9,"Bojan Bogdanovic",0,0,0,0,0,0
"1000",1000,0,0,0,0,0,0,0,0,0,0,0,0,0,0,0,0,1037850,"2023-11-29T00:00:00.000Z",56677729,9,"Malcolm Cazalon",0,0,0,0,0,0
"1001",1001,2,1,1,2,2,9,6,5,4,22,1,2,18,2,0,2,1037874,"2023-12-02T00:00:00.000Z",462,22,"Moritz Wagner",1,20,22,20,4,24.4
"1002",1002,1,1,5,6,2,16,8,2,2,31,0,3,20,5,0,1,1037874,"2023-12-02T00:00:00.000Z",3547251,22,"Cole Anthony",1,25,26,21,6,29.5
"1003",1003,0,0,0,3,1,3,1,0,0,16,0,1,3,0,0,0,1037874,"2023-12-02T00:00:00.000Z",38017724,22,"Caleb Houstan",0,3,3,3,0,3
"1004",1004,0,0,0,0,0,0,0,0,0,0,0,0,0,0,0,0,1037874,"2023-12-02T00:00:00.000Z",229,22,"Jonathan Isaac",0,0,0,0,0,0
"1005",1005,0,0,0,0,0,0,0,0,0,0,0,0,0,0,0,0,1037873,"2023-12-02T00:00:00.000Z",56677846,4,"Nick Smith Jr.",0,0,0,0,0,0
"1006",1006,0,0,0,0,0,0,0,0,0,0,0,0,0,0,0,0,1037873,"2023-12-02T00:00:00.000Z",18678001,4,"JT Thor",0,0,0,0,0,0
"1007",1007,0,0,0,0,0,0,0,0,0,0,0,0,0,0,0,0,1037873,"2023-12-02T00:00:00.000Z",56677848,4,"Amari Bailey",0,0,0,0,0,0
"1008",1008,0,0,0,0,0,0,0,0,0,0,0,0,0,0,0,0,1037873,"2023-12-02T00:00:00.000Z",3547239,4,"LaMelo Ball",0,0,0,0,0,0
"1009",1009,0,0,0,0,0,0,0,0,0,0,0,0,0,0,0,0,1037873,"2023-12-02T00:00:00.000Z",666748,4,"Cody Martin",0,0,0,0,0,0
"1010",1010,0,0,0,0,0,0,0,0,0,0,0,0,0,0,0,0,1037873,"2023-12-02T00:00:00.000Z",347,4,"Frank Ntilikina",0,0,0,0,0,0
"1011",1011,2,0,2,2,0,5,2,2,2,30,0,1,6,2,0,1,1037873,"2023-12-02T00:00:00.000Z",666400,18,"Nickeil Alexander-Walker",0,8,10,8,4,10.4
"1012",1012,5,1,4,8,4,23,12,0,0,32,3,3,28,7,0,3,1037873,"2023-12-02T00:00:00.000Z",447,18,"Karl-Anthony Towns",1,35,40,33,12,43.9
"1013",1013,0,3,10,0,0,12,10,9,6,39,2,1,26,12,0,1,1037873,"2023-12-02T00:00:00.000Z",176,18,"Rudy Gobert",3,38,38,26,12,48.4
"1014",1014,0,0,0,0,0,0,0,0,0,0,0,0,0,0,0,0,1037875,"2023-12-02T00:00:00.000Z",3547240,9,"James Wiseman",0,0,0,0,0,0
"1015",1015,0,0,0,0,0,0,0,0,0,0,0,0,0,0,0,0,1037875,"2023-12-02T00:00:00.000Z",56677729,9,"Malcolm Cazalon",0,0,0,0,0,0
"1016",1016,0,0,0,0,0,0,0,0,0,0,0,0,0,0,0,0,1037875,"2023-12-02T00:00:00.000Z",197,9,"Joe Harris",0,0,0,0,0,0
"1017",1017,0,0,0,0,0,0,0,0,0,0,0,0,0,0,0,0,1037875,"2023-12-02T00:00:00.000Z",330,9,"Monte Morris",0,0,0,0,0,0
"1018",1018,0,0,0,0,0,0,0,0,0,0,0,0,0,0,0,0,1037875,"2023-12-02T00:00:00.000Z",42097199,9,"Jared Rhoden",0,0,0,0,0,0
"1019",1019,5,0,5,10,4,16,9,0,0,38,0,4,22,5,1,1,1037875,"2023-12-02T00:00:00.000Z",666908,6,"Max Strus",1,27,32,27,10,37.5
"1020",1020,2,1,5,0,0,2,2,3,1,24,1,3,5,6,0,1,1037874,"2023-12-02T00:00:00.000Z",17896038,3,"Day'Ron Sharpe",1,11,13,7,8,17.2
"1021",1021,6,1,10,3,0,10,5,1,0,21,1,0,10,11,2,1,1037874,"2023-12-02T00:00:00.000Z",421,3,"Dennis Smith Jr.",3,21,27,16,17,40.2
"1022",1022,1,1,1,0,0,4,3,1,1,7,3,1,7,4,0,1,1037874,"2023-12-02T00:00:00.000Z",17896058,3,"Trendon Watford",1,11,12,8,5,15.3
"1023",1023,0,0,0,0,0,0,0,0,0,0,0,0,0,0,0,0,1037874,"2023-12-02T00:00:00.000Z",174,3,"Harry Giles III",0,0,0,0,0,0
"1024",1024,0,0,0,0,0,0,0,0,0,0,0,0,0,0,0,0,1037874,"2023-12-02T00:00:00.000Z",464,3,"Lonnie Walker IV",0,0,0,0,0,0
"1025",1025,0,0,0,0,0,0,0,0,0,0,0,0,0,0,0,0,1037874,"2023-12-02T00:00:00.000Z",9051997,3,"Armoni Brooks",0,0,0,0,0,0
"1026",1026,2,0,3,4,1,6,2,2,2,31,1,3,7,4,0,1,7049315,"2023-12-06T00:00:00.000Z",391,16,"Josh Richardson",0,11,13,9,6,13.8
"1027",1027,0,0,1,2,1,3,1,0,0,5,0,0,3,1,0,0,7049321,"2023-12-06T00:00:00.000Z",329,7,"Markieff Morris",0,4,4,3,1,4.2
"1028",1028,0,0,0,0,0,0,0,0,0,0,0,0,0,0,0,0,7049321,"2023-12-06T00:00:00.000Z",17896028,7,"Greg Brown III",0,0,0,0,0,0
"1029",1029,0,0,0,0,0,0,0,0,0,0,0,0,0,0,0,0,7049321,"2023-12-06T00:00:00.000Z",56677873,7,"Dexter Dennis",0,0,0,0,0,0
"1030",1030,0,0,0,0,0,0,0,0,0,0,0,0,0,0,0,0,7049321,"2023-12-06T00:00:00.000Z",3547258,7,"Josh Green",0,0,0,0,0,0
"1031",1031,0,0,0,0,0,0,0,0,0,0,0,0,0,0,0,0,7049321,"2023-12-06T00:00:00.000Z",257,7,"Maxi Kleber",0,0,0,0,0,0
"1032",1032,0,0,0,0,0,0,0,0,0,0,0,0,0,0,0,0,7049321,"2023-12-06T00:00:00.000Z",666965,7,"Grant Williams",0,0,0,0,0,0
"1033",1033,3,1,2,3,1,5,2,2,2,24,0,1,7,2,0,1,7049321,"2023-12-06T00:00:00.000Z",38017739,29,"Simone Fontecchio",1,9,12,10,5,15.9
"1034",1034,0,0,6,2,0,11,5,0,0,23,2,2,10,8,0,2,7049321,"2023-12-06T00:00:00.000Z",101,29,"John Collins",0,18,18,10,8,17.6
"1035",1035,0,0,0,0,0,0,0,0,0,0,0,0,0,0,0,0,7049317,"2023-12-06T00:00:00.000Z",417,3,"Ben Simmons",0,0,0,0,0,0
"1036",1036,0,0,0,0,0,0,0,0,0,0,0,0,0,0,0,0,7049317,"2023-12-06T00:00:00.000Z",56677841,3,"Dariq Whitehead",0,0,0,0,0,0
"1037",1037,0,0,0,0,0,0,0,0,0,0,0,0,0,0,0,0,7049317,"2023-12-06T00:00:00.000Z",56677722,3,"Jalen Wilson",0,0,0,0,0,0
"1038",1038,5,1,3,3,1,16,8,0,0,38,1,2,17,4,1,2,7049323,"2023-12-06T00:00:00.000Z",274,13,"Kawhi Leonard",2,21,26,22,9,33.3
"1039",1039,1,1,7,9,5,20,8,4,4,38,1,1,25,8,0,2,7049323,"2023-12-06T00:00:00.000Z",172,13,"Paul George",1,33,34,26,9,37.1
"1040",1040,0,1,7,0,0,7,4,6,2,27,2,3,10,9,2,0,7049323,"2023-12-06T00:00:00.000Z",493,13,"Ivica Zubac",3,19,19,10,9,29.8
"1041",1041,0,0,1,0,0,2,1,0,0,20,0,1,2,1,0,0,7049323,"2023-12-06T00:00:00.000Z",666743,13,"Terance Mann",0,3,3,2,1,3.2
"1042",1042,11,0,1,3,2,10,6,7,6,32,0,0,20,1,3,4,7049323,"2023-12-06T00:00:00.000Z",192,13,"James Harden",3,21,32,31,12,42.7
"1043",1043,1,0,4,3,1,4,1,0,0,17,0,4,3,4,0,0,7049323,"2023-12-06T00:00:00.000Z",56677849,13,"Kobe Brown",0,7,8,4,5,9.3
"1044",1044,0,0,0,0,0,0,0,0,0,0,0,0,0,0,0,0,7049323,"2023-12-06T00:00:00.000Z",666511,13,"Amir Coffey",0,0,0,0,0,0
"1045",1045,1,0,2,1,0,12,3,3,3,27,1,1,9,3,0,1,7049322,"2023-12-06T00:00:00.000Z",475,10,"Andrew Wiggins",0,12,13,10,4,13.1
"1046",1046,9,2,4,2,0,7,3,4,4,31,6,3,10,10,0,4,7049322,"2023-12-06T00:00:00.000Z",185,10,"Draymond Green",2,20,29,19,19,37.5
"1047",1047,0,0,6,0,0,6,2,2,2,16,2,2,6,8,1,0,7049322,"2023-12-06T00:00:00.000Z",282,10,"Kevon Looney",1,14,14,6,8,18.6
"1048",1048,1,0,5,8,1,13,3,4,4,27,0,0,11,5,0,0,7049322,"2023-12-06T00:00:00.000Z",443,10,"Klay Thompson",0,16,17,12,6,18.5
"1049",1049,1,0,5,13,5,18,8,11,10,34,0,2,31,5,0,4,7049322,"2023-12-06T00:00:00.000Z",115,10,"Stephen Curry",0,36,37,32,6,34.5
"1050",1050,0,0,0,0,0,0,0,0,0,0,0,0,0,0,0,0,7049322,"2023-12-06T00:00:00.000Z",56677799,10,"Trayce Jackson-Davis",0,0,0,0,0,0
"1051",1051,0,0,0,0,0,0,0,0,0,0,0,0,0,0,0,0,1037892,"2023-12-11T00:00:00.000Z",17896116,5,"Terry Taylor",0,0,0,0,0,0
"1052",1052,1,1,2,4,3,7,5,1,1,27,0,1,14,2,0,1,1037895,"2023-12-11T00:00:00.000Z",30,26,"Harrison Barnes",1,16,17,15,3,19.9
"1053",1053,3,0,2,4,4,13,9,2,2,34,1,4,24,3,0,0,1037895,"2023-12-11T00:00:00.000Z",38017688,26,"Keegan Murray",0,27,30,27,6,32.1
"1054",1054,9,0,12,1,1,14,6,4,2,34,4,2,15,16,2,4,1037895,"2023-12-11T00:00:00.000Z",406,26,"Domantas Sabonis",2,31,40,24,25,49.7
"1055",1055,1,0,1,5,2,6,2,0,0,17,0,4,6,1,0,0,1037895,"2023-12-11T00:00:00.000Z",221,26,"Kevin Huerter",0,7,8,7,2,8.7
"1056",1056,8,0,3,10,5,22,10,6,4,33,0,4,29,3,0,3,1037895,"2023-12-11T00:00:00.000Z",161,26,"De'Aaron Fox",0,32,40,37,11,41.6
"1057",1057,0,0,0,0,0,0,0,0,0,0,0,0,0,0,0,0,1037888,"2023-12-11T00:00:00.000Z",666656,1,"De'Andre Hunter",0,0,0,0,0,0
"1058",1058,0,0,0,0,0,0,0,0,0,0,0,0,0,0,0,0,1037888,"2023-12-11T00:00:00.000Z",17896040,1,"Jalen Johnson",0,0,0,0,0,0
"1059",1059,0,0,0,0,0,0,0,0,0,0,0,0,0,0,0,0,1037895,"2023-12-11T00:00:00.000Z",17895990,26,"Jordan Ford",0,0,0,0,0,0
"1060",1060,0,0,0,0,0,0,0,0,0,0,0,0,0,0,0,0,1037886,"2023-12-11T00:00:00.000Z",38017662,6,"Isaiah Mobley",0,0,0,0,0,0
"1061",1061,0,0,0,0,0,0,0,0,0,0,0,0,0,0,0,0,1037895,"2023-12-11T00:00:00.000Z",273,26,"Alex Len",0,0,0,0,0,0
"1062",1062,5,0,3,5,3,13,6,7,7,37,2,1,22,5,0,5,1037895,"2023-12-11T00:00:00.000Z",61,3,"Mikal Bridges",0,27,32,27,10,30.5
"1063",1063,2,0,4,4,3,13,6,0,0,31,0,0,15,4,1,1,1037895,"2023-12-11T00:00:00.000Z",666679,3,"Cameron Johnson",1,19,21,17,6,24.8
"1064",1064,0,3,6,0,0,6,3,2,2,26,4,2,8,10,0,0,1037895,"2023-12-11T00:00:00.000Z",666508,3,"Nicolas Claxton",3,18,18,8,10,29
"1065",1065,3,0,0,6,2,20,7,2,2,31,0,2,18,0,0,2,1037895,"2023-12-11T00:00:00.000Z",17896048,3,"Cam Thomas",0,18,21,21,3,20.5
"1066",1066,7,0,2,8,2,15,6,5,4,34,0,2,18,2,0,3,1037895,"2023-12-11T00:00:00.000Z",130,3,"Spencer Dinwiddie",0,20,27,25,9,27.9
"1067",1067,2,1,6,0,0,4,2,0,0,14,1,2,4,7,1,1,1037895,"2023-12-11T00:00:00.000Z",17896038,3,"Day'Ron Sharpe",2,11,13,6,9,20.4
"1068",1068,1,2,3,4,3,6,5,0,0,25,0,0,13,3,1,0,1037895,"2023-12-11T00:00:00.000Z",158,3,"Dorian Finney-Smith",3,16,17,14,4,27.1
"1069",1069,1,0,0,0,0,1,1,0,0,4,0,0,2,0,0,0,1037895,"2023-12-11T00:00:00.000Z",9051997,3,"Armoni Brooks",0,2,3,3,1,3.5
"1070",1070,0,1,4,2,0,4,1,0,0,11,1,2,2,5,0,1,1037895,"2023-12-11T00:00:00.000Z",4197162,26,"Aleksandar Vezenkov",1,7,7,2,5,10
"1071",1071,5,0,6,8,3,19,11,9,9,39,0,2,34,6,3,1,1037896,"2023-12-11T00:00:00.000Z",274,13,"Kawhi Leonard",3,40,45,39,11,56.7
"1072",1072,8,1,5,8,2,17,7,4,4,41,3,4,20,8,1,1,1037896,"2023-12-11T00:00:00.000Z",172,13,"Paul George",2,28,36,28,16,46.6
"1073",1073,2,2,3,0,0,13,9,0,0,34,3,2,18,6,0,0,1037896,"2023-12-11T00:00:00.000Z",493,13,"Ivica Zubac",2,24,26,20,8,34.2
"1074",1074,4,0,1,4,1,6,3,2,2,29,2,2,9,3,0,0,1037896,"2023-12-11T00:00:00.000Z",666743,13,"Terance Mann",0,12,16,13,7,18.6
"1075",1075,7,2,7,6,3,14,7,3,3,37,0,2,20,7,1,3,1037896,"2023-12-11T00:00:00.000Z",192,13,"James Harden",3,27,34,27,14,44.9
"1076",1076,1,0,5,2,1,8,4,2,2,33,1,0,11,6,2,3,1037926,"2023-12-16T00:00:00.000Z",38017676,17,"MarJon Beauchamp",2,17,18,12,7,22.7
"1077",1077,5,1,4,14,6,22,11,5,5,30,0,3,33,4,0,2,1037926,"2023-12-16T00:00:00.000Z",278,17,"Damian Lillard",1,37,42,38,9,46.3
"1078",1078,1,0,9,7,4,18,11,5,5,27,3,3,31,12,1,4,1037926,"2023-12-16T00:00:00.000Z",377,17,"Bobby Portis",1,43,44,32,13,45.9
"1079",1079,2,1,3,1,1,2,2,1,1,12,1,1,6,4,0,0,1037926,"2023-12-16T00:00:00.000Z",105,17,"Pat Connaughton",1,10,12,8,6,16.8
"1080",1080,1,0,0,6,3,6,3,0,0,20,1,5,9,1,0,0,1037926,"2023-12-16T00:00:00.000Z",38017733,17,"A.J. Green",0,10,11,10,2,11.7
"1081",1081,5,0,1,3,1,5,3,4,4,15,0,2,11,1,1,2,1037926,"2023-12-16T00:00:00.000Z",368,17,"Cameron Payne",1,12,17,16,6,20.7
"1082",1082,0,0,1,0,0,0,0,0,0,5,0,0,0,1,0,0,1037926,"2023-12-16T00:00:00.000Z",2148,17,"Thanasis Antetokounmpo",0,1,1,0,1,1.2
"1083",1083,0,0,3,0,0,1,1,0,0,9,0,2,2,3,0,0,1037926,"2023-12-16T00:00:00.000Z",56677854,17,"Chris Livingston",0,5,5,2,3,5.6
"1084",1084,1,1,0,1,0,2,0,0,0,6,0,0,0,0,0,0,1037926,"2023-12-16T00:00:00.000Z",284,17,"Robin Lopez",1,0,1,1,1,4.5
"1085",1085,0,0,0,1,0,4,2,2,2,5,0,0,6,0,0,0,1037926,"2023-12-16T00:00:00.000Z",666960,17,"Lindell Wigginton",0,6,6,6,0,6
"1086",1086,0,0,0,0,0,0,0,0,0,0,0,0,0,0,0,0,1037926,"2023-12-16T00:00:00.000Z",38,17,"Malik Beasley",0,0,0,0,0,0
"1087",1087,0,0,0,0,0,0,0,0,0,0,0,0,0,0,0,0,1037926,"2023-12-16T00:00:00.000Z",666453,17,"Marques Bolden",0,0,0,0,0,0
"1088",1088,0,0,0,0,0,0,0,0,0,0,0,0,0,0,0,0,1037926,"2023-12-16T00:00:00.000Z",112,17,"Jae Crowder",0,0,0,0,0,0
"1089",1089,2,1,3,6,2,17,5,2,1,28,1,0,13,4,1,1,1037926,"2023-12-16T00:00:00.000Z",38017682,9,"Jaden Ivey",2,17,19,15,6,25.8
"1090",1090,0,0,1,2,0,2,0,2,1,4,0,0,1,1,0,0,1037926,"2023-12-16T00:00:00.000Z",77,9,"Alec Burks",0,2,2,1,1,2.2
"1091",1091,0,0,0,1,0,2,0,0,0,9,0,2,0,0,0,0,1037926,"2023-12-16T00:00:00.000Z",259,9,"Kevin Knox",0,0,0,0,0,0
"1092",1092,0,0,0,1,0,1,0,0,0,7,0,1,0,0,0,0,1037926,"2023-12-16T00:00:00.000Z",197,9,"Joe Harris",0,0,0,0,0,0
"1093",1093,0,0,0,0,0,0,0,0,0,0,0,0,0,0,0,0,1037926,"2023-12-16T00:00:00.000Z",315,17,"Khris Middleton",0,0,0,0,0,0
"1094",1094,0,0,0,0,0,0,0,0,0,0,0,0,0,0,0,0,1037926,"2023-12-16T00:00:00.000Z",38017691,17,"TyTy Washington Jr.",0,0,0,0,0,0
"1095",1095,1,0,6,3,1,6,3,0,0,24,0,4,7,6,0,0,1037926,"2023-12-16T00:00:00.000Z",56677826,9,"Ausar Thompson",0,13,14,8,7,15.7
"1096",1096,2,0,1,6,2,15,8,6,6,31,1,3,24,2,1,2,1037926,"2023-12-16T00:00:00.000Z",54,9,"Bojan Bogdanovic",1,26,28,26,4,30.4
"1097",1097,1,2,4,0,0,11,6,1,0,22,3,3,12,7,1,0,1037926,"2023-12-16T00:00:00.000Z",24,9,"Marvin Bagley III",3,19,20,13,8,30.9
"1098",1098,5,0,4,0,0,4,1,0,0,14,0,0,2,4,0,1,1037926,"2023-12-16T00:00:00.000Z",3547241,9,"Killian Hayes",0,6,11,7,9,13.3
"1099",1099,6,0,1,2,0,17,10,6,5,31,0,3,25,1,1,2,1037926,"2023-12-16T00:00:00.000Z",17896075,9,"Cade Cunningham",1,26,32,31,7,36.2
"1100",1100,0,0,2,2,0,10,5,3,2,24,0,1,12,2,0,0,1037927,"2023-12-16T00:00:00.000Z",38017708,4,"Bryce McGowens",0,14,14,12,2,14.4
"1101",1101,0,0,0,0,0,0,0,0,0,0,0,0,0,0,0,0,1037953,"2023-12-19T00:00:00.000Z",38017693,27,"Blake Wesley",0,0,0,0,0,0
"1102",1102,0,0,7,2,0,2,0,0,0,22,1,3,0,8,0,1,1037952,"2023-12-19T00:00:00.000Z",666703,15,"John Konchar",0,8,8,0,8,8.6
"1103",1103,0,1,1,2,2,4,3,0,0,16,2,1,8,3,1,0,1037952,"2023-12-19T00:00:00.000Z",17896067,15,"Santi Aldama",2,11,11,8,3,17.6
"1104",1104,0,0,1,3,0,5,2,0,0,18,1,1,4,2,0,1,1037952,"2023-12-19T00:00:00.000Z",17896027,15,"Ziaire Williams",0,6,6,4,2,5.4
"1105",1105,1,0,4,1,1,5,3,0,0,20,2,3,7,6,1,1,1037952,"2023-12-19T00:00:00.000Z",3547285,15,"Xavier Tillman",1,13,14,8,7,17.7
"1106",1106,2,0,0,1,0,2,0,0,0,9,1,0,0,1,0,1,1037952,"2023-12-19T00:00:00.000Z",38017729,15,"David Roddy",0,1,3,2,3,3.2
"1107",1107,0,0,0,0,0,0,0,0,0,0,0,0,0,0,0,0,1037952,"2023-12-19T00:00:00.000Z",48248287,15,"Jacob Gilyard",0,0,0,0,0,0
"1108",1108,0,0,0,0,0,0,0,0,0,0,0,0,0,0,0,0,1037952,"2023-12-19T00:00:00.000Z",401,15,"Derrick Rose",0,0,0,0,0,0
"1109",1109,0,0,0,0,0,0,0,0,0,0,0,0,0,0,0,0,1037952,"2023-12-19T00:00:00.000Z",3,15,"Steven Adams",0,0,0,0,0,0
"1110",1110,0,0,0,0,0,0,0,0,0,0,0,0,0,0,0,0,1037952,"2023-12-19T00:00:00.000Z",420,15,"Marcus Smart",0,0,0,0,0,0
"1111",1111,0,0,0,0,0,0,0,0,0,0,0,0,0,0,0,0,1037952,"2023-12-19T00:00:00.000Z",666505,15,"Brandon Clarke",0,0,0,0,0,0
"1112",1112,0,0,0,0,0,0,0,0,0,0,0,0,0,0,0,0,1037952,"2023-12-19T00:00:00.000Z",56677830,15,"GG Jackson",0,0,0,0,0,0
"1113",1113,0,0,0,0,0,0,0,0,0,0,0,0,0,0,0,0,1037952,"2023-12-19T00:00:00.000Z",254,15,"Luke Kennard",0,0,0,0,0,0
"1114",1114,0,0,0,0,0,0,0,0,0,0,0,0,0,0,0,0,1037952,"2023-12-19T00:00:00.000Z",38017728,15,"Jake LaRavia",0,0,0,0,0,0
"1115",1115,0,0,0,0,0,0,0,0,0,0,0,0,0,0,0,0,1037952,"2023-12-19T00:00:00.000Z",38017732,15,"Kenneth Lofton Jr.",0,0,0,0,0,0
"1116",1116,3,3,2,8,4,13,8,5,5,26,2,2,25,4,1,2,1037957,"2023-12-20T00:00:00.000Z",210,12,"Buddy Hield",4,29,32,28,7,44.3
"1117",1117,0,0,4,3,0,5,2,2,2,23,0,1,6,4,0,1,1037957,"2023-12-20T00:00:00.000Z",3547243,12,"Obi Toppin",0,10,10,6,4,9.8
"1118",1118,0,2,5,4,1,9,5,7,7,25,1,2,18,6,0,1,1037957,"2023-12-20T00:00:00.000Z",452,12,"Myles Turner",2,24,24,18,6,30.2
"1119",1119,6,0,5,1,0,6,3,0,0,28,0,3,6,5,0,0,1037957,"2023-12-20T00:00:00.000Z",69,12,"Bruce Brown",0,11,17,12,11,21
"1120",1120,13,1,2,9,3,14,6,4,4,28,1,0,19,3,1,4,1037957,"2023-12-20T00:00:00.000Z",3547245,12,"Tyrese Haliburton",2,22,35,32,16,44.1
"1121",1121,1,0,2,6,4,7,5,0,0,29,0,2,14,2,1,2,1037957,"2023-12-20T00:00:00.000Z",38017686,12,"Bennedict Mathurin",1,16,17,15,3,18.9
"1122",1122,1,0,2,4,4,6,6,3,3,23,0,1,19,2,1,1,1037957,"2023-12-20T00:00:00.000Z",3547250,12,"Aaron Nesmith",1,21,22,20,3,24.9
"1123",1123,0,0,2,2,2,4,4,0,0,8,2,2,10,4,0,0,1037957,"2023-12-20T00:00:00.000Z",3547264,12,"Jalen Smith",0,14,14,10,4,14.8
"1124",1124,9,0,4,0,0,3,3,4,3,20,1,1,9,5,1,1,1037957,"2023-12-20T00:00:00.000Z",304,12,"T.J. McConnell",1,14,23,18,14,30.5
"1125",1125,1,2,2,1,0,7,4,3,2,15,1,3,10,3,1,1,1037957,"2023-12-20T00:00:00.000Z",17896035,12,"Isaiah Jackson",3,13,14,11,4,23.1
"1126",1126,9,1,8,2,0,14,8,2,2,35,2,6,18,10,1,3,1037982,"2023-12-23T00:00:00.000Z",246,8,"Nikola Jokic",2,28,37,27,19,46.5
"1127",1127,2,4,3,2,1,3,1,0,0,32,0,1,3,3,2,0,1037982,"2023-12-23T00:00:00.000Z",81,8,"Kentavious Caldwell-Pope",6,6,8,5,5,27.6
"1128",1128,1,2,3,1,0,7,4,2,1,26,4,3,9,7,1,0,1037976,"2023-12-22T00:00:00.000Z",3547244,1,"Onyeka Okongwu",3,16,17,10,8,27.9
"1129",1129,0,0,1,1,0,1,0,0,0,7,0,1,0,1,0,0,1037976,"2023-12-22T00:00:00.000Z",301,1,"Wesley Matthews",0,1,1,0,1,1.2
"1130",1130,0,0,0,0,0,0,0,0,0,0,0,0,0,0,0,0,1037976,"2023-12-22T00:00:00.000Z",666564,1,"Bruno Fernando",0,0,0,0,0,0
"1131",1131,0,0,0,0,0,0,0,0,0,0,0,0,0,0,0,0,1037976,"2023-12-22T00:00:00.000Z",3547297,1,"Trent Forrest",0,0,0,0,0,0
"1132",1132,0,0,0,0,0,0,0,0,0,0,0,0,0,0,0,0,1037976,"2023-12-22T00:00:00.000Z",56677838,1,"Kobe Bufkin",0,0,0,0,0,0
"1133",1133,0,0,0,0,0,0,0,0,0,0,0,0,0,0,0,0,1037976,"2023-12-22T00:00:00.000Z",38017689,1,"AJ Griffin",0,0,0,0,0,0
"1134",1134,0,0,0,0,0,0,0,0,0,0,0,0,0,0,0,0,1037976,"2023-12-22T00:00:00.000Z",56677806,1,"Mouhamed Gueye",0,0,0,0,0,0
"1135",1135,0,0,0,0,0,0,0,0,0,0,0,0,0,0,0,0,1037976,"2023-12-22T00:00:00.000Z",666656,1,"De'Andre Hunter",0,0,0,0,0,0
"1136",1136,0,0,0,0,0,0,0,0,0,0,0,0,0,0,0,0,1037976,"2023-12-22T00:00:00.000Z",17896040,1,"Jalen Johnson",0,0,0,0,0,0
"1137",1137,0,0,0,0,0,0,0,0,0,0,0,0,0,0,0,0,1037976,"2023-12-22T00:00:00.000Z",4197387,1,"Vit Krejci",0,0,0,0,0,0
"1138",1138,0,0,0,0,0,0,0,0,0,0,0,0,0,0,0,0,1037976,"2023-12-22T00:00:00.000Z",56677855,1,"Seth Lundy",0,0,0,0,0,0
"1139",1139,2,0,7,3,2,14,9,9,8,34,0,0,28,7,1,7,1037979,"2023-12-22T00:00:00.000Z",140,24,"Kevin Durant",1,35,37,30,9,35.4
"1140",1140,0,0,1,0,0,3,1,0,0,15,1,2,2,2,1,2,1037979,"2023-12-22T00:00:00.000Z",147,24,"Drew Eubanks",1,4,4,2,2,5.4
"1141",1141,2,1,2,6,3,10,4,0,0,30,2,1,11,4,3,1,1037979,"2023-12-22T00:00:00.000Z",8,24,"Grayson Allen",4,15,17,13,6,29.8
"1142",1142,7,0,2,3,0,20,9,9,6,36,2,1,24,4,0,0,1037979,"2023-12-22T00:00:00.000Z",57,24,"Devin Booker",0,28,35,31,11,39.3
"1143",1143,0,0,0,0,0,0,0,0,0,0,0,0,0,0,0,0,1037979,"2023-12-22T00:00:00.000Z",272,24,"Damion Lee",0,0,0,0,0,0
"1144",1144,0,0,0,0,0,0,0,0,0,0,0,0,0,0,0,0,1037979,"2023-12-22T00:00:00.000Z",3547253,24,"Theo Maledon",0,0,0,0,0,0
"1145",1145,0,1,1,7,2,15,7,2,2,25,0,3,18,1,0,1,1037978,"2023-12-22T00:00:00.000Z",17896045,30,"Corey Kispert",1,19,19,18,1,21.2
"1146",1146,0,0,4,1,0,5,1,0,0,14,2,2,2,6,0,1,1037978,"2023-12-22T00:00:00.000Z",337,30,"Mike Muscala",0,8,8,2,6,8.2
"1147",1147,1,0,0,1,0,2,0,0,0,13,0,2,0,0,0,0,1037978,"2023-12-22T00:00:00.000Z",414,30,"Landry Shamet",0,0,1,1,1,1.5
"1148",1148,1,1,1,1,1,4,3,1,0,11,0,1,7,1,0,0,1037978,"2023-12-22T00:00:00.000Z",38017712,30,"Ryan Rollins",1,8,9,8,2,12.7
"1149",1149,0,1,1,1,0,5,4,0,0,11,2,0,8,3,0,0,1037978,"2023-12-22T00:00:00.000Z",3547302,30,"Anthony Gill",1,11,11,8,3,14.6
"1150",1150,4,0,1,3,1,5,3,2,1,7,0,0,8,1,1,0,1037978,"2023-12-22T00:00:00.000Z",18677954,30,"Jared Butler",1,9,13,12,5,18.2
"1151",1151,0,0,0,0,0,3,1,0,0,6,0,0,2,0,0,0,1038008,"2023-12-27T00:00:00.000Z",38017712,30,"Ryan Rollins",0,2,2,2,0,2
"1152",1152,1,0,1,1,0,4,3,2,1,6,0,2,7,1,2,1,1038008,"2023-12-27T00:00:00.000Z",17896106,30,"Eugene Omoruyi",2,8,9,8,2,14.7
"1153",1154,0,0,0,0,0,0,0,0,0,0,0,0,0,0,0,0,1038008,"2023-12-27T00:00:00.000Z",18677954,30,"Jared Butler",0,0,0,0,0,0
"1154",1155,0,0,0,0,0,0,0,0,0,0,0,0,0,0,0,0,1038008,"2023-12-27T00:00:00.000Z",487,30,"Delon Wright",0,0,0,0,0,0
"1155",1156,11,0,5,2,0,15,9,5,4,32,1,3,22,6,1,4,1038008,"2023-12-27T00:00:00.000Z",416,28,"Pascal Siakam",1,28,39,33,17,44.7
"1156",1157,2,0,4,7,3,16,11,2,1,29,2,1,26,6,0,1,1038008,"2023-12-27T00:00:00.000Z",18,28,"OG Anunoby",0,32,34,28,8,35.2
"1157",1158,2,1,5,0,0,6,4,4,2,21,3,4,10,8,2,2,1038008,"2023-12-27T00:00:00.000Z",373,28,"Jakob Poeltl",3,18,20,12,10,29.6
"1158",1159,8,2,7,8,4,16,8,0,0,34,5,0,20,12,3,2,1038008,"2023-12-27T00:00:00.000Z",17896055,28,"Scottie Barnes",5,32,40,28,20,59.4
"1159",1160,4,0,2,8,3,10,4,2,1,26,0,1,12,2,2,1,1038008,"2023-12-27T00:00:00.000Z",3089,28,"Gary Trent Jr.",2,14,18,16,6,25.4
"1160",1161,0,1,0,0,0,2,1,2,1,11,0,0,3,0,1,1,1038008,"2023-12-27T00:00:00.000Z",3547249,28,"Precious Achiuwa",2,3,3,3,0,8
"1161",1162,3,0,5,5,1,16,8,8,7,36,0,4,24,5,1,4,1038007,"2023-12-27T00:00:00.000Z",17896026,22,"Franz Wagner",1,29,32,27,8,33.5
"1162",1163,4,1,9,8,1,21,6,7,6,38,0,0,19,9,1,1,1038007,"2023-12-27T00:00:00.000Z",38017683,22,"Paolo Banchero",2,28,32,23,13,40.8
"1163",1164,1,2,2,2,0,4,1,2,2,22,2,0,4,4,0,1,1038007,"2023-12-27T00:00:00.000Z",85,22,"Wendell Carter Jr.",2,8,9,5,5,15.3
"1164",1165,1,1,1,2,1,12,8,3,3,28,1,5,20,2,1,3,1038007,"2023-12-27T00:00:00.000Z",17896073,22,"Jalen Suggs",2,22,23,21,3,26.9
"1165",1166,4,1,3,3,1,6,1,0,0,24,1,2,3,4,1,0,1038007,"2023-12-27T00:00:00.000Z",56677827,22,"Anthony Black",2,7,11,7,8,19.8
"1166",1167,1,0,4,4,1,7,2,1,0,23,2,1,5,6,0,4,1038007,"2023-12-27T00:00:00.000Z",3547251,22,"Cole Anthony",0,11,12,6,7,9.7
"1167",1168,2,0,4,4,2,4,2,1,1,26,2,2,7,6,0,2,1038007,"2023-12-27T00:00:00.000Z",38017724,22,"Caleb Houstan",0,13,15,9,8,15.2
"1168",1169,0,1,3,2,1,3,1,0,0,15,1,2,3,4,0,0,1038007,"2023-12-27T00:00:00.000Z",666818,22,"Chuma Okeke",1,7,7,3,4,10.8
"1169",1170,0,4,1,0,0,1,1,0,0,9,0,0,2,1,0,0,1038007,"2023-12-27T00:00:00.000Z",666442,22,"Goga Bitadze",4,3,3,2,1,15.2
"1170",1171,0,0,0,1,0,1,0,0,0,1,0,0,0,0,1,0,1038007,"2023-12-27T00:00:00.000Z",17553983,22,"Trevelin Queen",1,0,0,0,0,3
"1171",1172,0,0,0,1,1,1,1,0,0,1,0,0,3,0,0,0,1038007,"2023-12-27T00:00:00.000Z",56677839,22,"Jett Howard",0,3,3,3,0,3
"1172",1173,0,0,0,0,0,0,0,0,0,1,0,0,0,0,0,0,1038007,"2023-12-27T00:00:00.000Z",666885,22,"Admiral Schofield",0,0,0,0,0,0
"1173",1174,1,0,3,1,0,4,3,0,0,12,0,0,6,3,1,1,1038009,"2023-12-27T00:00:00.000Z",61,3,"Mikal Bridges",1,9,10,7,4,13.1
"1174",1175,2,0,1,3,1,4,1,0,0,10,0,1,3,1,0,0,1038009,"2023-12-27T00:00:00.000Z",351,3,"Royce O'Neale",0,4,6,5,3,7.2
"1175",1176,0,0,0,0,0,0,0,0,0,0,0,0,0,0,0,0,1038023,"2023-12-29T00:00:00.000Z",56677855,1,"Seth Lundy",0,0,0,0,0,0
"1176",1177,0,0,0,2,0,2,0,2,2,12,0,1,2,0,0,0,1038023,"2023-12-29T00:00:00.000Z",30,26,"Harrison Barnes",0,2,2,2,0,2
"1177",1178,0,0,0,0,0,0,0,0,0,0,0,0,0,0,0,0,1038029,"2023-12-29T00:00:00.000Z",476,25,"Robert Williams III",0,0,0,0,0,0
"1178",1179,0,1,1,4,1,5,1,5,4,12,2,1,7,3,1,1,1038029,"2023-12-29T00:00:00.000Z",38017649,27,"Julian Champagnie",2,10,10,7,3,15.6
"1179",1180,4,0,3,0,0,3,0,2,2,29,1,2,2,4,1,3,1038029,"2023-12-29T00:00:00.000Z",38017699,27,"Jeremy Sochan",1,6,10,6,8,12.8
"1180",1181,2,1,2,1,0,10,8,3,1,18,1,3,17,3,0,1,1038029,"2023-12-29T00:00:00.000Z",102,27,"Zach Collins",1,20,22,19,5,25.6
"1181",1182,5,1,3,6,3,16,8,4,3,31,0,1,22,3,4,0,1038029,"2023-12-29T00:00:00.000Z",3547246,27,"Devin Vassell",5,25,30,27,8,48.1
"1182",1183,3,0,3,3,1,12,5,0,0,29,3,1,11,6,1,3,1038029,"2023-12-29T00:00:00.000Z",38017692,27,"Malaki Branham",1,17,20,14,9,22.7
"1183",1184,7,0,5,8,3,18,9,11,8,32,2,4,29,7,1,1,1038029,"2023-12-29T00:00:00.000Z",666682,27,"Keldon Johnson",1,36,43,36,14,49.9
"1184",1185,2,0,1,4,3,6,5,0,0,31,1,0,13,2,1,0,1038030,"2023-12-29T00:00:00.000Z",666511,13,"Amir Coffey",1,15,17,15,4,21.4
"1185",1186,3,0,6,8,2,21,8,6,5,36,1,6,23,7,1,4,1038030,"2023-12-29T00:00:00.000Z",172,13,"Paul George",1,30,33,26,10,34.9
"1186",1187,1,1,14,0,0,8,7,1,1,33,6,3,15,20,0,2,1038030,"2023-12-29T00:00:00.000Z",493,13,"Ivica Zubac",1,35,36,16,21,41.5
"1187",1188,2,0,2,6,0,10,3,6,5,23,1,1,11,3,1,0,1038030,"2023-12-29T00:00:00.000Z",666743,13,"Terance Mann",1,14,16,13,5,20.6
"1188",1189,13,3,4,9,2,13,4,8,6,44,0,1,16,4,0,5,1038030,"2023-12-29T00:00:00.000Z",192,13,"James Harden",3,20,33,29,17,44.3
"1189",1190,0,0,4,3,1,5,3,0,0,15,0,2,7,4,0,0,1038030,"2023-12-29T00:00:00.000Z",56677849,13,"Kobe Brown",0,11,11,7,4,11.8
"1190",1191,5,0,5,0,0,9,7,0,0,27,3,2,14,8,0,3,1038029,"2023-12-29T00:00:00.000Z",3547274,27,"Tre Jones",0,22,27,19,13,28.1
"1191",1192,2,0,4,1,0,4,2,0,0,18,0,1,4,4,0,0,1038029,"2023-12-29T00:00:00.000Z",359,27,"Cedi Osman",0,8,10,6,6,11.8
"1192",1193,0,0,1,1,0,6,1,0,0,14,1,2,2,2,1,0,1038029,"2023-12-29T00:00:00.000Z",38017730,27,"Dominick Barlow",1,4,4,2,2,7.4
"1193",1194,0,2,5,6,1,12,4,0,0,36,0,5,9,5,3,0,1038023,"2023-12-29T00:00:00.000Z",38017688,26,"Keegan Murray",5,14,14,9,5,30
"1194",1195,7,0,8,0,0,17,12,4,1,35,2,2,25,10,0,1,1038023,"2023-12-29T00:00:00.000Z",406,26,"Domantas Sabonis",0,35,42,32,17,46.5
"1195",1196,0,0,0,0,0,0,0,0,0,0,0,0,0,0,0,0,1038023,"2023-12-29T00:00:00.000Z",306,26,"JaVale McGee",0,0,0,0,0,0
"1196",1197,0,0,0,0,0,0,0,0,0,0,0,0,0,0,0,0,1038023,"2023-12-29T00:00:00.000Z",666925,26,"Juan Toscano-Anderson",0,0,0,0,0,0
"1197",1198,0,0,0,0,0,0,0,0,0,0,0,0,0,0,0,0,1038023,"2023-12-29T00:00:00.000Z",4197162,26,"Aleksandar Vezenkov",0,0,0,0,0,0
"1198",1199,0,0,0,0,0,0,0,0,0,0,0,0,0,0,0,0,1038023,"2023-12-29T00:00:00.000Z",17895990,26,"Jordan Ford",0,0,0,0,0,0
"1199",1200,0,0,0,0,0,0,0,0,0,0,0,0,0,0,0,0,1038023,"2023-12-29T00:00:00.000Z",56677845,26,"Colby Jones",0,0,0,0,0,0
"1200",1201,1,0,1,1,0,2,0,0,0,8,0,0,0,1,0,0,1038061,"2024-01-03T00:00:00.000Z",75,11,"Reggie Bullock",0,1,2,1,2,2.7
"1201",1202,0,0,0,0,0,0,0,0,0,0,0,0,0,0,0,0,1038061,"2024-01-03T00:00:00.000Z",19465326,11,"Jock Landale",0,0,0,0,0,0
"1202",1203,0,0,0,0,0,0,0,0,0,0,0,0,0,0,0,0,1038061,"2024-01-03T00:00:00.000Z",296,11,"Boban Marjanovic",0,0,0,0,0,0
"1203",1204,0,0,0,0,0,0,0,0,0,0,0,0,0,0,0,0,1038061,"2024-01-03T00:00:00.000Z",66,11,"Dillon Brooks",0,0,0,0,0,0
"1204",1205,0,0,0,0,0,0,0,0,0,0,0,0,0,0,0,0,1038061,"2024-01-03T00:00:00.000Z",38017695,11,"Tari Eason",0,0,0,0,0,0
"1205",1206,0,0,0,0,0,0,0,0,0,0,0,0,0,0,0,0,1038061,"2024-01-03T00:00:00.000Z",3547281,11,"Nate Hinton",0,0,0,0,0,0
"1206",1207,0,0,0,0,0,0,0,0,0,0,0,0,0,0,0,0,1038063,"2024-01-03T00:00:00.000Z",17896021,19,"Jeremiah Robinson-Earl",0,0,0,0,0,0
"1207",1208,0,0,0,0,0,0,0,0,0,0,0,0,0,0,0,0,1038063,"2024-01-03T00:00:00.000Z",38017663,19,"E.J. Liddell",0,0,0,0,0,0
"1208",1209,0,0,0,0,0,0,0,0,0,0,0,0,0,0,0,0,1038063,"2024-01-03T00:00:00.000Z",18677986,19,"Trey Murphy III",0,0,0,0,0,0
"1209",1210,0,0,0,0,0,0,0,0,0,0,0,0,0,0,0,0,1038063,"2024-01-03T00:00:00.000Z",17896017,19,"Matt Ryan",0,0,0,0,0,0
"1210",1211,0,0,0,0,0,0,0,0,0,0,0,0,0,0,0,0,1038063,"2024-01-03T00:00:00.000Z",38017726,19,"Dereon Seabron",0,0,0,0,0,0
"1211",1212,0,0,2,2,0,4,1,0,0,14,0,4,2,2,1,0,1038063,"2024-01-03T00:00:00.000Z",3547293,19,"Naji Marshall",1,4,4,2,2,7.4
"1212",1213,2,1,6,0,0,6,4,0,0,22,3,1,8,9,1,0,1038063,"2024-01-03T00:00:00.000Z",340,19,"Larry Nance Jr.",2,17,19,10,11,27.8
"1213",1214,1,0,0,0,0,0,0,0,0,2,1,0,0,1,0,0,1038063,"2024-01-03T00:00:00.000Z",491,19,"Cody Zeller",0,1,2,1,2,2.7
"1214",1215,1,2,0,0,0,3,2,2,1,23,0,2,5,0,2,1,1038064,"2024-01-03T00:00:00.000Z",247,7,"Derrick Jones Jr.",4,5,6,6,1,17.5
"1215",1216,4,3,3,0,0,1,0,0,0,19,1,1,0,4,2,0,1038064,"2024-01-03T00:00:00.000Z",56677840,7,"Dereck Lively II",5,4,8,4,8,25.8
"1216",1217,5,0,8,8,4,19,10,6,5,29,1,0,29,9,2,1,1038064,"2024-01-03T00:00:00.000Z",228,7,"Kyrie Irving",2,38,43,34,14,52.3
"1217",1218,5,0,6,7,4,21,13,14,11,31,0,1,41,6,1,4,1038064,"2024-01-03T00:00:00.000Z",132,7,"Luka Doncic",1,47,52,46,11,54.7
"1218",1219,0,0,3,5,2,10,5,2,2,23,0,2,14,3,0,0,1038064,"2024-01-03T00:00:00.000Z",191,7,"Tim Hardaway Jr.",0,17,17,14,3,17.6
"1219",1220,2,0,1,0,0,1,0,0,0,15,0,0,0,1,0,0,1038064,"2024-01-03T00:00:00.000Z",114,7,"Seth Curry",0,1,3,2,3,4.2
"1220",1221,2,0,2,0,0,1,1,6,3,13,1,2,5,3,0,1,1038064,"2024-01-03T00:00:00.000Z",379,7,"Dwight Powell",0,8,10,7,5,10.6
"1221",1222,2,0,1,0,0,2,1,0,0,15,1,2,2,2,0,3,1038064,"2024-01-03T00:00:00.000Z",666965,7,"Grant Williams",0,4,6,4,4,4.4
"1222",1223,1,1,3,1,1,3,1,0,0,12,0,2,3,3,0,1,1038064,"2024-01-03T00:00:00.000Z",329,7,"Markieff Morris",1,6,7,4,4,10.1
"1223",1224,1,1,2,6,1,10,4,3,2,11,0,0,11,2,0,0,1038064,"2024-01-03T00:00:00.000Z",38017679,7,"Jaden Hardy",1,13,14,12,3,17.9
"1224",1225,0,0,0,1,1,4,1,0,0,8,0,1,3,0,1,0,1038064,"2024-01-03T00:00:00.000Z",17554004,7,"AJ Lawson",1,3,3,3,0,6
"1225",1226,0,0,0,0,0,0,0,0,0,0,0,0,0,0,0,0,1038096,"2024-01-07T00:00:00.000Z",17896070,10,"Usman Garuba",0,0,0,0,0,0
"1226",1227,0,0,0,0,0,0,0,0,0,0,0,0,0,0,0,0,1038096,"2024-01-07T00:00:00.000Z",367,10,"Chris Paul",0,0,0,0,0,0
"1227",1228,0,0,0,0,0,0,0,0,0,0,0,0,0,0,0,0,1038096,"2024-01-07T00:00:00.000Z",2189,10,"Gary Payton II",0,0,0,0,0,0
"1228",1229,0,0,0,0,0,0,0,0,0,0,0,0,0,0,0,0,1038096,"2024-01-07T00:00:00.000Z",57875092,10,"Gui Santos",0,0,0,0,0,0
"1229",1230,6,0,6,8,5,20,13,8,6,36,0,3,37,6,1,0,1038096,"2024-01-07T00:00:00.000Z",666423,28,"RJ Barrett",1,43,49,43,12,56.2
"1230",1231,6,2,5,3,2,11,7,0,0,30,1,0,16,6,0,1,1038096,"2024-01-07T00:00:00.000Z",416,28,"Pascal Siakam",2,22,28,22,12,37.2
"1231",1232,5,0,8,0,0,8,6,5,2,31,3,3,14,11,0,2,1038096,"2024-01-07T00:00:00.000Z",373,28,"Jakob Poeltl",0,25,30,19,16,32.7
"1232",1233,3,1,1,4,0,11,3,0,0,24,1,1,6,2,1,2,1038096,"2024-01-07T00:00:00.000Z",17896055,28,"Scottie Barnes",2,8,11,9,5,16.9
"1233",1234,10,0,4,4,1,10,4,0,0,26,1,0,9,5,1,0,1038096,"2024-01-07T00:00:00.000Z",3547269,28,"Immanuel Quickley",1,14,24,19,15,33
"1234",1235,4,0,3,3,1,10,6,1,0,28,0,5,13,3,0,0,1038096,"2024-01-07T00:00:00.000Z",409,28,"Dennis Schroder",0,16,20,17,7,22.6
"1235",1236,1,1,1,2,0,3,1,0,0,11,1,1,2,2,0,0,1038096,"2024-01-07T00:00:00.000Z",2309958,28,"Jontay Porter",1,4,5,3,3,8.9
"1236",1237,1,1,7,3,3,7,7,0,0,16,2,0,17,9,1,0,1038096,"2024-01-07T00:00:00.000Z",58,28,"Chris Boucher",2,26,27,18,10,35.3
"1237",1238,1,0,0,0,0,0,0,0,0,4,0,0,0,0,0,0,1038096,"2024-01-07T00:00:00.000Z",666762,28,"Jalen McDaniels",0,0,1,1,1,1.5
"1238",1239,0,0,0,0,0,1,1,0,0,4,0,0,2,0,1,1,1038096,"2024-01-07T00:00:00.000Z",436,28,"Garrett Temple",1,2,2,2,0,4
"1239",1240,1,1,5,4,2,10,4,5,5,23,1,0,15,6,1,0,1038094,"2024-01-07T00:00:00.000Z",38017721,8,"Peyton Watson",2,21,22,16,7,29.7
"1240",1241,1,1,7,0,0,3,3,5,3,21,0,5,9,7,0,3,1038094,"2024-01-07T00:00:00.000Z",250,8,"DeAndre Jordan",1,16,17,10,8,18.9
"1241",1242,0,0,0,0,0,0,0,0,0,4,0,0,0,0,0,0,1038094,"2024-01-07T00:00:00.000Z",215,8,"Justin Holiday",0,0,0,0,0,0
"1242",1243,0,0,1,0,0,0,0,2,2,3,0,0,2,1,0,0,1038094,"2024-01-07T00:00:00.000Z",17896007,8,"Braxton Key",0,3,3,2,1,3.2
"1243",1244,0,0,0,0,0,0,0,0,0,3,0,1,0,0,0,1,1038094,"2024-01-07T00:00:00.000Z",38017727,8,"Collin Gillespie",0,0,0,0,0,-1
"1244",1245,0,0,0,1,0,1,0,0,0,3,0,0,0,0,0,0,1038094,"2024-01-07T00:00:00.000Z",3547268,8,"Zeke Nnaji",0,0,0,0,0,0
"1245",1246,0,0,0,1,0,1,0,0,0,2,0,1,0,0,0,0,1038094,"2024-01-07T00:00:00.000Z",17896103,8,"Jay Huff",0,0,0,0,0,0
"1246",1247,0,0,0,0,0,0,0,0,0,0,0,0,0,0,0,0,1038091,"2024-01-07T00:00:00.000Z",85,22,"Wendell Carter Jr.",0,0,0,0,0,0
"1247",1248,1,0,3,3,2,6,2,2,1,20,1,1,7,4,2,5,1038097,"2024-01-07T00:00:00.000Z",666860,14,"Cameron Reddish",2,11,12,8,5,14.3
"1248",1249,7,0,7,3,1,19,11,3,2,38,1,2,25,8,1,4,1038097,"2024-01-07T00:00:00.000Z",237,14,"LeBron James",1,33,40,32,15,44.1
"1249",1250,1,1,9,1,0,15,10,4,2,39,1,1,22,10,3,3,1038097,"2024-01-07T00:00:00.000Z",117,14,"Anthony Davis",4,32,33,23,11,44.5
"1250",1251,0,0,0,0,0,0,0,0,0,0,0,0,0,0,0,0,1038125,"2024-01-12T00:00:00.000Z",242,12,"James Johnson",0,0,0,0,0,0
"1251",1252,0,0,0,0,0,0,0,0,0,0,0,0,0,0,0,0,1038125,"2024-01-12T00:00:00.000Z",56677832,12,"Jarace Walker",0,0,0,0,0,0
"1252",1253,0,0,0,0,0,0,0,0,0,0,0,0,0,0,0,0,1038125,"2024-01-12T00:00:00.000Z",56677794,12,"Isaiah Wong",0,0,0,0,0,0
"1253",1254,1,1,5,0,0,2,2,2,1,12,0,0,5,5,0,0,1038128,"2024-01-12T00:00:00.000Z",137,5,"Andre Drummond",1,10,11,6,6,15.5
"1254",1255,0,0,0,0,0,0,0,0,0,0,0,0,0,0,0,0,1038128,"2024-01-12T00:00:00.000Z",87,5,"Jevon Carter",0,0,0,0,0,0
"1255",1256,0,0,0,0,0,0,0,0,0,0,0,0,0,0,0,0,1038128,"2024-01-12T00:00:00.000Z",110,5,"Torrey Craig",0,0,0,0,0,0
"1256",1257,3,0,2,3,1,8,4,0,0,24,0,1,9,2,2,4,1038130,"2024-01-12T00:00:00.000Z",3547259,18,"Jaden McDaniels",2,11,14,12,5,17.9
"1257",1258,1,0,7,3,3,8,7,7,6,28,1,2,23,8,2,0,1038130,"2024-01-12T00:00:00.000Z",447,18,"Karl-Anthony Towns",2,31,32,24,9,40.1
"1258",1259,0,2,12,0,0,11,9,8,6,29,5,2,24,17,0,1,1038130,"2024-01-12T00:00:00.000Z",176,18,"Rudy Gobert",2,41,41,24,17,49.4
"1259",1260,6,1,3,3,0,9,4,2,1,27,0,2,9,3,1,0,1038130,"2024-01-12T00:00:00.000Z",3547238,18,"Anthony Edwards",2,12,18,15,9,27.6
"1260",1261,10,0,4,5,3,7,3,0,0,20,0,1,9,4,0,0,1038130,"2024-01-12T00:00:00.000Z",104,18,"Mike Conley",0,13,23,19,14,28.8
"1261",1262,1,0,2,0,0,2,1,0,0,15,0,2,2,2,0,2,1038130,"2024-01-12T00:00:00.000Z",12,18,"Kyle Anderson",0,4,5,3,3,3.9
"1262",1263,3,0,2,2,0,3,1,0,0,19,0,1,2,2,2,2,1038130,"2024-01-12T00:00:00.000Z",666400,18,"Nickeil Alexander-Walker",2,4,7,5,5,12.9
"1263",1264,5,0,0,2,0,3,1,0,0,13,0,2,2,0,1,2,1038130,"2024-01-12T00:00:00.000Z",666767,18,"Jordan McLaughlin",1,2,7,7,5,10.5
"1264",1265,2,0,0,0,0,5,3,0,0,10,0,1,6,0,0,0,1038130,"2024-01-12T00:00:00.000Z",320,18,"Shake Milton",0,6,8,8,2,9
"1265",1266,0,1,0,0,0,3,0,2,2,9,0,2,2,0,1,0,1038130,"2024-01-12T00:00:00.000Z",38017715,18,"Josh Minott",2,2,2,2,0,8
"1266",1267,3,0,1,5,2,5,2,0,0,9,1,1,6,2,0,3,1038130,"2024-01-12T00:00:00.000Z",68,18,"Troy Brown Jr.",0,8,11,9,5,9.9
"1267",1268,0,0,0,0,0,2,2,0,0,8,0,2,4,0,2,0,1038130,"2024-01-12T00:00:00.000Z",38017700,18,"Wendell Moore Jr.",2,4,4,4,0,10
"1268",1269,0,1,2,2,0,4,2,0,0,8,0,2,4,2,1,1,1038130,"2024-01-12T00:00:00.000Z",56677782,18,"Leonard Miller",2,6,6,4,2,11.4
"1269",1270,0,0,0,0,0,0,0,0,0,0,0,0,0,0,0,0,1038130,"2024-01-12T00:00:00.000Z",17895968,18,"Daishen Nix",0,0,0,0,0,0
"1270",1271,5,0,5,5,2,21,15,8,7,41,1,5,39,6,0,1,1038128,"2024-01-12T00:00:00.000Z",125,5,"DeMar DeRozan",0,45,50,44,11,52.7
"1271",1272,2,1,1,6,2,6,2,0,0,29,1,0,6,2,0,0,1038128,"2024-01-12T00:00:00.000Z",89,5,"Alex Caruso",1,8,10,8,4,14.4
"1272",1273,2,0,5,5,2,12,6,0,0,33,2,1,14,7,0,3,1038128,"2024-01-12T00:00:00.000Z",460,5,"Nikola Vucevic",0,21,23,16,9,22.4
"1273",1274,7,1,8,8,4,15,9,3,3,35,0,3,25,8,0,1,1038128,"2024-01-12T00:00:00.000Z",268,5,"Zach LaVine",1,33,40,32,15,47.1
"1274",1275,7,0,4,7,5,13,9,3,2,37,0,4,25,4,0,1,1038128,"2024-01-12T00:00:00.000Z",666956,5,"Coby White",0,29,36,32,11,39.3
"1275",1276,8,0,3,3,0,8,3,0,0,33,3,0,6,6,3,0,1037615,"2023-10-27T00:00:00.000Z",3547274,27,"Tre Jones",3,12,20,14,14,34.2
"1276",1277,0,0,2,0,0,0,0,0,0,8,1,1,0,3,0,0,1037615,"2023-10-27T00:00:00.000Z",17895854,27,"Charles Bassey",0,3,3,0,3,3.6
"1277",1278,1,4,7,0,0,6,2,4,3,38,6,1,7,13,4,1,1037611,"2023-10-27T00:00:00.000Z",399,20,"Mitchell Robinson",8,20,21,8,14,47.1
"1278",1279,1,0,0,5,2,6,2,0,0,25,1,3,6,1,0,1,1037611,"2023-10-27T00:00:00.000Z",17895858,20,"Quentin Grimes",0,7,8,7,2,7.7
"1279",1280,5,0,3,12,8,21,11,2,1,33,0,1,31,3,0,1,1037611,"2023-10-27T00:00:00.000Z",73,20,"Jalen Brunson",0,34,39,36,8,41.1
"1280",1281,0,0,0,0,0,0,0,0,0,0,0,0,0,0,0,0,1037615,"2023-10-27T00:00:00.000Z",38017730,27,"Dominick Barlow",0,0,0,0,0,0
"1281",1282,0,0,0,0,0,0,0,0,0,0,0,0,0,0,0,0,1037615,"2023-10-27T00:00:00.000Z",38017649,27,"Julian Champagnie",0,0,0,0,0,0
"1282",1283,0,0,0,0,0,0,0,0,0,0,0,0,0,0,0,0,1037615,"2023-10-27T00:00:00.000Z",180,27,"Devonte' Graham",0,0,0,0,0,0
"1283",1284,0,2,0,0,0,4,3,2,1,13,0,1,7,0,1,1,1037610,"2023-10-27T00:00:00.000Z",3547268,8,"Zeke Nnaji",3,7,7,7,0,15
"1284",1285,0,0,0,0,0,2,0,0,0,5,0,2,0,0,0,0,1037610,"2023-10-27T00:00:00.000Z",56677776,8,"Julian Strawther",0,0,0,0,0,0
"1285",1286,0,0,0,0,0,0,0,0,0,0,0,0,0,0,0,0,1037610,"2023-10-27T00:00:00.000Z",215,8,"Justin Holiday",0,0,0,0,0,0
"1286",1287,0,0,0,0,0,0,0,0,0,0,0,0,0,0,0,0,1037610,"2023-10-27T00:00:00.000Z",250,8,"DeAndre Jordan",0,0,0,0,0,0
"1287",1288,0,0,0,0,0,0,0,0,0,0,0,0,0,0,0,0,1037610,"2023-10-27T00:00:00.000Z",17896007,8,"Braxton Key",0,0,0,0,0,0
"1288",1289,0,0,0,0,0,0,0,0,0,0,0,0,0,0,0,0,1037610,"2023-10-27T00:00:00.000Z",56677582,8,"Jalen Pickett",0,0,0,0,0,0
"1289",1290,0,0,0,0,0,0,0,0,0,0,0,0,0,0,0,0,1037610,"2023-10-27T00:00:00.000Z",56677871,8,"Hunter Tyson",0,0,0,0,0,0
"1290",1291,0,0,0,0,0,0,0,0,0,0,0,0,0,0,0,0,1037610,"2023-10-27T00:00:00.000Z",666489,8,"Vlatko Cancar",0,0,0,0,0,0
"1291",1292,4,1,2,7,3,14,8,2,1,35,2,5,20,4,0,3,1037615,"2023-10-27T00:00:00.000Z",666682,27,"Keldon Johnson",1,24,28,24,8,30.8
"1292",1293,1,3,7,6,0,19,7,8,7,31,5,2,21,12,2,4,1037615,"2023-10-27T00:00:00.000Z",56677822,27,"Victor Wembanyama",5,33,34,22,13,47.9
"1293",1294,8,0,6,7,0,12,4,3,1,39,0,5,9,6,4,4,1037615,"2023-10-27T00:00:00.000Z",102,27,"Zach Collins",4,15,23,17,14,36.2
"1294",1295,2,0,3,7,3,13,7,11,8,40,0,0,25,3,0,1,1037615,"2023-10-27T00:00:00.000Z",3547246,27,"Devin Vassell",0,28,30,27,5,30.6
"1295",1296,0,0,0,0,0,0,0,0,0,0,0,0,0,0,0,0,1037610,"2023-10-27T00:00:00.000Z",38017727,8,"Collin Gillespie",0,0,0,0,0,0
"1296",1297,0,0,0,0,0,0,0,0,0,0,0,0,0,0,0,0,1037610,"2023-10-27T00:00:00.000Z",17896103,8,"Jay Huff",0,0,0,0,0,0
"1297",1298,4,0,4,1,0,9,5,4,4,26,1,3,14,5,2,2,1037615,"2023-10-27T00:00:00.000Z",38017699,27,"Jeremy Sochan",2,19,23,18,9,30
"1298",1299,0,0,1,1,0,4,2,0,0,11,0,0,4,1,0,0,1037614,"2023-10-27T00:00:00.000Z",17895983,5,"Ayo Dosunmu",0,5,5,4,1,5.2
"1299",1300,1,0,1,0,0,4,4,2,2,21,0,1,10,1,0,0,1037615,"2023-10-27T00:00:00.000Z",188,11,"Jeff Green",0,11,12,11,2,12.7
"1300",1301,2,0,7,2,0,7,3,2,2,24,4,2,8,11,0,5,1037649,"2023-11-01T00:00:00.000Z",17896040,1,"Jalen Johnson",0,19,21,10,13,19.2
"1301",1302,1,1,3,5,1,10,4,3,3,23,0,2,12,3,1,1,1037649,"2023-11-01T00:00:00.000Z",53,1,"Bogdan Bogdanovic",2,15,16,13,4,22.1
"1302",1303,0,0,0,2,0,2,0,0,0,12,0,0,0,0,0,0,1037649,"2023-11-01T00:00:00.000Z",38017689,1,"AJ Griffin",0,0,0,0,0,0
"1303",1304,2,1,6,1,0,8,6,4,4,27,5,3,16,11,0,1,1037649,"2023-11-01T00:00:00.000Z",3547244,1,"Onyeka Okongwu",1,27,29,18,13,34.2
"1304",1305,0,0,0,0,0,0,0,0,0,0,0,0,0,0,0,0,1037649,"2023-11-01T00:00:00.000Z",56677838,1,"Kobe Bufkin",0,0,0,0,0,0
"1305",1306,0,0,0,0,0,0,0,0,0,0,0,0,0,0,0,0,1037649,"2023-11-01T00:00:00.000Z",666564,1,"Bruno Fernando",0,0,0,0,0,0
"1306",1307,0,0,0,0,0,0,0,0,0,0,0,0,0,0,0,0,1037649,"2023-11-01T00:00:00.000Z",3547297,1,"Trent Forrest",0,0,0,0,0,0
"1307",1308,0,0,0,0,0,0,0,0,0,0,0,0,0,0,0,0,1037649,"2023-11-01T00:00:00.000Z",56677806,1,"Mouhamed Gueye",0,0,0,0,0,0
"1308",1309,0,0,0,0,0,0,0,0,0,0,0,0,0,0,0,0,1037649,"2023-11-01T00:00:00.000Z",666754,1,"Garrison Mathews",0,0,0,0,0,0
"1309",1310,0,0,0,0,0,0,0,0,0,0,0,0,0,0,0,0,1037649,"2023-11-01T00:00:00.000Z",319,1,"Patty Mills",0,0,0,0,0,0
"1310",1311,0,0,0,0,0,0,0,0,0,0,0,0,0,0,0,0,1037649,"2023-11-01T00:00:00.000Z",56677855,1,"Seth Lundy",0,0,0,0,0,0
"1311",1312,0,0,0,0,0,0,0,0,0,0,0,0,0,0,0,0,1037649,"2023-11-01T00:00:00.000Z",301,1,"Wesley Matthews",0,0,0,0,0,0
"1312",1313,0,0,0,0,0,0,0,0,0,0,0,0,0,0,0,0,1037649,"2023-11-01T00:00:00.000Z",56677875,1,"Miles Norris",0,0,0,0,0,0
"1313",1314,3,1,2,4,2,16,10,1,0,24,3,5,22,5,2,1,1037649,"2023-11-01T00:00:00.000Z",3547242,30,"Deni Avdija",3,27,30,25,8,40.5
"1314",1315,6,0,9,6,1,21,11,3,2,25,0,1,25,9,0,1,1037649,"2023-11-01T00:00:00.000Z",265,30,"Kyle Kuzma",0,34,40,31,15,43.8
"1315",1316,1,1,3,4,1,7,2,2,2,22,1,3,7,4,1,2,1037649,"2023-11-01T00:00:00.000Z",337,30,"Mike Muscala",2,11,12,8,5,17.3
"1316",1317,2,1,2,3,1,7,3,3,3,22,0,3,10,2,1,1,1037647,"2023-11-01T00:00:00.000Z",38017682,9,"Jaden Ivey",2,12,14,12,4,20.4
"1317",1318,1,0,2,0,0,4,2,0,0,6,0,4,4,2,0,1,1037647,"2023-11-01T00:00:00.000Z",3547240,9,"James Wiseman",0,6,7,5,3,6.9
"1318",1319,0,0,2,0,0,1,0,0,0,12,0,3,0,2,0,0,1037647,"2023-11-01T00:00:00.000Z",44477024,9,"Stanley Umude",0,2,2,0,2,2.4
"1319",1320,6,1,3,1,0,6,4,0,0,24,0,3,8,3,4,0,1037647,"2023-11-01T00:00:00.000Z",56677792,9,"Marcus Sasser",5,11,17,14,9,35.6
"1320",1321,1,0,1,6,3,7,4,0,0,17,1,1,11,2,0,0,1037647,"2023-11-01T00:00:00.000Z",197,9,"Joe Harris",0,13,14,12,3,14.9
"1321",1322,0,0,0,0,0,0,0,0,0,0,0,0,0,0,0,0,1037647,"2023-11-01T00:00:00.000Z",56677729,9,"Malcolm Cazalon",0,0,0,0,0,0
"1322",1323,0,0,0,0,0,0,0,0,0,0,0,0,0,0,0,0,1037647,"2023-11-01T00:00:00.000Z",42097199,9,"Jared Rhoden",0,0,0,0,0,0
"1323",1324,0,0,0,0,0,0,0,0,0,0,0,0,0,0,0,0,1037647,"2023-11-01T00:00:00.000Z",54,9,"Bojan Bogdanovic",0,0,0,0,0,0
"1324",1325,0,0,0,0,0,0,0,0,0,0,0,0,0,0,0,0,1037647,"2023-11-01T00:00:00.000Z",77,9,"Alec Burks",0,0,0,0,0,0
"1325",1326,0,1,4,4,2,4,2,0,0,19,0,2,6,4,0,0,1037680,"2023-11-05T00:00:00.000Z",376,28,"Otto Porter Jr.",1,10,10,6,4,13.8
"1326",1327,0,0,0,0,0,0,0,0,0,0,0,0,0,0,0,0,1037680,"2023-11-05T00:00:00.000Z",58,28,"Chris Boucher",0,0,0,0,0,0
"1327",1328,0,0,0,0,0,0,0,0,0,0,0,0,0,0,0,0,1037680,"2023-11-05T00:00:00.000Z",436,28,"Garrett Temple",0,0,0,0,0,0
"1328",1329,0,0,0,0,0,0,0,0,0,0,0,0,0,0,0,0,1037680,"2023-11-05T00:00:00.000Z",489,28,"Thaddeus Young",0,0,0,0,0,0
"1329",1330,0,0,0,0,0,0,0,0,0,0,0,0,0,0,0,0,1037680,"2023-11-05T00:00:00.000Z",3547249,28,"Precious Achiuwa",0,0,0,0,0,0
"1330",1331,0,0,0,0,0,0,0,0,0,0,0,0,0,0,0,0,1037680,"2023-11-05T00:00:00.000Z",56677805,28,"Javon Freeman-Liberty",0,0,0,0,0,0
"1331",1332,0,0,0,0,0,0,0,0,0,0,0,0,0,0,0,0,1037680,"2023-11-05T00:00:00.000Z",38017717,28,"Ron Harper Jr.",0,0,0,0,0,0
"1332",1333,0,0,0,0,0,0,0,0,0,0,0,0,0,0,0,0,1037680,"2023-11-05T00:00:00.000Z",38017710,28,"Christian Koloko",0,0,0,0,0,0
"1333",1334,0,0,0,0,0,0,0,0,0,0,0,0,0,0,0,0,1037680,"2023-11-05T00:00:00.000Z",56677869,28,"Markquis Nowell",0,0,0,0,0,0
"1334",1335,4,0,4,10,3,13,6,0,0,36,0,3,15,4,1,0,1037681,"2023-11-05T00:00:00.000Z",666908,6,"Max Strus",1,19,23,19,8,28.8
"1335",1336,2,1,11,1,0,10,6,4,1,29,5,4,13,16,0,5,1037681,"2023-11-05T00:00:00.000Z",17896076,6,"Evan Mobley",1,29,31,15,18,33.2
"1336",1337,3,0,4,0,0,7,5,2,2,28,5,1,12,9,0,2,1037681,"2023-11-05T00:00:00.000Z",9,6,"Jarrett Allen",0,21,24,15,12,25.3
"1337",1338,7,0,1,11,5,19,11,4,4,34,1,3,31,2,2,4,1037681,"2023-11-05T00:00:00.000Z",322,6,"Donovan Mitchell",2,33,40,38,9,45.9
"1338",1339,7,0,3,5,0,17,6,13,12,30,0,3,24,3,0,6,1037681,"2023-11-05T00:00:00.000Z",666581,6,"Darius Garland",0,27,34,31,10,32.1
"1339",1340,1,0,6,4,2,6,2,0,0,25,0,4,6,6,0,0,1037681,"2023-11-05T00:00:00.000Z",344,6,"Georges Niang",0,12,13,7,7,14.7
"1340",1341,2,0,5,3,0,6,3,2,2,32,0,0,8,5,2,1,1037681,"2023-11-05T00:00:00.000Z",277,6,"Caris LeVert",2,13,15,10,7,22
"1341",1342,0,1,4,0,0,2,1,3,1,11,1,2,3,5,0,0,1037681,"2023-11-05T00:00:00.000Z",444,6,"Tristan Thompson",1,8,8,3,5,12
"1342",1343,0,0,0,0,0,0,0,0,0,0,0,0,0,0,0,0,1037681,"2023-11-05T00:00:00.000Z",404,6,"Ricky Rubio",0,0,0,0,0,0
"1343",1344,1,0,2,2,1,9,3,4,1,26,3,1,8,5,0,0,1037681,"2023-11-05T00:00:00.000Z",475,10,"Andrew Wiggins",0,13,14,9,6,15.5
"1344",1345,8,1,3,3,2,11,5,6,6,29,0,0,18,3,3,1,1037681,"2023-11-05T00:00:00.000Z",185,10,"Draymond Green",4,21,29,26,11,44.6
"1345",1346,5,0,6,0,0,2,1,0,0,15,5,1,2,11,0,0,1037681,"2023-11-05T00:00:00.000Z",282,10,"Kevon Looney",0,13,18,7,16,22.7
"1346",1347,2,0,1,9,3,14,5,2,2,32,2,2,15,3,1,2,1037681,"2023-11-05T00:00:00.000Z",443,10,"Klay Thompson",1,18,20,17,5,22.6
"1347",1348,4,0,2,11,7,16,8,6,5,31,0,0,28,2,1,6,1037681,"2023-11-05T00:00:00.000Z",115,10,"Stephen Curry",1,30,34,32,6,33.4
"1348",1349,0,0,4,1,0,3,0,0,0,13,1,2,0,5,0,1,1037681,"2023-11-05T00:00:00.000Z",407,10,"Dario Saric",0,5,5,0,5,5
"1349",1350,1,0,0,3,1,7,2,0,0,12,2,2,5,2,0,0,1037681,"2023-11-05T00:00:00.000Z",2189,10,"Gary Payton II",0,7,8,6,3,8.9
"1350",1351,0,0,0,0,0,0,0,0,0,0,0,0,0,0,0,0,3277398,"2023-11-10T00:00:00.000Z",38017687,30,"Johnny Davis",0,0,0,0,0,0
"1351",1352,1,1,1,2,1,4,3,2,2,17,2,3,9,3,1,1,1037711,"2023-11-09T00:00:00.000Z",56677827,22,"Anthony Black",2,12,13,10,4,19.1
"1352",1353,0,2,6,4,1,8,3,7,5,16,1,1,12,7,0,0,1037711,"2023-11-09T00:00:00.000Z",229,22,"Jonathan Isaac",2,19,19,12,7,26.4
"1353",1354,8,0,3,15,5,27,12,13,12,34,2,1,41,5,2,3,1037711,"2023-11-09T00:00:00.000Z",490,1,"Trae Young",2,46,54,49,13,62
"1354",1355,3,0,4,6,3,11,6,0,0,29,0,3,15,4,3,1,1037711,"2023-11-09T00:00:00.000Z",53,1,"Bogdan Bogdanovic",3,19,22,18,7,32.3
"1355",1356,0,0,2,0,0,4,1,0,0,29,1,3,2,3,1,1,1037711,"2023-11-09T00:00:00.000Z",3547256,1,"Saddiq Bey",1,5,5,2,3,7.6
"1356",1357,2,4,1,1,0,4,3,2,1,21,1,4,7,2,3,1,1037711,"2023-11-09T00:00:00.000Z",3547244,1,"Onyeka Okongwu",7,9,11,9,4,32.4
"1357",1358,0,0,0,0,0,0,0,0,0,0,0,0,0,0,0,0,1037711,"2023-11-09T00:00:00.000Z",319,1,"Patty Mills",0,0,0,0,0,0
"1358",1359,0,0,0,0,0,0,0,0,0,0,0,0,0,0,0,0,1037711,"2023-11-09T00:00:00.000Z",56677838,1,"Kobe Bufkin",0,0,0,0,0,0
"1359",1360,0,0,0,0,0,0,0,0,0,0,0,0,0,0,0,0,1037711,"2023-11-09T00:00:00.000Z",3547297,1,"Trent Forrest",0,0,0,0,0,0
"1360",1361,0,0,0,0,0,0,0,0,0,0,0,0,0,0,0,0,1037711,"2023-11-09T00:00:00.000Z",56677806,1,"Mouhamed Gueye",0,0,0,0,0,0
"1361",1362,0,0,0,0,0,0,0,0,0,0,0,0,0,0,0,0,1037711,"2023-11-09T00:00:00.000Z",301,1,"Wesley Matthews",0,0,0,0,0,0
"1362",1363,0,0,0,0,0,0,0,0,0,0,0,0,0,0,0,0,1037711,"2023-11-09T00:00:00.000Z",56677875,1,"Miles Norris",0,0,0,0,0,0
"1363",1364,0,0,0,0,0,0,0,0,0,0,0,0,0,0,0,0,3277398,"2023-11-10T00:00:00.000Z",3547302,30,"Anthony Gill",0,0,0,0,0,0
"1364",1365,0,0,0,0,0,0,0,0,0,0,0,0,0,0,0,0,3277398,"2023-11-10T00:00:00.000Z",337,30,"Mike Muscala",0,0,0,0,0,0
"1365",1366,0,0,0,0,0,0,0,0,0,0,0,0,0,0,0,0,3277398,"2023-11-10T00:00:00.000Z",38017712,30,"Ryan Rollins",0,0,0,0,0,0
"1366",1367,0,0,0,0,0,0,0,0,0,0,0,0,0,0,0,0,3277398,"2023-11-10T00:00:00.000Z",18677954,30,"Jared Butler",0,0,0,0,0,0
"1367",1368,0,0,0,0,0,0,0,0,0,0,0,0,0,0,0,0,3277398,"2023-11-10T00:00:00.000Z",38124126,30,"John Butler Jr.",0,0,0,0,0,0
"1368",1369,0,0,0,0,0,0,0,0,0,0,0,0,0,0,0,0,3277398,"2023-11-10T00:00:00.000Z",17896106,30,"Eugene Omoruyi",0,0,0,0,0,0
"1369",1370,9,1,5,4,1,20,10,8,6,36,0,0,27,5,4,0,3277398,"2023-11-10T00:00:00.000Z",204,4,"Gordon Hayward",5,32,41,36,14,61.5
"1370",1371,4,0,7,6,0,15,5,2,1,38,3,0,11,10,1,2,3277398,"2023-11-10T00:00:00.000Z",666950,4,"P.J. Washington",1,21,25,15,14,30
"1371",1372,3,0,9,0,0,18,10,2,1,30,12,0,21,21,0,0,3277398,"2023-11-10T00:00:00.000Z",38017698,4,"Mark Williams",0,42,45,24,24,50.7
"1372",1373,2,2,1,6,0,16,5,2,2,31,2,5,12,3,2,1,3277398,"2023-11-10T00:00:00.000Z",56677823,4,"Brandon Miller",4,15,17,14,5,29.6
"1373",1374,6,0,3,8,4,19,9,4,3,38,3,5,25,6,2,2,3277398,"2023-11-10T00:00:00.000Z",3547239,4,"LaMelo Ball",2,31,37,31,12,45.2
"1374",1375,0,0,0,0,0,0,0,0,0,0,0,0,0,0,0,0,3277398,"2023-11-10T00:00:00.000Z",56677848,4,"Amari Bailey",0,0,0,0,0,0
"1375",1376,0,0,0,0,0,0,0,0,0,0,0,0,0,0,0,0,3277425,"2023-11-14T00:00:00.000Z",38017736,16,"Cole Swider",0,0,0,0,0,0
"1376",1377,0,1,5,0,0,7,4,5,3,24,5,6,11,10,0,2,3277428,"2023-11-14T00:00:00.000Z",17896038,3,"Day'Ron Sharpe",1,21,21,11,10,24
"1377",1378,1,0,4,6,4,6,4,2,1,34,0,4,13,4,0,1,3277428,"2023-11-14T00:00:00.000Z",351,3,"Royce O'Neale",0,17,18,14,5,18.3
"1378",1379,1,0,2,6,3,9,4,0,0,20,0,0,11,2,2,2,3277428,"2023-11-14T00:00:00.000Z",464,3,"Lonnie Walker IV",2,13,14,12,3,18.9
"1379",1380,5,0,2,1,0,7,3,0,0,19,1,3,6,3,2,1,3277428,"2023-11-14T00:00:00.000Z",421,3,"Dennis Smith Jr.",2,9,14,11,8,22.1
"1380",1381,0,0,0,0,0,0,0,0,0,0,0,0,0,0,0,0,3277428,"2023-11-14T00:00:00.000Z",174,3,"Harry Giles III",0,0,0,0,0,0
"1381",1382,0,0,0,0,0,0,0,0,0,0,0,0,0,0,0,0,3277428,"2023-11-14T00:00:00.000Z",17896048,3,"Cam Thomas",0,0,0,0,0,0
"1382",1383,0,0,0,0,0,0,0,0,0,0,0,0,0,0,0,0,3277428,"2023-11-14T00:00:00.000Z",17896058,3,"Trendon Watford",0,0,0,0,0,0
"1383",1384,0,0,0,0,0,0,0,0,0,0,0,0,0,0,0,0,3277428,"2023-11-14T00:00:00.000Z",9051997,3,"Armoni Brooks",0,0,0,0,0,0
"1384",1385,0,0,0,0,0,0,0,0,0,0,0,0,0,0,0,0,3277428,"2023-11-14T00:00:00.000Z",56677843,3,"Noah Clowney",0,0,0,0,0,0
"1385",1386,1,0,2,1,0,7,6,2,2,25,1,4,14,3,2,0,3277428,"2023-11-14T00:00:00.000Z",666442,22,"Goga Bitadze",2,17,18,15,4,25.1
"1386",1387,2,1,2,7,2,13,4,0,0,32,0,2,10,2,2,3,3277428,"2023-11-14T00:00:00.000Z",17896073,22,"Jalen Suggs",3,12,14,12,4,21.4
"1387",1388,1,0,0,3,0,4,1,0,0,19,0,2,2,0,0,1,3277428,"2023-11-14T00:00:00.000Z",56677827,22,"Anthony Black",0,2,3,3,1,2.5
"1388",1389,4,1,2,3,3,4,4,0,0,21,1,1,11,3,1,1,3277428,"2023-11-14T00:00:00.000Z",226,22,"Joe Ingles",2,14,18,15,7,25.6
"1389",1390,2,0,3,8,2,10,2,4,4,28,3,0,10,6,0,4,3277428,"2023-11-14T00:00:00.000Z",3547251,22,"Cole Anthony",0,16,18,12,8,16.2
"1390",1391,1,1,3,4,1,4,1,0,0,12,0,1,3,3,2,2,3277428,"2023-11-14T00:00:00.000Z",229,22,"Jonathan Isaac",3,6,7,4,4,15.1
"1391",1392,0,0,0,1,1,1,1,0,0,5,0,1,3,0,0,0,3277428,"2023-11-14T00:00:00.000Z",38017724,22,"Caleb Houstan",0,3,3,3,0,3
"1392",1393,0,0,0,4,0,4,0,0,0,4,0,0,0,0,0,0,3277428,"2023-11-14T00:00:00.000Z",56677839,22,"Jett Howard",0,0,0,0,0,0
"1393",1394,0,0,0,0,0,0,0,0,0,2,0,0,0,0,0,0,3277428,"2023-11-14T00:00:00.000Z",666818,22,"Chuma Okeke",0,0,0,0,0,0
"1394",1395,2,1,4,5,1,8,2,2,1,22,0,4,6,4,1,1,3277427,"2023-11-14T00:00:00.000Z",3547250,12,"Aaron Nesmith",2,10,12,8,6,18.8
"1395",1396,4,0,1,1,0,3,1,0,0,10,1,1,2,2,1,0,3277427,"2023-11-14T00:00:00.000Z",38017507,12,"Andrew Nembhard",1,4,8,6,6,13.4
"1396",1397,0,0,0,0,0,0,0,0,0,0,0,0,0,0,0,0,3277427,"2023-11-14T00:00:00.000Z",3547207,12,"Jordan Nwora",0,0,0,0,0,0
"1397",1398,0,0,0,0,0,0,0,0,0,0,0,0,0,0,0,0,3277427,"2023-11-14T00:00:00.000Z",56677861,12,"Ben Sheppard",0,0,0,0,0,0
"1398",1399,0,0,0,0,0,0,0,0,0,0,0,0,0,0,0,0,3277427,"2023-11-14T00:00:00.000Z",56677832,12,"Jarace Walker",0,0,0,0,0,0
"1399",1400,0,0,0,0,0,0,0,0,0,0,0,0,0,0,0,0,3277427,"2023-11-14T00:00:00.000Z",38017701,12,"Kendall Brown",0,0,0,0,0,0
"1400",1401,1,0,0,2,1,2,1,0,0,12,0,3,3,0,0,0,1037775,"2023-11-18T00:00:00.000Z",48248287,15,"Jacob Gilyard",0,3,4,4,1,4.5
"1401",1402,3,1,8,5,1,15,7,3,2,36,2,2,17,10,1,3,1037775,"2023-11-18T00:00:00.000Z",17896067,15,"Santi Aldama",2,27,30,20,13,36.5
"1402",1403,1,0,1,1,1,4,3,3,2,14,0,1,9,1,0,0,1037775,"2023-11-18T00:00:00.000Z",401,15,"Derrick Rose",0,10,11,10,2,11.7
"1403",1404,1,0,2,3,0,5,0,2,0,26,2,1,0,4,2,1,1037775,"2023-11-18T00:00:00.000Z",38017729,15,"David Roddy",2,4,5,1,5,11.3
"1404",1405,0,0,4,0,0,4,1,0,0,13,3,3,2,7,1,1,1037772,"2023-11-18T00:00:00.000Z",491,19,"Cody Zeller",1,9,9,2,7,12.4
"1405",1406,0,0,0,0,0,0,0,0,0,0,0,0,0,0,0,0,1037772,"2023-11-18T00:00:00.000Z",3547260,19,"Kira Lewis Jr.",0,0,0,0,0,0
"1406",1407,0,0,0,0,0,0,0,0,0,0,0,0,0,0,0,0,1037772,"2023-11-18T00:00:00.000Z",666969,19,"Zion Williamson",0,0,0,0,0,0
"1407",1408,0,0,0,0,0,0,0,0,0,0,0,0,0,0,0,0,1037772,"2023-11-18T00:00:00.000Z",17896097,19,"Jose Alvarado",0,0,0,0,0,0
"1408",1409,0,0,0,0,0,0,0,0,0,0,0,0,0,0,0,0,1037772,"2023-11-18T00:00:00.000Z",38017663,19,"E.J. Liddell",0,0,0,0,0,0
"1409",1410,0,0,0,0,0,0,0,0,0,0,0,0,0,0,0,0,1037772,"2023-11-18T00:00:00.000Z",303,19,"CJ McCollum",0,0,0,0,0,0
"1410",1411,0,0,0,0,0,0,0,0,0,0,0,0,0,0,0,0,1037774,"2023-11-18T00:00:00.000Z",112,17,"Jae Crowder",0,0,0,0,0,0
"1411",1412,0,0,0,0,0,0,0,0,0,0,0,0,0,0,0,0,1037774,"2023-11-18T00:00:00.000Z",56677854,17,"Chris Livingston",0,0,0,0,0,0
"1412",1413,0,0,0,0,0,0,0,0,0,0,0,0,0,0,0,0,1037774,"2023-11-18T00:00:00.000Z",315,17,"Khris Middleton",0,0,0,0,0,0
"1413",1414,1,0,6,2,0,7,0,0,0,19,2,1,0,8,0,2,1037774,"2023-11-18T00:00:00.000Z",247,7,"Derrick Jones Jr.",0,8,9,1,9,9.1
"1414",1415,2,1,4,3,1,5,3,0,0,17,1,1,7,5,0,0,1037773,"2023-11-18T00:00:00.000Z",110,5,"Torrey Craig",1,12,14,9,7,19
"1415",1416,1,0,1,9,3,9,3,0,0,14,0,2,9,1,0,0,1037773,"2023-11-18T00:00:00.000Z",87,5,"Jevon Carter",0,10,11,10,2,11.7
"1416",1417,2,0,1,2,0,2,0,2,2,13,0,2,2,1,0,1,1037773,"2023-11-18T00:00:00.000Z",17895983,5,"Ayo Dosunmu",0,3,5,4,3,5.2
"1417",1418,0,1,6,0,0,3,2,2,2,15,3,3,6,9,1,1,1037773,"2023-11-18T00:00:00.000Z",137,5,"Andre Drummond",2,15,15,6,9,21.8
"1418",1419,1,1,1,1,0,5,1,0,0,15,3,2,2,4,1,0,1037773,"2023-11-18T00:00:00.000Z",3547248,5,"Patrick Williams",2,6,7,3,5,14.3
"1419",1420,0,0,0,0,0,0,0,0,0,0,0,0,0,0,0,0,1037773,"2023-11-18T00:00:00.000Z",17896116,5,"Terry Taylor",0,0,0,0,0,0
"1420",1421,0,0,0,0,0,0,0,0,0,0,0,0,0,0,0,0,1037773,"2023-11-18T00:00:00.000Z",38017719,5,"Dalen Terry",0,0,0,0,0,0
"1421",1422,0,0,0,0,0,0,0,0,0,0,0,0,0,0,0,0,1037773,"2023-11-18T00:00:00.000Z",27,5,"Lonzo Ball",0,0,0,0,0,0
"1422",1423,0,0,0,0,0,0,0,0,0,0,0,0,0,0,0,0,1037776,"2023-11-18T00:00:00.000Z",44,21,"Davis Bertans",0,0,0,0,0,0
"1423",1424,0,0,0,0,0,0,0,0,0,0,0,0,0,0,0,0,1037776,"2023-11-18T00:00:00.000Z",17896036,21,"Tre Mann",0,0,0,0,0,0
"1424",1425,0,0,0,0,0,0,0,0,0,0,0,0,0,0,0,0,1037776,"2023-11-18T00:00:00.000Z",3547271,21,"Aleksej Pokusevski",0,0,0,0,0,0
"1425",1426,0,0,3,1,0,2,0,0,0,14,1,3,0,4,0,0,1037808,"2023-11-22T00:00:00.000Z",38017706,21,"Jaylin Williams",0,4,4,0,4,4.8
"1426",1427,1,1,1,0,0,0,0,0,0,5,1,0,0,2,0,0,1037808,"2023-11-22T00:00:00.000Z",27924547,21,"Lindy Waters III",1,2,3,1,3,6.9
"1427",1428,2,0,4,3,3,6,5,2,0,23,1,0,13,5,0,0,1037808,"2023-11-22T00:00:00.000Z",480,21,"Kenrich Williams",0,18,20,15,7,22
"1428",1429,2,0,0,3,0,4,1,0,0,11,0,0,2,0,0,2,1037808,"2023-11-22T00:00:00.000Z",4197029,21,"Vasilije Micic",0,2,4,4,2,3
"1429",1430,1,0,4,0,0,2,2,2,2,11,0,1,6,4,0,1,1037808,"2023-11-22T00:00:00.000Z",17896078,21,"Aaron Wiggins",0,10,11,7,5,11.3
"1430",1431,0,0,0,0,0,0,0,0,0,0,0,0,0,0,0,0,1037808,"2023-11-22T00:00:00.000Z",3547271,21,"Aleksej Pokusevski",0,0,0,0,0,0
"1431",1432,0,0,0,0,0,0,0,0,0,0,0,0,0,0,0,0,1037808,"2023-11-22T00:00:00.000Z",56677853,21,"Keyontae Johnson",0,0,0,0,0,0
"1432",1433,0,0,0,0,0,0,0,0,0,0,0,0,0,0,0,0,1037808,"2023-11-22T00:00:00.000Z",24572055,21,"Olivier Sarr",0,0,0,0,0,0
"1433",1434,0,0,0,0,0,0,0,0,0,0,0,0,0,0,0,0,1037808,"2023-11-22T00:00:00.000Z",38017703,21,"Jalen Williams",0,0,0,0,0,0
"1434",1435,6,1,1,2,0,17,6,13,13,36,1,3,25,2,2,1,1037808,"2023-11-22T00:00:00.000Z",125,5,"DeMar DeRozan",3,27,33,31,8,44.4
"1435",1436,1,0,5,6,2,12,5,0,0,27,1,1,12,6,1,0,1037808,"2023-11-22T00:00:00.000Z",89,5,"Alex Caruso",1,18,19,13,7,23.7
"1436",1437,3,0,7,5,2,13,6,2,2,37,5,4,16,12,2,1,1037808,"2023-11-22T00:00:00.000Z",460,5,"Nikola Vucevic",2,28,31,19,15,39.9
"1437",1438,0,0,3,3,0,3,0,0,0,15,0,4,0,3,0,1,1037808,"2023-11-22T00:00:00.000Z",110,5,"Torrey Craig",0,3,3,0,3,2.6
"1438",1439,2,0,0,6,1,7,1,0,0,19,0,2,3,0,0,0,1037808,"2023-11-22T00:00:00.000Z",87,5,"Jevon Carter",0,3,5,5,2,6
"1439",1440,0,0,0,0,0,0,0,0,0,0,0,0,0,0,0,0,1037800,"2023-11-22T00:00:00.000Z",17896103,8,"Jay Huff",0,0,0,0,0,0
"1440",1441,0,0,0,0,0,0,0,0,0,0,0,0,0,0,0,0,1037800,"2023-11-22T00:00:00.000Z",335,8,"Jamal Murray",0,0,0,0,0,0
"1441",1442,0,0,0,0,0,0,0,0,0,0,0,0,0,0,0,0,1037808,"2023-11-22T00:00:00.000Z",27,5,"Lonzo Ball",0,0,0,0,0,0
"1442",1443,0,0,0,0,0,0,0,0,0,0,0,0,0,0,0,0,1037805,"2023-11-22T00:00:00.000Z",357,11,"Victor Oladipo",0,0,0,0,0,0
"1443",1444,0,0,0,0,0,0,0,0,0,0,0,0,0,0,0,0,1037805,"2023-11-22T00:00:00.000Z",56677809,11,"Jermaine Samuels Jr.",0,0,0,0,0,0
"1444",1445,0,0,0,0,0,0,0,0,0,0,0,0,0,0,0,0,1037805,"2023-11-22T00:00:00.000Z",56677825,11,"Amen Thompson",0,0,0,0,0,0
"1445",1446,0,0,0,0,0,0,0,0,0,0,0,0,0,0,0,0,1037805,"2023-11-22T00:00:00.000Z",56677831,11,"Cam Whitmore",0,0,0,0,0,0
"1446",1447,0,1,2,3,1,5,2,3,3,22,0,5,8,2,0,0,1037805,"2023-11-22T00:00:00.000Z",17896067,15,"Santi Aldama",1,10,10,8,2,13.4
"1447",1448,0,1,6,4,0,21,7,12,9,37,1,4,23,7,1,2,1037805,"2023-11-22T00:00:00.000Z",231,15,"Jaren Jackson Jr.",2,30,30,23,7,35.4
"1448",1449,2,2,5,0,0,4,2,2,1,32,0,0,5,5,1,1,1037805,"2023-11-22T00:00:00.000Z",48,15,"Bismack Biyombo",3,10,12,7,7,22
"1449",1450,4,0,6,6,2,12,6,10,9,26,1,4,23,7,1,2,1037805,"2023-11-22T00:00:00.000Z",3547287,15,"Desmond Bane",1,30,34,27,11,38.4
"1450",1451,3,0,3,5,1,10,5,0,0,33,0,4,11,3,2,2,1037838,"2023-11-27T00:00:00.000Z",69,12,"Bruce Brown",2,14,17,14,6,23.1
"1451",1452,9,0,2,6,3,17,11,9,8,36,0,1,33,2,0,3,1037838,"2023-11-27T00:00:00.000Z",3547245,12,"Tyrese Haliburton",0,35,44,42,11,45.9
"1452",1453,1,1,4,0,0,2,1,0,0,10,1,3,2,5,0,1,1037838,"2023-11-27T00:00:00.000Z",17896035,12,"Isaiah Jackson",1,7,8,3,6,11.5
"1453",1454,2,1,4,2,0,14,8,0,0,28,0,4,16,4,2,1,1037837,"2023-11-27T00:00:00.000Z",56677826,9,"Ausar Thompson",3,20,22,18,6,31.8
"1454",1455,0,0,6,7,1,11,3,0,0,29,2,2,7,8,1,0,1037837,"2023-11-27T00:00:00.000Z",3547267,9,"Isaiah Stewart",1,15,15,7,8,19.6
"1455",1456,3,5,7,0,0,8,5,5,2,33,7,5,12,14,1,6,1037837,"2023-11-27T00:00:00.000Z",38017694,9,"Jalen Duren",6,26,29,15,17,45.3
"1456",1457,7,1,5,3,2,12,6,2,1,33,2,3,15,7,1,3,1037837,"2023-11-27T00:00:00.000Z",38017682,9,"Jaden Ivey",2,22,29,22,14,36.9
"1457",1458,7,0,4,7,2,22,10,4,4,32,1,2,26,5,1,1,1037837,"2023-11-27T00:00:00.000Z",17896075,9,"Cade Cunningham",1,31,38,33,12,44.5
"1458",1459,3,0,1,8,2,11,3,0,0,23,0,1,8,1,1,2,1037837,"2023-11-27T00:00:00.000Z",17896071,9,"Isaiah Livers",1,9,12,11,4,14.7
"1459",1460,3,1,0,5,1,10,3,0,0,22,1,1,7,1,0,1,1037837,"2023-11-27T00:00:00.000Z",56677792,9,"Marcus Sasser",1,8,11,10,4,14.7
"1460",1461,3,3,3,0,0,1,0,0,0,16,1,1,0,4,0,0,1037837,"2023-11-27T00:00:00.000Z",3547241,9,"Killian Hayes",3,4,7,3,7,18.3
"1461",1462,1,0,0,5,0,8,2,4,4,13,0,1,8,0,0,0,1037837,"2023-11-27T00:00:00.000Z",77,9,"Alec Burks",0,8,9,9,1,9.5
"1462",1463,0,0,0,0,0,0,0,0,0,0,0,0,0,0,0,0,1037837,"2023-11-27T00:00:00.000Z",24,9,"Marvin Bagley III",0,0,0,0,0,0
"1463",1464,0,0,0,0,0,0,0,0,0,0,0,0,0,0,0,0,1037837,"2023-11-27T00:00:00.000Z",259,9,"Kevin Knox",0,0,0,0,0,0
"1464",1465,2,0,0,6,3,6,3,0,0,25,0,2,9,0,1,0,1037839,"2023-11-27T00:00:00.000Z",313,23,"De'Anthony Melton",1,9,11,11,2,15
"1465",1466,8,0,3,12,5,20,9,9,8,36,0,2,31,3,1,0,1037839,"2023-11-27T00:00:00.000Z",3547254,23,"Tyrese Maxey",1,34,42,39,11,49.6
"1466",1467,3,0,4,8,4,9,4,0,0,24,2,2,12,6,0,1,1037839,"2023-11-27T00:00:00.000Z",45,23,"Patrick Beverley",0,18,21,15,9,22.7
"1467",1468,2,1,4,2,0,3,0,0,0,18,3,1,0,7,0,0,1037839,"2023-11-27T00:00:00.000Z",108,23,"Robert Covington",1,7,9,2,9,14.4
"1468",1469,0,0,1,5,4,8,6,0,0,20,0,2,16,1,1,0,1037839,"2023-11-27T00:00:00.000Z",328,23,"Marcus Morris",1,17,17,16,1,20.2
"1469",1470,0,0,2,1,1,5,4,0,0,17,1,1,9,3,2,0,1037839,"2023-11-27T00:00:00.000Z",3547270,23,"Paul Reed",2,12,12,9,3,18.6
"1470",1471,0,0,2,1,1,4,3,0,0,6,1,0,7,3,0,0,1037839,"2023-11-27T00:00:00.000Z",28,23,"Mo Bamba",0,10,10,7,3,10.6
"1471",1472,1,0,3,3,0,6,3,0,0,26,0,3,6,3,1,1,1037839,"2023-11-27T00:00:00.000Z",38017697,14,"Max Christie",1,9,10,7,4,13.1
"1472",1473,7,0,2,2,1,10,5,2,1,24,0,0,12,2,0,0,1037839,"2023-11-27T00:00:00.000Z",405,14,"D'Angelo Russell",0,14,21,19,9,24.9
"1473",1474,2,0,2,4,1,10,4,3,3,29,0,2,12,2,0,3,1037839,"2023-11-27T00:00:00.000Z",17553995,14,"Austin Reaves",0,14,16,14,4,14.4
"1474",1475,1,1,0,2,0,6,3,1,1,19,2,3,7,2,0,2,1037839,"2023-11-27T00:00:00.000Z",666626,14,"Jaxson Hayes",1,9,10,8,3,11.9
"1475",1476,0,0,0,0,0,0,0,0,0,0,0,0,0,0,0,0,1037876,"2023-12-02T00:00:00.000Z",3547257,16,"R.J. Hampton",0,0,0,0,0,0
"1476",1477,0,0,0,0,0,0,0,0,0,0,0,0,0,0,0,0,1037876,"2023-12-02T00:00:00.000Z",666633,16,"Tyler Herro",0,0,0,0,0,0
"1477",1478,0,0,0,0,0,0,0,0,0,0,0,0,0,0,0,0,1037876,"2023-12-02T00:00:00.000Z",19465585,16,"Dru Smith",0,0,0,0,0,0
"1478",1479,0,0,0,0,0,0,0,0,0,4,0,2,0,0,0,0,1037876,"2023-12-02T00:00:00.000Z",56677861,12,"Ben Sheppard",0,0,0,0,0,0
"1479",1480,0,0,0,0,0,0,0,0,0,0,0,0,0,0,0,0,1037875,"2023-12-02T00:00:00.000Z",44477024,9,"Stanley Umude",0,0,0,0,0,0
"1480",1481,0,0,1,0,0,1,0,0,0,3,1,0,0,2,0,0,1037875,"2023-12-02T00:00:00.000Z",444,6,"Tristan Thompson",0,2,2,0,2,2.4
"1481",1482,0,0,0,0,0,0,0,0,0,0,0,0,0,0,0,0,1037875,"2023-12-02T00:00:00.000Z",56677847,6,"Emoni Bates",0,0,0,0,0,0
"1482",1483,0,0,0,0,0,0,0,0,0,0,0,0,0,0,0,0,1037876,"2023-12-02T00:00:00.000Z",56677778,12,"Oscar Tshiebwe",0,0,0,0,0,0
"1483",1484,0,0,0,0,0,0,0,0,0,0,0,0,0,0,0,0,1037875,"2023-12-02T00:00:00.000Z",666676,6,"Ty Jerome",0,0,0,0,0,0
"1484",1485,0,0,0,0,0,0,0,0,0,0,0,0,0,0,0,0,1037875,"2023-12-02T00:00:00.000Z",404,6,"Ricky Rubio",0,0,0,0,0,0
"1485",1486,0,0,0,0,0,0,0,0,0,0,0,0,0,0,0,0,1037876,"2023-12-02T00:00:00.000Z",56677832,12,"Jarace Walker",0,0,0,0,0,0
"1486",1487,0,0,0,0,0,0,0,0,0,0,0,0,0,0,0,0,1037876,"2023-12-02T00:00:00.000Z",38017701,12,"Kendall Brown",0,0,0,0,0,0
"1487",1488,0,0,0,0,0,0,0,0,0,0,0,0,0,0,0,0,1037876,"2023-12-02T00:00:00.000Z",3547245,12,"Tyrese Haliburton",0,0,0,0,0,0
"1488",1489,0,0,0,0,0,0,0,0,0,0,0,0,0,0,0,0,1037876,"2023-12-02T00:00:00.000Z",3547264,12,"Jalen Smith",0,0,0,0,0,0
"1489",1490,0,0,0,0,0,0,0,0,0,0,0,0,0,0,0,0,1037876,"2023-12-02T00:00:00.000Z",56677794,12,"Isaiah Wong",0,0,0,0,0,0
"1490",1491,0,0,0,0,0,0,0,0,0,9,1,1,0,1,0,0,1037878,"2023-12-02T00:00:00.000Z",38017733,17,"A.J. Green",0,1,1,0,1,1.2
"1491",1492,0,0,0,0,0,0,0,0,0,0,0,0,0,0,0,0,1037875,"2023-12-02T00:00:00.000Z",666940,6,"Dean Wade",0,0,0,0,0,0
"1492",1493,6,0,7,13,8,17,10,3,3,40,2,4,31,9,1,3,1037877,"2023-12-02T00:00:00.000Z",666956,5,"Coby White",1,40,46,37,15,50.8
"1493",1494,3,0,0,4,1,9,6,2,2,33,0,2,15,0,2,2,1037877,"2023-12-02T00:00:00.000Z",17895983,5,"Ayo Dosunmu",2,15,18,18,3,23.5
"1494",1495,2,1,3,4,3,6,5,2,2,19,3,3,15,6,0,1,1037877,"2023-12-02T00:00:00.000Z",110,5,"Torrey Craig",1,21,23,17,8,27.2
"1495",1496,1,1,5,0,0,7,3,2,1,15,3,2,7,8,0,1,1037877,"2023-12-02T00:00:00.000Z",137,5,"Andre Drummond",1,15,16,8,9,20.1
"1496",1497,2,0,0,1,0,2,1,0,0,15,0,1,2,0,0,1,1037877,"2023-12-02T00:00:00.000Z",87,5,"Jevon Carter",0,2,4,4,2,4
"1497",1498,2,0,1,4,1,7,2,2,2,26,2,3,7,3,1,1,1037877,"2023-12-02T00:00:00.000Z",3547293,19,"Naji Marshall",1,10,12,9,5,15.6
"1498",1499,0,0,1,0,0,4,1,2,2,12,3,2,4,4,0,0,1037877,"2023-12-02T00:00:00.000Z",491,19,"Cody Zeller",0,8,8,4,4,8.8
"1499",1500,0,0,0,0,0,0,0,0,0,1,0,0,0,0,0,0,1037877,"2023-12-02T00:00:00.000Z",17896021,19,"Jeremiah Robinson-Earl",0,0,0,0,0,0
"1500",1501,0,0,0,0,0,0,0,0,0,0,0,0,0,0,0,0,1037884,"2023-12-11T00:00:00.000Z",3547239,4,"LaMelo Ball",0,0,0,0,0,0
"1501",1502,0,0,0,0,0,0,0,0,0,0,0,0,0,0,0,0,1037884,"2023-12-11T00:00:00.000Z",666748,4,"Cody Martin",0,0,0,0,0,0
"1502",1503,0,0,0,0,0,0,0,0,0,0,0,0,0,0,0,0,1037884,"2023-12-11T00:00:00.000Z",347,4,"Frank Ntilikina",0,0,0,0,0,0
"1503",1504,0,0,0,0,0,0,0,0,0,0,0,0,0,0,0,0,1037884,"2023-12-11T00:00:00.000Z",56677846,4,"Nick Smith Jr.",0,0,0,0,0,0
"1504",1505,2,2,3,4,2,8,4,0,0,25,0,4,10,3,1,0,1037894,"2023-12-11T00:00:00.000Z",56677833,21,"Cason Wallace",3,13,15,12,5,25.6
"1505",1506,3,0,2,2,2,10,5,3,3,22,1,1,15,3,0,2,1037894,"2023-12-11T00:00:00.000Z",38017703,21,"Jalen Williams",0,18,21,18,6,21.1
"1506",1507,2,2,6,3,2,9,6,2,2,25,2,2,16,8,1,3,1037894,"2023-12-11T00:00:00.000Z",38017685,21,"Chet Holmgren",3,24,26,18,10,34.6
"1507",1508,8,1,8,3,2,11,5,0,0,24,2,1,12,10,1,3,1037894,"2023-12-11T00:00:00.000Z",17896065,21,"Josh Giddey",2,22,30,20,18,39
"1508",1509,7,0,3,1,0,17,12,6,6,28,1,1,30,4,3,1,1037894,"2023-12-11T00:00:00.000Z",175,21,"Shai Gilgeous-Alexander",3,34,41,37,11,53.3
"1509",1510,1,0,1,1,1,2,2,2,2,10,0,0,7,1,1,1,1037894,"2023-12-11T00:00:00.000Z",38017706,21,"Jaylin Williams",1,8,9,8,2,11.7
"1510",1511,1,1,0,7,3,8,3,0,0,14,0,1,9,0,0,0,1037894,"2023-12-11T00:00:00.000Z",3547272,21,"Isaiah Joe",1,9,10,10,1,13.5
"1511",1512,3,0,3,4,3,7,6,4,3,26,0,2,18,3,0,1,1037894,"2023-12-11T00:00:00.000Z",38017716,21,"Ousmane Dieng",0,21,24,21,6,25.1
"1512",1513,5,0,1,3,0,5,1,0,0,16,0,0,2,1,1,0,1037894,"2023-12-11T00:00:00.000Z",4197029,21,"Vasilije Micic",1,3,8,7,6,13.7
"1513",1514,0,0,0,1,1,4,1,0,0,4,1,0,3,1,0,0,1037894,"2023-12-11T00:00:00.000Z",17896078,21,"Aaron Wiggins",0,4,4,3,1,4.2
"1514",1515,1,0,2,0,0,1,1,0,0,7,0,0,2,2,1,0,1037894,"2023-12-11T00:00:00.000Z",480,21,"Kenrich Williams",1,4,5,3,3,8.9
"1515",1516,0,0,2,1,0,6,2,0,0,13,0,2,4,2,0,1,1037894,"2023-12-11T00:00:00.000Z",17896036,21,"Tre Mann",0,6,6,4,2,5.4
"1516",1517,1,1,0,2,1,2,1,0,0,9,0,1,3,0,0,0,1037894,"2023-12-11T00:00:00.000Z",44,21,"Davis Bertans",1,3,4,4,1,7.5
"1517",1518,0,0,1,2,0,2,0,0,0,9,0,0,0,1,0,0,1037894,"2023-12-11T00:00:00.000Z",3547271,21,"Aleksej Pokusevski",0,1,1,0,1,1.2
"1518",1519,1,0,0,4,1,4,1,0,0,8,0,2,3,0,0,0,1037894,"2023-12-11T00:00:00.000Z",27924547,21,"Lindy Waters III",0,3,4,4,1,4.5
"1519",1520,0,0,0,0,0,0,0,0,0,0,0,0,0,0,0,0,1037894,"2023-12-11T00:00:00.000Z",666541,21,"Luguentz Dort",0,0,0,0,0,0
"1520",1521,0,0,0,0,0,0,0,0,0,0,0,0,0,0,0,0,1037894,"2023-12-11T00:00:00.000Z",56677853,21,"Keyontae Johnson",0,0,0,0,0,0
"1521",1522,0,0,0,0,0,0,0,0,0,0,0,0,0,0,0,0,1037894,"2023-12-11T00:00:00.000Z",24572055,21,"Olivier Sarr",0,0,0,0,0,0
"1522",1523,2,1,1,1,0,4,1,0,0,22,0,1,2,1,3,1,1037894,"2023-12-11T00:00:00.000Z",38017620,29,"Ochai Agbaji",4,3,5,4,3,17.2
"1523",1524,1,4,1,6,3,11,7,2,2,23,1,1,19,2,0,0,1037894,"2023-12-11T00:00:00.000Z",38017739,29,"Simone Fontecchio",4,21,22,20,3,34.9
"1524",1525,3,0,6,2,0,5,1,0,0,21,0,2,2,6,0,2,1037894,"2023-12-11T00:00:00.000Z",358,29,"Kelly Olynyk",0,8,11,5,9,11.7
"1525",1526,2,0,2,6,2,6,2,0,0,25,0,2,6,2,4,1,1037927,"2023-12-16T00:00:00.000Z",313,23,"De'Anthony Melton",4,8,10,8,4,22.4
"1526",1527,7,1,2,8,5,13,8,0,0,33,0,1,21,2,2,0,1037927,"2023-12-16T00:00:00.000Z",3547254,23,"Tyrese Maxey",3,23,30,28,9,42.9
"1527",1528,2,0,0,1,0,1,0,4,3,8,0,1,3,0,0,0,1037927,"2023-12-16T00:00:00.000Z",45,23,"Patrick Beverley",0,3,5,5,2,6
"1528",1529,0,0,0,0,0,0,0,0,0,0,0,0,0,0,0,0,1037928,"2023-12-16T00:00:00.000Z",666581,6,"Darius Garland",0,0,0,0,0,0
"1529",1530,0,0,0,0,0,0,0,0,0,0,0,0,0,0,0,0,1037928,"2023-12-16T00:00:00.000Z",666676,6,"Ty Jerome",0,0,0,0,0,0
"1530",1531,0,0,0,0,0,0,0,0,0,0,0,0,0,0,0,0,1037928,"2023-12-16T00:00:00.000Z",17896076,6,"Evan Mobley",0,0,0,0,0,0
"1531",1532,0,0,0,0,0,0,0,0,0,0,0,0,0,0,0,0,1037928,"2023-12-16T00:00:00.000Z",404,6,"Ricky Rubio",0,0,0,0,0,0
"1532",1533,0,0,2,2,2,7,5,6,6,26,0,1,18,2,1,0,1037928,"2023-12-16T00:00:00.000Z",666656,1,"De'Andre Hunter",1,20,20,18,2,23.4
"1533",1534,0,0,5,7,1,9,1,2,2,36,1,0,5,6,2,2,1037928,"2023-12-16T00:00:00.000Z",3547256,1,"Saddiq Bey",2,11,11,5,6,16.2
"1534",1535,1,1,2,4,2,12,7,0,0,32,2,4,16,4,0,1,1037928,"2023-12-16T00:00:00.000Z",3547244,1,"Onyeka Okongwu",1,20,21,17,5,24.3
"1535",1536,6,1,3,5,0,19,8,6,5,37,0,2,21,3,1,0,1037928,"2023-12-16T00:00:00.000Z",334,1,"Dejounte Murray",2,24,30,27,9,39.6
"1536",1537,2,0,3,2,0,18,9,11,10,35,1,3,28,4,2,2,1037929,"2023-12-16T00:00:00.000Z",79,16,"Jimmy Butler",2,32,34,30,6,39.8
"1537",1538,2,0,2,0,0,8,6,8,5,37,2,4,17,4,2,2,1037929,"2023-12-16T00:00:00.000Z",666747,16,"Caleb Martin",2,21,23,19,6,28.8
"1538",1539,1,0,1,2,0,4,1,0,0,11,1,2,2,2,0,0,1037929,"2023-12-16T00:00:00.000Z",39398582,16,"Orlando Robinson",0,4,5,3,3,5.9
"1539",1540,6,0,1,9,3,9,3,0,0,24,0,0,9,1,0,2,1037929,"2023-12-16T00:00:00.000Z",397,16,"Duncan Robinson",0,10,16,15,7,17.2
"1540",1541,7,1,3,3,1,7,3,4,3,32,0,2,10,3,0,0,1037929,"2023-12-16T00:00:00.000Z",286,16,"Kyle Lowry",1,13,20,17,10,27.1
"1541",1542,4,0,4,3,1,14,8,1,1,35,1,1,18,5,2,2,1037929,"2023-12-16T00:00:00.000Z",56677785,16,"Jaime Jaquez Jr.",2,23,27,22,9,34
"1542",1543,1,0,6,10,6,12,8,0,0,26,1,2,22,7,1,1,1037929,"2023-12-16T00:00:00.000Z",285,16,"Kevin Love",1,29,30,23,8,33.9
"1543",1544,0,0,0,0,0,0,0,0,0,0,0,0,0,0,0,0,1037927,"2023-12-16T00:00:00.000Z",3547239,4,"LaMelo Ball",0,0,0,0,0,0
"1544",1545,0,0,0,0,0,0,0,0,0,0,0,0,0,0,0,0,1037927,"2023-12-16T00:00:00.000Z",204,4,"Gordon Hayward",0,0,0,0,0,0
"1545",1546,0,0,0,0,0,0,0,0,0,0,0,0,0,0,0,0,1037927,"2023-12-16T00:00:00.000Z",666748,4,"Cody Martin",0,0,0,0,0,0
"1546",1547,0,0,0,0,0,0,0,0,0,0,0,0,0,0,0,0,1037927,"2023-12-16T00:00:00.000Z",347,4,"Frank Ntilikina",0,0,0,0,0,0
"1547",1548,0,0,0,0,0,0,0,0,0,0,0,0,0,0,0,0,1037927,"2023-12-16T00:00:00.000Z",666950,4,"P.J. Washington",0,0,0,0,0,0
"1548",1549,0,0,0,0,0,0,0,0,0,0,0,0,0,0,0,0,1037927,"2023-12-16T00:00:00.000Z",56913527,23,"Ricky Council IV",0,0,0,0,0,0
"1549",1550,0,0,0,0,0,0,0,0,0,0,0,0,0,0,0,0,1037927,"2023-12-16T00:00:00.000Z",17554001,23,"Javonte Smart",0,0,0,0,0,0
"1550",1551,0,0,7,0,0,6,5,2,2,25,2,2,12,9,1,1,1037964,"2023-12-20T00:00:00.000Z",493,13,"Ivica Zubac",1,21,21,12,9,24.8
"1551",1552,1,1,3,2,1,8,3,0,0,29,1,3,7,4,0,1,1037964,"2023-12-20T00:00:00.000Z",666743,13,"Terance Mann",1,11,12,8,5,15.3
"1552",1553,11,2,5,8,2,12,4,8,7,39,0,3,17,5,0,4,1037964,"2023-12-20T00:00:00.000Z",192,13,"James Harden",2,22,33,28,16,41.5
"1553",1554,0,0,0,0,0,0,0,0,0,0,0,0,0,0,0,0,1037964,"2023-12-20T00:00:00.000Z",114,7,"Seth Curry",0,0,0,0,0,0
"1554",1555,0,0,0,0,0,0,0,0,0,0,0,0,0,0,0,0,1037964,"2023-12-20T00:00:00.000Z",217,7,"Richaun Holmes",0,0,0,0,0,0
"1555",1556,0,0,0,1,0,1,0,0,0,4,0,1,0,0,0,0,1037968,"2023-12-21T00:00:00.000Z",56677857,5,"Julian Phillips",0,0,0,0,0,0
"1556",1557,3,0,3,2,0,2,0,2,1,18,0,1,1,3,0,0,1037968,"2023-12-21T00:00:00.000Z",38017719,5,"Dalen Terry",0,4,7,4,6,9.1
"1557",1558,0,0,0,0,0,0,0,0,0,2,0,1,0,0,0,1,1037968,"2023-12-21T00:00:00.000Z",17896116,5,"Terry Taylor",0,0,0,0,0,-1
"1558",1559,0,0,0,0,0,0,0,0,0,0,0,0,0,0,0,0,1037968,"2023-12-21T00:00:00.000Z",27,5,"Lonzo Ball",0,0,0,0,0,0
"1559",1560,0,0,0,0,0,0,0,0,0,0,0,0,0,0,0,0,1037968,"2023-12-21T00:00:00.000Z",56677874,5,"Onuralp Bitim",0,0,0,0,0,0
"1560",1562,0,0,0,0,0,0,0,0,0,0,0,0,0,0,0,0,1037968,"2023-12-21T00:00:00.000Z",268,5,"Zach LaVine",0,0,0,0,0,0
"1561",1563,0,0,0,0,0,0,0,0,0,0,0,0,0,0,0,0,1037968,"2023-12-21T00:00:00.000Z",56677860,5,"Adama Sanogo",0,0,0,0,0,0
"1562",1564,2,0,4,2,0,13,5,3,1,32,2,3,11,6,0,3,1037968,"2023-12-21T00:00:00.000Z",666682,27,"Keldon Johnson",0,17,19,13,8,18.2
"1563",1565,5,3,5,1,0,8,3,3,1,22,0,0,7,5,2,2,1037968,"2023-12-21T00:00:00.000Z",56677822,27,"Victor Wembanyama",5,12,17,12,10,33.5
"1564",1566,2,0,3,8,3,15,7,4,4,31,1,0,21,4,1,1,1037968,"2023-12-21T00:00:00.000Z",3547246,27,"Devin Vassell",1,25,27,23,6,30.8
"1565",1567,3,0,1,8,6,16,9,6,5,27,2,4,29,3,3,3,1037965,"2023-12-20T00:00:00.000Z",161,26,"De'Aaron Fox",3,32,35,32,6,43.1
"1566",1568,5,0,2,4,0,10,3,4,4,25,0,1,10,2,0,1,1037965,"2023-12-20T00:00:00.000Z",324,26,"Malik Monk",0,12,17,15,7,18.9
"1567",1569,4,2,2,7,4,7,4,0,0,19,0,1,12,2,1,0,1037965,"2023-12-20T00:00:00.000Z",38017714,26,"Keon Ellis",3,14,18,16,6,29.4
"1568",1570,3,1,4,6,3,7,4,0,0,27,1,1,11,5,0,0,1037965,"2023-12-20T00:00:00.000Z",290,26,"Trey Lyles",1,16,19,14,8,24.5
"1569",1571,0,0,1,3,1,4,1,0,0,13,2,0,3,3,0,0,1037965,"2023-12-20T00:00:00.000Z",4197162,26,"Aleksandar Vezenkov",0,6,6,3,3,6.6
"1570",1572,0,0,2,2,1,5,3,0,0,6,0,0,7,2,0,0,1037965,"2023-12-20T00:00:00.000Z",17896044,26,"Kessler Edwards",0,9,9,7,2,9.4
"1571",1573,0,0,1,1,0,2,0,0,0,5,0,0,0,1,0,0,1037965,"2023-12-20T00:00:00.000Z",17896030,26,"Chris Duarte",0,1,1,0,1,1.2
"1572",1574,2,0,6,4,1,11,6,0,0,29,0,1,13,6,0,3,1037968,"2023-12-21T00:00:00.000Z",38017692,27,"Malaki Branham",0,19,21,15,8,20.2
"1573",1575,1,0,2,9,5,13,5,0,0,23,0,3,15,2,1,0,1037964,"2023-12-20T00:00:00.000Z",38017679,7,"Jaden Hardy",1,17,18,16,3,21.9
"1574",1576,2,0,1,1,0,9,6,2,2,24,3,3,14,4,0,1,1038009,"2023-12-27T00:00:00.000Z",56677843,3,"Noah Clowney",0,18,20,16,6,20.8
"1575",1577,0,0,0,0,0,0,0,0,0,0,0,0,0,0,0,0,1038008,"2023-12-27T00:00:00.000Z",56677805,28,"Javon Freeman-Liberty",0,0,0,0,0,0
"1576",1578,0,0,0,0,0,0,0,0,0,0,0,0,0,0,0,0,1038008,"2023-12-27T00:00:00.000Z",38017710,28,"Christian Koloko",0,0,0,0,0,0
"1577",1579,0,0,0,0,0,0,0,0,0,0,0,0,0,0,0,0,1038008,"2023-12-27T00:00:00.000Z",56677869,28,"Markquis Nowell",0,0,0,0,0,0
"1578",1580,0,0,0,0,0,0,0,0,0,0,0,0,0,0,0,0,1038008,"2023-12-27T00:00:00.000Z",2309958,28,"Jontay Porter",0,0,0,0,0,0
"1579",1581,0,0,0,0,0,0,0,0,0,0,0,0,0,0,0,0,1038008,"2023-12-27T00:00:00.000Z",436,28,"Garrett Temple",0,0,0,0,0,0
"1580",1582,2,0,3,3,0,13,5,11,11,30,7,4,21,10,0,1,1038009,"2023-12-27T00:00:00.000Z",56677722,3,"Jalen Wilson",0,31,33,23,12,35
"1581",1583,3,0,4,3,0,5,1,0,0,21,0,0,2,4,0,0,1038009,"2023-12-27T00:00:00.000Z",56677841,3,"Dariq Whitehead",0,6,9,5,7,11.3
"1582",1584,0,0,0,0,0,0,0,0,0,0,0,0,0,0,0,0,1038009,"2023-12-27T00:00:00.000Z",666508,3,"Nicolas Claxton",0,0,0,0,0,0
"1583",1585,0,0,0,0,0,0,0,0,0,0,0,0,0,0,0,0,1038009,"2023-12-27T00:00:00.000Z",130,3,"Spencer Dinwiddie",0,0,0,0,0,0
"1584",1586,0,0,0,0,0,0,0,0,0,0,0,0,0,0,0,0,1038009,"2023-12-27T00:00:00.000Z",158,3,"Dorian Finney-Smith",0,0,0,0,0,0
"1585",1587,0,0,0,0,0,0,0,0,0,0,0,0,0,0,0,0,1038009,"2023-12-27T00:00:00.000Z",666679,3,"Cameron Johnson",0,0,0,0,0,0
"1586",1588,0,0,0,0,0,0,0,0,0,0,0,0,0,0,0,0,1038009,"2023-12-27T00:00:00.000Z",417,3,"Ben Simmons",0,0,0,0,0,0
"1587",1589,0,0,0,0,0,0,0,0,0,0,0,0,0,0,0,0,1038009,"2023-12-27T00:00:00.000Z",464,3,"Lonnie Walker IV",0,0,0,0,0,0
"1588",1590,1,0,2,1,0,3,0,2,2,16,0,2,2,2,0,1,1038007,"2023-12-27T00:00:00.000Z",462,22,"Moritz Wagner",0,4,5,3,3,4.9
"1589",1591,0,0,0,0,0,0,0,0,0,0,0,0,0,0,0,0,1038007,"2023-12-27T00:00:00.000Z",165,22,"Markelle Fultz",0,0,0,0,0,0
"1590",1592,0,0,0,0,0,0,0,0,0,0,0,0,0,0,0,0,1038007,"2023-12-27T00:00:00.000Z",196,22,"Gary Harris",0,0,0,0,0,0
"1591",1593,0,0,0,0,0,0,0,0,0,0,0,0,0,0,0,0,1038007,"2023-12-27T00:00:00.000Z",38017607,22,"Kevon Harris",0,0,0,0,0,0
"1592",1594,0,0,0,0,0,0,0,0,0,0,0,0,0,0,0,0,1038007,"2023-12-27T00:00:00.000Z",226,22,"Joe Ingles",0,0,0,0,0,0
"1593",1595,0,0,0,0,0,0,0,0,0,0,0,0,0,0,0,0,1038007,"2023-12-27T00:00:00.000Z",229,22,"Jonathan Isaac",0,0,0,0,0,0
"1594",1596,1,2,3,4,1,7,1,2,1,29,1,1,4,4,2,1,1038007,"2023-12-27T00:00:00.000Z",360,23,"Kelly Oubre Jr.",4,8,9,5,5,21.3
"1595",1597,2,0,6,5,1,23,10,1,1,33,1,0,22,7,1,0,1038007,"2023-12-27T00:00:00.000Z",200,23,"Tobias Harris",1,29,31,24,9,36.4
"1596",1598,2,2,4,6,0,7,1,0,0,25,2,3,2,6,0,0,1038009,"2023-12-27T00:00:00.000Z",283,17,"Brook Lopez",2,8,10,4,8,18.2
"1597",1599,1,0,0,8,5,9,6,0,0,22,1,0,17,1,1,0,1038009,"2023-12-27T00:00:00.000Z",38,17,"Malik Beasley",1,18,19,18,2,22.7
"1598",1600,4,0,3,9,3,10,4,1,1,29,0,0,12,3,0,4,1038009,"2023-12-27T00:00:00.000Z",278,17,"Damian Lillard",0,15,19,16,7,17.6
"1599",1601,5,1,2,0,0,9,5,0,0,26,1,3,10,3,0,4,1038053,"2024-01-02T00:00:00.000Z",666969,19,"Zion Williamson",1,13,18,15,8,20.1
"1600",1602,0,1,9,1,1,5,5,0,0,20,3,0,11,12,1,1,1038053,"2024-01-02T00:00:00.000Z",455,19,"Jonas Valanciunas",2,23,23,11,12,30.4
"1601",1603,1,1,2,4,2,10,5,2,2,24,2,1,14,4,2,3,1038053,"2024-01-02T00:00:00.000Z",17896024,19,"Herbert Jones",3,18,19,15,5,26.3
"1602",1604,5,0,4,8,4,11,6,0,0,24,2,0,16,6,0,2,1038053,"2024-01-02T00:00:00.000Z",303,19,"CJ McCollum",0,22,27,21,11,28.7
"1603",1605,1,1,1,2,0,6,2,2,2,16,1,0,6,2,1,0,1038053,"2024-01-02T00:00:00.000Z",3547293,19,"Naji Marshall",2,8,9,7,3,15.9
"1604",1606,2,0,2,6,3,9,4,3,2,22,1,2,13,3,2,1,1038053,"2024-01-02T00:00:00.000Z",17896097,19,"Jose Alvarado",2,16,18,15,5,24.6
"1605",1607,0,0,6,2,1,4,2,2,1,20,2,2,6,8,2,1,1038053,"2024-01-02T00:00:00.000Z",340,19,"Larry Nance Jr.",2,14,14,6,8,20.6
"1606",1608,1,2,0,8,2,13,3,4,3,26,0,0,11,0,0,0,1038053,"2024-01-02T00:00:00.000Z",56677837,19,"Jordan Hawkins",2,11,12,12,1,18.5
"1607",1609,3,2,1,4,1,5,2,2,2,20,1,0,7,2,2,1,1038053,"2024-01-02T00:00:00.000Z",38017677,19,"Dyson Daniels",4,9,12,10,5,24.9
"1608",1610,0,0,1,0,0,3,1,3,2,8,1,2,4,2,0,0,1038053,"2024-01-02T00:00:00.000Z",491,19,"Cody Zeller",0,6,6,4,2,6.4
"1609",1611,1,2,2,2,1,6,4,4,3,28,0,1,12,2,0,1,1038052,"2024-01-02T00:00:00.000Z",38017699,27,"Jeremy Sochan",2,14,15,13,3,20.9
"1610",1612,1,4,7,5,2,16,8,4,2,26,0,0,20,7,0,1,1038052,"2024-01-02T00:00:00.000Z",56677822,27,"Victor Wembanyama",4,27,28,21,8,40.9
"1611",1613,2,0,1,1,0,3,1,0,0,13,3,4,2,4,0,0,1038054,"2024-01-02T00:00:00.000Z",480,21,"Kenrich Williams",0,6,8,4,6,9.8
"1612",1614,3,0,0,2,1,3,2,0,0,17,1,3,5,1,1,0,1038054,"2024-01-02T00:00:00.000Z",56677833,21,"Cason Wallace",1,6,9,8,4,13.7
"1613",1615,1,0,1,1,0,3,1,2,2,13,0,1,4,1,1,0,1038054,"2024-01-02T00:00:00.000Z",17896078,21,"Aaron Wiggins",1,5,6,5,2,9.7
"1614",1616,5,0,1,4,1,5,1,0,0,11,0,2,3,1,0,0,1038054,"2024-01-02T00:00:00.000Z",4197029,21,"Vasilije Micic",0,4,9,8,6,11.7
"1615",1617,1,1,2,3,1,4,2,0,0,8,0,0,5,2,0,0,1038054,"2024-01-02T00:00:00.000Z",38017706,21,"Jaylin Williams",1,7,8,6,3,11.9
"1616",1618,0,0,0,0,0,0,0,0,0,0,0,0,0,0,0,0,1038053,"2024-01-02T00:00:00.000Z",17896017,19,"Matt Ryan",0,0,0,0,0,0
"1617",1619,0,0,0,0,0,0,0,0,0,0,0,0,0,0,0,0,1038053,"2024-01-02T00:00:00.000Z",38017726,19,"Dereon Seabron",0,0,0,0,0,0
"1618",1620,2,0,4,9,5,12,6,0,0,27,0,2,17,4,1,1,1038053,"2024-01-02T00:00:00.000Z",666679,3,"Cameron Johnson",1,21,23,19,6,26.8
"1619",1621,1,0,3,4,1,6,1,0,0,20,1,1,3,4,2,0,1038053,"2024-01-02T00:00:00.000Z",158,3,"Dorian Finney-Smith",2,7,8,4,5,15.3
"1620",1622,1,2,3,0,0,7,4,0,0,23,0,1,8,3,0,0,1038053,"2024-01-02T00:00:00.000Z",666508,3,"Nicolas Claxton",2,11,12,9,4,19.1
"1621",1623,2,0,1,5,2,11,4,3,3,29,2,0,13,3,0,4,1038053,"2024-01-02T00:00:00.000Z",61,3,"Mikal Bridges",0,16,18,15,5,15.6
"1622",1624,5,0,0,4,0,6,0,0,0,21,0,1,0,0,0,1,1038053,"2024-01-02T00:00:00.000Z",130,3,"Spencer Dinwiddie",0,0,5,5,5,6.5
"1623",1625,5,0,4,5,0,6,0,0,0,28,4,3,0,8,1,3,1038053,"2024-01-02T00:00:00.000Z",351,3,"Royce O'Neale",1,8,13,5,13,17.1
"1624",1626,0,0,0,0,0,0,0,0,0,0,0,0,0,0,0,0,1038091,"2024-01-07T00:00:00.000Z",229,22,"Jonathan Isaac",0,0,0,0,0,0
"1625",1627,0,0,0,0,0,0,0,0,0,0,0,0,0,0,0,0,1038091,"2024-01-07T00:00:00.000Z",17896026,22,"Franz Wagner",0,0,0,0,0,0
"1626",1628,2,0,6,4,2,10,5,5,4,38,1,1,16,7,1,0,1038091,"2024-01-07T00:00:00.000Z",3547256,1,"Saddiq Bey",1,23,25,18,9,30.4
"1627",1629,4,1,10,4,0,12,6,0,0,40,1,6,12,11,0,3,1038091,"2024-01-07T00:00:00.000Z",17896040,1,"Jalen Johnson",1,23,27,16,15,31.2
"1628",1630,0,2,8,0,0,6,2,2,0,36,4,3,4,12,3,1,1038091,"2024-01-07T00:00:00.000Z",83,1,"Clint Capela",5,16,16,4,12,32.4
"1629",1631,0,0,0,0,0,0,0,0,0,0,0,0,0,0,0,0,1038091,"2024-01-07T00:00:00.000Z",56677838,1,"Kobe Bufkin",0,0,0,0,0,0
"1630",1632,0,0,0,0,0,0,0,0,0,0,0,0,0,0,0,0,1038091,"2024-01-07T00:00:00.000Z",56677806,1,"Mouhamed Gueye",0,0,0,0,0,0
"1631",1633,0,0,0,0,0,0,0,0,0,0,0,0,0,0,0,0,1038091,"2024-01-07T00:00:00.000Z",666656,1,"De'Andre Hunter",0,0,0,0,0,0
"1632",1634,0,0,0,0,0,0,0,0,0,0,0,0,0,0,0,0,1038091,"2024-01-07T00:00:00.000Z",4197387,1,"Vit Krejci",0,0,0,0,0,0
"1633",1635,0,0,0,2,0,2,0,0,0,10,0,1,0,0,1,0,1038092,"2024-01-07T00:00:00.000Z",17553994,26,"Davion Mitchell",1,0,0,0,0,3
"1634",1636,0,0,1,5,1,9,5,0,0,21,1,0,11,2,0,0,1038092,"2024-01-07T00:00:00.000Z",4197162,26,"Aleksandar Vezenkov",0,13,13,11,2,13.4
"1635",1637,0,0,1,2,2,4,3,2,2,8,1,0,10,2,0,0,1038092,"2024-01-07T00:00:00.000Z",17896044,26,"Kessler Edwards",0,12,12,10,2,12.4
"1636",1638,1,0,1,0,0,1,0,0,0,6,0,0,0,1,0,1,1038092,"2024-01-07T00:00:00.000Z",306,26,"JaVale McGee",0,1,2,1,2,1.7
"1637",1639,1,0,0,3,3,6,5,0,0,12,2,1,13,2,1,0,1038092,"2024-01-07T00:00:00.000Z",38017714,26,"Keon Ellis",1,15,16,14,3,19.9
"1638",1640,4,0,1,2,0,5,2,0,0,10,0,1,4,1,1,0,1038092,"2024-01-07T00:00:00.000Z",56677845,26,"Colby Jones",1,5,9,8,5,14.2
"1639",1641,3,0,0,0,0,2,0,0,0,10,1,1,0,1,1,0,1038092,"2024-01-07T00:00:00.000Z",273,26,"Alex Len",1,1,4,3,4,8.7
"1640",1642,0,0,0,0,0,0,0,0,0,0,0,0,0,0,0,0,1038092,"2024-01-07T00:00:00.000Z",17895990,26,"Jordan Ford",0,0,0,0,0,0
"1641",1643,2,0,6,2,0,20,9,10,6,40,0,2,24,6,0,3,1038091,"2024-01-07T00:00:00.000Z",334,1,"Dejounte Murray",0,30,32,26,8,31.2
"1642",1644,9,1,4,9,2,23,11,10,7,42,0,2,31,4,1,5,1038091,"2024-01-07T00:00:00.000Z",490,1,"Trae Young",2,35,44,40,13,50.3
"1643",1645,1,0,2,9,4,17,7,0,0,26,1,5,18,3,4,0,1038091,"2024-01-07T00:00:00.000Z",53,1,"Bogdan Bogdanovic",4,21,22,19,4,35.1
"1644",1646,3,5,5,2,1,3,2,2,0,32,1,3,5,6,0,0,1038091,"2024-01-07T00:00:00.000Z",3547244,1,"Onyeka Okongwu",5,11,14,8,9,31.7
"1645",1647,0,0,0,0,0,0,0,0,0,2,0,0,0,0,0,0,1038091,"2024-01-07T00:00:00.000Z",666754,1,"Garrison Mathews",0,0,0,0,0,0
"1646",1648,0,1,1,0,0,0,0,0,0,9,0,1,0,1,0,0,1038091,"2024-01-07T00:00:00.000Z",301,1,"Wesley Matthews",1,1,1,0,1,4.2
"1647",1649,0,0,0,0,0,0,0,0,0,0,0,0,0,0,0,0,1038091,"2024-01-07T00:00:00.000Z",666564,1,"Bruno Fernando",0,0,0,0,0,0
"1648",1650,2,1,3,5,1,9,5,2,1,24,0,2,12,3,0,2,1038092,"2024-01-07T00:00:00.000Z",56677837,19,"Jordan Hawkins",1,15,17,14,5,19.6
"1649",1651,0,0,3,7,2,12,3,0,0,21,1,2,8,4,0,0,1037598,"2023-10-25T00:00:00.000Z",17896073,22,"Jalen Suggs",0,12,12,8,4,12.8
"1650",1652,2,0,1,0,0,9,5,0,0,24,3,0,10,4,3,1,1037598,"2023-10-25T00:00:00.000Z",165,22,"Markelle Fultz",3,14,16,12,6,25.8
"1651",1653,2,0,7,2,1,12,8,3,3,24,1,2,20,8,0,0,1037598,"2023-10-25T00:00:00.000Z",3547251,22,"Cole Anthony",0,28,30,22,10,32.6
"1652",1654,0,0,5,2,2,6,5,1,1,13,3,4,13,8,1,0,1037596,"2023-10-25T00:00:00.000Z",3547264,12,"Jalen Smith",1,21,21,13,8,25.6
"1653",1655,0,0,3,1,0,5,0,0,0,6,1,1,0,4,1,0,1037596,"2023-10-25T00:00:00.000Z",56677832,12,"Jarace Walker",1,4,4,0,4,7.8
"1654",1656,1,1,0,2,1,7,2,0,0,6,1,0,5,1,0,0,1037596,"2023-10-25T00:00:00.000Z",3547207,12,"Jordan Nwora",1,6,7,6,2,10.7
"1655",1657,0,0,0,0,0,1,0,0,0,6,0,0,0,0,0,0,1037596,"2023-10-25T00:00:00.000Z",56677861,12,"Ben Sheppard",0,0,0,0,0,0
"1656",1658,0,0,0,0,0,0,0,0,0,0,0,0,0,0,0,0,1037596,"2023-10-25T00:00:00.000Z",439,12,"Daniel Theis",0,0,0,0,0,0
"1657",1659,0,0,0,0,0,0,0,0,0,0,0,0,0,0,0,0,1037596,"2023-10-25T00:00:00.000Z",38017701,12,"Kendall Brown",0,0,0,0,0,0
"1658",1660,7,1,5,1,0,8,4,3,2,33,3,1,10,8,1,6,1037595,"2023-10-25T00:00:00.000Z",204,4,"Gordon Hayward",2,18,25,17,15,30.1
"1659",1661,2,0,4,6,1,18,12,0,0,32,1,4,25,5,0,1,1037595,"2023-10-25T00:00:00.000Z",666950,4,"P.J. Washington",0,30,32,27,7,33
"1660",1662,1,1,11,0,0,6,5,3,3,30,4,2,13,15,3,2,1037595,"2023-10-25T00:00:00.000Z",38017698,4,"Mark Williams",4,28,29,14,16,42.5
"1661",1663,6,0,4,7,2,16,7,12,8,34,1,2,24,5,0,3,1037595,"2023-10-25T00:00:00.000Z",403,4,"Terry Rozier",0,29,35,30,11,36
"1662",1664,10,0,5,11,4,15,4,4,3,31,1,3,15,6,1,3,1037595,"2023-10-25T00:00:00.000Z",3547239,4,"LaMelo Ball",1,21,31,25,16,37.2
"1663",1665,2,0,3,7,3,9,5,0,0,25,0,3,13,3,0,1,1037595,"2023-10-25T00:00:00.000Z",56677823,4,"Brandon Miller",0,16,18,15,5,18.6
"1664",1666,0,0,0,0,0,0,0,0,0,0,0,0,0,0,0,0,1037596,"2023-10-25T00:00:00.000Z",56677778,12,"Oscar Tshiebwe",0,0,0,0,0,0
"1665",1667,0,0,0,0,0,0,0,0,0,0,0,0,0,0,0,0,1037596,"2023-10-25T00:00:00.000Z",56677794,12,"Isaiah Wong",0,0,0,0,0,0
"1666",1668,0,2,1,4,1,18,9,6,6,25,1,0,25,2,0,0,1037596,"2023-10-25T00:00:00.000Z",265,30,"Kyle Kuzma",2,27,27,25,2,33.4
"1667",1669,5,0,5,0,0,8,4,2,1,21,2,0,9,7,1,2,1037596,"2023-10-25T00:00:00.000Z",3547242,30,"Deni Avdija",1,16,21,14,12,25.9
"1668",1670,0,2,4,0,0,2,2,4,2,21,1,5,6,5,0,0,1037596,"2023-10-25T00:00:00.000Z",666577,30,"Daniel Gafford",2,11,11,6,5,18
"1669",1671,5,1,2,6,0,18,7,5,4,26,0,1,18,2,1,4,1037596,"2023-10-25T00:00:00.000Z",666848,30,"Jordan Poole",2,20,25,23,7,29.9
"1670",1672,6,1,2,4,2,12,7,1,0,28,1,1,16,3,1,2,1037596,"2023-10-25T00:00:00.000Z",249,30,"Tyus Jones",2,19,25,22,9,32.6
"1671",1673,0,0,0,0,0,1,0,0,0,3,0,0,0,0,0,0,1037596,"2023-10-25T00:00:00.000Z",38017704,30,"Patrick Baldwin Jr.",0,0,0,0,0,0
"1672",1674,5,0,4,3,0,3,0,0,0,18,0,3,0,4,0,1,1037598,"2023-10-25T00:00:00.000Z",226,22,"Joe Ingles",0,4,9,5,9,11.3
"1673",1675,0,1,3,4,1,8,5,0,0,17,3,0,11,6,0,0,1037598,"2023-10-25T00:00:00.000Z",196,22,"Gary Harris",1,17,17,11,6,21.2
"1674",1676,0,0,2,0,0,2,2,3,2,13,1,0,6,3,2,0,1037642,"2023-10-30T00:00:00.000Z",3547268,8,"Zeke Nnaji",2,9,9,6,3,15.6
"1675",1677,0,0,2,2,0,4,2,0,0,6,0,0,4,2,0,0,1037642,"2023-10-30T00:00:00.000Z",56677776,8,"Julian Strawther",0,6,6,4,2,6.4
"1676",1678,0,0,0,0,0,0,0,0,0,0,0,0,0,0,0,0,1037642,"2023-10-30T00:00:00.000Z",38017727,8,"Collin Gillespie",0,0,0,0,0,0
"1677",1679,1,0,2,0,0,3,1,4,3,10,0,2,5,2,0,0,1037635,"2023-10-30T00:00:00.000Z",3547302,30,"Anthony Gill",0,7,8,6,3,8.9
"1678",1680,3,0,0,0,0,2,0,8,7,12,1,1,7,1,4,1,1037635,"2023-10-30T00:00:00.000Z",38017712,30,"Ryan Rollins",4,8,11,10,4,23.7
"1679",1681,1,1,3,1,1,5,5,4,3,12,3,0,14,6,1,0,1037635,"2023-10-30T00:00:00.000Z",17896106,30,"Eugene Omoruyi",2,20,21,15,7,28.7
"1680",1682,0,0,0,0,0,0,0,0,0,0,0,0,0,0,0,0,1037635,"2023-10-30T00:00:00.000Z",337,30,"Mike Muscala",0,0,0,0,0,0
"1681",1683,0,0,0,0,0,0,0,0,0,0,0,0,0,0,0,0,1037635,"2023-10-30T00:00:00.000Z",38124126,30,"John Butler Jr.",0,0,0,0,0,0
"1682",1684,0,0,0,0,0,0,0,0,0,0,0,0,0,0,0,0,1037642,"2023-10-30T00:00:00.000Z",215,8,"Justin Holiday",0,0,0,0,0,0
"1683",1685,0,0,0,0,0,0,0,0,0,0,0,0,0,0,0,0,1037642,"2023-10-30T00:00:00.000Z",250,8,"DeAndre Jordan",0,0,0,0,0,0
"1684",1686,0,0,0,0,0,0,0,0,0,0,0,0,0,0,0,0,1037642,"2023-10-30T00:00:00.000Z",56677582,8,"Jalen Pickett",0,0,0,0,0,0
"1685",1687,0,0,0,0,0,0,0,0,0,0,0,0,0,0,0,0,1037642,"2023-10-30T00:00:00.000Z",56677871,8,"Hunter Tyson",0,0,0,0,0,0
"1686",1688,0,0,0,0,0,0,0,0,0,0,0,0,0,0,0,0,1037642,"2023-10-30T00:00:00.000Z",56677842,29,"Brice Sensabaugh",0,0,0,0,0,0
"1687",1689,3,2,4,4,1,4,1,2,2,27,0,6,5,4,0,0,1037634,"2023-10-30T00:00:00.000Z",3547250,12,"Aaron Nesmith",2,9,12,8,7,20.3
"1688",1690,0,1,2,2,0,7,4,0,0,16,0,3,8,2,1,1,1037634,"2023-10-30T00:00:00.000Z",3547264,12,"Jalen Smith",2,10,10,8,2,15.4
"1689",1691,4,0,2,8,3,12,4,0,0,19,3,0,11,5,0,2,1037634,"2023-10-30T00:00:00.000Z",210,12,"Buddy Hield",0,16,20,15,9,21
"1690",1692,0,0,0,0,0,0,0,0,0,0,0,0,0,0,0,0,1037634,"2023-10-30T00:00:00.000Z",17896035,12,"Isaiah Jackson",0,0,0,0,0,0
"1691",1693,0,0,0,0,0,0,0,0,0,0,0,0,0,0,0,0,1037634,"2023-10-30T00:00:00.000Z",304,12,"T.J. McConnell",0,0,0,0,0,0
"1692",1694,0,0,0,0,0,0,0,0,0,0,0,0,0,0,0,0,1037634,"2023-10-30T00:00:00.000Z",3547207,12,"Jordan Nwora",0,0,0,0,0,0
"1693",1695,1,0,0,2,0,2,0,0,0,6,0,0,0,0,0,1,1037635,"2023-10-30T00:00:00.000Z",18677954,30,"Jared Butler",0,0,1,1,1,0.5
"1694",1696,2,1,6,2,0,10,7,2,2,19,2,3,16,8,2,0,1037639,"2023-10-30T00:00:00.000Z",377,17,"Bobby Portis",3,24,26,18,10,37.6
"1695",1697,2,0,0,3,0,4,0,0,0,15,0,3,0,0,0,0,1037639,"2023-10-30T00:00:00.000Z",38017733,17,"A.J. Green",0,0,2,2,2,3
"1696",1698,0,0,0,4,3,5,4,0,0,13,1,0,11,1,0,1,1037639,"2023-10-30T00:00:00.000Z",368,17,"Cameron Payne",0,12,12,11,1,11.2
"1697",1699,0,0,0,0,0,0,0,0,0,0,0,0,0,0,0,0,1037639,"2023-10-30T00:00:00.000Z",2148,17,"Thanasis Antetokounmpo",0,0,0,0,0,0
"1698",1700,0,0,0,0,0,0,0,0,0,0,0,0,0,0,0,0,1037639,"2023-10-30T00:00:00.000Z",56677852,17,"Andre Jackson Jr.",0,0,0,0,0,0
"1699",1701,0,0,0,0,0,0,0,0,0,0,0,0,0,0,0,0,1037680,"2023-11-05T00:00:00.000Z",38017693,27,"Blake Wesley",0,0,0,0,0,0
"1700",1702,0,0,0,0,0,0,0,0,0,0,0,0,0,0,0,0,1037680,"2023-11-05T00:00:00.000Z",56677865,27,"Charles Bediako",0,0,0,0,0,0
"1701",1703,0,0,0,0,0,0,0,0,0,0,0,0,0,0,0,0,1037680,"2023-11-05T00:00:00.000Z",56677870,27,"Sir'Jabari Rice",0,0,0,0,0,0
"1702",1704,0,0,0,0,0,0,0,0,0,0,0,0,0,0,0,0,1037680,"2023-11-05T00:00:00.000Z",3547246,27,"Devin Vassell",0,0,0,0,0,0
"1703",1705,4,0,5,13,7,16,8,4,1,38,2,3,24,7,1,1,1037680,"2023-11-05T00:00:00.000Z",18,28,"OG Anunoby",1,31,35,28,11,40.4
"1704",1706,5,0,6,4,1,12,2,3,3,36,0,3,8,6,1,3,1037680,"2023-11-05T00:00:00.000Z",416,28,"Pascal Siakam",1,14,19,13,11,22.7
"1705",1707,0,1,7,0,0,10,8,2,0,29,3,2,16,10,3,1,1037680,"2023-11-05T00:00:00.000Z",373,28,"Jakob Poeltl",4,26,26,16,10,39
"1706",1708,6,3,7,10,5,20,9,11,7,42,4,1,30,11,3,3,1037680,"2023-11-05T00:00:00.000Z",17896055,28,"Scottie Barnes",6,41,47,36,17,67.2
"1707",1709,6,1,1,8,1,19,10,4,3,38,2,1,24,3,2,2,1037680,"2023-11-05T00:00:00.000Z",409,28,"Dennis Schroder",3,27,33,30,9,43.6
"1708",1710,0,0,0,4,2,8,4,0,0,29,0,1,10,0,1,2,1037680,"2023-11-05T00:00:00.000Z",3089,28,"Gary Trent Jr.",1,10,10,10,0,11
"1709",1711,4,0,2,2,0,2,0,0,0,14,1,1,0,3,0,1,1037680,"2023-11-05T00:00:00.000Z",56677828,28,"Gradey Dick",0,3,7,4,7,8.6
"1710",1712,4,1,2,2,1,3,1,2,2,15,1,1,5,3,0,0,1037680,"2023-11-05T00:00:00.000Z",3547275,28,"Malachi Flynn",1,8,12,9,7,17.6
"1711",1713,0,0,1,1,0,3,0,0,0,5,0,0,0,1,0,1,1037680,"2023-11-05T00:00:00.000Z",666762,28,"Jalen McDaniels",0,1,1,0,1,0.2
"1712",1714,0,1,4,4,2,4,2,0,0,19,0,2,6,4,0,0,1037680,"2023-11-05T00:00:00.000Z",376,28,"Otto Porter Jr.",1,10,10,6,4,13.8
"1713",1715,0,0,0,0,0,0,0,0,0,0,0,0,0,0,0,0,1037680,"2023-11-05T00:00:00.000Z",58,28,"Chris Boucher",0,0,0,0,0,0
"1714",1716,0,0,0,0,0,0,0,0,0,0,0,0,0,0,0,0,1037680,"2023-11-05T00:00:00.000Z",436,28,"Garrett Temple",0,0,0,0,0,0
"1715",1717,0,0,0,0,0,0,0,0,0,0,0,0,0,0,0,0,1037680,"2023-11-05T00:00:00.000Z",489,28,"Thaddeus Young",0,0,0,0,0,0
"1716",1718,0,0,0,0,0,0,0,0,0,0,0,0,0,0,0,0,1037680,"2023-11-05T00:00:00.000Z",3547249,28,"Precious Achiuwa",0,0,0,0,0,0
"1717",1719,0,0,0,0,0,0,0,0,0,0,0,0,0,0,0,0,1037680,"2023-11-05T00:00:00.000Z",56677805,28,"Javon Freeman-Liberty",0,0,0,0,0,0
"1718",1720,0,0,0,0,0,0,0,0,0,0,0,0,0,0,0,0,1037680,"2023-11-05T00:00:00.000Z",38017717,28,"Ron Harper Jr.",0,0,0,0,0,0
"1719",1721,0,0,0,0,0,0,0,0,0,0,0,0,0,0,0,0,1037680,"2023-11-05T00:00:00.000Z",38017710,28,"Christian Koloko",0,0,0,0,0,0
"1720",1722,0,0,0,0,0,0,0,0,0,0,0,0,0,0,0,0,1037680,"2023-11-05T00:00:00.000Z",56677869,28,"Markquis Nowell",0,0,0,0,0,0
"1721",1723,4,0,4,10,3,13,6,0,0,36,0,3,15,4,1,0,1037681,"2023-11-05T00:00:00.000Z",666908,6,"Max Strus",1,19,23,19,8,28.8
"1722",1724,2,1,11,1,0,10,6,4,1,29,5,4,13,16,0,5,1037681,"2023-11-05T00:00:00.000Z",17896076,6,"Evan Mobley",1,29,31,15,18,33.2
"1723",1725,3,0,4,0,0,7,5,2,2,28,5,1,12,9,0,2,1037681,"2023-11-05T00:00:00.000Z",9,6,"Jarrett Allen",0,21,24,15,12,25.3
"1724",1726,0,0,0,0,0,0,0,0,0,4,0,0,0,0,0,0,1037721,"2023-11-11T00:00:00.000Z",56677854,17,"Chris Livingston",0,0,0,0,0,0
"1725",1727,0,0,0,0,0,0,0,0,0,0,0,0,0,0,0,0,1037721,"2023-11-11T00:00:00.000Z",284,17,"Robin Lopez",0,0,0,0,0,0
"1726",1728,0,0,0,0,0,0,0,0,0,0,0,0,0,0,0,0,1037721,"2023-11-11T00:00:00.000Z",666960,17,"Lindell Wigginton",0,0,0,0,0,0
"1727",1729,0,0,0,0,0,0,0,0,0,0,0,0,0,0,0,0,1037721,"2023-11-11T00:00:00.000Z",666453,17,"Marques Bolden",0,0,0,0,0,0
"1728",1730,0,0,0,0,0,0,0,0,0,0,0,0,0,0,0,0,1037721,"2023-11-11T00:00:00.000Z",278,17,"Damian Lillard",0,0,0,0,0,0
"1729",1731,0,0,0,0,0,0,0,0,0,0,0,0,0,0,0,0,1037721,"2023-11-11T00:00:00.000Z",38017691,17,"TyTy Washington Jr.",0,0,0,0,0,0
"1730",1732,7,2,3,2,0,9,4,0,0,30,0,2,8,3,1,4,1037722,"2023-11-11T00:00:00.000Z",214,2,"Jrue Holiday",3,11,18,15,10,27.1
"1731",1733,0,0,4,6,4,6,4,0,0,18,0,2,12,4,0,0,1037722,"2023-11-11T00:00:00.000Z",17896060,2,"Sam Hauser",0,16,16,12,4,16.8
"1732",1734,0,0,0,1,0,1,0,0,0,6,0,0,0,0,0,0,1037722,"2023-11-11T00:00:00.000Z",17896094,2,"Dalano Banton",0,0,0,0,0,0
"1733",1735,0,0,0,0,0,0,0,0,0,5,0,0,0,0,0,0,1037722,"2023-11-11T00:00:00.000Z",666468,2,"Oshae Brissett",0,0,0,0,0,0
"1734",1736,2,1,5,4,0,11,4,2,2,36,0,4,10,5,1,3,1037723,"2023-11-11T00:00:00.000Z",666656,1,"De'Andre Hunter",2,15,17,12,7,22
"1735",1737,5,0,5,2,0,5,1,0,0,18,0,1,2,5,0,0,1037722,"2023-11-11T00:00:00.000Z",3547249,28,"Precious Achiuwa",0,7,12,7,10,15.5
"1736",1738,2,0,4,3,1,8,4,0,0,22,0,2,9,4,0,3,1037723,"2023-11-11T00:00:00.000Z",17896040,1,"Jalen Johnson",0,13,15,11,6,13.8
"1737",1739,0,2,5,0,0,6,4,0,0,24,7,3,8,12,1,0,1037723,"2023-11-11T00:00:00.000Z",83,1,"Clint Capela",3,20,20,8,12,31.4
"1738",1740,5,1,5,9,5,16,9,1,0,36,0,1,23,5,3,3,1037723,"2023-11-11T00:00:00.000Z",334,1,"Dejounte Murray",4,28,33,28,10,45.5
"1739",1741,11,0,2,9,3,19,7,11,10,38,0,0,27,2,1,5,1037723,"2023-11-11T00:00:00.000Z",490,1,"Trae Young",1,29,40,38,13,43.9
"1740",1742,1,0,3,12,5,13,5,0,0,29,0,4,15,3,0,2,1037723,"2023-11-11T00:00:00.000Z",53,1,"Bogdan Bogdanovic",0,18,19,16,4,18.1
"1741",1743,0,0,5,7,2,9,3,0,0,24,3,0,8,8,0,4,1037723,"2023-11-11T00:00:00.000Z",3547256,1,"Saddiq Bey",0,16,16,8,8,13.6
"1742",1744,2,2,3,0,0,3,0,2,2,24,4,2,2,7,0,0,1037723,"2023-11-11T00:00:00.000Z",3547244,1,"Onyeka Okongwu",2,9,11,4,9,19.4
"1743",1745,0,0,1,2,2,2,2,2,1,7,1,3,7,2,0,1,1037723,"2023-11-11T00:00:00.000Z",301,1,"Wesley Matthews",0,9,9,7,2,8.4
"1744",1746,0,0,0,0,0,0,0,0,0,0,0,0,0,0,0,0,1037723,"2023-11-11T00:00:00.000Z",666564,1,"Bruno Fernando",0,0,0,0,0,0
"1745",1747,0,0,0,0,0,0,0,0,0,0,0,0,0,0,0,0,1037723,"2023-11-11T00:00:00.000Z",3547297,1,"Trent Forrest",0,0,0,0,0,0
"1746",1748,0,0,0,0,0,0,0,0,0,0,0,0,0,0,0,0,1037723,"2023-11-11T00:00:00.000Z",38017689,1,"AJ Griffin",0,0,0,0,0,0
"1747",1749,0,0,0,0,0,0,0,0,0,0,0,0,0,0,0,0,1037723,"2023-11-11T00:00:00.000Z",666754,1,"Garrison Mathews",0,0,0,0,0,0
"1748",1750,0,0,0,0,0,0,0,0,0,0,0,0,0,0,0,0,1037723,"2023-11-11T00:00:00.000Z",319,1,"Patty Mills",0,0,0,0,0,0
"1749",1751,0,0,0,0,0,0,0,0,0,0,0,0,0,0,0,0,3277445,"2023-11-17T00:00:00.000Z",666960,17,"Lindell Wigginton",0,0,0,0,0,0
"1750",1752,0,0,0,0,0,0,0,0,0,0,0,0,0,0,0,0,3277445,"2023-11-17T00:00:00.000Z",38017676,17,"MarJon Beauchamp",0,0,0,0,0,0
"1751",1753,0,0,0,0,0,0,0,0,0,0,0,0,0,0,0,0,3277445,"2023-11-17T00:00:00.000Z",112,17,"Jae Crowder",0,0,0,0,0,0
"1752",1754,0,0,0,0,0,0,0,0,0,0,0,0,0,0,0,0,3277445,"2023-11-17T00:00:00.000Z",56677854,17,"Chris Livingston",0,0,0,0,0,0
"1753",1755,6,1,3,6,2,13,5,3,2,32,0,2,14,3,0,1,3277449,"2023-11-17T00:00:00.000Z",17896055,28,"Scottie Barnes",1,17,23,20,9,28.6
"1754",1756,5,0,5,1,0,16,11,1,1,29,1,5,23,6,0,3,3277449,"2023-11-17T00:00:00.000Z",416,28,"Pascal Siakam",0,29,34,28,11,34.7
"1755",1757,4,0,6,0,0,5,5,2,1,34,2,0,11,8,1,3,3277449,"2023-11-17T00:00:00.000Z",373,28,"Jakob Poeltl",1,19,23,15,12,26.6
"1756",1758,1,0,2,5,3,9,4,4,3,31,0,0,14,2,1,0,3277449,"2023-11-17T00:00:00.000Z",3089,28,"Gary Trent Jr.",1,16,17,15,3,20.9
"1757",1759,6,0,7,11,5,19,9,0,0,35,0,2,23,7,0,2,3277449,"2023-11-17T00:00:00.000Z",409,28,"Dennis Schroder",0,30,36,29,13,38.4
"1758",1760,1,0,9,2,0,4,2,2,1,25,0,1,5,9,2,1,3277449,"2023-11-17T00:00:00.000Z",3547249,28,"Precious Achiuwa",2,14,15,6,10,22.3
"1759",1761,0,0,0,0,0,0,0,0,0,0,0,0,0,0,0,0,3277449,"2023-11-17T00:00:00.000Z",18,28,"OG Anunoby",0,0,0,0,0,0
"1760",1762,0,0,1,0,0,2,1,0,0,7,0,0,2,1,0,0,3277445,"2023-11-17T00:00:00.000Z",3547282,4,"Nick Richards",0,3,3,2,1,3.2
"1761",1763,0,1,1,1,0,6,1,0,0,9,1,1,2,2,0,1,3277445,"2023-11-17T00:00:00.000Z",56677846,4,"Nick Smith Jr.",1,4,4,2,2,6.4
"1762",1764,0,0,1,0,0,1,1,0,0,5,0,1,2,1,0,0,3277445,"2023-11-17T00:00:00.000Z",18678001,4,"JT Thor",0,3,3,2,1,3.2
"1763",1765,0,0,0,0,0,0,0,0,0,0,0,0,0,0,0,0,3277445,"2023-11-17T00:00:00.000Z",56677848,4,"Amari Bailey",0,0,0,0,0,0
"1764",1766,0,0,0,0,0,0,0,0,0,0,0,0,0,0,0,0,3277446,"2023-11-17T00:00:00.000Z",666423,20,"RJ Barrett",0,0,0,0,0,0
"1765",1767,0,0,0,0,0,0,0,0,0,0,0,0,0,0,0,0,3277446,"2023-11-17T00:00:00.000Z",666474,20,"Charles Brown",0,0,0,0,0,0
"1766",1768,0,0,0,0,0,0,0,0,0,0,0,0,0,0,0,0,3277446,"2023-11-17T00:00:00.000Z",17895858,20,"Quentin Grimes",0,0,0,0,0,0
"1767",1769,0,0,0,0,0,0,0,0,0,0,0,0,0,0,0,0,3277446,"2023-11-17T00:00:00.000Z",56677795,20,"Jacob Toppin",0,0,0,0,0,0
"1768",1770,0,0,0,0,0,0,0,0,0,0,0,0,0,0,0,0,3277449,"2023-11-17T00:00:00.000Z",489,28,"Thaddeus Young",0,0,0,0,0,0
"1769",1771,4,1,3,5,3,14,9,3,2,36,0,2,23,3,1,3,3277449,"2023-11-17T00:00:00.000Z",70,2,"Jaylen Brown",2,26,30,27,7,35.6
"1770",1772,2,0,6,11,1,22,8,0,0,37,1,3,17,7,1,3,3277449,"2023-11-17T00:00:00.000Z",434,2,"Jayson Tatum",1,24,26,19,9,28.4
"1771",1773,5,3,10,3,0,13,6,2,2,35,2,3,14,12,1,2,3277449,"2023-11-17T00:00:00.000Z",378,2,"Kristaps Porzingis",4,26,31,19,17,45.9
"1772",1774,5,0,4,8,3,10,4,2,2,34,0,1,13,4,0,1,3277449,"2023-11-17T00:00:00.000Z",473,2,"Derrick White",0,17,22,18,9,24.3
"1773",1775,5,0,6,4,2,14,5,2,2,35,2,2,14,8,0,1,3277449,"2023-11-17T00:00:00.000Z",214,2,"Jrue Holiday",0,22,27,19,13,30.1
"1774",1776,0,0,0,0,0,0,0,0,0,0,0,0,0,0,0,0,1037801,"2023-11-22T00:00:00.000Z",56677843,3,"Noah Clowney",0,0,0,0,0,0
"1775",1777,0,0,0,0,0,0,0,0,0,0,0,0,0,0,0,0,1037801,"2023-11-22T00:00:00.000Z",17896041,3,"Keon Johnson",0,0,0,0,0,0
"1776",1778,0,0,0,0,0,0,0,0,0,0,0,0,0,0,0,0,1037801,"2023-11-22T00:00:00.000Z",417,3,"Ben Simmons",0,0,0,0,0,0
"1777",1779,0,0,0,0,0,0,0,0,0,0,0,0,0,0,0,0,1037801,"2023-11-22T00:00:00.000Z",17896048,3,"Cam Thomas",0,0,0,0,0,0
"1778",1780,0,0,0,0,0,0,0,0,0,0,0,0,0,0,0,0,1037801,"2023-11-22T00:00:00.000Z",56677841,3,"Dariq Whitehead",0,0,0,0,0,0
"1779",1781,0,0,0,0,0,0,0,0,0,0,0,0,0,0,0,0,1037801,"2023-11-22T00:00:00.000Z",56677722,3,"Jalen Wilson",0,0,0,0,0,0
"1780",1782,0,0,1,1,0,1,0,2,1,2,0,0,1,1,0,1,1037806,"2023-11-22T00:00:00.000Z",17896056,18,"Luka Garza",0,2,2,1,1,1.2
"1781",1783,0,0,0,0,0,0,0,0,0,0,0,0,0,0,0,0,1037806,"2023-11-22T00:00:00.000Z",56677851,18,"Jaylen Clark",0,0,0,0,0,0
"1782",1784,0,0,3,1,0,2,0,0,0,14,1,3,0,4,0,0,1037808,"2023-11-22T00:00:00.000Z",38017706,21,"Jaylin Williams",0,4,4,0,4,4.8
"1783",1785,1,1,1,0,0,0,0,0,0,5,1,0,0,2,0,0,1037808,"2023-11-22T00:00:00.000Z",27924547,21,"Lindy Waters III",1,2,3,1,3,6.9
"1784",1786,2,0,4,3,3,6,5,2,0,23,1,0,13,5,0,0,1037808,"2023-11-22T00:00:00.000Z",480,21,"Kenrich Williams",0,18,20,15,7,22
"1785",1787,2,0,0,3,0,4,1,0,0,11,0,0,2,0,0,2,1037808,"2023-11-22T00:00:00.000Z",4197029,21,"Vasilije Micic",0,2,4,4,2,3
"1786",1788,1,0,4,0,0,2,2,2,2,11,0,1,6,4,0,1,1037808,"2023-11-22T00:00:00.000Z",17896078,21,"Aaron Wiggins",0,10,11,7,5,11.3
"1787",1789,0,0,0,0,0,0,0,0,0,0,0,0,0,0,0,0,1037808,"2023-11-22T00:00:00.000Z",3547271,21,"Aleksej Pokusevski",0,0,0,0,0,0
"1788",1790,0,0,0,0,0,0,0,0,0,0,0,0,0,0,0,0,1037808,"2023-11-22T00:00:00.000Z",56677853,21,"Keyontae Johnson",0,0,0,0,0,0
"1789",1791,0,0,0,0,0,0,0,0,0,0,0,0,0,0,0,0,1037808,"2023-11-22T00:00:00.000Z",24572055,21,"Olivier Sarr",0,0,0,0,0,0
"1790",1792,0,0,0,0,0,0,0,0,0,0,0,0,0,0,0,0,1037808,"2023-11-22T00:00:00.000Z",38017703,21,"Jalen Williams",0,0,0,0,0,0
"1791",1793,6,1,1,2,0,17,6,13,13,36,1,3,25,2,2,1,1037808,"2023-11-22T00:00:00.000Z",125,5,"DeMar DeRozan",3,27,33,31,8,44.4
"1792",1794,1,0,5,6,2,12,5,0,0,27,1,1,12,6,1,0,1037808,"2023-11-22T00:00:00.000Z",89,5,"Alex Caruso",1,18,19,13,7,23.7
"1793",1795,3,0,7,5,2,13,6,2,2,37,5,4,16,12,2,1,1037808,"2023-11-22T00:00:00.000Z",460,5,"Nikola Vucevic",2,28,31,19,15,39.9
"1794",1796,0,0,3,3,0,3,0,0,0,15,0,4,0,3,0,1,1037808,"2023-11-22T00:00:00.000Z",110,5,"Torrey Craig",0,3,3,0,3,2.6
"1795",1797,2,0,0,6,1,7,1,0,0,19,0,2,3,0,0,0,1037808,"2023-11-22T00:00:00.000Z",87,5,"Jevon Carter",0,3,5,5,2,6
"1796",1798,0,0,0,0,0,0,0,0,0,0,0,0,0,0,0,0,1037800,"2023-11-22T00:00:00.000Z",17896103,8,"Jay Huff",0,0,0,0,0,0
"1797",1799,0,0,0,0,0,0,0,0,0,0,0,0,0,0,0,0,1037800,"2023-11-22T00:00:00.000Z",335,8,"Jamal Murray",0,0,0,0,0,0
"1798",1800,0,0,0,0,0,0,0,0,0,0,0,0,0,0,0,0,1037808,"2023-11-22T00:00:00.000Z",27,5,"Lonzo Ball",0,0,0,0,0,0
"1799",1801,2,2,6,4,3,9,6,0,0,25,1,2,15,7,0,1,3277532,"2023-11-28T00:00:00.000Z",667378,18,"Naz Reid",2,22,24,17,9,31.4
"1800",1802,0,0,3,4,3,6,5,6,4,21,0,2,17,3,0,1,3277532,"2023-11-28T00:00:00.000Z",68,18,"Troy Brown Jr.",0,20,20,17,3,19.6
"1801",1803,0,0,0,0,0,0,0,0,0,0,0,0,0,0,0,0,3277532,"2023-11-28T00:00:00.000Z",56677782,18,"Leonard Miller",0,0,0,0,0,0
"1802",1804,0,0,0,0,0,0,0,0,0,0,0,0,0,0,0,0,3277532,"2023-11-28T00:00:00.000Z",38017715,18,"Josh Minott",0,0,0,0,0,0
"1803",1805,0,0,0,0,0,0,0,0,0,0,0,0,0,0,0,0,3277532,"2023-11-28T00:00:00.000Z",38017700,18,"Wendell Moore Jr.",0,0,0,0,0,0
"1804",1806,0,0,0,0,0,0,0,0,0,0,0,0,0,0,0,0,3277532,"2023-11-28T00:00:00.000Z",17895968,18,"Daishen Nix",0,0,0,0,0,0
"1805",1807,0,0,0,0,0,0,0,0,0,0,0,0,0,0,0,0,3277532,"2023-11-28T00:00:00.000Z",56677851,18,"Jaylen Clark",0,0,0,0,0,0
"1806",1808,0,0,0,0,0,0,0,0,0,0,0,0,0,0,0,0,3277532,"2023-11-28T00:00:00.000Z",17896056,18,"Luka Garza",0,0,0,0,0,0
"1807",1809,0,0,0,0,0,0,0,0,0,0,0,0,0,0,0,0,3277532,"2023-11-28T00:00:00.000Z",3547259,18,"Jaden McDaniels",0,0,0,0,0,0
"1808",1810,0,0,0,0,0,0,0,0,0,0,0,0,0,0,0,0,3277532,"2023-11-28T00:00:00.000Z",666767,18,"Jordan McLaughlin",0,0,0,0,0,0
"1809",1811,1,0,3,2,1,5,1,0,0,25,0,5,3,3,0,1,3277532,"2023-11-28T00:00:00.000Z",666541,21,"Luguentz Dort",0,6,7,4,4,7.1
"1810",1812,3,1,3,3,0,10,2,7,6,34,0,4,10,3,0,1,3277532,"2023-11-28T00:00:00.000Z",38017703,21,"Jalen Williams",1,13,16,13,6,20.1
"1811",1813,6,1,6,8,3,20,6,2,1,34,2,2,16,8,1,0,3277532,"2023-11-28T00:00:00.000Z",38017685,21,"Chet Holmgren",2,24,30,22,14,40.6
"1812",1814,1,0,3,1,0,8,4,4,2,28,3,1,10,6,0,2,3277532,"2023-11-28T00:00:00.000Z",17896065,21,"Josh Giddey",0,16,17,11,7,16.7
"1813",1815,4,2,3,1,0,22,13,6,6,34,1,2,32,4,3,3,3277532,"2023-11-28T00:00:00.000Z",175,21,"Shai Gilgeous-Alexander",5,36,40,36,8,54.8
"1814",1816,3,0,1,5,1,7,3,2,2,24,0,2,9,1,3,0,3277532,"2023-11-28T00:00:00.000Z",3547272,21,"Isaiah Joe",3,10,13,12,4,23.7
"1815",1817,3,0,4,3,1,6,1,0,0,11,1,1,3,5,0,1,3277532,"2023-11-28T00:00:00.000Z",38017706,21,"Jaylin Williams",0,8,11,6,8,12.5
"1816",1818,0,0,1,0,0,1,0,0,0,2,0,0,0,1,0,0,3277532,"2023-11-28T00:00:00.000Z",38017716,21,"Ousmane Dieng",0,1,1,0,1,1.2
"1817",1819,0,0,0,3,3,4,3,2,1,17,0,0,10,0,1,0,3277532,"2023-11-28T00:00:00.000Z",56677833,21,"Cason Wallace",1,10,10,10,0,13
"1818",1820,0,0,1,2,0,3,1,0,0,15,1,4,2,2,0,0,3277532,"2023-11-28T00:00:00.000Z",480,21,"Kenrich Williams",0,4,4,2,2,4.4
"1819",1821,1,0,2,2,2,4,3,0,0,16,1,2,8,3,0,0,3277532,"2023-11-28T00:00:00.000Z",17896078,21,"Aaron Wiggins",0,11,12,9,4,13.1
"1820",1822,0,0,0,0,0,0,0,0,0,0,0,0,0,0,0,0,3277532,"2023-11-28T00:00:00.000Z",44,21,"Davis Bertans",0,0,0,0,0,0
"1821",1823,0,0,0,0,0,0,0,0,0,0,0,0,0,0,0,0,3277532,"2023-11-28T00:00:00.000Z",17896036,21,"Tre Mann",0,0,0,0,0,0
"1822",1824,0,0,0,0,0,0,0,0,0,0,0,0,0,0,0,0,3277532,"2023-11-28T00:00:00.000Z",4197029,21,"Vasilije Micic",0,0,0,0,0,0
"1823",1825,0,0,0,0,0,0,0,0,0,0,0,0,0,0,0,0,3277532,"2023-11-28T00:00:00.000Z",24572055,21,"Olivier Sarr",0,0,0,0,0,0
"1824",1826,0,0,0,0,0,0,0,0,0,0,0,0,0,0,0,0,7049323,"2023-12-06T00:00:00.000Z",17896051,13,"Joshua Primo",0,0,0,0,0,0
"1825",1827,0,1,6,5,4,8,7,0,0,34,3,2,18,9,0,2,7049323,"2023-12-06T00:00:00.000Z",375,8,"Michael Porter Jr.",1,27,27,18,9,29.8
"1826",1828,2,0,4,0,0,8,4,0,0,31,1,2,8,5,2,0,7049323,"2023-12-06T00:00:00.000Z",177,8,"Aaron Gordon",2,13,15,10,7,23
"1827",1829,10,0,10,7,2,32,9,2,2,37,5,2,22,15,1,4,7049323,"2023-12-06T00:00:00.000Z",246,8,"Nikola Jokic",1,37,47,32,25,54
"1828",1830,0,1,2,4,1,10,5,1,1,26,2,2,12,4,1,1,7049322,"2023-12-06T00:00:00.000Z",17553992,10,"Moses Moody",2,16,16,12,4,21.8
"1829",1831,0,0,4,3,2,7,4,4,3,20,2,3,13,6,0,4,7049322,"2023-12-06T00:00:00.000Z",407,10,"Dario Saric",0,19,19,13,6,16.2
"1830",1832,1,0,4,1,1,3,1,2,0,21,1,2,3,5,0,1,7049322,"2023-12-06T00:00:00.000Z",56677858,10,"Brandin Podziemski",0,8,9,4,6,9.5
"1831",1833,6,0,2,2,0,4,1,0,0,21,1,2,2,3,0,2,7049322,"2023-12-06T00:00:00.000Z",367,10,"Chris Paul",0,5,11,8,9,12.6
"1832",1834,1,0,1,0,0,6,6,2,1,17,0,2,13,1,2,0,7049322,"2023-12-06T00:00:00.000Z",17553979,10,"Jonathan Kuminga",2,14,15,14,2,21.7
"1833",1835,0,0,0,0,0,0,0,0,0,0,0,0,0,0,0,0,7049322,"2023-12-06T00:00:00.000Z",2189,10,"Gary Payton II",0,0,0,0,0,0
"1834",1836,0,0,0,0,0,0,0,0,0,0,0,0,0,0,0,0,7049322,"2023-12-06T00:00:00.000Z",17896070,10,"Usman Garuba",0,0,0,0,0,0
"1835",1837,3,0,1,4,3,10,4,4,3,19,0,1,14,1,1,2,7049323,"2023-12-06T00:00:00.000Z",236,8,"Reggie Jackson",1,15,18,17,4,20.7
"1836",1838,3,1,3,2,0,3,0,2,2,16,0,1,2,3,1,1,7049323,"2023-12-06T00:00:00.000Z",38017721,8,"Peyton Watson",2,5,8,5,6,15.1
"1837",1839,2,0,1,2,0,2,0,0,0,13,0,4,0,1,0,1,7049323,"2023-12-06T00:00:00.000Z",56677776,8,"Julian Strawther",0,1,3,2,3,3.2
"1838",1840,0,1,2,0,0,6,2,0,0,11,3,0,4,5,0,0,7049323,"2023-12-06T00:00:00.000Z",250,8,"DeAndre Jordan",1,9,9,4,5,13
"1839",1841,0,0,0,0,0,0,0,0,0,0,0,0,0,0,0,0,7049323,"2023-12-06T00:00:00.000Z",17896007,8,"Braxton Key",0,0,0,0,0,0
"1840",1842,0,0,0,0,0,0,0,0,0,0,0,0,0,0,0,0,7049323,"2023-12-06T00:00:00.000Z",3547268,8,"Zeke Nnaji",0,0,0,0,0,0
"1841",1843,0,0,0,0,0,0,0,0,0,0,0,0,0,0,0,0,7049323,"2023-12-06T00:00:00.000Z",666489,8,"Vlatko Cancar",0,0,0,0,0,0
"1842",1844,0,0,0,0,0,0,0,0,0,0,0,0,0,0,0,0,7049323,"2023-12-06T00:00:00.000Z",17896103,8,"Jay Huff",0,0,0,0,0,0
"1843",1845,0,0,0,0,0,0,0,0,0,0,0,0,0,0,0,0,7049323,"2023-12-06T00:00:00.000Z",56677582,8,"Jalen Pickett",0,0,0,0,0,0
"1844",1846,0,0,0,0,0,0,0,0,0,0,0,0,0,0,0,0,7049323,"2023-12-06T00:00:00.000Z",56677871,8,"Hunter Tyson",0,0,0,0,0,0
"1845",1847,0,0,0,0,0,0,0,0,0,0,0,0,0,0,0,0,7049322,"2023-12-06T00:00:00.000Z",476,25,"Robert Williams III",0,0,0,0,0,0
"1846",1848,0,0,0,0,0,0,0,0,0,0,0,0,0,0,0,0,7049322,"2023-12-06T00:00:00.000Z",45658838,10,"Lester Quinones",0,0,0,0,0,0
"1847",1849,0,0,0,0,0,0,0,0,0,0,0,0,0,0,0,0,7049322,"2023-12-06T00:00:00.000Z",398,10,"Jerome Robinson",0,0,0,0,0,0
"1848",1850,0,0,0,0,0,0,0,0,0,0,0,0,0,0,0,0,7049322,"2023-12-06T00:00:00.000Z",57875092,10,"Gui Santos",0,0,0,0,0,0
"1849",1851,0,0,0,0,0,0,0,0,0,0,0,0,0,0,0,0,1037917,"2023-12-14T00:00:00.000Z",45658838,10,"Lester Quinones",0,0,0,0,0,0
"1850",1852,0,0,0,0,0,0,0,0,0,0,0,0,0,0,0,0,1037917,"2023-12-14T00:00:00.000Z",398,10,"Jerome Robinson",0,0,0,0,0,0
"1851",1853,0,0,0,0,0,0,0,0,0,0,0,0,0,0,0,0,1037917,"2023-12-14T00:00:00.000Z",57875092,10,"Gui Santos",0,0,0,0,0,0
"1852",1854,4,7,8,1,0,6,5,0,0,27,2,0,10,10,1,1,1037915,"2023-12-14T00:00:00.000Z",38017705,29,"Walker Kessler",8,20,24,14,14,51
"1853",1855,4,0,1,5,2,17,11,3,3,32,1,2,27,2,1,2,1037915,"2023-12-14T00:00:00.000Z",413,29,"Collin Sexton",1,29,33,31,6,36.4
"1854",1856,4,0,1,6,0,19,9,6,5,30,1,2,23,2,4,3,1037915,"2023-12-14T00:00:00.000Z",666650,29,"Talen Horton-Tucker",4,25,29,27,6,40.4
"1855",1857,4,0,5,0,0,9,2,2,2,25,1,0,6,6,0,1,1037920,"2023-12-15T00:00:00.000Z",3547242,30,"Deni Avdija",0,12,16,10,10,18.2
"1856",1858,4,0,5,9,4,23,11,8,5,30,0,3,31,5,1,3,1037920,"2023-12-15T00:00:00.000Z",265,30,"Kyle Kuzma",1,36,40,35,9,43
"1857",1859,4,3,5,0,0,6,3,4,3,28,5,4,9,10,0,2,1037920,"2023-12-15T00:00:00.000Z",666577,30,"Daniel Gafford",3,19,23,13,14,34
"1858",1860,8,0,4,4,3,18,12,4,3,32,0,4,30,4,1,2,1037920,"2023-12-15T00:00:00.000Z",666848,30,"Jordan Poole",1,34,42,38,12,47.8
"1859",1861,11,2,10,2,1,7,6,0,0,29,0,2,13,10,2,2,1037920,"2023-12-15T00:00:00.000Z",249,30,"Tyus Jones",4,23,34,24,21,51.5
"1860",1862,1,0,0,0,0,1,1,0,0,3,0,0,2,0,0,1,1037920,"2023-12-15T00:00:00.000Z",18677954,30,"Jared Butler",0,2,3,3,1,2.5
"1861",1863,0,0,1,0,0,2,1,0,0,3,0,0,2,1,0,1,1037920,"2023-12-15T00:00:00.000Z",38017704,30,"Patrick Baldwin Jr.",0,3,3,2,1,2.2
"1862",1864,4,0,3,1,0,4,2,0,0,22,2,0,4,5,2,0,1037919,"2023-12-15T00:00:00.000Z",33,23,"Nicolas Batum",2,9,13,8,9,22
"1863",1865,2,1,5,3,1,8,4,4,4,23,2,3,13,7,3,2,1037919,"2023-12-15T00:00:00.000Z",200,23,"Tobias Harris",4,20,22,15,9,34.4
"1864",1866,2,4,13,3,2,19,9,16,15,29,0,2,35,13,2,4,1037919,"2023-12-15T00:00:00.000Z",145,23,"Joel Embiid",6,48,50,37,15,67.6
"1865",1867,1,1,1,3,0,6,1,2,2,23,2,4,4,3,1,0,1037919,"2023-12-15T00:00:00.000Z",313,23,"De'Anthony Melton",2,7,8,5,4,15.1
"1866",1868,4,0,1,6,1,16,7,5,4,27,0,1,19,1,2,1,1037919,"2023-12-15T00:00:00.000Z",3547254,23,"Tyrese Maxey",2,20,24,23,5,31.2
"1867",1869,0,0,0,0,0,1,0,2,1,12,0,0,1,0,3,0,1037919,"2023-12-15T00:00:00.000Z",45,23,"Patrick Beverley",3,1,1,1,0,10
"1868",1870,0,0,2,1,0,2,0,0,0,13,1,0,0,3,1,1,1037919,"2023-12-15T00:00:00.000Z",108,23,"Robert Covington",1,3,3,0,3,5.6
"1869",1871,2,0,1,3,1,5,1,0,0,12,3,2,3,4,0,0,1037919,"2023-12-15T00:00:00.000Z",2175,23,"Danuel House Jr.",0,7,9,5,6,10.8
"1870",1872,0,1,3,1,1,2,1,0,0,9,1,2,3,4,0,0,1037919,"2023-12-15T00:00:00.000Z",28,23,"Mo Bamba",1,7,7,3,4,10.8
"1871",1873,4,1,3,4,1,10,4,0,0,34,0,2,9,3,1,1,1037918,"2023-12-15T00:00:00.000Z",204,4,"Gordon Hayward",2,12,16,13,7,23.6
"1872",1874,2,0,8,8,2,24,10,6,5,39,2,5,27,10,1,3,1037918,"2023-12-15T00:00:00.000Z",62,4,"Miles Bridges",1,37,39,29,12,42
"1873",1875,1,1,5,0,0,7,7,2,2,30,1,5,16,6,0,0,1037918,"2023-12-15T00:00:00.000Z",3547282,4,"Nick Richards",1,22,23,17,7,27.7
"1874",1876,0,0,0,0,0,0,0,0,0,0,0,0,0,0,0,0,1037964,"2023-12-20T00:00:00.000Z",450,13,"PJ Tucker",0,0,0,0,0,0
"1875",1877,3,0,3,2,2,5,3,4,2,30,1,1,10,4,0,0,1037965,"2023-12-20T00:00:00.000Z",30,26,"Harrison Barnes",0,14,17,13,7,19.3
"1876",1878,0,0,0,7,3,11,5,0,0,26,1,4,13,1,0,1,1037965,"2023-12-20T00:00:00.000Z",38017688,26,"Keegan Murray",0,14,14,13,1,13.2
"1877",1879,8,1,5,1,0,14,6,4,1,26,5,2,13,10,0,1,1037965,"2023-12-20T00:00:00.000Z",406,26,"Domantas Sabonis",1,23,31,21,18,39
"1878",1880,0,0,1,2,1,5,3,1,0,16,0,1,7,1,0,0,1037965,"2023-12-20T00:00:00.000Z",221,26,"Kevin Huerter",0,8,8,7,1,8.2
"1879",1881,0,1,0,0,0,0,0,0,0,1,0,0,0,0,0,1,1037962,"2023-12-20T00:00:00.000Z",486,14,"Christian Wood",1,0,0,0,0,2
"1880",1882,0,0,0,0,0,0,0,0,0,0,0,0,0,0,0,0,1037962,"2023-12-20T00:00:00.000Z",56677738,14,"Colin Castleton",0,0,0,0,0,0
"1881",1883,0,0,0,0,0,0,0,0,0,0,0,0,0,0,0,0,1037962,"2023-12-20T00:00:00.000Z",56677867,14,"Alex Fudge",0,0,0,0,0,0
"1882",1884,0,0,0,0,0,0,0,0,0,0,0,0,0,0,0,0,1037962,"2023-12-20T00:00:00.000Z",56677868,14,"D'Moi Hodge",0,0,0,0,0,0
"1883",1885,0,0,0,0,0,0,0,0,0,0,0,0,0,0,0,0,1037962,"2023-12-20T00:00:00.000Z",56677835,14,"Jalen Hood-Schifino",0,0,0,0,0,0
"1884",1886,0,0,0,0,0,0,0,0,0,0,0,0,0,0,0,0,1037964,"2023-12-20T00:00:00.000Z",56677840,7,"Dereck Lively II",0,0,0,0,0,0
"1885",1887,3,0,5,5,2,6,3,4,4,39,0,5,12,5,1,3,1037964,"2023-12-20T00:00:00.000Z",666511,13,"Amir Coffey",1,17,20,15,8,22.5
"1886",1888,5,1,7,6,1,22,12,5,5,38,3,0,30,10,1,0,1037964,"2023-12-20T00:00:00.000Z",274,13,"Kawhi Leonard",2,40,45,35,15,55.5
"1887",1889,0,0,7,0,0,6,5,2,2,25,2,2,12,9,1,1,1037964,"2023-12-20T00:00:00.000Z",493,13,"Ivica Zubac",1,21,21,12,9,24.8
"1888",1890,1,1,3,2,1,8,3,0,0,29,1,3,7,4,0,1,1037964,"2023-12-20T00:00:00.000Z",666743,13,"Terance Mann",1,11,12,8,5,15.3
"1889",1891,11,2,5,8,2,12,4,8,7,39,0,3,17,5,0,4,1037964,"2023-12-20T00:00:00.000Z",192,13,"James Harden",2,22,33,28,16,41.5
"1890",1892,0,0,0,0,0,0,0,0,0,0,0,0,0,0,0,0,1037964,"2023-12-20T00:00:00.000Z",114,7,"Seth Curry",0,0,0,0,0,0
"1891",1893,0,0,0,0,0,0,0,0,0,0,0,0,0,0,0,0,1037964,"2023-12-20T00:00:00.000Z",217,7,"Richaun Holmes",0,0,0,0,0,0
"1892",1894,0,0,0,1,0,1,0,0,0,4,0,1,0,0,0,0,1037968,"2023-12-21T00:00:00.000Z",56677857,5,"Julian Phillips",0,0,0,0,0,0
"1893",1895,3,0,3,2,0,2,0,2,1,18,0,1,1,3,0,0,1037968,"2023-12-21T00:00:00.000Z",38017719,5,"Dalen Terry",0,4,7,4,6,9.1
"1894",1896,0,0,0,0,0,0,0,0,0,2,0,1,0,0,0,1,1037968,"2023-12-21T00:00:00.000Z",17896116,5,"Terry Taylor",0,0,0,0,0,-1
"1895",1897,0,0,0,0,0,0,0,0,0,0,0,0,0,0,0,0,1037968,"2023-12-21T00:00:00.000Z",27,5,"Lonzo Ball",0,0,0,0,0,0
"1896",1898,0,0,0,0,0,0,0,0,0,0,0,0,0,0,0,0,1037968,"2023-12-21T00:00:00.000Z",56677874,5,"Onuralp Bitim",0,0,0,0,0,0
"1897",1900,0,0,0,0,0,0,0,0,0,0,0,0,0,0,0,0,1037968,"2023-12-21T00:00:00.000Z",268,5,"Zach LaVine",0,0,0,0,0,0
"1898",1901,0,0,0,0,0,0,0,0,0,0,0,0,0,0,0,0,1038017,"2023-12-28T00:00:00.000Z",56677871,8,"Hunter Tyson",0,0,0,0,0,0
"1899",1902,0,1,7,0,0,4,2,2,2,30,2,4,6,9,1,1,1038019,"2023-12-28T00:00:00.000Z",38017711,25,"Jabari Walker",2,15,15,6,9,21.8
"1900",1903,0,0,0,0,0,0,0,0,0,0,0,0,0,0,0,0,1038019,"2023-12-28T00:00:00.000Z",22,25,"Deandre Ayton",0,0,0,0,0,0
"1901",1904,0,0,0,0,0,0,0,0,0,0,0,0,0,0,0,0,1038019,"2023-12-28T00:00:00.000Z",47957121,25,"Justin Minaya",0,0,0,0,0,0
"1902",1905,0,0,0,0,0,0,0,0,0,0,0,0,0,0,0,0,1038019,"2023-12-28T00:00:00.000Z",56677791,25,"Kris Murray",0,0,0,0,0,0
"1903",1906,0,0,0,0,0,0,0,0,0,0,0,0,0,0,0,0,1038019,"2023-12-28T00:00:00.000Z",56677829,25,"Rayan Rupert",0,0,0,0,0,0
"1904",1907,0,0,0,0,0,0,0,0,0,0,0,0,0,0,0,0,1038019,"2023-12-28T00:00:00.000Z",38017690,25,"Shaedon Sharpe",0,0,0,0,0,0
"1905",1908,0,0,0,0,0,0,0,0,0,0,0,0,0,0,0,0,1038019,"2023-12-28T00:00:00.000Z",476,25,"Robert Williams III",0,0,0,0,0,0
"1906",1909,1,0,4,3,0,11,5,0,0,24,1,0,10,5,0,6,1038018,"2023-12-28T00:00:00.000Z",17553979,10,"Jonathan Kuminga",0,15,16,11,6,11.5
"1907",1910,5,0,0,6,2,11,4,4,3,25,0,2,13,0,2,0,1038018,"2023-12-28T00:00:00.000Z",443,10,"Klay Thompson",2,13,18,18,5,26.5
"1908",1911,0,1,2,0,0,2,2,3,1,14,3,3,5,5,0,0,1038018,"2023-12-28T00:00:00.000Z",282,10,"Kevon Looney",1,10,10,5,5,14
"1909",1912,5,0,2,5,2,9,4,0,0,28,1,2,10,3,0,1,1038018,"2023-12-28T00:00:00.000Z",56677858,10,"Brandin Podziemski",0,13,18,15,8,20.1
"1910",1913,6,1,4,8,2,15,3,6,5,32,0,1,13,4,2,1,1038018,"2023-12-28T00:00:00.000Z",115,10,"Stephen Curry",3,17,23,19,10,34.8
"1911",1914,0,0,0,0,0,0,0,0,0,0,0,0,0,0,0,0,1038018,"2023-12-28T00:00:00.000Z",185,10,"Draymond Green",0,0,0,0,0,0
"1912",1915,0,0,1,4,0,5,0,0,0,5,0,0,0,1,0,0,1038019,"2023-12-28T00:00:00.000Z",17896120,25,"Ish Wainright",0,1,1,0,1,1.2
"1913",1916,3,1,6,2,0,10,6,5,4,31,1,4,16,7,0,2,1038019,"2023-12-28T00:00:00.000Z",38017699,27,"Jeremy Sochan",1,23,26,19,10,29.9
"1914",1917,6,7,6,4,2,14,9,10,10,24,0,0,30,6,0,1,1038019,"2023-12-28T00:00:00.000Z",56677822,27,"Victor Wembanyama",7,36,42,36,12,66.2
"1915",1918,7,1,5,9,2,16,7,1,1,35,0,0,17,5,4,1,1038019,"2023-12-28T00:00:00.000Z",3547246,27,"Devin Vassell",5,22,29,24,12,47.5
"1916",1919,4,0,3,6,3,10,4,2,2,28,2,5,13,5,1,2,1038019,"2023-12-28T00:00:00.000Z",38017692,27,"Malaki Branham",1,18,22,17,9,26
"1917",1920,2,0,6,2,0,9,4,4,3,17,1,6,11,7,0,1,1038019,"2023-12-28T00:00:00.000Z",102,27,"Zach Collins",0,18,20,13,9,21.4
"1918",1921,2,0,3,6,1,11,4,0,0,31,0,5,9,3,1,2,1038019,"2023-12-28T00:00:00.000Z",666682,27,"Keldon Johnson",1,12,14,11,5,16.6
"1919",1922,6,0,2,2,0,6,2,4,4,26,3,0,8,5,1,1,1038019,"2023-12-28T00:00:00.000Z",3547274,27,"Tre Jones",1,13,19,14,11,25
"1920",1923,3,0,3,5,2,9,3,0,0,30,0,4,8,3,1,2,1038015,"2023-12-28T00:00:00.000Z",666965,7,"Grant Williams",1,11,14,11,6,17.1
"1921",1924,2,0,1,0,0,4,1,0,0,15,3,5,2,4,0,2,1038015,"2023-12-28T00:00:00.000Z",56677840,7,"Dereck Lively II",0,6,8,4,6,7.8
"1922",1925,5,0,3,5,1,7,1,2,1,22,0,1,4,3,0,2,1038016,"2023-12-28T00:00:00.000Z",56677834,29,"Keyonte George",0,7,12,9,8,13.1
"1923",1,0,0,0,0,0,0,0,0,0,0,0,0,0,0,0,0,1038089,"2024-01-07T00:00:00.000Z",666676,6,"Ty Jerome",0,0,0,0,0,0
"1924",2,0,0,0,0,0,0,0,0,0,0,0,0,0,0,0,0,1038089,"2024-01-07T00:00:00.000Z",17896076,6,"Evan Mobley",0,0,0,0,0,0
"1925",3,0,0,0,0,0,0,0,0,0,0,0,0,0,0,0,0,1038089,"2024-01-07T00:00:00.000Z",38017662,6,"Isaiah Mobley",0,0,0,0,0,0
"1926",4,1,0,2,2,0,2,0,2,2,16,0,0,2,2,1,1,1038089,"2024-01-07T00:00:00.000Z",38017649,27,"Julian Champagnie",1,4,5,3,3,7.9
"1927",5,4,0,4,5,2,9,4,1,1,28,1,2,11,5,0,1,1038089,"2024-01-07T00:00:00.000Z",38017699,27,"Jeremy Sochan",0,16,20,15,9,22
"1928",6,3,5,9,5,2,13,6,11,10,25,0,3,24,9,1,3,1038089,"2024-01-07T00:00:00.000Z",56677822,27,"Victor Wembanyama",6,33,36,27,12,54.3
"1929",7,2,0,3,9,4,19,9,0,0,35,0,2,22,3,3,0,1038089,"2024-01-07T00:00:00.000Z",3547246,27,"Devin Vassell",3,25,27,24,5,37.6
"1930",8,5,0,2,2,2,8,7,2,2,34,0,1,18,2,2,2,1038089,"2024-01-07T00:00:00.000Z",3547274,27,"Tre Jones",2,20,25,23,7,31.9
"1931",9,2,1,4,0,0,5,3,0,0,22,2,3,6,6,1,1,1038089,"2024-01-07T00:00:00.000Z",38017730,27,"Dominick Barlow",2,12,14,8,8,21.2
"1932",10,2,0,1,6,3,16,6,4,3,33,3,3,18,4,1,0,1038089,"2024-01-07T00:00:00.000Z",666682,27,"Keldon Johnson",1,22,24,20,6,28.8
"1933",11,1,0,4,4,1,7,4,0,0,21,2,1,9,6,1,0,1038089,"2024-01-07T00:00:00.000Z",359,27,"Cedi Osman",1,15,16,10,7,20.7
"1934",12,2,0,1,3,0,5,1,0,0,15,0,2,2,1,0,1,1038089,"2024-01-07T00:00:00.000Z",38017692,27,"Malaki Branham",0,3,5,4,3,5.2
"1935",13,0,0,2,1,0,2,1,2,1,11,0,1,3,2,0,2,1038089,"2024-01-07T00:00:00.000Z",38017693,27,"Blake Wesley",0,5,5,3,2,3.4
"1936",14,0,0,0,0,0,0,0,0,0,0,0,0,0,0,0,0,1038089,"2024-01-07T00:00:00.000Z",3547163,27,"Mamadi Diakite",0,0,0,0,0,0
"1937",15,0,0,0,0,0,0,0,0,0,0,0,0,0,0,0,0,1038089,"2024-01-07T00:00:00.000Z",180,27,"Devonte' Graham",0,0,0,0,0,0
"1938",16,0,0,0,0,0,0,0,0,0,0,0,0,0,0,0,0,1038089,"2024-01-07T00:00:00.000Z",17896059,27,"Sandro Mamukelashvili",0,0,0,0,0,0
"1939",17,0,0,0,0,0,0,0,0,0,0,0,0,0,0,0,0,1038089,"2024-01-07T00:00:00.000Z",305,27,"Doug McDermott",0,0,0,0,0,0
"1940",18,0,0,0,0,0,0,0,0,0,1,0,0,0,0,0,0,1038067,"2024-01-03T00:00:00.000Z",39398582,16,"Orlando Robinson",0,0,0,0,0,0
"1941",19,0,0,0,0,0,0,0,0,0,0,0,0,0,0,0,0,1038067,"2024-01-03T00:00:00.000Z",74,16,"Thomas Bryant",0,0,0,0,0,0
"1942",20,4,2,1,0,0,3,3,0,0,15,0,1,6,1,1,0,1038069,"2024-01-04T00:00:00.000Z",38017730,27,"Dominick Barlow",3,7,11,10,5,22.2
"1943",21,1,0,8,8,2,17,5,2,2,30,2,1,14,10,0,1,1038069,"2024-01-04T00:00:00.000Z",666682,27,"Keldon Johnson",0,24,25,15,11,26.5
"1944",22,2,0,0,0,0,0,0,0,0,2,0,0,0,0,0,0,1038069,"2024-01-04T00:00:00.000Z",17896059,27,"Sandro Mamukelashvili",0,0,2,2,2,3
"1945",23,0,0,0,0,0,0,0,0,0,0,0,0,0,0,0,0,1038069,"2024-01-04T00:00:00.000Z",38017692,27,"Malaki Branham",0,0,0,0,0,0
"1946",24,0,0,0,0,0,0,0,0,0,0,0,0,0,0,0,0,1038069,"2024-01-04T00:00:00.000Z",3547163,27,"Mamadi Diakite",0,0,0,0,0,0
"1947",25,0,0,0,0,0,0,0,0,0,0,0,0,0,0,0,0,1038069,"2024-01-04T00:00:00.000Z",180,27,"Devonte' Graham",0,0,0,0,0,0
"1948",26,7,0,9,4,0,8,2,0,0,27,0,2,4,9,0,3,1038124,"2024-01-12T00:00:00.000Z",45,23,"Patrick Beverley",0,13,20,11,16,22.3
"1949",27,0,4,1,2,2,6,4,2,1,20,2,1,11,3,1,2,1038124,"2024-01-12T00:00:00.000Z",28,23,"Mo Bamba",5,14,14,11,3,27.6
"1950",28,1,0,2,1,0,2,1,2,2,14,0,3,4,2,0,0,1038124,"2024-01-12T00:00:00.000Z",2175,23,"Danuel House Jr.",0,6,7,5,3,7.9
"1951",29,0,0,2,2,1,3,1,0,0,10,0,1,3,2,0,2,1038124,"2024-01-12T00:00:00.000Z",38017714,26,"Keon Ellis",0,5,5,3,2,3.4
"1952",30,0,0,0,1,0,3,1,0,0,6,1,1,2,1,0,0,1038124,"2024-01-12T00:00:00.000Z",17896044,26,"Kessler Edwards",0,3,3,2,1,3.2
"1953",31,2,0,1,0,0,2,1,0,0,8,0,0,2,1,1,0,1038126,"2024-01-12T00:00:00.000Z",56677825,11,"Amen Thompson",1,3,5,4,3,9.2
"1954",32,0,0,1,5,1,7,1,0,0,15,0,2,3,1,0,0,1038126,"2024-01-12T00:00:00.000Z",56677831,11,"Cam Whitmore",0,4,4,3,1,4.2
"1955",33,0,0,1,0,0,0,0,0,0,3,0,0,0,1,0,0,1038126,"2024-01-12T00:00:00.000Z",213,11,"Aaron Holiday",0,1,1,0,1,1.2
"1956",34,0,0,2,0,0,2,2,2,2,13,0,2,6,2,0,1,1038126,"2024-01-12T00:00:00.000Z",188,11,"Jeff Green",0,8,8,6,2,7.4
"1957",35,1,0,4,3,1,3,1,0,0,21,0,0,3,4,1,1,1038126,"2024-01-12T00:00:00.000Z",75,11,"Reggie Bullock",1,7,8,4,5,11.3
"1958",36,0,0,0,0,0,0,0,0,0,0,0,0,0,0,0,0,1038126,"2024-01-12T00:00:00.000Z",19465326,11,"Jock Landale",0,0,0,0,0,0
"1959",37,0,0,0,0,0,0,0,0,0,0,0,0,0,0,0,0,1038126,"2024-01-12T00:00:00.000Z",296,11,"Boban Marjanovic",0,0,0,0,0,0
"1960",38,0,0,0,0,0,0,0,0,0,0,0,0,0,0,0,0,1038125,"2024-01-12T00:00:00.000Z",56677838,1,"Kobe Bufkin",0,0,0,0,0,0
"1961",39,0,0,0,0,0,0,0,0,0,0,0,0,0,0,0,0,1038125,"2024-01-12T00:00:00.000Z",56677806,1,"Mouhamed Gueye",0,0,0,0,0,0
"1962",40,0,0,0,0,0,0,0,0,0,0,0,0,0,0,0,0,1038125,"2024-01-12T00:00:00.000Z",666656,1,"De'Andre Hunter",0,0,0,0,0,0
"1963",41,0,0,0,0,0,0,0,0,0,0,0,0,0,0,0,0,1038125,"2024-01-12T00:00:00.000Z",4197387,1,"Vit Krejci",0,0,0,0,0,0
"1964",42,0,0,0,0,0,0,0,0,0,0,0,0,0,0,0,0,1038125,"2024-01-12T00:00:00.000Z",301,1,"Wesley Matthews",0,0,0,0,0,0
"1965",43,0,0,3,3,3,6,5,0,0,21,1,3,13,4,1,1,1038125,"2024-01-12T00:00:00.000Z",3547250,12,"Aaron Nesmith",1,17,17,13,4,19.8
"1966",44,0,0,4,0,0,7,3,0,0,19,3,1,6,7,0,0,1038125,"2024-01-12T00:00:00.000Z",3547264,12,"Jalen Smith",0,13,13,6,7,14.4
"1967",45,4,2,5,3,0,9,5,3,2,26,2,2,12,7,2,3,1038125,"2024-01-12T00:00:00.000Z",452,12,"Myles Turner",4,19,23,16,11,35.4
"1968",46,4,0,1,3,2,9,5,0,0,21,0,0,12,1,0,2,1038125,"2024-01-12T00:00:00.000Z",69,12,"Bruce Brown",0,13,17,16,5,17.2
"1969",47,6,0,4,2,2,6,4,0,0,23,0,2,10,4,2,4,1038125,"2024-01-12T00:00:00.000Z",38017507,12,"Andrew Nembhard",2,14,20,16,10,25.8
"1970",48,2,3,3,6,4,11,7,0,0,23,0,3,18,3,0,2,1038125,"2024-01-12T00:00:00.000Z",210,12,"Buddy Hield",3,21,23,20,5,31.6
"1971",49,2,4,4,0,0,7,6,0,0,18,1,3,12,5,4,2,1038125,"2024-01-12T00:00:00.000Z",17896035,12,"Isaiah Jackson",8,17,19,14,7,43
"1972",50,0,0,0,0,0,0,0,0,0,4,0,1,0,0,0,0,1038125,"2024-01-12T00:00:00.000Z",38017701,12,"Kendall Brown",0,0,0,0,0,0
"1973",51,0,0,0,0,0,0,0,0,0,0,0,0,0,0,0,0,1037652,"2023-11-01T00:00:00.000Z",666423,20,"RJ Barrett",0,0,0,0,0,0
"1974",52,0,0,0,0,0,0,0,0,0,0,0,0,0,0,0,0,1037652,"2023-11-01T00:00:00.000Z",160,20,"Evan Fournier",0,0,0,0,0,0
"1975",53,0,0,0,0,0,0,0,0,0,0,0,0,0,0,0,0,1037652,"2023-11-01T00:00:00.000Z",666675,20,"DaQuan Jeffries",0,0,0,0,0,0
"1976",54,0,0,0,0,0,0,0,0,0,0,0,0,0,0,0,0,1037652,"2023-11-01T00:00:00.000Z",17896063,20,"Jericho Sims",0,0,0,0,0,0
"1977",55,0,0,0,0,0,0,0,0,0,0,0,0,0,0,0,0,1037652,"2023-11-01T00:00:00.000Z",666971,20,"Dylan Windler",0,0,0,0,0,0
"1978",56,0,0,0,0,0,0,0,0,0,0,0,0,0,0,0,0,1037652,"2023-11-01T00:00:00.000Z",666474,20,"Charles Brown",0,0,0,0,0,0
"1979",57,0,0,0,0,0,0,0,0,0,0,0,0,0,0,0,0,1037652,"2023-11-01T00:00:00.000Z",56677795,20,"Jacob Toppin",0,0,0,0,0,0
"1980",58,0,0,0,0,0,0,0,0,0,0,0,0,0,0,0,0,1037652,"2023-11-01T00:00:00.000Z",17896089,20,"Duane Washington Jr.",0,0,0,0,0,0
"1981",59,2,0,10,3,1,6,1,2,2,28,0,4,5,10,1,0,1037652,"2023-11-01T00:00:00.000Z",344,6,"Georges Niang",1,15,17,7,12,23
"1982",60,2,0,3,2,0,3,1,0,0,31,0,6,2,3,1,1,1037652,"2023-11-01T00:00:00.000Z",3547247,6,"Isaac Okoro",1,5,7,4,5,10.6
"1983",61,5,2,6,0,0,12,6,3,2,35,2,2,14,8,2,2,1037652,"2023-11-01T00:00:00.000Z",17896076,6,"Evan Mobley",4,22,27,19,13,41.1
"1984",62,4,1,5,15,6,22,9,6,6,37,1,5,30,6,1,5,1037652,"2023-11-01T00:00:00.000Z",322,6,"Donovan Mitchell",2,36,40,34,10,44.2
"1985",63,4,2,4,5,0,9,3,3,3,35,0,3,9,4,0,5,1037652,"2023-11-01T00:00:00.000Z",666908,6,"Max Strus",2,13,17,13,8,20.8
"1986",64,5,0,6,4,3,14,6,4,4,30,0,3,19,6,1,3,1037652,"2023-11-01T00:00:00.000Z",277,6,"Caris LeVert",1,25,30,24,11,33.7
"1987",65,0,0,1,0,0,1,1,2,2,11,0,3,4,1,1,0,1037652,"2023-11-01T00:00:00.000Z",56677872,6,"Craig Porter",1,5,5,4,1,8.2
"1988",66,0,0,3,0,0,4,3,0,0,13,2,1,6,5,0,2,1037652,"2023-11-01T00:00:00.000Z",444,6,"Tristan Thompson",0,11,11,6,5,10
"1989",67,0,0,2,3,2,3,2,0,0,20,1,0,6,3,0,0,1037652,"2023-11-01T00:00:00.000Z",666940,6,"Dean Wade",0,9,9,6,3,9.6
"1990",68,0,0,0,0,0,0,0,0,0,0,0,0,0,0,0,0,1037652,"2023-11-01T00:00:00.000Z",56677847,6,"Emoni Bates",0,0,0,0,0,0
"1991",69,0,0,0,0,0,0,0,0,0,0,0,0,0,0,0,0,1037652,"2023-11-01T00:00:00.000Z",248,6,"Damian Jones",0,0,0,0,0,0
"1992",70,0,0,0,0,0,0,0,0,0,0,0,0,0,0,0,0,1037652,"2023-11-01T00:00:00.000Z",3547299,6,"Sam Merrill",0,0,0,0,0,0
"1993",71,0,0,0,0,0,0,0,0,0,0,0,0,0,0,0,0,1037652,"2023-11-01T00:00:00.000Z",38017662,6,"Isaiah Mobley",0,0,0,0,0,0
"1994",72,1,0,0,6,2,13,5,1,1,20,0,1,13,0,1,1,1037649,"2023-11-01T00:00:00.000Z",666848,30,"Jordan Poole",1,13,14,14,1,16.5
"1995",73,3,0,1,3,0,6,3,0,0,22,0,1,6,1,1,1,1037649,"2023-11-01T00:00:00.000Z",249,30,"Tyus Jones",1,7,10,9,4,13.7
"1996",74,5,0,3,10,6,23,12,1,0,36,0,2,30,3,0,3,1037651,"2023-11-01T00:00:00.000Z",666633,16,"Tyler Herro",0,33,38,35,8,38.1
"1997",75,3,1,3,5,2,5,2,0,0,30,0,3,6,3,2,2,1037651,"2023-11-01T00:00:00.000Z",286,16,"Kyle Lowry",3,9,12,9,6,21.1
"1998",76,0,0,0,0,0,0,0,0,0,3,0,0,0,0,0,0,1037922,"2023-12-15T00:00:00.000Z",489,28,"Thaddeus Young",0,0,0,0,0,0
"1999",77,3,2,7,6,3,8,4,0,0,30,1,2,11,8,1,3,1037924,"2023-12-15T00:00:00.000Z",38017731,15,"Vince Williams Jr.",3,19,22,14,11,31.1
"2000",78,2,4,2,7,0,23,8,7,6,33,1,5,22,3,0,1,1037924,"2023-12-15T00:00:00.000Z",231,15,"Jaren Jackson Jr.",4,25,27,24,5,39.6
"2001",79,1,1,8,0,0,9,5,1,0,33,1,2,10,9,0,2,1037924,"2023-12-15T00:00:00.000Z",48,15,"Bismack Biyombo",1,19,20,11,10,23.3
"2002",80,3,0,7,12,4,25,11,3,2,40,6,4,28,13,2,4,1037924,"2023-12-15T00:00:00.000Z",3547287,15,"Desmond Bane",2,41,44,31,16,50.1
"2003",81,2,0,1,2,1,3,1,0,0,9,0,0,3,1,0,0,1037924,"2023-12-15T00:00:00.000Z",401,15,"Derrick Rose",0,4,6,5,3,7.2
"2004",82,3,0,1,2,0,3,0,0,0,16,0,1,0,1,1,2,1037924,"2023-12-15T00:00:00.000Z",48248287,15,"Jacob Gilyard",1,1,4,3,4,6.7
"2005",83,0,0,2,4,2,8,4,2,1,26,2,3,11,4,0,2,1037924,"2023-12-15T00:00:00.000Z",17896067,15,"Santi Aldama",0,15,15,11,4,13.8
"2006",84,14,0,5,6,2,17,7,10,7,36,2,1,23,7,2,2,1037923,"2023-12-15T00:00:00.000Z",237,14,"LeBron James",2,30,44,37,21,56.4
"2007",85,0,1,4,0,0,4,3,3,2,20,3,5,8,7,1,0,1037923,"2023-12-15T00:00:00.000Z",666626,14,"Jaxson Hayes",2,15,15,8,7,22.4
"2008",86,4,0,5,10,4,18,8,2,2,34,2,0,22,7,0,2,1037923,"2023-12-15T00:00:00.000Z",17553995,14,"Austin Reaves",0,29,33,26,11,34.4
"2009",87,1,0,0,1,0,6,1,0,0,23,0,1,2,0,0,1,1037923,"2023-12-15T00:00:00.000Z",38017697,14,"Max Christie",0,2,3,3,1,2.5
"2010",88,1,0,5,1,0,3,0,0,0,13,0,4,0,5,0,0,1037923,"2023-12-15T00:00:00.000Z",457,14,"Jarred Vanderbilt",0,5,6,1,6,7.5
"2011",89,4,1,5,5,0,15,8,5,4,34,0,1,20,5,0,0,1037923,"2023-12-15T00:00:00.000Z",666609,14,"Rui Hachimura",1,25,29,24,9,35
"2012",90,3,2,6,5,2,10,6,8,3,30,2,1,17,8,1,0,1037923,"2023-12-15T00:00:00.000Z",486,14,"Christian Wood",3,25,28,20,11,40.1
"2013",91,0,0,0,0,0,0,0,0,0,0,0,0,0,0,0,0,1037922,"2023-12-15T00:00:00.000Z",376,28,"Otto Porter Jr.",0,0,0,0,0,0
"2014",92,0,0,0,0,0,0,0,0,0,0,0,0,0,0,0,0,1037922,"2023-12-15T00:00:00.000Z",56677805,28,"Javon Freeman-Liberty",0,0,0,0,0,0
"2015",93,0,0,0,0,0,0,0,0,0,0,0,0,0,0,0,0,1037922,"2023-12-15T00:00:00.000Z",38017710,28,"Christian Koloko",0,0,0,0,0,0
"2016",94,3,0,0,2,1,3,2,0,0,8,0,0,5,0,0,0,1037923,"2023-12-15T00:00:00.000Z",56677868,14,"D'Moi Hodge",0,5,8,8,3,9.5
"2017",95,1,0,1,0,0,3,3,0,0,6,0,0,6,1,0,0,1037923,"2023-12-15T00:00:00.000Z",56677738,14,"Colin Castleton",0,7,8,7,2,8.7
"2018",96,0,0,0,0,0,0,0,0,0,0,0,0,0,0,0,0,1037923,"2023-12-15T00:00:00.000Z",117,14,"Anthony Davis",0,0,0,0,0,0
"2019",97,0,0,0,0,0,0,0,0,0,0,0,0,0,0,0,0,1037922,"2023-12-15T00:00:00.000Z",666656,1,"De'Andre Hunter",0,0,0,0,0,0
"2020",98,0,0,0,0,0,0,0,0,0,0,0,0,0,0,0,0,1037922,"2023-12-15T00:00:00.000Z",17896040,1,"Jalen Johnson",0,0,0,0,0,0
"2021",99,0,0,0,0,0,0,0,0,0,0,0,0,0,0,0,0,1037922,"2023-12-15T00:00:00.000Z",56677875,1,"Miles Norris",0,0,0,0,0,0
"2022",100,0,0,0,0,0,0,0,0,0,0,0,0,0,0,0,0,1037921,"2023-12-15T00:00:00.000Z",17553983,22,"Trevelin Queen",0,0,0,0,0,0
"2023",101,1,1,3,1,1,14,7,5,4,37,4,4,19,7,1,2,1037976,"2023-12-22T00:00:00.000Z",56677785,16,"Jaime Jaquez Jr.",2,26,27,20,8,32.9
"2024",102,2,1,6,4,2,9,4,1,1,35,2,4,11,8,1,0,1037976,"2023-12-22T00:00:00.000Z",666747,16,"Caleb Martin",2,19,21,13,10,29.6
"2025",103,6,0,9,1,0,14,5,10,8,38,2,2,18,11,2,6,1037976,"2023-12-22T00:00:00.000Z",4,16,"Bam Adebayo",2,29,35,24,17,40.2
"2026",104,2,0,7,13,7,21,11,2,1,34,0,1,30,7,1,4,1037976,"2023-12-22T00:00:00.000Z",666633,16,"Tyler Herro",1,37,39,32,9,40.4
"2027",105,3,0,4,2,1,2,1,0,0,22,0,2,3,4,0,2,1037976,"2023-12-22T00:00:00.000Z",286,16,"Kyle Lowry",0,7,10,6,7,10.3
"2028",106,1,0,3,4,0,5,1,1,1,29,0,0,3,3,1,1,1037976,"2023-12-22T00:00:00.000Z",391,16,"Josh Richardson",1,6,7,4,4,10.1
"2029",107,1,0,0,4,1,4,1,4,3,10,0,3,6,0,0,0,1037976,"2023-12-22T00:00:00.000Z",285,16,"Kevin Love",0,6,7,7,1,7.5
"2030",108,2,0,2,3,1,6,2,0,0,10,3,2,5,5,0,0,1037976,"2023-12-22T00:00:00.000Z",3092,16,"Haywood Highsmith",0,10,12,7,7,14
"2031",109,3,0,2,7,4,11,8,7,7,25,1,0,27,3,1,2,1037976,"2023-12-22T00:00:00.000Z",397,16,"Duncan Robinson",1,30,33,30,6,36.1
"2032",110,0,0,0,0,0,0,0,0,0,0,0,0,0,0,0,0,1037976,"2023-12-22T00:00:00.000Z",74,16,"Thomas Bryant",0,0,0,0,0,0
"2033",111,0,0,0,0,0,0,0,0,0,0,0,0,0,0,0,0,1037976,"2023-12-22T00:00:00.000Z",38017734,16,"Jamal Cain",0,0,0,0,0,0
"2034",112,0,0,0,0,0,0,0,0,0,0,0,0,0,0,0,0,1037976,"2023-12-22T00:00:00.000Z",39398582,16,"Orlando Robinson",0,0,0,0,0,0
"2035",113,0,0,0,0,0,0,0,0,0,0,0,0,0,0,0,0,1037976,"2023-12-22T00:00:00.000Z",79,16,"Jimmy Butler",0,0,0,0,0,0
"2036",114,0,0,0,0,0,0,0,0,0,0,0,0,0,0,0,0,1037976,"2023-12-22T00:00:00.000Z",3547257,16,"R.J. Hampton",0,0,0,0,0,0
"2037",115,0,0,0,0,0,0,0,0,0,0,0,0,0,0,0,0,1037976,"2023-12-22T00:00:00.000Z",38017696,16,"Nikola Jovic",0,0,0,0,0,0
"2038",116,4,0,2,12,2,17,3,0,0,24,0,5,8,2,0,0,1037977,"2023-12-22T00:00:00.000Z",38017679,7,"Jaden Hardy",0,10,14,12,6,16.4
"2039",117,1,0,2,8,2,20,6,2,2,26,1,0,16,3,0,1,1037977,"2023-12-22T00:00:00.000Z",191,7,"Tim Hardaway Jr.",0,19,20,17,4,20.1
"2040",118,0,0,4,1,0,1,0,0,0,8,0,1,0,4,0,0,1037977,"2023-12-22T00:00:00.000Z",379,7,"Dwight Powell",0,4,4,0,4,4.8
"2041",119,0,0,2,2,0,7,0,0,0,18,0,1,0,2,2,2,1037977,"2023-12-22T00:00:00.000Z",114,7,"Seth Curry",2,2,2,0,2,6.4
"2042",120,2,0,1,4,1,13,6,9,7,30,5,2,20,6,1,3,1037977,"2023-12-22T00:00:00.000Z",56677859,7,"Olivier-Maxence Prosper",1,26,28,22,8,30.2
"2043",121,1,0,2,1,0,4,3,2,2,23,0,0,8,2,4,3,1037977,"2023-12-22T00:00:00.000Z",17554004,7,"AJ Lawson",4,10,11,9,3,20.9
"2044",122,2,0,4,1,0,3,0,4,3,12,1,1,3,5,0,0,1037977,"2023-12-22T00:00:00.000Z",17896028,7,"Greg Brown III",0,8,10,5,7,12
"2045",123,1,0,3,0,0,12,7,3,2,22,5,2,16,8,1,1,1037977,"2023-12-22T00:00:00.000Z",217,7,"Richaun Holmes",1,24,25,17,9,29.1
"2046",124,4,0,5,3,1,11,8,2,1,17,0,0,18,5,0,0,1037977,"2023-12-22T00:00:00.000Z",56677873,7,"Dexter Dennis",0,23,27,22,9,30
"2047",125,0,0,0,0,0,0,0,0,0,0,0,0,0,0,0,0,1037977,"2023-12-22T00:00:00.000Z",132,7,"Luka Doncic",0,0,0,0,0,0
"2048",126,7,1,0,7,3,11,5,1,1,27,0,1,14,0,1,1,1038037,"2023-12-31T00:00:00.000Z",249,30,"Tyus Jones",2,14,21,21,7,29.5
"2049",127,3,0,3,1,0,3,0,2,2,17,1,2,2,4,0,0,1038037,"2023-12-31T00:00:00.000Z",56677844,30,"Bilal Coulibaly",0,6,9,5,7,11.3
"2050",128,3,0,4,5,2,8,4,0,0,20,0,1,10,4,0,0,1038037,"2023-12-31T00:00:00.000Z",337,30,"Mike Muscala",0,14,17,13,7,19.3
"2051",129,2,0,0,2,1,2,1,0,0,18,0,2,3,0,0,3,1038037,"2023-12-31T00:00:00.000Z",487,30,"Delon Wright",0,3,5,5,2,3
"2052",130,4,0,0,5,1,10,5,5,4,18,0,0,15,0,0,0,1038037,"2023-12-31T00:00:00.000Z",17896045,30,"Corey Kispert",0,15,19,19,4,21
"2053",131,2,2,2,2,0,6,2,0,0,18,0,1,4,2,1,0,1038037,"2023-12-31T00:00:00.000Z",414,30,"Landry Shamet",3,6,8,6,4,18.4
"2054",133,0,0,0,0,0,0,0,0,0,0,0,0,0,0,0,0,1038037,"2023-12-31T00:00:00.000Z",38017687,30,"Johnny Davis",0,0,0,0,0,0
"2055",134,0,0,0,0,0,0,0,0,0,0,0,0,0,0,0,0,1038037,"2023-12-31T00:00:00.000Z",3547302,30,"Anthony Gill",0,0,0,0,0,0
"2056",135,0,0,0,0,0,0,0,0,0,0,0,0,0,0,0,0,1038037,"2023-12-31T00:00:00.000Z",17896106,30,"Eugene Omoruyi",0,0,0,0,0,0
"2057",136,0,0,0,0,0,0,0,0,0,0,0,0,0,0,0,0,1038037,"2023-12-31T00:00:00.000Z",38017712,30,"Ryan Rollins",0,0,0,0,0,0
"2058",137,0,0,0,0,0,0,0,0,0,0,0,0,0,0,0,0,1038037,"2023-12-31T00:00:00.000Z",38017704,30,"Patrick Baldwin Jr.",0,0,0,0,0,0
"2059",138,0,0,0,0,0,0,0,0,0,0,0,0,0,0,0,0,1038037,"2023-12-31T00:00:00.000Z",18677954,30,"Jared Butler",0,0,0,0,0,0
"2060",139,0,0,0,0,0,0,0,0,0,0,0,0,0,0,0,0,1038037,"2023-12-31T00:00:00.000Z",167,30,"Danilo Gallinari",0,0,0,0,0,0
"2061",140,0,0,0,0,0,0,0,0,0,0,0,0,0,0,0,0,1038029,"2023-12-29T00:00:00.000Z",419,25,"Anfernee Simons",0,0,0,0,0,0
"2062",141,0,0,0,0,0,0,0,0,0,0,0,0,0,0,0,0,1038030,"2023-12-29T00:00:00.000Z",371,13,"Mason Plumlee",0,0,0,0,0,0
"2063",142,2,0,2,11,4,14,7,4,4,32,0,0,22,2,3,2,1038030,"2023-12-29T00:00:00.000Z",420,15,"Marcus Smart",3,24,26,24,4,34.4
"2064",143,4,2,2,6,4,17,8,2,2,37,0,5,22,2,2,1,1038030,"2023-12-29T00:00:00.000Z",231,15,"Jaren Jackson Jr.",4,24,28,26,6,41.4
"2065",144,5,1,1,4,1,6,1,3,2,22,0,3,5,1,0,1,1038030,"2023-12-29T00:00:00.000Z",38017731,15,"Vince Williams Jr.",1,6,11,10,6,15.7
"2066",145,0,1,2,1,0,5,1,0,0,17,2,3,2,4,1,1,1038030,"2023-12-29T00:00:00.000Z",3547285,15,"Xavier Tillman",2,6,6,2,4,11.8
"2067",146,1,0,2,2,0,3,0,0,0,6,0,1,0,2,0,0,1038030,"2023-12-29T00:00:00.000Z",17896027,15,"Ziaire Williams",0,2,3,1,3,3.9
"2068",147,0,0,0,0,0,0,0,0,0,0,0,0,0,0,0,0,1038030,"2023-12-29T00:00:00.000Z",3,15,"Steven Adams",0,0,0,0,0,0
"2069",148,0,0,0,0,0,0,0,0,0,0,0,0,0,0,0,0,1038030,"2023-12-29T00:00:00.000Z",666505,15,"Brandon Clarke",0,0,0,0,0,0
"2070",149,0,0,0,0,0,0,0,0,0,0,0,0,0,0,0,0,1038030,"2023-12-29T00:00:00.000Z",56677830,15,"GG Jackson",0,0,0,0,0,0
"2071",150,0,0,0,0,0,0,0,0,0,0,0,0,0,0,0,0,1038030,"2023-12-29T00:00:00.000Z",254,15,"Luke Kennard",0,0,0,0,0,0
"2072",151,3,0,4,8,4,26,15,8,8,44,0,0,42,4,0,3,1038090,"2024-01-07T00:00:00.000Z",61,3,"Mikal Bridges",0,46,49,45,7,48.3
"2073",152,0,1,2,0,0,9,4,2,1,20,5,2,9,7,0,1,1038072,"2024-01-05T00:00:00.000Z",83,1,"Clint Capela",1,16,16,9,7,19.4
"2074",153,2,0,1,3,2,19,13,2,2,34,0,0,30,1,0,1,1038072,"2024-01-05T00:00:00.000Z",334,1,"Dejounte Murray",0,31,33,32,3,33.2
"2075",154,6,0,2,11,1,18,4,5,4,28,0,2,13,2,2,3,1038072,"2024-01-05T00:00:00.000Z",490,1,"Trae Young",2,15,21,19,8,27.4
"2076",155,2,1,0,1,1,3,2,3,2,10,0,0,7,0,0,1,1038079,"2024-01-05T00:00:00.000Z",24489167,7,"Brandon Williams",1,7,9,9,2,12
"2077",156,0,0,2,2,1,5,3,0,0,19,1,3,7,3,0,2,1038079,"2024-01-05T00:00:00.000Z",56677829,25,"Rayan Rupert",0,10,10,7,3,8.6
"2078",157,0,0,0,0,0,0,0,0,0,0,0,0,0,0,0,0,1038079,"2024-01-05T00:00:00.000Z",17896120,25,"Ish Wainright",0,0,0,0,0,0
"2079",158,0,0,0,0,0,0,0,0,0,0,0,0,0,0,0,0,1038079,"2024-01-05T00:00:00.000Z",22,25,"Deandre Ayton",0,0,0,0,0,0
"2080",159,0,0,0,0,0,0,0,0,0,0,0,0,0,0,0,0,1038079,"2024-01-05T00:00:00.000Z",666476,25,"Moses Brown",0,0,0,0,0,0
"2081",160,0,0,0,0,0,0,0,0,0,0,0,0,0,0,0,0,1038079,"2024-01-05T00:00:00.000Z",47957121,25,"Justin Minaya",0,0,0,0,0,0
"2082",161,0,0,0,0,0,0,0,0,0,0,0,0,0,0,0,0,1038079,"2024-01-05T00:00:00.000Z",38017711,25,"Jabari Walker",0,0,0,0,0,0
"2083",162,0,0,0,0,0,0,0,0,0,0,0,0,0,0,0,0,1038080,"2024-01-05T00:00:00.000Z",17896026,22,"Franz Wagner",0,0,0,0,0,0
"2084",163,1,0,1,1,0,2,0,8,6,14,0,3,6,1,1,0,1038071,"2024-01-05T00:00:00.000Z",358,29,"Kelly Olynyk",1,7,8,7,2,11.7
"2085",164,0,0,1,1,0,10,4,6,3,12,0,1,11,1,2,0,1038071,"2024-01-05T00:00:00.000Z",666650,29,"Talen Horton-Tucker",2,12,12,11,1,18.2
"2086",165,0,0,0,2,0,6,2,0,0,13,1,4,4,1,0,0,1038080,"2024-01-05T00:00:00.000Z",38017721,8,"Peyton Watson",0,5,5,4,1,5.2
"2087",166,0,0,0,0,0,0,0,0,0,0,0,0,0,0,0,0,1038080,"2024-01-05T00:00:00.000Z",666489,8,"Vlatko Cancar",0,0,0,0,0,0
"2088",167,0,0,0,0,0,0,0,0,0,0,0,0,0,0,0,0,1038080,"2024-01-05T00:00:00.000Z",56677582,8,"Jalen Pickett",0,0,0,0,0,0
"2089",168,0,0,0,0,0,0,0,0,0,0,0,0,0,0,0,0,1038080,"2024-01-05T00:00:00.000Z",56677776,8,"Julian Strawther",0,0,0,0,0,0
"2090",169,0,0,0,0,0,0,0,0,0,0,0,0,0,0,0,0,1038080,"2024-01-05T00:00:00.000Z",56677871,8,"Hunter Tyson",0,0,0,0,0,0
"2091",170,1,1,4,3,1,3,1,2,0,28,3,1,3,7,1,4,1038080,"2024-01-05T00:00:00.000Z",666818,22,"Chuma Okeke",2,10,11,4,8,14.9
"2092",171,11,0,9,4,1,21,8,19,15,41,1,2,32,10,3,5,1038080,"2024-01-05T00:00:00.000Z",38017683,22,"Paolo Banchero",3,42,53,43,21,64.5
"2093",172,3,0,8,4,2,14,8,2,1,38,3,4,19,11,2,0,1038080,"2024-01-05T00:00:00.000Z",462,22,"Moritz Wagner",2,30,33,22,14,42.7
"2094",173,1,1,2,9,7,15,9,4,2,34,2,3,27,4,0,2,1038080,"2024-01-05T00:00:00.000Z",17896073,22,"Jalen Suggs",1,31,32,28,5,34.3
"2095",174,3,0,5,3,2,7,3,0,0,14,1,3,8,6,0,0,1038079,"2024-01-05T00:00:00.000Z",56677859,7,"Olivier-Maxence Prosper",0,14,17,11,9,19.7
"2096",175,1,0,0,0,0,1,0,0,0,5,0,1,0,0,0,0,1038080,"2024-01-05T00:00:00.000Z",56677827,22,"Anthony Black",0,0,1,1,1,1.5
"2097",176,0,0,1,2,1,2,1,0,0,5,0,0,3,1,0,0,1037598,"2023-10-25T00:00:00.000Z",38017724,22,"Caleb Houstan",0,4,4,3,1,4.2
"2098",177,2,1,7,3,1,13,9,4,2,29,0,1,21,7,2,0,1037595,"2023-10-25T00:00:00.000Z",17896040,1,"Jalen Johnson",3,28,30,23,9,41.4
"2099",178,0,0,2,1,0,2,1,0,0,10,0,1,2,2,0,1,1037595,"2023-10-25T00:00:00.000Z",38017689,1,"AJ Griffin",0,4,4,2,2,3.4
"2100",179,2,0,3,0,0,5,3,1,1,19,1,5,7,4,0,1,1037595,"2023-10-25T00:00:00.000Z",3547244,1,"Onyeka Okongwu",0,11,13,9,6,13.8
"2101",180,0,0,0,0,0,0,0,0,0,0,0,0,0,0,0,0,1037595,"2023-10-25T00:00:00.000Z",3547297,1,"Trent Forrest",0,0,0,0,0,0
"2102",181,0,0,0,0,0,0,0,0,0,0,0,0,0,0,0,0,1037595,"2023-10-25T00:00:00.000Z",56677806,1,"Mouhamed Gueye",0,0,0,0,0,0
"2103",182,0,0,0,0,0,0,0,0,0,0,0,0,0,0,0,0,1037595,"2023-10-25T00:00:00.000Z",666754,1,"Garrison Mathews",0,0,0,0,0,0
"2104",183,0,0,0,0,0,0,0,0,0,0,0,0,0,0,0,0,1037595,"2023-10-25T00:00:00.000Z",319,1,"Patty Mills",0,0,0,0,0,0
"2105",184,1,3,6,9,4,13,7,2,2,34,0,2,20,6,2,2,1037601,"2023-10-25T00:00:00.000Z",18,28,"OG Anunoby",5,26,27,21,7,41.7
"2106",185,6,0,7,5,3,17,5,2,2,34,0,2,15,7,1,2,1037601,"2023-10-25T00:00:00.000Z",416,28,"Pascal Siakam",1,22,28,21,13,33.4
"2107",186,1,1,8,0,0,3,3,4,1,24,3,1,7,11,1,0,1037601,"2023-10-25T00:00:00.000Z",373,28,"Jakob Poeltl",2,18,19,8,12,27.7
"2108",187,5,5,7,4,1,16,6,6,4,37,1,1,17,8,2,4,1037601,"2023-10-25T00:00:00.000Z",17896055,28,"Scottie Barnes",7,25,30,22,13,51.1
"2109",188,7,0,2,8,4,17,8,2,2,32,1,1,22,3,0,2,1037601,"2023-10-25T00:00:00.000Z",409,28,"Dennis Schroder",0,25,32,29,10,34.1
"2110",189,6,0,6,1,0,11,6,4,2,28,2,4,14,8,0,1,1037598,"2023-10-25T00:00:00.000Z",17896062,11,"Alperen Sengun",0,22,28,20,14,31.6
"2111",190,0,1,1,1,0,10,2,7,6,30,0,2,10,1,1,4,1037598,"2023-10-25T00:00:00.000Z",17895966,11,"Jalen Green",2,11,11,10,1,13.2
"2112",191,5,0,1,6,4,13,5,0,0,34,0,0,14,1,1,3,1037598,"2023-10-25T00:00:00.000Z",458,11,"Fred VanVleet",1,15,20,19,6,22.7
"2113",192,2,0,4,7,1,10,3,2,1,21,1,2,8,5,0,4,1037598,"2023-10-25T00:00:00.000Z",56677825,11,"Amen Thompson",0,13,15,10,7,13
"2114",193,2,0,0,2,1,2,1,0,0,9,0,1,3,0,0,1,1037598,"2023-10-25T00:00:00.000Z",19465326,11,"Jock Landale",0,3,5,5,2,5
"2115",194,0,1,2,1,1,2,2,0,0,15,0,1,5,2,1,0,1037598,"2023-10-25T00:00:00.000Z",3547301,11,"Jae'Sean Tate",2,7,7,5,2,13.4
"2116",195,0,0,6,1,0,9,4,0,0,24,3,1,8,9,0,2,1037601,"2023-10-25T00:00:00.000Z",3547249,28,"Precious Achiuwa",0,17,17,8,9,16.8
"2117",196,4,0,5,0,0,18,6,9,7,34,8,0,19,13,2,0,1037600,"2023-10-25T00:00:00.000Z",79,16,"Jimmy Butler",2,32,36,23,17,46.6
"2118",197,2,0,8,6,3,9,4,2,2,28,2,5,13,10,0,1,1037600,"2023-10-25T00:00:00.000Z",285,16,"Kevin Love",0,23,25,15,12,27
"2119",198,3,2,6,0,0,13,7,10,8,32,2,3,22,8,0,2,1037600,"2023-10-25T00:00:00.000Z",4,16,"Bam Adebayo",2,30,33,25,11,40.1
"2120",199,3,0,2,7,2,24,7,0,0,34,0,1,16,2,3,2,1037600,"2023-10-25T00:00:00.000Z",666633,16,"Tyler Herro",3,18,21,19,5,29.9
"2121",200,2,1,2,0,0,1,0,0,0,32,0,4,0,2,2,0,1037600,"2023-10-25T00:00:00.000Z",286,16,"Kyle Lowry",3,2,4,2,4,14.4
"2122",201,1,0,2,0,0,1,0,0,0,15,1,0,0,3,0,0,1037682,"2023-11-05T00:00:00.000Z",18678001,4,"JT Thor",0,3,4,1,4,5.1
"2123",202,1,1,6,0,0,7,6,0,0,21,3,4,12,9,0,0,1037682,"2023-11-05T00:00:00.000Z",3547282,4,"Nick Richards",1,21,22,13,10,27.3
"2124",203,0,0,2,1,0,1,0,2,1,10,0,0,1,2,2,0,1037682,"2023-11-05T00:00:00.000Z",38017708,4,"Bryce McGowens",2,3,3,1,2,9.4
"2125",204,0,0,0,0,0,0,0,0,0,3,0,3,0,0,0,1,1037682,"2023-11-05T00:00:00.000Z",422,4,"Ish Smith",0,0,0,0,0,-1
"2126",205,0,0,0,0,0,0,0,0,0,0,0,0,0,0,0,0,1037682,"2023-11-05T00:00:00.000Z",56677846,4,"Nick Smith Jr.",0,0,0,0,0,0
"2127",206,0,0,0,0,0,0,0,0,0,0,0,0,0,0,0,0,1037682,"2023-11-05T00:00:00.000Z",17896037,4,"James Bouknight",0,0,0,0,0,0
"2128",207,0,0,0,0,0,0,0,0,0,0,0,0,0,0,0,0,1037682,"2023-11-05T00:00:00.000Z",62,4,"Miles Bridges",0,0,0,0,0,0
"2129",208,0,0,0,0,0,0,0,0,0,0,0,0,0,0,0,0,1037682,"2023-11-05T00:00:00.000Z",666748,4,"Cody Martin",0,0,0,0,0,0
"2130",209,0,0,0,0,0,0,0,0,0,0,0,0,0,0,0,0,1037682,"2023-11-05T00:00:00.000Z",347,4,"Frank Ntilikina",0,0,0,0,0,0
"2131",210,0,0,0,0,0,0,0,0,0,0,0,0,0,0,0,0,1037682,"2023-11-05T00:00:00.000Z",403,4,"Terry Rozier",0,0,0,0,0,0
"2132",211,3,0,1,13,4,22,10,4,3,38,2,3,27,3,0,2,1037683,"2023-11-05T00:00:00.000Z",182,25,"Jerami Grant",0,30,33,30,6,33.1
"2133",212,0,1,9,0,0,9,3,0,0,35,2,4,6,11,2,3,1037683,"2023-11-05T00:00:00.000Z",22,25,"Deandre Ayton",3,17,17,6,11,25.2
"2134",213,3,1,7,8,3,15,7,3,1,41,1,1,18,8,1,3,1037683,"2023-11-05T00:00:00.000Z",38017690,25,"Shaedon Sharpe",2,26,29,21,11,35.1
"2135",214,11,0,4,8,2,20,6,4,4,39,3,2,18,7,1,1,1037683,"2023-11-05T00:00:00.000Z",65,25,"Malcolm Brogdon",1,25,36,29,18,44.9
"2136",215,2,0,1,5,1,9,2,2,2,16,0,3,7,1,2,0,1037683,"2023-11-05T00:00:00.000Z",3547289,25,"Skylar Mays",2,8,10,9,3,17.2
"2137",216,2,0,3,3,2,5,3,0,0,25,3,1,8,6,1,3,1037683,"2023-11-05T00:00:00.000Z",56677850,25,"Toumani Camara",1,14,16,10,8,18.2
"2138",217,0,0,0,0,0,0,0,0,0,0,0,0,0,0,0,0,1037683,"2023-11-05T00:00:00.000Z",666476,25,"Moses Brown",0,0,0,0,0,0
"2139",218,0,0,0,0,0,0,0,0,0,0,0,0,0,0,0,0,1037683,"2023-11-05T00:00:00.000Z",47957121,25,"Justin Minaya",0,0,0,0,0,0
"2140",219,0,0,1,0,0,3,2,1,1,11,2,4,5,3,0,1,1037683,"2023-11-05T00:00:00.000Z",476,25,"Robert Williams III",0,8,8,5,3,7.6
"2141",220,1,1,2,5,0,9,2,1,1,16,3,2,5,5,3,0,1037683,"2023-11-05T00:00:00.000Z",38017711,25,"Jabari Walker",4,10,11,6,6,24.5
"2142",221,0,0,0,0,0,0,0,0,0,0,0,0,0,0,0,0,1037683,"2023-11-05T00:00:00.000Z",56677791,25,"Kris Murray",0,0,0,0,0,0
"2143",222,0,0,0,0,0,0,0,0,0,0,0,0,0,0,0,0,1037683,"2023-11-05T00:00:00.000Z",56677829,25,"Rayan Rupert",0,0,0,0,0,0
"2144",223,0,0,0,0,0,0,0,0,0,0,0,0,0,0,0,0,1037683,"2023-11-05T00:00:00.000Z",56677747,25,"Scoot Henderson",0,0,0,0,0,0
"2145",224,0,0,0,0,0,0,0,0,0,0,0,0,0,0,0,0,1037683,"2023-11-05T00:00:00.000Z",56783340,25,"Duop Reath",0,0,0,0,0,0
"2146",225,0,0,0,0,0,0,0,0,0,0,0,0,0,0,0,0,1037683,"2023-11-05T00:00:00.000Z",419,25,"Anfernee Simons",0,0,0,0,0,0
"2147",226,1,0,0,3,0,4,1,0,0,19,0,2,2,0,0,1,3277428,"2023-11-14T00:00:00.000Z",56677827,22,"Anthony Black",0,2,3,3,1,2.5
"2148",227,4,1,2,3,3,4,4,0,0,21,1,1,11,3,1,1,3277428,"2023-11-14T00:00:00.000Z",226,22,"Joe Ingles",2,14,18,15,7,25.6
"2149",228,2,0,3,8,2,10,2,4,4,28,3,0,10,6,0,4,3277428,"2023-11-14T00:00:00.000Z",3547251,22,"Cole Anthony",0,16,18,12,8,16.2
"2150",229,1,1,3,4,1,4,1,0,0,12,0,1,3,3,2,2,3277428,"2023-11-14T00:00:00.000Z",229,22,"Jonathan Isaac",3,6,7,4,4,15.1
"2151",230,0,0,0,1,1,1,1,0,0,5,0,1,3,0,0,0,3277428,"2023-11-14T00:00:00.000Z",38017724,22,"Caleb Houstan",0,3,3,3,0,3
"2152",231,0,0,0,4,0,4,0,0,0,4,0,0,0,0,0,0,3277428,"2023-11-14T00:00:00.000Z",56677839,22,"Jett Howard",0,0,0,0,0,0
"2153",232,0,0,0,0,0,0,0,0,0,2,0,0,0,0,0,0,3277428,"2023-11-14T00:00:00.000Z",666818,22,"Chuma Okeke",0,0,0,0,0,0
"2154",233,2,1,4,5,1,8,2,2,1,22,0,4,6,4,1,1,3277427,"2023-11-14T00:00:00.000Z",3547250,12,"Aaron Nesmith",2,10,12,8,6,18.8
"2155",234,4,0,1,1,0,3,1,0,0,10,1,1,2,2,1,0,3277427,"2023-11-14T00:00:00.000Z",38017507,12,"Andrew Nembhard",1,4,8,6,6,13.4
"2156",235,0,0,0,0,0,0,0,0,0,0,0,0,0,0,0,0,3277427,"2023-11-14T00:00:00.000Z",3547207,12,"Jordan Nwora",0,0,0,0,0,0
"2157",236,0,0,0,0,0,0,0,0,0,0,0,0,0,0,0,0,3277427,"2023-11-14T00:00:00.000Z",56677861,12,"Ben Sheppard",0,0,0,0,0,0
"2158",237,0,0,0,0,0,0,0,0,0,0,0,0,0,0,0,0,3277427,"2023-11-14T00:00:00.000Z",56677832,12,"Jarace Walker",0,0,0,0,0,0
"2159",238,0,0,0,0,0,0,0,0,0,0,0,0,0,0,0,0,3277427,"2023-11-14T00:00:00.000Z",38017701,12,"Kendall Brown",0,0,0,0,0,0
"2160",239,0,0,0,0,0,0,0,0,0,0,0,0,0,0,0,0,3277427,"2023-11-14T00:00:00.000Z",439,12,"Daniel Theis",0,0,0,0,0,0
"2161",240,0,0,0,0,0,0,0,0,0,0,0,0,0,0,0,0,3277427,"2023-11-14T00:00:00.000Z",56677778,12,"Oscar Tshiebwe",0,0,0,0,0,0
"2162",241,0,0,0,0,0,0,0,0,0,0,0,0,0,0,0,0,3277427,"2023-11-14T00:00:00.000Z",56677794,12,"Isaiah Wong",0,0,0,0,0,0
"2163",242,2,0,4,4,1,7,1,0,0,18,0,2,3,4,2,0,3277429,"2023-11-14T00:00:00.000Z",38017706,21,"Jaylin Williams",2,7,9,5,6,16.8
"2164",243,2,0,0,3,1,7,4,0,0,15,0,3,9,0,0,1,3277429,"2023-11-14T00:00:00.000Z",480,21,"Kenrich Williams",0,9,11,11,2,11
"2165",244,0,0,0,3,2,3,2,0,0,5,0,0,6,0,0,0,3277429,"2023-11-14T00:00:00.000Z",27924547,21,"Lindy Waters III",0,6,6,6,0,6
"2166",245,1,0,0,1,1,1,1,0,0,5,0,0,3,0,1,0,3277429,"2023-11-14T00:00:00.000Z",17896078,21,"Aaron Wiggins",1,3,4,4,1,7.5
"2167",246,0,0,0,0,0,0,0,0,0,0,0,0,0,0,0,0,3277429,"2023-11-14T00:00:00.000Z",38017716,21,"Ousmane Dieng",0,0,0,0,0,0
"2168",247,0,0,0,0,0,0,0,0,0,0,0,0,0,0,0,0,3277429,"2023-11-14T00:00:00.000Z",56677853,21,"Keyontae Johnson",0,0,0,0,0,0
"2169",248,0,0,0,0,0,0,0,0,0,0,0,0,0,0,0,0,3277429,"2023-11-14T00:00:00.000Z",24572055,21,"Olivier Sarr",0,0,0,0,0,0
"2170",249,3,3,2,7,3,14,4,2,2,31,1,0,13,3,4,2,3277429,"2023-11-14T00:00:00.000Z",38017649,27,"Julian Champagnie",7,16,19,16,6,40.1
"2171",250,2,2,11,3,0,15,4,0,0,28,3,2,8,14,0,5,3277429,"2023-11-14T00:00:00.000Z",56677822,27,"Victor Wembanyama",2,22,24,10,16,28.8
"2172",251,0,0,0,0,0,0,0,0,0,0,0,0,0,0,0,0,1037808,"2023-11-22T00:00:00.000Z",56677853,21,"Keyontae Johnson",0,0,0,0,0,0
"2173",252,0,0,0,0,0,0,0,0,0,0,0,0,0,0,0,0,1037808,"2023-11-22T00:00:00.000Z",24572055,21,"Olivier Sarr",0,0,0,0,0,0
"2174",253,0,0,0,0,0,0,0,0,0,0,0,0,0,0,0,0,1037808,"2023-11-22T00:00:00.000Z",38017703,21,"Jalen Williams",0,0,0,0,0,0
"2175",254,6,1,1,2,0,17,6,13,13,36,1,3,25,2,2,1,1037808,"2023-11-22T00:00:00.000Z",125,5,"DeMar DeRozan",3,27,33,31,8,44.4
"2176",255,1,0,5,6,2,12,5,0,0,27,1,1,12,6,1,0,1037808,"2023-11-22T00:00:00.000Z",89,5,"Alex Caruso",1,18,19,13,7,23.7
"2177",256,3,0,7,5,2,13,6,2,2,37,5,4,16,12,2,1,1037808,"2023-11-22T00:00:00.000Z",460,5,"Nikola Vucevic",2,28,31,19,15,39.9
"2178",257,0,0,3,3,0,3,0,0,0,15,0,4,0,3,0,1,1037808,"2023-11-22T00:00:00.000Z",110,5,"Torrey Craig",0,3,3,0,3,2.6
"2179",258,2,0,0,6,1,7,1,0,0,19,0,2,3,0,0,0,1037808,"2023-11-22T00:00:00.000Z",87,5,"Jevon Carter",0,3,5,5,2,6
"2180",259,0,0,0,0,0,0,0,0,0,0,0,0,0,0,0,0,1037800,"2023-11-22T00:00:00.000Z",17896103,8,"Jay Huff",0,0,0,0,0,0
"2181",260,0,0,0,0,0,0,0,0,0,0,0,0,0,0,0,0,1037800,"2023-11-22T00:00:00.000Z",335,8,"Jamal Murray",0,0,0,0,0,0
"2182",261,0,0,0,0,0,0,0,0,0,0,0,0,0,0,0,0,1037808,"2023-11-22T00:00:00.000Z",27,5,"Lonzo Ball",0,0,0,0,0,0
"2183",262,0,0,0,0,0,0,0,0,0,0,0,0,0,0,0,0,1037805,"2023-11-22T00:00:00.000Z",357,11,"Victor Oladipo",0,0,0,0,0,0
"2184",263,0,0,0,0,0,0,0,0,0,0,0,0,0,0,0,0,1037805,"2023-11-22T00:00:00.000Z",56677809,11,"Jermaine Samuels Jr.",0,0,0,0,0,0
"2185",264,0,0,0,0,0,0,0,0,0,0,0,0,0,0,0,0,1037805,"2023-11-22T00:00:00.000Z",56677825,11,"Amen Thompson",0,0,0,0,0,0
"2186",265,0,0,0,0,0,0,0,0,0,0,0,0,0,0,0,0,1037805,"2023-11-22T00:00:00.000Z",56677831,11,"Cam Whitmore",0,0,0,0,0,0
"2187",266,0,1,2,3,1,5,2,3,3,22,0,5,8,2,0,0,1037805,"2023-11-22T00:00:00.000Z",17896067,15,"Santi Aldama",1,10,10,8,2,13.4
"2188",267,0,1,6,4,0,21,7,12,9,37,1,4,23,7,1,2,1037805,"2023-11-22T00:00:00.000Z",231,15,"Jaren Jackson Jr.",2,30,30,23,7,35.4
"2189",268,2,2,5,0,0,4,2,2,1,32,0,0,5,5,1,1,1037805,"2023-11-22T00:00:00.000Z",48,15,"Bismack Biyombo",3,10,12,7,7,22
"2190",269,4,0,6,6,2,12,6,10,9,26,1,4,23,7,1,2,1037805,"2023-11-22T00:00:00.000Z",3547287,15,"Desmond Bane",1,30,34,27,11,38.4
"2191",270,1,0,4,5,0,14,4,5,5,27,1,4,13,5,1,1,1037805,"2023-11-22T00:00:00.000Z",66,11,"Dillon Brooks",1,18,19,14,6,22.5
"2192",271,2,1,9,4,3,10,6,4,3,27,0,2,18,9,0,0,1037805,"2023-11-22T00:00:00.000Z",38017684,11,"Jabari Smith Jr.",1,27,29,20,11,34.8
"2193",272,3,3,6,1,1,9,4,3,2,32,1,5,11,7,0,2,1037805,"2023-11-22T00:00:00.000Z",17896062,11,"Alperen Sengun",3,18,21,14,10,30.9
"2194",273,3,0,4,4,1,18,9,4,4,29,0,5,23,4,1,2,1037807,"2023-11-22T00:00:00.000Z",227,19,"Brandon Ingram",1,27,30,26,7,33.3
"2195",274,6,0,4,0,0,16,10,7,5,35,1,3,25,5,0,2,1037807,"2023-11-22T00:00:00.000Z",666969,19,"Zion Williamson",0,30,36,31,11,38
"2196",275,2,0,8,0,0,9,6,4,3,28,3,5,15,11,0,1,1037807,"2023-11-22T00:00:00.000Z",455,19,"Jonas Valanciunas",0,26,28,17,13,30.2
"2197",276,0,0,0,0,0,0,0,0,0,0,0,0,0,0,0,0,1037868,"2023-12-01T00:00:00.000Z",489,28,"Thaddeus Young",0,0,0,0,0,0
"2198",277,0,0,0,0,0,0,0,0,0,0,0,0,0,0,0,0,1037868,"2023-12-01T00:00:00.000Z",56677828,28,"Gradey Dick",0,0,0,0,0,0
"2199",278,1,0,0,1,1,2,1,0,0,10,0,1,3,0,1,2,1037869,"2023-12-01T00:00:00.000Z",17896027,15,"Ziaire Williams",1,3,4,4,1,5.5
"2200",279,0,0,0,0,0,0,0,0,0,0,0,0,0,0,0,0,1037869,"2023-12-01T00:00:00.000Z",3,15,"Steven Adams",0,0,0,0,0,0
"2201",280,0,0,0,0,0,0,0,0,0,0,0,0,0,0,0,0,1037869,"2023-12-01T00:00:00.000Z",666505,15,"Brandon Clarke",0,0,0,0,0,0
"2202",281,0,0,0,0,0,0,0,0,0,0,0,0,0,0,0,0,1037869,"2023-12-01T00:00:00.000Z",56677830,15,"GG Jackson",0,0,0,0,0,0
"2203",282,0,0,0,0,0,0,0,0,0,0,0,0,0,0,0,0,1037869,"2023-12-01T00:00:00.000Z",254,15,"Luke Kennard",0,0,0,0,0,0
"2204",283,0,0,0,0,0,0,0,0,0,0,0,0,0,0,0,0,1037869,"2023-12-01T00:00:00.000Z",38017728,15,"Jake LaRavia",0,0,0,0,0,0
"2205",284,0,0,0,0,0,0,0,0,0,0,0,0,0,0,0,0,1037869,"2023-12-01T00:00:00.000Z",666786,15,"Ja Morant",0,0,0,0,0,0
"2206",285,0,0,0,0,0,0,0,0,0,0,0,0,0,0,0,0,1037869,"2023-12-01T00:00:00.000Z",420,15,"Marcus Smart",0,0,0,0,0,0
"2207",286,3,0,1,6,4,11,4,4,3,23,0,2,15,1,0,0,1037866,"2023-12-01T00:00:00.000Z",17896045,30,"Corey Kispert",0,16,19,18,4,20.7
"2208",287,2,0,0,3,3,8,5,3,0,18,0,4,13,0,0,2,1037866,"2023-12-01T00:00:00.000Z",414,30,"Landry Shamet",0,13,15,15,2,14
"2209",288,0,0,0,0,0,0,0,0,0,0,0,0,0,0,0,0,1037866,"2023-12-01T00:00:00.000Z",3547302,30,"Anthony Gill",0,0,0,0,0,0
"2210",289,0,0,0,0,0,0,0,0,0,0,0,0,0,0,0,0,1037866,"2023-12-01T00:00:00.000Z",337,30,"Mike Muscala",0,0,0,0,0,0
"2211",290,0,0,0,0,0,0,0,0,0,0,0,0,0,0,0,0,1037866,"2023-12-01T00:00:00.000Z",17896106,30,"Eugene Omoruyi",0,0,0,0,0,0
"2212",291,0,0,0,0,0,0,0,0,0,0,0,0,0,0,0,0,1037866,"2023-12-01T00:00:00.000Z",38124126,30,"John Butler Jr.",0,0,0,0,0,0
"2213",292,0,0,0,0,0,0,0,0,0,0,0,0,0,0,0,0,1037866,"2023-12-01T00:00:00.000Z",38017712,30,"Ryan Rollins",0,0,0,0,0,0
"2214",293,0,0,0,0,0,0,0,0,0,0,0,0,0,0,0,0,1037866,"2023-12-01T00:00:00.000Z",487,30,"Delon Wright",0,0,0,0,0,0
"2215",294,0,0,0,0,0,0,0,0,0,0,0,0,0,0,0,0,1037868,"2023-12-01T00:00:00.000Z",38017717,28,"Ron Harper Jr.",0,0,0,0,0,0
"2216",295,0,0,0,0,0,0,0,0,0,0,0,0,0,0,0,0,1037868,"2023-12-01T00:00:00.000Z",38017710,28,"Christian Koloko",0,0,0,0,0,0
"2217",296,0,0,0,0,0,0,0,0,0,0,0,0,0,0,0,0,1037868,"2023-12-01T00:00:00.000Z",56677869,28,"Markquis Nowell",0,0,0,0,0,0
"2218",297,6,0,3,6,1,18,6,3,2,27,1,1,15,4,0,2,1037868,"2023-12-01T00:00:00.000Z",666423,20,"RJ Barrett",0,19,25,21,10,26.8
"2219",298,9,0,8,4,1,15,8,3,3,35,2,3,20,10,0,2,1037868,"2023-12-01T00:00:00.000Z",387,20,"Julius Randle",0,30,39,29,19,43.5
"2220",299,1,1,3,0,0,3,3,0,0,32,2,3,6,5,4,2,1037868,"2023-12-01T00:00:00.000Z",399,20,"Mitchell Robinson",5,11,12,7,6,26.5
"2221",300,8,0,5,8,3,21,9,1,1,37,0,2,22,5,1,2,1037868,"2023-12-01T00:00:00.000Z",73,20,"Jalen Brunson",1,27,35,30,13,41
"2222",301,0,0,0,0,0,0,0,0,0,0,0,0,0,0,0,0,1037899,"2023-12-12T00:00:00.000Z",56677874,5,"Onuralp Bitim",0,0,0,0,0,0
"2223",302,0,0,0,0,0,0,0,0,0,0,0,0,0,0,0,0,1037899,"2023-12-12T00:00:00.000Z",268,5,"Zach LaVine",0,0,0,0,0,0
"2224",303,0,0,0,0,0,0,0,0,0,0,0,0,0,0,0,0,1037899,"2023-12-12T00:00:00.000Z",45969255,5,"Justin Lewis",0,0,0,0,0,0
"2225",304,0,0,0,0,0,0,0,0,0,0,0,0,0,0,0,0,1037899,"2023-12-12T00:00:00.000Z",56677860,5,"Adama Sanogo",0,0,0,0,0,0
"2226",305,0,0,7,8,2,16,6,4,3,32,0,1,17,7,1,0,1037899,"2023-12-12T00:00:00.000Z",375,8,"Michael Porter Jr.",1,24,24,17,7,28.4
"2227",306,6,0,2,2,1,13,6,2,1,32,5,1,14,7,0,0,1037899,"2023-12-12T00:00:00.000Z",177,8,"Aaron Gordon",0,21,27,20,13,31.4
"2228",307,6,0,6,0,0,5,2,0,0,16,3,1,4,9,0,0,1037899,"2023-12-12T00:00:00.000Z",246,8,"Nikola Jokic",0,13,19,10,15,23.8
"2229",308,0,0,1,0,0,4,2,0,0,12,0,2,4,1,0,0,1037899,"2023-12-12T00:00:00.000Z",81,8,"Kentavious Caldwell-Pope",0,5,5,4,1,5.2
"2230",309,6,0,2,8,5,16,9,2,2,32,0,4,25,2,0,2,1037899,"2023-12-12T00:00:00.000Z",236,8,"Reggie Jackson",0,27,33,31,8,34.4
"2231",310,2,1,1,4,2,6,4,4,3,23,1,1,13,2,0,3,1037899,"2023-12-12T00:00:00.000Z",38017709,8,"Christian Braun",1,15,17,15,4,18.4
"2232",311,3,0,6,5,2,9,4,8,6,23,0,1,16,6,1,2,1037899,"2023-12-12T00:00:00.000Z",56677776,8,"Julian Strawther",1,22,25,19,9,28.7
"2233",312,2,0,0,3,2,4,3,0,0,23,1,3,8,1,0,0,1037899,"2023-12-12T00:00:00.000Z",215,8,"Justin Holiday",0,9,11,10,3,12.2
"2234",313,1,1,0,0,0,6,1,2,2,23,1,1,4,1,1,1,1037899,"2023-12-12T00:00:00.000Z",38017721,8,"Peyton Watson",2,5,6,5,2,11.7
"2235",314,2,2,6,0,0,4,2,10,5,24,4,5,9,10,1,2,1037899,"2023-12-12T00:00:00.000Z",250,8,"DeAndre Jordan",3,19,21,11,12,31
"2236",315,0,0,0,0,0,0,0,0,0,0,0,0,0,0,0,0,1037899,"2023-12-12T00:00:00.000Z",3547268,8,"Zeke Nnaji",0,0,0,0,0,0
"2237",316,1,0,2,0,0,1,0,0,0,13,2,4,0,4,0,0,1037898,"2023-12-12T00:00:00.000Z",666626,14,"Jaxson Hayes",0,4,5,1,5,6.3
"2238",317,8,0,5,7,4,14,7,5,4,32,0,2,22,5,0,3,1037898,"2023-12-12T00:00:00.000Z",17553995,14,"Austin Reaves",0,27,35,30,13,37
"2239",318,2,0,3,2,1,9,3,0,0,28,0,3,7,3,1,1,1037898,"2023-12-12T00:00:00.000Z",666609,14,"Rui Hachimura",1,10,12,9,5,15.6
"2240",319,1,0,0,0,0,0,0,0,0,6,0,1,0,0,0,0,1037898,"2023-12-12T00:00:00.000Z",38017697,14,"Max Christie",0,0,1,1,1,1.5
"2241",320,0,0,0,0,0,0,0,0,0,0,0,0,0,0,0,0,1037898,"2023-12-12T00:00:00.000Z",457,14,"Jarred Vanderbilt",0,0,0,0,0,0
"2242",321,0,0,0,0,0,0,0,0,0,0,0,0,0,0,0,0,1037898,"2023-12-12T00:00:00.000Z",1603383,14,"Gabe Vincent",0,0,0,0,0,0
"2243",322,0,0,0,0,0,0,0,0,0,0,0,0,0,0,0,0,1037898,"2023-12-12T00:00:00.000Z",486,14,"Christian Wood",0,0,0,0,0,0
"2244",323,0,0,0,0,0,0,0,0,0,0,0,0,0,0,0,0,1037898,"2023-12-12T00:00:00.000Z",56677738,14,"Colin Castleton",0,0,0,0,0,0
"2245",324,0,0,0,0,0,0,0,0,0,0,0,0,0,0,0,0,1037898,"2023-12-12T00:00:00.000Z",56677867,14,"Alex Fudge",0,0,0,0,0,0
"2246",325,0,0,0,0,0,0,0,0,0,0,0,0,0,0,0,0,1037898,"2023-12-12T00:00:00.000Z",56677868,14,"D'Moi Hodge",0,0,0,0,0,0
"2247",326,2,0,10,2,1,14,9,5,4,38,3,4,23,13,0,4,1037959,"2023-12-20T00:00:00.000Z",447,18,"Karl-Anthony Towns",0,36,38,25,15,37.6
"2248",327,1,0,7,0,0,4,3,2,2,24,2,4,8,9,2,0,1037959,"2023-12-20T00:00:00.000Z",176,18,"Rudy Gobert",2,17,18,9,10,26.3
"2249",328,5,0,6,6,2,20,9,8,7,36,1,2,27,7,0,1,1037959,"2023-12-20T00:00:00.000Z",3547238,18,"Anthony Edwards",0,34,39,32,12,41.9
"2250",329,4,0,0,4,1,7,3,2,2,26,0,1,9,0,0,2,1037959,"2023-12-20T00:00:00.000Z",104,18,"Mike Conley",0,9,13,13,4,13
"2251",330,1,1,1,6,2,9,4,0,0,20,1,3,10,2,0,4,1037959,"2023-12-20T00:00:00.000Z",667378,18,"Naz Reid",1,12,13,11,3,12.9
"2252",331,1,0,0,0,0,5,1,0,0,13,0,0,2,0,0,2,1037959,"2023-12-20T00:00:00.000Z",12,18,"Kyle Anderson",0,2,3,3,1,1.5
"2253",332,2,1,2,1,0,3,2,0,0,16,0,1,4,2,0,0,1037959,"2023-12-20T00:00:00.000Z",666400,18,"Nickeil Alexander-Walker",1,6,8,6,4,12.4
"2254",333,1,0,1,2,1,4,2,0,0,10,1,0,5,2,0,3,1037959,"2023-12-20T00:00:00.000Z",68,18,"Troy Brown Jr.",0,7,8,6,3,5.9
"2255",334,3,0,0,0,0,2,0,2,2,13,0,2,2,0,0,1,1037959,"2023-12-20T00:00:00.000Z",320,18,"Shake Milton",0,2,5,5,3,5.5
"2256",335,1,0,0,0,0,0,0,0,0,2,0,0,0,0,0,0,1037959,"2023-12-20T00:00:00.000Z",666767,18,"Jordan McLaughlin",0,0,1,1,1,1.5
"2257",336,0,0,0,0,0,1,1,0,0,2,0,0,2,0,1,1,1037959,"2023-12-20T00:00:00.000Z",38017700,18,"Wendell Moore Jr.",1,2,2,2,0,4
"2258",337,1,0,1,1,0,1,0,0,0,2,0,2,0,1,0,0,1037959,"2023-12-20T00:00:00.000Z",17896056,18,"Luka Garza",0,1,2,1,2,2.7
"2259",338,0,0,0,0,0,0,0,0,0,0,0,0,0,0,0,0,1037959,"2023-12-20T00:00:00.000Z",56677782,18,"Leonard Miller",0,0,0,0,0,0
"2260",339,0,0,0,0,0,0,0,0,0,0,0,0,0,0,0,0,1037959,"2023-12-20T00:00:00.000Z",56677851,18,"Jaylen Clark",0,0,0,0,0,0
"2261",340,0,0,0,0,0,0,0,0,0,0,0,0,0,0,0,0,1037959,"2023-12-20T00:00:00.000Z",38017715,18,"Josh Minott",0,0,0,0,0,0
"2262",341,0,0,0,0,0,0,0,0,0,0,0,0,0,0,0,0,1037959,"2023-12-20T00:00:00.000Z",17895968,18,"Daishen Nix",0,0,0,0,0,0
"2263",342,1,0,3,2,1,7,4,0,0,12,1,3,9,4,1,1,1037958,"2023-12-20T00:00:00.000Z",229,22,"Jonathan Isaac",1,13,14,10,5,17.3
"2264",343,1,0,2,0,0,8,5,1,1,18,5,5,11,7,0,2,1037958,"2023-12-20T00:00:00.000Z",462,22,"Moritz Wagner",0,18,19,12,8,18.9
"2265",344,1,0,2,2,1,3,2,0,0,5,0,1,5,2,1,0,1037958,"2023-12-20T00:00:00.000Z",666818,22,"Chuma Okeke",1,7,8,6,3,11.9
"2266",345,0,0,0,0,0,0,0,0,0,0,0,0,0,0,0,0,1037958,"2023-12-20T00:00:00.000Z",165,22,"Markelle Fultz",0,0,0,0,0,0
"2267",346,0,0,0,0,0,0,0,0,0,0,0,0,0,0,0,0,1037958,"2023-12-20T00:00:00.000Z",38017607,22,"Kevon Harris",0,0,0,0,0,0
"2268",347,0,0,0,0,0,0,0,0,0,0,0,0,0,0,0,0,1037958,"2023-12-20T00:00:00.000Z",79,16,"Jimmy Butler",0,0,0,0,0,0
"2269",348,0,0,0,0,0,0,0,0,0,0,0,0,0,0,0,0,1037958,"2023-12-20T00:00:00.000Z",3547257,16,"R.J. Hampton",0,0,0,0,0,0
"2270",349,0,0,0,0,0,0,0,0,0,0,0,0,0,0,0,0,1037958,"2023-12-20T00:00:00.000Z",285,16,"Kevin Love",0,0,0,0,0,0
"2271",350,0,0,0,0,0,0,0,0,0,0,0,0,0,0,0,0,1037958,"2023-12-20T00:00:00.000Z",19465585,16,"Dru Smith",0,0,0,0,0,0
"2272",351,3,1,4,5,1,8,4,1,1,25,2,1,10,6,2,1,1038017,"2023-12-28T00:00:00.000Z",666703,15,"John Konchar",3,16,19,13,9,29.7
"2273",352,5,0,4,12,3,19,7,7,7,35,6,1,24,10,1,3,1038016,"2023-12-28T00:00:00.000Z",297,29,"Lauri Markkanen",1,34,39,29,15,43.5
"2274",353,0,1,9,3,1,7,3,2,1,26,3,2,8,12,0,1,1038016,"2023-12-28T00:00:00.000Z",101,29,"John Collins",1,20,20,8,12,24.4
"2275",354,0,1,1,1,1,5,5,0,0,29,3,1,11,4,2,1,1038016,"2023-12-28T00:00:00.000Z",38017705,29,"Walker Kessler",3,15,15,11,4,23.8
"2276",355,3,1,0,3,1,5,3,0,0,19,0,2,7,0,0,0,1038016,"2023-12-28T00:00:00.000Z",139,29,"Kris Dunn",1,7,10,10,3,14.5
"2277",356,3,0,4,6,3,17,8,9,7,30,1,4,26,5,0,0,1038016,"2023-12-28T00:00:00.000Z",413,29,"Collin Sexton",0,31,34,29,8,36.5
"2278",357,6,0,2,5,1,11,3,3,3,24,0,0,10,2,0,6,1038016,"2023-12-28T00:00:00.000Z",100,29,"Jordan Clarkson",0,12,18,16,8,15.4
"2279",358,1,1,0,3,2,3,2,0,0,12,0,0,6,0,0,0,1038017,"2023-12-28T00:00:00.000Z",48248287,15,"Jacob Gilyard",1,6,7,7,1,10.5
"2280",359,0,0,0,0,0,0,0,0,0,0,0,0,0,0,0,0,1038017,"2023-12-28T00:00:00.000Z",17896067,15,"Santi Aldama",0,0,0,0,0,0
"2281",360,0,0,0,0,0,0,0,0,0,0,0,0,0,0,0,0,1038017,"2023-12-28T00:00:00.000Z",666786,15,"Ja Morant",0,0,0,0,0,0
"2282",361,0,0,0,0,0,0,0,0,0,1,0,0,0,0,0,0,1038014,"2023-12-28T00:00:00.000Z",56677857,5,"Julian Phillips",0,0,0,0,0,0
"2283",362,0,0,0,0,0,0,0,0,0,1,0,0,0,0,0,0,1038014,"2023-12-28T00:00:00.000Z",56677860,5,"Adama Sanogo",0,0,0,0,0,0
"2284",363,4,0,2,3,0,13,4,0,0,24,1,3,8,3,1,1,1038014,"2023-12-28T00:00:00.000Z",38017507,12,"Andrew Nembhard",1,11,15,12,7,19.6
"2285",364,20,1,3,13,6,17,7,2,1,37,0,2,21,3,2,0,1038014,"2023-12-28T00:00:00.000Z",3547245,12,"Tyrese Haliburton",3,24,44,41,23,63.6
"2286",365,0,0,0,0,0,0,0,0,0,0,0,0,0,0,0,0,1038014,"2023-12-28T00:00:00.000Z",38017701,12,"Kendall Brown",0,0,0,0,0,0
"2287",366,0,0,0,0,0,0,0,0,0,0,0,0,0,0,0,0,1038014,"2023-12-28T00:00:00.000Z",56677778,12,"Oscar Tshiebwe",0,0,0,0,0,0
"2288",367,0,0,0,0,0,0,0,0,0,0,0,0,0,0,0,0,1038014,"2023-12-28T00:00:00.000Z",56677794,12,"Isaiah Wong",0,0,0,0,0,0
"2289",368,1,1,1,3,1,8,2,2,2,24,1,1,7,2,1,1,1038017,"2023-12-28T00:00:00.000Z",17896027,15,"Ziaire Williams",2,9,10,8,3,15.9
"2290",369,0,0,4,1,0,5,0,2,1,21,3,1,1,7,0,1,1038019,"2023-12-28T00:00:00.000Z",56677850,25,"Toumani Camara",0,8,8,1,7,8.4
"2291",370,5,0,7,5,1,21,9,13,10,41,3,4,29,10,0,4,1038019,"2023-12-28T00:00:00.000Z",182,25,"Jerami Grant",0,39,44,34,15,44.5
"2292",371,0,0,2,0,0,6,2,0,0,14,5,3,4,7,0,0,1038019,"2023-12-28T00:00:00.000Z",666476,25,"Moses Brown",0,11,11,4,7,12.4
"2293",372,6,0,5,8,6,19,10,5,3,37,1,1,29,6,1,1,1038019,"2023-12-28T00:00:00.000Z",65,25,"Malcolm Brogdon",1,35,41,35,12,47.2
"2294",373,4,0,1,7,3,23,8,6,6,36,2,5,25,3,1,6,1038019,"2023-12-28T00:00:00.000Z",56677747,25,"Scoot Henderson",1,28,32,29,7,31.6
"2295",374,1,0,2,7,1,7,1,2,1,28,0,1,4,2,2,0,1038019,"2023-12-28T00:00:00.000Z",666923,25,"Matisse Thybulle",2,6,7,5,3,13.9
"2296",375,0,0,2,4,0,8,0,0,0,14,1,0,0,3,1,0,1038019,"2023-12-28T00:00:00.000Z",3547289,25,"Skylar Mays",1,3,3,0,3,6.6
"2297",376,5,2,9,7,3,18,10,1,1,29,0,0,24,9,2,1,1038079,"2024-01-05T00:00:00.000Z",228,7,"Kyrie Irving",4,33,38,29,14,53.3
"2298",377,4,1,2,7,3,14,8,1,0,27,0,3,19,2,1,1,1038079,"2024-01-05T00:00:00.000Z",191,7,"Tim Hardaway Jr.",2,21,25,23,6,32.4
"2299",378,1,0,1,4,1,9,4,0,0,20,1,2,9,2,0,0,1038079,"2024-01-05T00:00:00.000Z",114,7,"Seth Curry",0,11,12,10,3,12.9
"2300",379,2,0,4,4,1,8,4,6,5,25,1,5,14,5,2,2,1038079,"2024-01-05T00:00:00.000Z",17554004,7,"AJ Lawson",2,19,21,16,7,27
"2301",380,0,0,0,0,0,0,0,0,0,0,0,0,0,0,0,0,1038078,"2024-01-05T00:00:00.000Z",56677856,13,"Jordan Miller",0,0,0,0,0,0
"2302",381,0,0,0,0,0,0,0,0,0,0,0,0,0,0,0,0,1038078,"2024-01-05T00:00:00.000Z",24417679,13,"Xavier Moon",0,0,0,0,0,0
"2303",382,0,0,0,0,0,0,0,0,0,0,0,0,0,0,0,0,1038078,"2024-01-05T00:00:00.000Z",17896051,13,"Joshua Primo",0,0,0,0,0,0
"2304",383,1,3,1,2,1,5,3,0,0,12,1,2,7,2,0,2,1038079,"2024-01-05T00:00:00.000Z",17896028,7,"Greg Brown III",3,9,10,8,3,17.9
"2305",384,4,2,3,14,9,19,11,0,0,37,1,4,31,4,0,2,1038081,"2024-01-05T00:00:00.000Z",8,24,"Grayson Allen",2,35,39,35,8,45.8
"2306",385,0,0,2,0,0,3,3,1,1,17,0,0,7,2,2,2,1038081,"2024-01-05T00:00:00.000Z",314,24,"Chimezie Metu",2,9,9,7,2,13.4
"2307",386,2,0,8,1,0,6,3,0,0,26,1,2,6,9,1,0,1038081,"2024-01-05T00:00:00.000Z",349,24,"Jusuf Nurkic",1,15,17,8,11,22.8
"2308",387,0,0,0,0,0,0,0,0,0,0,0,0,0,0,0,0,1038079,"2024-01-05T00:00:00.000Z",132,7,"Luka Doncic",0,0,0,0,0,0
"2309",388,0,0,0,0,0,0,0,0,0,0,0,0,0,0,0,0,1038079,"2024-01-05T00:00:00.000Z",151,7,"Dante Exum",0,0,0,0,0,0
"2310",389,0,0,0,0,0,0,0,0,0,0,0,0,0,0,0,0,1038079,"2024-01-05T00:00:00.000Z",217,7,"Richaun Holmes",0,0,0,0,0,0
"2311",390,0,0,0,0,0,0,0,0,0,0,0,0,0,0,0,0,1038079,"2024-01-05T00:00:00.000Z",257,7,"Maxi Kleber",0,0,0,0,0,0
"2312",391,0,0,0,0,0,0,0,0,0,0,0,0,0,0,0,0,1038079,"2024-01-05T00:00:00.000Z",56677840,7,"Dereck Lively II",0,0,0,0,0,0
"2313",392,0,0,0,0,0,0,0,0,0,0,0,0,0,0,0,0,1038079,"2024-01-05T00:00:00.000Z",329,7,"Markieff Morris",0,0,0,0,0,0
"2314",393,0,0,0,0,0,0,0,0,0,0,0,0,0,0,0,0,1038079,"2024-01-05T00:00:00.000Z",666965,7,"Grant Williams",0,0,0,0,0,0
"2315",394,9,0,7,6,2,18,11,1,1,37,1,2,25,8,0,2,1038081,"2024-01-05T00:00:00.000Z",37,24,"Bradley Beal",0,33,42,34,17,46.1
"2316",395,10,0,5,7,2,19,9,0,0,35,0,2,20,5,2,3,1038081,"2024-01-05T00:00:00.000Z",57,24,"Devin Booker",2,25,35,30,15,44
"2317",396,4,2,1,1,0,2,0,8,7,24,1,5,7,2,3,0,1038081,"2024-01-05T00:00:00.000Z",356,24,"Josh Okogie",5,9,13,11,6,30.4
"2318",397,0,0,0,0,0,0,0,0,0,2,0,0,0,0,0,0,1038075,"2024-01-05T00:00:00.000Z",17896063,20,"Jericho Sims",0,0,0,0,0,0
"2319",398,0,0,0,0,0,0,0,0,0,0,0,0,0,0,0,0,1038075,"2024-01-05T00:00:00.000Z",160,20,"Evan Fournier",0,0,0,0,0,0
"2320",399,0,0,0,0,0,0,0,0,0,0,0,0,0,0,0,0,1038075,"2024-01-05T00:00:00.000Z",173,20,"Taj Gibson",0,0,0,0,0,0
"2321",400,13,0,3,6,1,7,2,3,3,29,0,2,8,3,0,1,1038078,"2024-01-05T00:00:00.000Z",192,13,"James Harden",0,11,24,21,16,30.1
"2322",401,0,0,2,4,1,12,6,2,2,29,3,1,15,5,5,2,1037595,"2023-10-25T00:00:00.000Z",3547256,1,"Saddiq Bey",5,20,20,15,5,34
"2323",402,0,0,7,0,0,10,6,4,3,29,6,1,15,13,1,2,1037595,"2023-10-25T00:00:00.000Z",83,1,"Clint Capela",1,28,28,15,13,31.6
"2324",403,6,0,2,3,0,14,3,6,5,33,0,0,11,2,0,1,1037595,"2023-10-25T00:00:00.000Z",334,1,"Dejounte Murray",0,13,19,17,8,21.4
"2325",404,1,2,6,9,4,13,5,1,1,30,2,4,15,8,1,0,1037604,"2023-10-25T00:00:00.000Z",38017688,26,"Keegan Murray",3,23,24,16,9,35.1
"2326",405,0,0,0,4,2,5,3,0,0,16,0,0,8,0,0,0,1037615,"2023-10-27T00:00:00.000Z",305,27,"Doug McDermott",0,8,8,8,0,8
"2327",406,0,0,0,0,0,0,0,0,0,0,0,0,0,0,0,0,1037615,"2023-10-27T00:00:00.000Z",17896059,27,"Sandro Mamukelashvili",0,0,0,0,0,0
"2328",407,3,1,1,1,0,4,2,2,0,13,0,1,4,1,0,1,1037615,"2023-10-27T00:00:00.000Z",56677825,11,"Amen Thompson",1,5,8,7,4,11.7
"2329",408,0,0,0,1,0,2,1,1,1,14,0,1,3,0,3,1,1037615,"2023-10-27T00:00:00.000Z",3547301,11,"Jae'Sean Tate",3,3,3,3,0,11
"2330",409,2,1,3,4,1,5,2,0,0,23,1,2,5,4,3,0,1037606,"2023-10-25T00:00:00.000Z",108,13,"Robert Covington",4,9,11,7,6,24.8
"2331",410,0,0,0,1,0,1,0,0,0,3,0,0,0,0,0,0,1037602,"2023-10-25T00:00:00.000Z",27924547,21,"Lindy Waters III",0,0,0,0,0,0
"2332",411,0,0,2,1,0,1,0,0,0,2,0,0,0,2,0,0,1037602,"2023-10-25T00:00:00.000Z",3547271,21,"Aleksej Pokusevski",0,2,2,0,2,2.4
"2333",412,1,0,0,0,0,0,0,0,0,2,0,0,0,0,0,0,1037602,"2023-10-25T00:00:00.000Z",17896036,21,"Tre Mann",0,0,1,1,1,1.5
"2334",413,0,0,0,0,0,0,0,0,0,0,0,0,0,0,0,0,1037602,"2023-10-25T00:00:00.000Z",44,21,"Davis Bertans",0,0,0,0,0,0
"2335",414,0,0,0,0,0,0,0,0,0,0,0,0,0,0,0,0,1037602,"2023-10-25T00:00:00.000Z",4197029,21,"Vasilije Micic",0,0,0,0,0,0
"2336",415,0,0,0,0,0,0,0,0,0,0,0,0,0,0,0,0,1037602,"2023-10-25T00:00:00.000Z",56677853,21,"Keyontae Johnson",0,0,0,0,0,0
"2337",416,0,0,0,0,0,0,0,0,0,0,0,0,0,0,0,0,1037602,"2023-10-25T00:00:00.000Z",38017706,21,"Jaylin Williams",0,0,0,0,0,0
"2338",417,0,0,0,0,0,0,0,0,0,0,0,0,0,0,0,0,1037602,"2023-10-25T00:00:00.000Z",480,21,"Kenrich Williams",0,0,0,0,0,0
"2339",418,6,1,4,5,5,17,9,0,0,29,1,2,23,5,1,4,1037606,"2023-10-25T00:00:00.000Z",274,13,"Kawhi Leonard",2,28,34,29,11,40
"2340",419,0,4,7,0,0,10,8,5,4,26,5,3,20,12,0,2,1037606,"2023-10-25T00:00:00.000Z",493,13,"Ivica Zubac",4,32,32,20,12,44.4
"2341",420,6,0,3,7,4,17,11,1,1,32,0,2,27,3,3,4,1037606,"2023-10-25T00:00:00.000Z",172,13,"Paul George",3,30,36,33,9,44.6
"2342",421,13,0,3,2,1,8,5,0,0,29,2,3,11,5,0,3,1037606,"2023-10-25T00:00:00.000Z",472,13,"Russell Westbrook",0,16,29,24,18,33.5
"2343",422,1,1,3,0,0,0,0,0,0,9,0,0,0,3,1,0,1037606,"2023-10-25T00:00:00.000Z",33,13,"Nicolas Batum",2,3,4,1,4,11.1
"2344",423,0,0,0,1,0,2,0,0,0,5,0,1,0,0,0,0,1037606,"2023-10-25T00:00:00.000Z",56677849,13,"Kobe Brown",0,0,0,0,0,0
"2345",424,1,0,0,0,0,1,0,2,2,4,0,0,2,0,0,0,1037606,"2023-10-25T00:00:00.000Z",666511,13,"Amir Coffey",0,2,3,3,1,3.5
"2346",425,1,0,0,0,0,2,2,0,0,7,0,1,4,0,0,0,1037615,"2023-10-27T00:00:00.000Z",296,11,"Boban Marjanovic",0,4,5,5,1,5.5
"2347",426,3,0,4,0,0,15,8,2,2,30,0,3,18,4,0,4,3277351,"2023-11-03T00:00:00.000Z",4,16,"Bam Adebayo",0,22,25,21,7,23.3
"2348",427,9,0,10,7,4,17,9,2,2,37,0,3,24,10,2,3,3277351,"2023-11-03T00:00:00.000Z",666633,16,"Tyler Herro",2,34,43,33,19,52.5
"2349",428,7,0,1,4,1,4,1,0,0,26,2,1,3,3,2,2,3277351,"2023-11-03T00:00:00.000Z",286,16,"Kyle Lowry",2,6,13,10,10,21.1
"2350",429,0,1,2,0,0,7,5,2,1,18,2,4,11,4,0,2,3277351,"2023-11-03T00:00:00.000Z",74,16,"Thomas Bryant",1,15,15,11,4,16.8
"2351",430,0,0,0,0,0,0,0,0,0,0,0,0,0,0,0,0,3277353,"2023-11-03T00:00:00.000Z",56677858,10,"Brandin Podziemski",0,0,0,0,0,0
"2352",431,0,0,0,0,0,0,0,0,0,0,0,0,0,0,0,0,3277353,"2023-11-03T00:00:00.000Z",45658838,10,"Lester Quinones",0,0,0,0,0,0
"2353",432,3,0,2,8,3,17,8,2,1,33,0,0,20,2,0,0,3277352,"2023-11-03T00:00:00.000Z",61,3,"Mikal Bridges",0,22,25,23,5,26.9
"2354",433,0,1,1,9,5,14,8,0,0,33,2,1,21,3,0,0,3277352,"2023-11-03T00:00:00.000Z",158,3,"Dorian Finney-Smith",1,24,24,21,3,27.6
"2355",434,9,0,3,4,2,7,4,0,0,31,0,0,10,3,2,3,3277352,"2023-11-03T00:00:00.000Z",130,3,"Spencer Dinwiddie",2,13,22,19,12,30.1
"2356",435,6,0,6,0,0,8,4,0,0,33,3,3,8,9,1,4,3277352,"2023-11-03T00:00:00.000Z",417,3,"Ben Simmons",1,17,23,14,15,26.8
"2357",436,8,1,5,9,3,10,3,0,0,32,0,4,9,5,0,0,3277352,"2023-11-03T00:00:00.000Z",351,3,"Royce O'Neale",1,14,22,17,13,30
"2358",437,1,1,1,4,1,10,5,0,0,16,0,2,11,1,0,0,3277352,"2023-11-03T00:00:00.000Z",464,3,"Lonnie Walker IV",1,12,13,12,2,16.7
"2359",438,1,0,0,2,1,9,3,0,0,16,1,0,7,1,1,1,3277352,"2023-11-03T00:00:00.000Z",421,3,"Dennis Smith Jr.",1,8,9,8,2,11.7
"2360",439,1,0,5,6,2,9,4,2,2,27,0,2,12,5,0,0,3277349,"2023-11-03T00:00:00.000Z",344,6,"Georges Niang",0,17,18,13,6,19.5
"2361",440,3,0,5,7,4,9,6,4,4,20,1,2,20,6,1,1,3277353,"2023-11-03T00:00:00.000Z",407,10,"Dario Saric",1,26,29,23,9,33.7
"2362",441,13,0,2,2,0,6,0,2,1,28,0,1,1,2,2,0,3277353,"2023-11-03T00:00:00.000Z",367,10,"Chris Paul",2,3,16,14,15,28.9
"2363",442,1,0,3,3,1,6,4,0,0,22,0,2,9,3,2,1,3277353,"2023-11-03T00:00:00.000Z",2189,10,"Gary Payton II",2,12,13,10,4,19.1
"2364",443,0,0,0,0,0,0,0,0,0,0,0,0,0,0,0,0,3277353,"2023-11-03T00:00:00.000Z",398,10,"Jerome Robinson",0,0,0,0,0,0
"2365",444,4,1,5,4,0,12,5,4,3,30,0,2,13,5,0,1,3277349,"2023-11-03T00:00:00.000Z",277,6,"Caris LeVert",1,18,22,17,9,27
"2366",445,2,0,1,1,1,3,2,0,0,23,0,4,5,1,2,1,3277349,"2023-11-03T00:00:00.000Z",3547247,6,"Isaac Okoro",2,6,8,7,3,14.2
"2367",446,0,0,0,0,0,0,0,0,0,0,0,0,0,0,0,0,3277353,"2023-11-03T00:00:00.000Z",56677799,10,"Trayce Jackson-Davis",0,0,0,0,0,0
"2368",447,0,0,0,0,0,0,0,0,0,0,0,0,0,0,0,0,3277350,"2023-11-03T00:00:00.000Z",17896063,20,"Jericho Sims",0,0,0,0,0,0
"2369",448,0,0,0,0,0,0,0,0,0,0,0,0,0,0,0,0,3277350,"2023-11-03T00:00:00.000Z",666971,20,"Dylan Windler",0,0,0,0,0,0
"2370",449,0,0,0,0,0,0,0,0,0,0,0,0,0,0,0,0,3277350,"2023-11-03T00:00:00.000Z",666423,20,"RJ Barrett",0,0,0,0,0,0
"2371",450,0,0,0,0,0,0,0,0,0,0,0,0,0,0,0,0,3277350,"2023-11-03T00:00:00.000Z",666474,20,"Charles Brown",0,0,0,0,0,0
"2372",451,0,0,0,0,0,0,0,0,0,0,0,0,0,0,0,0,1037731,"2023-11-12T00:00:00.000Z",17896097,19,"Jose Alvarado",0,0,0,0,0,0
"2373",452,0,0,0,0,0,0,0,0,0,0,0,0,0,0,0,0,1037731,"2023-11-12T00:00:00.000Z",17896024,19,"Herbert Jones",0,0,0,0,0,0
"2374",453,0,0,0,0,0,0,0,0,0,0,0,0,0,0,0,0,1037731,"2023-11-12T00:00:00.000Z",38017663,19,"E.J. Liddell",0,0,0,0,0,0
"2375",454,0,0,0,0,0,0,0,0,0,0,0,0,0,0,0,0,1037731,"2023-11-12T00:00:00.000Z",303,19,"CJ McCollum",0,0,0,0,0,0
"2376",455,0,0,0,0,0,0,0,0,0,0,0,0,0,0,0,0,1037731,"2023-11-12T00:00:00.000Z",18677986,19,"Trey Murphy III",0,0,0,0,0,0
"2377",456,2,0,1,6,2,6,2,2,1,22,0,0,7,1,0,1,1037731,"2023-11-12T00:00:00.000Z",247,7,"Derrick Jones Jr.",0,8,10,9,3,10.2
"2378",457,1,0,0,2,0,2,0,0,0,8,0,2,0,0,0,0,1037730,"2023-11-12T00:00:00.000Z",56677776,8,"Julian Strawther",0,0,1,1,1,1.5
"2379",458,0,0,0,0,0,0,0,0,0,0,0,0,0,0,0,0,1037730,"2023-11-12T00:00:00.000Z",215,8,"Justin Holiday",0,0,0,0,0,0
"2380",459,6,0,3,3,1,6,2,0,0,20,0,1,5,3,1,2,1037729,"2023-11-12T00:00:00.000Z",56677792,9,"Marcus Sasser",1,8,14,11,9,18.6
"2381",460,0,2,1,1,0,6,3,0,0,14,1,3,6,2,1,2,1037729,"2023-11-12T00:00:00.000Z",3547240,9,"James Wiseman",3,8,8,6,2,15.4
"2382",461,2,0,0,2,0,4,2,2,2,12,0,1,6,0,1,1,1037729,"2023-11-12T00:00:00.000Z",38017682,9,"Jaden Ivey",1,6,8,8,2,11
"2383",462,1,0,3,5,4,8,7,0,0,24,0,2,18,3,1,1,1037729,"2023-11-12T00:00:00.000Z",259,9,"Kevin Knox",1,21,22,19,4,25.1
"2384",463,0,0,0,0,0,0,0,0,0,0,0,0,0,0,0,0,1037728,"2023-11-12T00:00:00.000Z",56677832,12,"Jarace Walker",0,0,0,0,0,0
"2385",464,0,0,0,0,0,0,0,0,0,0,0,0,0,0,0,0,1037728,"2023-11-12T00:00:00.000Z",38017701,12,"Kendall Brown",0,0,0,0,0,0
"2386",465,1,2,1,2,0,4,0,0,0,21,1,1,0,2,1,0,1037731,"2023-11-12T00:00:00.000Z",666965,7,"Grant Williams",3,2,3,1,3,12.9
"2387",466,0,2,1,0,0,5,4,4,2,26,1,5,10,2,1,1,1037731,"2023-11-12T00:00:00.000Z",56677840,7,"Dereck Lively II",3,12,12,10,2,20.4
"2388",467,0,0,0,0,0,0,0,0,0,0,0,0,0,0,0,0,1037732,"2023-11-12T00:00:00.000Z",286,16,"Kyle Lowry",0,0,0,0,0,0
"2389",468,0,0,0,0,0,0,0,0,0,0,0,0,0,0,0,0,1037732,"2023-11-12T00:00:00.000Z",666747,16,"Caleb Martin",0,0,0,0,0,0
"2390",469,7,0,7,3,1,7,3,2,2,24,2,5,9,9,1,2,1037734,"2023-11-12T00:00:00.000Z",185,10,"Draymond Green",1,18,25,16,16,31.3
"2391",470,2,0,2,2,0,7,3,2,0,26,2,4,6,4,1,1,1037734,"2023-11-12T00:00:00.000Z",475,10,"Andrew Wiggins",1,10,12,8,6,15.8
"2392",471,0,0,1,0,0,3,1,0,0,19,5,3,2,6,1,0,1037734,"2023-11-12T00:00:00.000Z",282,10,"Kevon Looney",1,8,8,2,6,12.2
"2393",472,3,0,5,10,3,16,5,3,3,33,0,1,16,5,1,1,1037734,"2023-11-12T00:00:00.000Z",443,10,"Klay Thompson",1,21,24,19,8,28.5
"2394",473,3,0,4,13,5,25,11,12,11,36,1,2,38,5,1,5,1037734,"2023-11-12T00:00:00.000Z",115,10,"Stephen Curry",1,43,46,41,8,46.5
"2395",474,1,0,0,0,0,1,1,0,0,1,0,0,2,0,0,0,1037734,"2023-11-12T00:00:00.000Z",56677799,10,"Trayce Jackson-Davis",0,2,3,3,1,3.5
"2396",475,2,0,0,2,2,2,2,0,0,17,0,1,6,0,0,0,1037733,"2023-11-12T00:00:00.000Z",470,24,"Yuta Watanabe",0,6,8,8,2,9
"2397",476,2,1,7,2,1,7,6,3,3,27,1,5,16,8,0,2,3277483,"2023-11-21T00:00:00.000Z",486,14,"Christian Wood",1,24,26,18,10,29.6
"2398",477,4,1,5,5,1,8,3,0,0,25,0,2,7,5,1,0,3277483,"2023-11-21T00:00:00.000Z",38017697,14,"Max Christie",2,12,16,11,9,25
"2399",478,1,1,2,0,0,4,4,3,2,19,0,1,10,2,0,2,3277483,"2023-11-21T00:00:00.000Z",666626,14,"Jaxson Hayes",1,12,13,11,3,14.9
"2400",479,0,0,0,0,0,0,0,0,0,0,0,0,0,0,0,0,3277483,"2023-11-21T00:00:00.000Z",56677835,14,"Jalen Hood-Schifino",0,0,0,0,0,0
"2401",480,0,0,0,0,0,0,0,0,0,0,0,0,0,0,0,0,3277483,"2023-11-21T00:00:00.000Z",457,14,"Jarred Vanderbilt",0,0,0,0,0,0
"2402",481,0,0,0,0,0,0,0,0,0,0,0,0,0,0,0,0,3277483,"2023-11-21T00:00:00.000Z",56677738,14,"Colin Castleton",0,0,0,0,0,0
"2403",482,0,0,0,0,0,0,0,0,0,0,0,0,0,0,0,0,3277483,"2023-11-21T00:00:00.000Z",56677867,14,"Alex Fudge",0,0,0,0,0,0
"2404",483,0,0,0,0,0,0,0,0,0,0,0,0,0,0,0,0,3277483,"2023-11-21T00:00:00.000Z",56677868,14,"D'Moi Hodge",0,0,0,0,0,0
"2405",484,0,0,0,0,0,0,0,0,0,0,0,0,0,0,0,0,3277483,"2023-11-21T00:00:00.000Z",56677836,14,"Maxwell Lewis",0,0,0,0,0,0
"2406",485,0,0,0,0,0,0,0,0,0,0,0,0,0,0,0,0,3277483,"2023-11-21T00:00:00.000Z",1603383,14,"Gabe Vincent",0,0,0,0,0,0
"2407",486,1,0,3,2,0,3,0,0,0,9,0,1,0,3,0,1,3277483,"2023-11-21T00:00:00.000Z",666881,29,"Luka Samanic",0,3,4,1,4,4.1
"2408",487,0,0,0,0,0,0,0,0,0,0,0,0,0,0,0,0,3277483,"2023-11-21T00:00:00.000Z",17896023,29,"Josh Christopher",0,0,0,0,0,0
"2409",488,0,0,0,0,0,0,0,0,0,0,0,0,0,0,0,0,3277483,"2023-11-21T00:00:00.000Z",56677824,29,"Taylor Hendricks",0,0,0,0,0,0
"2410",489,0,0,0,0,0,0,0,0,0,0,0,0,0,0,0,0,1037789,"2023-11-20T00:00:00.000Z",56677860,5,"Adama Sanogo",0,0,0,0,0,0
"2411",490,6,0,3,2,0,11,4,9,8,29,0,2,16,3,1,1,1037789,"2023-11-20T00:00:00.000Z",79,16,"Jimmy Butler",1,19,25,22,9,30.6
"2412",491,0,0,1,1,0,1,0,0,0,3,0,0,0,1,1,0,1037789,"2023-11-20T00:00:00.000Z",19465585,16,"Dru Smith",1,1,1,0,1,4.2
"2413",492,0,0,0,0,0,0,0,0,0,2,0,1,0,0,0,0,1037789,"2023-11-20T00:00:00.000Z",39398582,16,"Orlando Robinson",0,0,0,0,0,0
"2414",493,0,0,0,0,0,0,0,0,0,0,0,0,0,0,0,0,1037789,"2023-11-20T00:00:00.000Z",74,16,"Thomas Bryant",0,0,0,0,0,0
"2415",494,0,0,0,0,0,0,0,0,0,0,0,0,0,0,0,0,1037789,"2023-11-20T00:00:00.000Z",38017734,16,"Jamal Cain",0,0,0,0,0,0
"2416",495,0,0,0,0,0,0,0,0,0,0,0,0,0,0,0,0,1037789,"2023-11-20T00:00:00.000Z",3547257,16,"R.J. Hampton",0,0,0,0,0,0
"2417",496,0,0,0,0,0,0,0,0,0,0,0,0,0,0,0,0,1037789,"2023-11-20T00:00:00.000Z",666633,16,"Tyler Herro",0,0,0,0,0,0
"2418",497,0,0,0,0,0,0,0,0,0,0,0,0,0,0,0,0,1037789,"2023-11-20T00:00:00.000Z",38017696,16,"Nikola Jovic",0,0,0,0,0,0
"2419",498,0,0,0,0,0,0,0,0,0,0,0,0,0,0,0,0,1037789,"2023-11-20T00:00:00.000Z",38017736,16,"Cole Swider",0,0,0,0,0,0
"2420",499,0,0,0,0,0,0,0,0,0,0,0,0,0,0,0,0,3277483,"2023-11-21T00:00:00.000Z",38017630,29,"Johnny Juzang",0,0,0,0,0,0
"2421",500,0,0,0,0,0,0,0,0,0,0,0,0,0,0,0,0,3277483,"2023-11-21T00:00:00.000Z",38017705,29,"Walker Kessler",0,0,0,0,0,0
"2422",501,0,0,0,0,0,0,0,0,0,0,0,0,0,0,0,0,1037854,"2023-11-29T00:00:00.000Z",17554001,23,"Javonte Smart",0,0,0,0,0,0
"2423",502,0,0,0,0,0,0,0,0,0,0,0,0,0,0,0,0,1037854,"2023-11-29T00:00:00.000Z",56677788,23,"Terquavion Smith",0,0,0,0,0,0
"2424",503,0,0,0,0,0,0,0,0,0,0,0,0,0,0,0,0,1037854,"2023-11-29T00:00:00.000Z",17896025,23,"Jaden Springer",0,0,0,0,0,0
"2425",504,4,0,2,5,3,7,4,0,0,27,1,2,11,3,2,0,1037855,"2023-11-29T00:00:00.000Z",215,8,"Justin Holiday",2,14,18,15,7,26.6
"2426",505,5,0,8,12,7,17,11,3,1,34,2,2,30,10,1,0,1037855,"2023-11-29T00:00:00.000Z",375,8,"Michael Porter Jr.",1,40,45,35,15,52.5
"2427",506,15,0,4,2,1,19,12,8,7,33,6,2,32,10,1,0,1037855,"2023-11-29T00:00:00.000Z",246,8,"Nikola Jokic",1,42,57,47,25,69.5
"2428",507,2,0,1,3,2,6,4,0,0,32,0,0,10,1,0,0,1037855,"2023-11-29T00:00:00.000Z",81,8,"Kentavious Caldwell-Pope",0,11,13,12,3,14.2
"2429",508,6,0,6,8,3,14,4,5,5,22,0,2,16,6,0,0,1037855,"2023-11-29T00:00:00.000Z",335,8,"Jamal Murray",0,22,28,22,12,32.2
"2430",509,2,1,2,7,2,14,6,0,0,24,0,3,14,2,0,0,1037855,"2023-11-29T00:00:00.000Z",236,8,"Reggie Jackson",1,16,18,16,4,22.4
"2431",510,0,1,1,0,0,4,2,4,3,18,2,2,7,3,0,0,1037855,"2023-11-29T00:00:00.000Z",3547268,8,"Zeke Nnaji",1,10,10,7,3,13.6
"2432",511,1,0,2,2,1,7,4,2,2,19,1,2,11,3,0,2,1037855,"2023-11-29T00:00:00.000Z",38017709,8,"Christian Braun",0,14,15,12,4,14.1
"2433",512,1,0,1,2,0,4,0,0,0,13,0,1,0,1,0,0,1037855,"2023-11-29T00:00:00.000Z",56677776,8,"Julian Strawther",0,1,2,1,2,2.7
"2434",513,0,0,0,0,0,1,1,2,0,6,1,0,2,1,0,0,1037855,"2023-11-29T00:00:00.000Z",250,8,"DeAndre Jordan",0,3,3,2,1,3.2
"2435",514,0,0,0,0,0,0,0,0,0,3,0,1,0,0,0,0,1037855,"2023-11-29T00:00:00.000Z",56677871,8,"Hunter Tyson",0,0,0,0,0,0
"2436",515,1,0,1,0,0,0,0,2,1,3,0,1,1,1,0,0,1037855,"2023-11-29T00:00:00.000Z",17896007,8,"Braxton Key",0,2,3,2,2,3.7
"2437",516,0,0,0,1,0,1,0,0,0,3,0,0,0,0,0,1,1037855,"2023-11-29T00:00:00.000Z",38017727,8,"Collin Gillespie",0,0,0,0,0,-1
"2438",517,0,0,0,1,0,1,0,0,0,3,0,0,0,0,0,0,1037855,"2023-11-29T00:00:00.000Z",56677582,8,"Jalen Pickett",0,0,0,0,0,0
"2439",518,0,0,0,0,0,0,0,0,0,0,0,0,0,0,0,0,1037855,"2023-11-29T00:00:00.000Z",38017721,8,"Peyton Watson",0,0,0,0,0,0
"2440",519,0,0,0,0,0,0,0,0,0,0,0,0,0,0,0,0,1037853,"2023-11-29T00:00:00.000Z",420,15,"Marcus Smart",0,0,0,0,0,0
"2441",520,0,0,0,0,0,0,0,0,0,0,0,0,0,0,0,0,1037853,"2023-11-29T00:00:00.000Z",3547285,15,"Xavier Tillman",0,0,0,0,0,0
"2442",521,4,0,4,8,4,13,4,0,0,26,0,1,12,4,1,0,1037853,"2023-11-29T00:00:00.000Z",38017739,29,"Simone Fontecchio",1,16,20,16,8,25.8
"2443",522,1,0,3,5,3,14,7,2,0,29,1,2,17,4,1,1,1037853,"2023-11-29T00:00:00.000Z",101,29,"John Collins",1,21,22,18,5,25.3
"2444",523,1,0,2,0,0,5,2,0,0,15,2,2,4,4,1,2,1037853,"2023-11-29T00:00:00.000Z",11891374,29,"Omer Yurtseven",1,8,9,5,5,11.3
"2445",524,2,0,2,4,2,6,2,2,2,24,1,0,8,3,0,2,1037853,"2023-11-29T00:00:00.000Z",56677834,29,"Keyonte George",0,11,13,10,5,12.6
"2446",525,5,0,2,5,2,10,4,3,2,27,1,0,12,3,0,4,1037853,"2023-11-29T00:00:00.000Z",100,29,"Jordan Clarkson",0,15,20,17,8,19.1
"2447",526,4,0,1,1,1,6,3,2,1,18,1,3,8,2,0,0,1037886,"2023-12-11T00:00:00.000Z",3547251,22,"Cole Anthony",0,10,14,12,6,16.4
"2448",527,1,0,3,3,1,6,3,0,0,13,1,0,7,4,2,0,1037886,"2023-12-11T00:00:00.000Z",229,22,"Jonathan Isaac",2,11,12,8,5,19.3
"2449",528,2,0,1,9,3,14,5,7,4,34,0,2,17,1,3,2,1037885,"2023-12-11T00:00:00.000Z",54,9,"Bojan Bogdanovic",3,18,20,19,3,28.2
"2450",529,2,1,4,2,1,10,8,5,3,33,2,4,20,6,1,1,1037885,"2023-12-11T00:00:00.000Z",56677826,9,"Ausar Thompson",2,26,28,22,8,35.2
"2451",530,2,0,6,1,1,5,5,4,2,34,1,3,13,7,0,2,1037885,"2023-12-11T00:00:00.000Z",3547267,9,"Isaiah Stewart",0,20,22,15,9,22.4
"2452",531,7,0,6,6,1,21,11,0,0,38,0,3,23,6,1,3,1037885,"2023-12-11T00:00:00.000Z",17896075,9,"Cade Cunningham",1,29,36,30,13,40.7
"2453",532,7,0,1,0,0,4,2,2,2,23,0,0,6,1,1,2,1037885,"2023-12-11T00:00:00.000Z",3547241,9,"Killian Hayes",1,7,14,13,8,18.7
"2454",533,3,0,2,5,2,5,2,2,2,17,0,1,8,2,2,0,1037885,"2023-12-11T00:00:00.000Z",17896071,9,"Isaiah Livers",2,10,13,11,5,20.9
"2455",534,2,0,2,3,0,15,7,4,4,34,1,2,18,3,1,2,1037885,"2023-12-11T00:00:00.000Z",38017682,9,"Jaden Ivey",1,21,23,20,5,25.6
"2456",535,0,0,0,3,2,6,4,4,4,13,0,0,14,0,1,1,1037885,"2023-12-11T00:00:00.000Z",77,9,"Alec Burks",1,14,14,14,0,16
"2457",536,0,0,0,0,0,0,0,0,0,1,0,0,0,0,0,0,1037885,"2023-12-11T00:00:00.000Z",259,9,"Kevin Knox",0,0,0,0,0,0
"2458",537,0,0,0,0,0,0,0,0,0,0,0,0,0,0,0,0,1037885,"2023-12-11T00:00:00.000Z",24,9,"Marvin Bagley III",0,0,0,0,0,0
"2459",538,0,0,0,0,0,0,0,0,0,0,0,0,0,0,0,0,1037885,"2023-12-11T00:00:00.000Z",197,9,"Joe Harris",0,0,0,0,0,0
"2460",539,0,0,0,0,0,0,0,0,0,0,0,0,0,0,0,0,1037885,"2023-12-11T00:00:00.000Z",56677792,9,"Marcus Sasser",0,0,0,0,0,0
"2461",540,3,0,4,3,1,8,3,2,2,26,2,1,9,6,1,3,1037887,"2023-12-11T00:00:00.000Z",3547242,30,"Deni Avdija",1,15,18,12,9,20.7
"2462",541,1,0,7,2,1,17,9,4,2,28,2,0,21,9,0,2,1037887,"2023-12-11T00:00:00.000Z",265,30,"Kyle Kuzma",0,30,31,22,10,31.3
"2463",542,1,0,1,3,0,4,0,2,0,20,3,3,0,4,0,0,1037887,"2023-12-11T00:00:00.000Z",337,30,"Mike Muscala",0,4,5,1,5,6.3
"2464",543,3,0,0,3,1,11,3,4,4,26,0,1,11,0,0,3,1037887,"2023-12-11T00:00:00.000Z",666848,30,"Jordan Poole",0,11,14,14,3,12.5
"2465",544,3,0,5,5,1,9,4,0,0,21,0,0,9,5,1,2,1037887,"2023-12-11T00:00:00.000Z",249,30,"Tyus Jones",1,14,17,12,8,20.5
"2466",545,0,0,1,0,0,0,0,2,2,11,0,2,2,1,0,2,1037887,"2023-12-11T00:00:00.000Z",167,30,"Danilo Gallinari",0,3,3,2,1,1.2
"2467",546,1,0,1,3,1,6,3,4,2,23,1,4,9,2,0,3,1037887,"2023-12-11T00:00:00.000Z",17896045,30,"Corey Kispert",0,11,12,10,3,9.9
"2468",547,4,1,5,7,2,11,4,6,3,31,3,0,13,8,1,3,1037887,"2023-12-11T00:00:00.000Z",56677844,30,"Bilal Coulibaly",2,21,25,17,12,31.6
"2469",548,4,0,0,0,0,7,5,3,2,19,0,2,12,0,2,1,1037887,"2023-12-11T00:00:00.000Z",18677954,30,"Jared Butler",2,12,16,16,4,23
"2470",549,0,0,0,0,0,1,0,0,0,2,0,1,0,0,0,0,1037887,"2023-12-11T00:00:00.000Z",17896106,30,"Eugene Omoruyi",0,0,0,0,0,0
"2471",550,1,0,4,3,2,5,3,2,2,17,0,2,10,4,0,0,1037887,"2023-12-11T00:00:00.000Z",38017704,30,"Patrick Baldwin Jr.",0,14,15,11,5,16.3
"2472",551,0,0,0,0,0,0,0,0,0,0,0,0,0,0,0,0,1037952,"2023-12-19T00:00:00.000Z",666505,15,"Brandon Clarke",0,0,0,0,0,0
"2473",552,0,0,0,0,0,0,0,0,0,0,0,0,0,0,0,0,1037952,"2023-12-19T00:00:00.000Z",56677830,15,"GG Jackson",0,0,0,0,0,0
"2474",553,0,0,0,0,0,0,0,0,0,0,0,0,0,0,0,0,1037952,"2023-12-19T00:00:00.000Z",254,15,"Luke Kennard",0,0,0,0,0,0
"2475",554,0,0,0,0,0,0,0,0,0,0,0,0,0,0,0,0,1037952,"2023-12-19T00:00:00.000Z",38017728,15,"Jake LaRavia",0,0,0,0,0,0
"2476",555,0,0,0,0,0,0,0,0,0,0,0,0,0,0,0,0,1037952,"2023-12-19T00:00:00.000Z",38017732,15,"Kenneth Lofton Jr.",0,0,0,0,0,0
"2477",556,3,3,2,8,4,13,8,5,5,26,2,2,25,4,1,2,1037957,"2023-12-20T00:00:00.000Z",210,12,"Buddy Hield",4,29,32,28,7,44.3
"2478",557,0,0,4,3,0,5,2,2,2,23,0,1,6,4,0,1,1037957,"2023-12-20T00:00:00.000Z",3547243,12,"Obi Toppin",0,10,10,6,4,9.8
"2479",558,0,2,5,4,1,9,5,7,7,25,1,2,18,6,0,1,1037957,"2023-12-20T00:00:00.000Z",452,12,"Myles Turner",2,24,24,18,6,30.2
"2480",559,6,0,5,1,0,6,3,0,0,28,0,3,6,5,0,0,1037957,"2023-12-20T00:00:00.000Z",69,12,"Bruce Brown",0,11,17,12,11,21
"2481",560,13,1,2,9,3,14,6,4,4,28,1,0,19,3,1,4,1037957,"2023-12-20T00:00:00.000Z",3547245,12,"Tyrese Haliburton",2,22,35,32,16,44.1
"2482",561,1,0,2,6,4,7,5,0,0,29,0,2,14,2,1,2,1037957,"2023-12-20T00:00:00.000Z",38017686,12,"Bennedict Mathurin",1,16,17,15,3,18.9
"2483",562,1,0,2,4,4,6,6,3,3,23,0,1,19,2,1,1,1037957,"2023-12-20T00:00:00.000Z",3547250,12,"Aaron Nesmith",1,21,22,20,3,24.9
"2484",563,0,0,2,2,2,4,4,0,0,8,2,2,10,4,0,0,1037957,"2023-12-20T00:00:00.000Z",3547264,12,"Jalen Smith",0,14,14,10,4,14.8
"2485",564,9,0,4,0,0,3,3,4,3,20,1,1,9,5,1,1,1037957,"2023-12-20T00:00:00.000Z",304,12,"T.J. McConnell",1,14,23,18,14,30.5
"2486",565,1,2,2,1,0,7,4,3,2,15,1,3,10,3,1,1,1037957,"2023-12-20T00:00:00.000Z",17896035,12,"Isaiah Jackson",3,13,14,11,4,23.1
"2487",566,1,0,0,1,0,5,2,2,2,9,0,3,6,0,0,0,1037957,"2023-12-20T00:00:00.000Z",3547207,12,"Jordan Nwora",0,6,7,7,1,7.5
"2488",567,2,0,0,0,0,1,1,0,0,6,0,0,2,0,0,0,1037957,"2023-12-20T00:00:00.000Z",242,12,"James Johnson",0,2,4,4,2,5
"2489",568,0,0,0,0,0,0,0,0,0,0,0,0,0,0,0,0,1037957,"2023-12-20T00:00:00.000Z",38017507,12,"Andrew Nembhard",0,0,0,0,0,0
"2490",569,0,0,0,0,0,0,0,0,0,0,0,0,0,0,0,0,1037957,"2023-12-20T00:00:00.000Z",38017701,12,"Kendall Brown",0,0,0,0,0,0
"2491",570,0,0,0,0,0,0,0,0,0,0,0,0,0,0,0,0,1037954,"2023-12-19T00:00:00.000Z",45658838,10,"Lester Quinones",0,0,0,0,0,0
"2492",571,0,0,0,0,0,0,0,0,0,0,0,0,0,0,0,0,1037954,"2023-12-19T00:00:00.000Z",398,10,"Jerome Robinson",0,0,0,0,0,0
"2493",572,0,0,0,0,0,0,0,0,0,0,0,0,0,0,0,0,1037954,"2023-12-19T00:00:00.000Z",57875092,10,"Gui Santos",0,0,0,0,0,0
"2494",573,7,1,5,4,1,22,10,8,7,41,3,2,28,8,0,4,1037954,"2023-12-19T00:00:00.000Z",70,2,"Jaylen Brown",1,36,43,35,15,47.1
"2495",574,7,0,5,9,2,17,5,3,3,41,3,0,15,8,2,0,1037954,"2023-12-19T00:00:00.000Z",434,2,"Jayson Tatum",2,23,30,22,15,41.1
"2496",575,6,1,10,10,3,14,4,2,2,38,2,1,13,12,0,2,1037954,"2023-12-19T00:00:00.000Z",219,2,"Al Horford",1,25,31,19,18,37.4
"2497",576,0,0,0,0,0,0,0,0,0,0,0,0,0,0,0,0,1038021,"2023-12-29T00:00:00.000Z",38017607,22,"Kevon Harris",0,0,0,0,0,0
"2498",577,5,3,7,15,7,24,10,4,3,38,3,2,30,10,1,2,1038024,"2023-12-29T00:00:00.000Z",17896055,28,"Scottie Barnes",4,40,45,35,15,59.5
"2499",578,9,1,0,5,2,12,6,2,1,35,2,2,15,2,0,0,1038024,"2023-12-29T00:00:00.000Z",409,28,"Dennis Schroder",1,17,26,24,11,33.9
"2500",579,0,0,3,3,1,3,1,0,0,7,0,1,3,3,0,0,1038024,"2023-12-29T00:00:00.000Z",58,28,"Chris Boucher",0,6,6,3,3,6.6
"2501",580,2,0,0,1,0,1,0,0,0,8,0,0,0,0,0,0,1038024,"2023-12-29T00:00:00.000Z",376,28,"Otto Porter Jr.",0,0,2,2,2,3
"2502",581,2,0,0,7,2,10,5,2,1,15,0,4,13,0,1,0,1038024,"2023-12-29T00:00:00.000Z",666762,28,"Jalen McDaniels",1,13,15,15,2,19
"2503",582,0,0,2,0,0,1,0,0,0,2,0,0,0,2,0,0,1038024,"2023-12-29T00:00:00.000Z",3547249,28,"Precious Achiuwa",0,2,2,0,2,2.4
"2504",583,0,0,0,0,0,0,0,0,0,6,0,1,0,0,2,0,1038024,"2023-12-29T00:00:00.000Z",3547275,28,"Malachi Flynn",2,0,0,0,0,6
"2505",584,0,0,0,0,0,0,0,0,0,0,0,0,0,0,0,0,1038024,"2023-12-29T00:00:00.000Z",56677828,28,"Gradey Dick",0,0,0,0,0,0
"2506",585,0,0,0,0,0,0,0,0,0,0,0,0,0,0,0,0,1038024,"2023-12-29T00:00:00.000Z",489,28,"Thaddeus Young",0,0,0,0,0,0
"2507",586,0,0,0,0,0,0,0,0,0,0,0,0,0,0,0,0,1038024,"2023-12-29T00:00:00.000Z",56677805,28,"Javon Freeman-Liberty",0,0,0,0,0,0
"2508",587,0,0,0,0,0,0,0,0,0,0,0,0,0,0,0,0,1038024,"2023-12-29T00:00:00.000Z",38017710,28,"Christian Koloko",0,0,0,0,0,0
"2509",588,0,0,0,0,0,0,0,0,0,0,0,0,0,0,0,0,1038024,"2023-12-29T00:00:00.000Z",56677869,28,"Markquis Nowell",0,0,0,0,0,0
"2510",589,0,0,0,0,0,0,0,0,0,0,0,0,0,0,0,0,1038024,"2023-12-29T00:00:00.000Z",2309958,28,"Jontay Porter",0,0,0,0,0,0
"2511",590,0,0,0,0,0,0,0,0,0,0,0,0,0,0,0,0,1038024,"2023-12-29T00:00:00.000Z",436,28,"Garrett Temple",0,0,0,0,0,0
"2512",591,0,0,0,0,0,0,0,0,0,0,0,0,0,0,0,0,1038021,"2023-12-29T00:00:00.000Z",56677839,22,"Jett Howard",0,0,0,0,0,0
"2513",592,0,0,0,0,0,0,0,0,0,0,0,0,0,0,0,0,1038021,"2023-12-29T00:00:00.000Z",226,22,"Joe Ingles",0,0,0,0,0,0
"2514",593,2,0,4,1,0,4,2,0,0,35,1,3,4,5,0,0,1038026,"2023-12-29T00:00:00.000Z",3547301,11,"Jae'Sean Tate",0,9,11,6,7,13
"2515",594,0,1,2,2,0,11,5,1,0,33,2,2,10,4,1,0,1038026,"2023-12-29T00:00:00.000Z",188,11,"Jeff Green",2,14,14,10,4,20.8
"2516",595,8,1,4,2,1,16,12,4,3,34,3,6,28,7,1,5,1038026,"2023-12-29T00:00:00.000Z",17896062,11,"Alperen Sengun",2,35,43,36,15,49.4
"2517",596,4,0,6,9,5,19,12,4,2,36,0,0,31,6,0,1,1038026,"2023-12-29T00:00:00.000Z",17895966,11,"Jalen Green",0,37,41,35,10,43.2
"2518",597,10,1,3,12,8,16,9,8,7,43,0,3,33,3,1,5,1038026,"2023-12-29T00:00:00.000Z",458,11,"Fred VanVleet",2,36,46,43,13,52.6
"2519",598,0,1,0,0,0,5,2,2,2,8,1,4,6,1,0,0,1038026,"2023-12-29T00:00:00.000Z",19465326,11,"Jock Landale",1,7,7,6,1,10.2
"2520",599,3,0,1,2,0,6,2,0,0,15,1,2,4,2,2,3,1038026,"2023-12-29T00:00:00.000Z",213,11,"Aaron Holiday",2,6,9,7,5,13.9
"2521",600,1,0,3,3,1,6,3,0,0,10,0,0,7,3,0,0,1038023,"2023-12-29T00:00:00.000Z",221,26,"Kevin Huerter",0,10,11,8,4,12.1
"2522",601,0,0,0,0,0,0,0,0,0,0,0,0,0,0,0,0,1038084,"2024-01-05T00:00:00.000Z",17896044,26,"Kessler Edwards",0,0,0,0,0,0
"2523",602,0,0,0,0,0,0,0,0,0,0,0,0,0,0,0,0,1038084,"2024-01-05T00:00:00.000Z",38017714,26,"Keon Ellis",0,0,0,0,0,0
"2524",603,0,0,0,0,0,0,0,0,0,0,0,0,0,0,0,0,1038082,"2024-01-05T00:00:00.000Z",330,9,"Monte Morris",0,0,0,0,0,0
"2525",604,0,0,0,0,0,0,0,0,0,0,0,0,0,0,0,0,1038082,"2024-01-05T00:00:00.000Z",42097199,9,"Jared Rhoden",0,0,0,0,0,0
"2526",605,0,0,0,0,0,0,0,0,0,0,0,0,0,0,0,0,1038082,"2024-01-05T00:00:00.000Z",3547267,9,"Isaiah Stewart",0,0,0,0,0,0
"2527",606,0,0,0,0,0,0,0,0,0,0,0,0,0,0,0,0,1038082,"2024-01-05T00:00:00.000Z",44477024,9,"Stanley Umude",0,0,0,0,0,0
"2528",607,0,0,0,0,0,0,0,0,0,0,0,0,0,0,0,0,1038084,"2024-01-05T00:00:00.000Z",273,26,"Alex Len",0,0,0,0,0,0
"2529",608,9,0,1,9,3,16,6,1,0,32,0,4,15,1,1,1,1038084,"2024-01-05T00:00:00.000Z",324,26,"Malik Monk",1,16,25,24,10,31.7
"2530",609,2,0,1,4,1,8,3,0,0,11,0,0,7,1,0,0,1038084,"2024-01-05T00:00:00.000Z",17553994,26,"Davion Mitchell",0,8,10,9,3,11.2
"2531",610,0,0,0,0,0,0,0,0,0,0,0,0,0,0,0,0,1038084,"2024-01-05T00:00:00.000Z",666925,26,"Juan Toscano-Anderson",0,0,0,0,0,0
"2532",611,0,0,0,0,0,0,0,0,0,0,0,0,0,0,0,0,1038084,"2024-01-05T00:00:00.000Z",4197162,26,"Aleksandar Vezenkov",0,0,0,0,0,0
"2533",612,0,0,0,0,0,0,0,0,0,0,0,0,0,0,0,0,1038084,"2024-01-05T00:00:00.000Z",17895990,26,"Jordan Ford",0,0,0,0,0,0
"2534",613,0,0,0,0,0,0,0,0,0,0,0,0,0,0,0,0,1038084,"2024-01-05T00:00:00.000Z",56677845,26,"Colby Jones",0,0,0,0,0,0
"2535",614,0,0,0,0,0,0,0,0,0,0,0,0,0,0,0,0,1038084,"2024-01-05T00:00:00.000Z",56677862,26,"Jalen Slawson",0,0,0,0,0,0
"2536",615,2,1,3,4,2,8,4,4,4,27,1,2,14,4,0,0,1038084,"2024-01-05T00:00:00.000Z",666423,28,"RJ Barrett",1,18,20,16,6,24.8
"2537",616,1,0,0,5,2,6,3,2,0,24,0,3,8,0,0,0,1038080,"2024-01-05T00:00:00.000Z",38017724,22,"Caleb Houstan",0,8,9,9,1,9.5
"2538",617,2,1,7,4,2,15,7,4,3,30,2,1,19,9,1,2,1038078,"2024-01-05T00:00:00.000Z",274,13,"Kawhi Leonard",2,28,30,21,11,36.8
"2539",618,2,2,8,0,0,7,6,4,3,23,0,3,15,8,0,1,1038078,"2024-01-05T00:00:00.000Z",493,13,"Ivica Zubac",2,23,25,17,10,32.6
"2540",619,1,0,2,3,2,3,2,2,2,17,1,2,8,3,1,0,1038078,"2024-01-05T00:00:00.000Z",666743,13,"Terance Mann",1,11,12,9,4,16.1
"2541",620,2,1,4,1,0,4,2,1,1,31,1,4,5,5,2,0,1038080,"2024-01-05T00:00:00.000Z",17553983,22,"Trevelin Queen",3,10,12,7,7,23
"2542",621,1,0,0,2,1,3,2,0,0,8,1,0,5,1,0,0,1038080,"2024-01-05T00:00:00.000Z",666885,22,"Admiral Schofield",0,6,7,6,2,7.7
"2543",622,0,0,0,0,0,0,0,0,0,0,0,0,0,0,0,0,1038080,"2024-01-05T00:00:00.000Z",666442,22,"Goga Bitadze",0,0,0,0,0,0
"2544",623,0,0,0,0,0,0,0,0,0,0,0,0,0,0,0,0,1038080,"2024-01-05T00:00:00.000Z",85,22,"Wendell Carter Jr.",0,0,0,0,0,0
"2545",624,0,0,0,0,0,0,0,0,0,0,0,0,0,0,0,0,1038080,"2024-01-05T00:00:00.000Z",165,22,"Markelle Fultz",0,0,0,0,0,0
"2546",625,0,0,0,0,0,0,0,0,0,0,0,0,0,0,0,0,1038080,"2024-01-05T00:00:00.000Z",196,22,"Gary Harris",0,0,0,0,0,0
"2547",626,0,0,0,0,0,0,0,0,0,0,0,0,0,0,0,0,1037620,"2023-10-28T00:00:00.000Z",54,9,"Bojan Bogdanovic",0,0,0,0,0,0
"2548",627,0,0,0,0,0,0,0,0,0,0,0,0,0,0,0,0,1037620,"2023-10-28T00:00:00.000Z",17896071,9,"Isaiah Livers",0,0,0,0,0,0
"2549",628,0,0,0,0,0,0,0,0,0,0,0,0,0,0,0,0,1037620,"2023-10-28T00:00:00.000Z",330,9,"Monte Morris",0,0,0,0,0,0
"2550",629,4,2,1,1,0,13,7,7,6,32,1,3,20,2,1,1,1037620,"2023-10-28T00:00:00.000Z",125,5,"DeMar DeRozan",3,22,26,24,6,36.4
"2551",630,1,0,2,1,0,3,0,0,0,21,1,3,0,3,1,1,1037620,"2023-10-28T00:00:00.000Z",3547248,5,"Patrick Williams",1,3,4,1,4,7.1
"2552",631,1,0,4,2,1,12,5,1,1,32,0,5,12,4,0,1,1037620,"2023-10-28T00:00:00.000Z",460,5,"Nikola Vucevic",0,16,17,13,5,17.3
"2553",632,2,1,2,0,0,6,1,0,0,15,3,0,2,5,3,0,1037620,"2023-10-28T00:00:00.000Z",137,5,"Andre Drummond",4,7,9,4,7,23
"2554",633,0,0,0,0,0,0,0,0,0,1,0,0,0,0,0,0,1037620,"2023-10-28T00:00:00.000Z",56677857,5,"Julian Phillips",0,0,0,0,0,0
"2555",634,0,0,0,1,1,1,1,0,0,1,0,0,3,0,0,0,1037620,"2023-10-28T00:00:00.000Z",38017719,5,"Dalen Terry",0,3,3,3,0,3
"2556",635,0,0,0,0,0,0,0,0,0,1,0,0,0,0,0,0,1037620,"2023-10-28T00:00:00.000Z",17896116,5,"Terry Taylor",0,0,0,0,0,0
"2557",636,0,0,0,0,0,0,0,0,0,0,0,0,0,0,0,0,1037620,"2023-10-28T00:00:00.000Z",27,5,"Lonzo Ball",0,0,0,0,0,0
"2558",637,0,0,0,0,0,0,0,0,0,0,0,0,0,0,0,0,1037620,"2023-10-28T00:00:00.000Z",56677874,5,"Onuralp Bitim",0,0,0,0,0,0
"2559",638,0,0,0,0,0,0,0,0,0,0,0,0,0,0,0,0,1037620,"2023-10-28T00:00:00.000Z",45969255,5,"Justin Lewis",0,0,0,0,0,0
"2560",639,0,0,0,0,0,0,0,0,0,0,0,0,0,0,0,0,1037620,"2023-10-28T00:00:00.000Z",56677860,5,"Adama Sanogo",0,0,0,0,0,0
"2561",640,2,0,3,1,1,2,2,0,0,17,2,2,5,5,0,3,1037640,"2023-10-30T00:00:00.000Z",340,19,"Larry Nance Jr.",0,10,12,7,7,11
"2562",641,2,0,2,7,3,9,4,1,1,27,1,2,12,3,0,2,1037640,"2023-10-30T00:00:00.000Z",17896017,19,"Matt Ryan",0,15,17,14,5,16.6
"2563",642,0,0,1,0,0,2,0,2,0,5,1,0,0,2,0,0,1037640,"2023-10-30T00:00:00.000Z",491,19,"Cody Zeller",0,2,2,0,2,2.4
"2564",643,0,0,0,0,0,0,0,0,0,0,0,0,0,0,0,0,1037640,"2023-10-30T00:00:00.000Z",38017663,19,"E.J. Liddell",0,0,0,0,0,0
"2565",644,0,0,0,0,0,0,0,0,0,0,0,0,0,0,0,0,1037640,"2023-10-30T00:00:00.000Z",17896097,19,"Jose Alvarado",0,0,0,0,0,0
"2566",645,0,0,0,0,0,0,0,0,0,0,0,0,0,0,0,0,1037640,"2023-10-30T00:00:00.000Z",3547293,19,"Naji Marshall",0,0,0,0,0,0
"2567",646,0,0,0,0,0,0,0,0,0,0,0,0,0,0,0,0,1037640,"2023-10-30T00:00:00.000Z",18677986,19,"Trey Murphy III",0,0,0,0,0,0
"2568",647,0,0,0,0,0,0,0,0,0,0,0,0,0,0,0,0,1037640,"2023-10-30T00:00:00.000Z",38017726,19,"Dereon Seabron",0,0,0,0,0,0
"2569",648,0,0,2,2,1,8,4,2,0,20,1,2,9,3,0,3,1037640,"2023-10-30T00:00:00.000Z",475,10,"Andrew Wiggins",0,12,12,9,3,9.6
"2570",649,7,1,5,2,0,8,3,0,0,21,1,2,6,6,0,1,1037640,"2023-10-30T00:00:00.000Z",185,10,"Draymond Green",1,12,19,13,13,25.7
"2571",650,1,0,5,0,0,5,3,2,2,24,2,2,8,7,1,1,1037640,"2023-10-30T00:00:00.000Z",282,10,"Kevon Looney",1,15,16,9,8,19.9
"2572",651,4,1,4,1,0,8,4,0,0,26,0,1,8,4,1,2,3277402,"2023-11-10T00:00:00.000Z",3547274,27,"Tre Jones",2,12,16,12,8,22.8
"2573",652,0,0,0,0,0,0,0,0,0,0,0,0,0,0,0,0,3277402,"2023-11-10T00:00:00.000Z",38017649,27,"Julian Champagnie",0,0,0,0,0,0
"2574",653,0,0,0,0,0,0,0,0,0,0,0,0,0,0,0,0,3277402,"2023-11-10T00:00:00.000Z",180,27,"Devonte' Graham",0,0,0,0,0,0
"2575",654,0,0,0,0,0,0,0,0,0,0,0,0,0,0,0,0,3277402,"2023-11-10T00:00:00.000Z",17896059,27,"Sandro Mamukelashvili",0,0,0,0,0,0
"2576",655,0,0,3,2,0,11,5,0,0,26,2,6,10,5,2,0,3277402,"2023-11-10T00:00:00.000Z",3547259,18,"Jaden McDaniels",2,15,15,10,5,22
"2577",656,2,0,11,7,3,21,11,4,4,34,1,1,29,12,0,3,3277402,"2023-11-10T00:00:00.000Z",447,18,"Karl-Anthony Towns",0,41,43,31,14,43.4
"2578",657,1,0,6,0,0,10,5,1,1,34,4,3,11,10,1,1,3277402,"2023-11-10T00:00:00.000Z",176,18,"Rudy Gobert",1,21,22,12,11,26.5
"2579",658,5,1,5,8,2,21,9,11,8,37,2,1,28,7,2,4,3277402,"2023-11-10T00:00:00.000Z",3547238,18,"Anthony Edwards",3,35,40,33,12,48.9
"2580",659,6,0,1,3,1,7,3,4,4,31,2,3,11,3,0,4,3277402,"2023-11-10T00:00:00.000Z",104,18,"Mike Conley",0,14,20,17,9,19.6
"2581",660,4,1,3,1,1,4,3,2,2,19,0,0,9,3,0,0,3277402,"2023-11-10T00:00:00.000Z",666400,18,"Nickeil Alexander-Walker",1,12,16,13,7,21.6
"2582",661,1,2,5,5,3,8,6,0,0,30,1,3,15,6,1,1,3277401,"2023-11-10T00:00:00.000Z",38017620,29,"Ochai Agbaji",3,21,22,16,7,31.7
"2583",662,0,4,3,3,3,6,5,7,5,38,0,2,18,3,0,3,3277401,"2023-11-10T00:00:00.000Z",101,29,"John Collins",4,21,21,18,3,30.6
"2584",663,1,2,7,9,4,13,8,6,6,37,0,3,26,7,2,3,3277401,"2023-11-10T00:00:00.000Z",297,29,"Lauri Markkanen",4,33,34,27,8,44.9
"2585",664,11,1,3,6,1,12,2,2,2,30,0,1,7,3,0,2,3277401,"2023-11-10T00:00:00.000Z",56677834,29,"Keyonte George",1,10,21,18,14,28.1
"2586",665,4,1,2,5,2,16,9,6,6,36,2,1,26,4,2,3,3277401,"2023-11-10T00:00:00.000Z",100,29,"Jordan Clarkson",3,30,34,30,8,42.8
"2587",666,6,0,1,2,0,8,3,4,4,18,1,0,10,2,1,3,3277401,"2023-11-10T00:00:00.000Z",413,29,"Collin Sexton",1,12,18,16,8,21.4
"2588",667,3,0,3,8,2,13,6,3,3,27,0,0,17,3,0,0,3277403,"2023-11-10T00:00:00.000Z",191,7,"Tim Hardaway Jr.",0,20,23,20,6,25.1
"2589",668,4,0,1,0,0,3,2,5,5,22,4,3,9,5,1,1,3277403,"2023-11-10T00:00:00.000Z",379,7,"Dwight Powell",1,14,18,13,9,23
"2590",669,3,0,0,4,1,4,1,0,0,18,0,2,3,0,0,0,3277403,"2023-11-10T00:00:00.000Z",3547258,7,"Josh Green",0,3,6,6,3,7.5
"2591",670,0,0,0,0,0,1,0,2,1,5,1,1,1,1,0,0,3277403,"2023-11-10T00:00:00.000Z",56677859,7,"Olivier-Maxence Prosper",0,2,2,1,1,2.2
"2592",671,6,0,1,3,2,7,3,0,0,18,1,3,8,2,0,0,3277403,"2023-11-10T00:00:00.000Z",151,7,"Dante Exum",0,10,16,14,8,19.4
"2593",672,0,0,2,2,1,8,5,1,0,12,0,1,11,2,0,2,3277403,"2023-11-10T00:00:00.000Z",38017679,7,"Jaden Hardy",0,13,13,11,2,11.4
"2594",673,0,0,0,0,0,0,0,0,0,0,0,0,0,0,0,0,3277403,"2023-11-10T00:00:00.000Z",217,7,"Richaun Holmes",0,0,0,0,0,0
"2595",674,0,0,0,0,0,0,0,0,0,0,0,0,0,0,0,0,3277403,"2023-11-10T00:00:00.000Z",329,7,"Markieff Morris",0,0,0,0,0,0
"2596",675,2,1,2,5,3,7,4,2,2,18,1,2,13,3,1,1,3277401,"2023-11-10T00:00:00.000Z",666650,29,"Talen Horton-Tucker",2,16,18,15,5,24.6
"2597",676,0,0,0,0,0,0,0,0,0,0,0,0,0,0,0,0,1037787,"2023-11-20T00:00:00.000Z",54,9,"Bojan Bogdanovic",0,0,0,0,0,0
"2598",677,0,0,0,0,0,0,0,0,0,0,0,0,0,0,0,0,1037787,"2023-11-20T00:00:00.000Z",56677729,9,"Malcolm Cazalon",0,0,0,0,0,0
"2599",678,0,0,0,0,0,0,0,0,0,0,0,0,0,0,0,0,1037787,"2023-11-20T00:00:00.000Z",197,9,"Joe Harris",0,0,0,0,0,0
"2600",679,0,0,0,0,0,0,0,0,0,0,0,0,0,0,0,0,1037787,"2023-11-20T00:00:00.000Z",330,9,"Monte Morris",0,0,0,0,0,0
"2601",680,0,0,0,0,0,0,0,0,0,0,0,0,0,0,0,0,1037787,"2023-11-20T00:00:00.000Z",42097199,9,"Jared Rhoden",0,0,0,0,0,0
"2602",681,2,1,9,9,4,15,5,1,0,38,2,3,14,11,0,4,1037787,"2023-11-20T00:00:00.000Z",375,8,"Michael Porter Jr.",1,25,27,16,13,29.2
"2603",682,2,2,4,0,0,14,7,0,0,29,2,3,14,6,0,0,1037788,"2023-11-20T00:00:00.000Z",666577,30,"Daniel Gafford",2,20,22,16,8,30.2
"2604",683,1,0,1,9,3,26,11,5,5,33,0,4,30,1,0,0,1037788,"2023-11-20T00:00:00.000Z",666848,30,"Jordan Poole",0,31,32,31,2,32.7
"2605",684,3,0,2,1,0,13,9,0,0,26,0,0,18,2,0,0,1037788,"2023-11-20T00:00:00.000Z",249,30,"Tyus Jones",0,20,23,21,5,24.9
"2606",685,0,0,0,0,0,0,0,0,0,1,0,0,0,0,0,0,1037788,"2023-11-20T00:00:00.000Z",18677954,30,"Jared Butler",0,0,0,0,0,0
"2607",686,0,0,0,0,0,0,0,0,0,0,0,0,0,0,0,0,1037788,"2023-11-20T00:00:00.000Z",38017704,30,"Patrick Baldwin Jr.",0,0,0,0,0,0
"2608",687,0,0,0,0,0,0,0,0,0,0,0,0,0,0,0,0,1037788,"2023-11-20T00:00:00.000Z",38124126,30,"John Butler Jr.",0,0,0,0,0,0
"2609",688,7,0,4,1,0,10,4,4,3,37,4,1,11,8,1,2,1037787,"2023-11-20T00:00:00.000Z",177,8,"Aaron Gordon",1,19,26,18,15,32.1
"2610",689,5,1,5,4,1,8,4,0,0,15,0,1,9,5,0,1,1037787,"2023-11-20T00:00:00.000Z",246,8,"Nikola Jokic",1,14,19,14,10,24.5
"2611",690,3,2,2,5,2,17,8,2,2,36,1,2,20,3,2,3,1037787,"2023-11-20T00:00:00.000Z",81,8,"Kentavious Caldwell-Pope",4,23,26,23,6,37.1
"2612",691,6,1,3,3,1,15,9,3,2,32,0,2,21,3,1,0,1037787,"2023-11-20T00:00:00.000Z",236,8,"Reggie Jackson",2,24,30,27,9,39.6
"2613",692,2,1,5,2,2,10,5,4,3,32,1,2,15,6,1,2,1037787,"2023-11-20T00:00:00.000Z",38017709,8,"Christian Braun",2,21,23,17,8,29.2
"2614",693,2,2,1,0,0,2,1,2,2,14,0,1,4,1,0,1,1037787,"2023-11-20T00:00:00.000Z",38017721,8,"Peyton Watson",2,5,7,6,3,13.2
"2615",694,0,0,0,0,0,0,0,0,0,0,0,0,0,0,0,0,1037787,"2023-11-20T00:00:00.000Z",38017727,8,"Collin Gillespie",0,0,0,0,0,0
"2616",695,0,0,0,0,0,0,0,0,0,0,0,0,0,0,0,0,1037787,"2023-11-20T00:00:00.000Z",215,8,"Justin Holiday",0,0,0,0,0,0
"2617",696,0,0,0,0,0,0,0,0,0,0,0,0,0,0,0,0,1037787,"2023-11-20T00:00:00.000Z",250,8,"DeAndre Jordan",0,0,0,0,0,0
"2618",697,0,0,0,0,0,0,0,0,0,0,0,0,0,0,0,0,1037787,"2023-11-20T00:00:00.000Z",56677871,8,"Hunter Tyson",0,0,0,0,0,0
"2619",698,0,0,0,0,0,0,0,0,0,0,0,0,0,0,0,0,1037787,"2023-11-20T00:00:00.000Z",666489,8,"Vlatko Cancar",0,0,0,0,0,0
"2620",699,0,0,0,0,0,0,0,0,0,0,0,0,0,0,0,0,1037787,"2023-11-20T00:00:00.000Z",17896103,8,"Jay Huff",0,0,0,0,0,0
"2621",700,0,0,0,0,0,0,0,0,0,0,0,0,0,0,0,0,1037787,"2023-11-20T00:00:00.000Z",335,8,"Jamal Murray",0,0,0,0,0,0
"2622",701,0,0,0,0,0,0,0,0,0,0,0,0,0,0,0,0,1037858,"2023-11-30T00:00:00.000Z",417,3,"Ben Simmons",0,0,0,0,0,0
"2623",702,0,0,0,0,0,0,0,0,0,0,0,0,0,0,0,0,1037858,"2023-11-30T00:00:00.000Z",56677841,3,"Dariq Whitehead",0,0,0,0,0,0
"2624",703,1,0,1,0,0,0,0,0,0,6,0,3,0,1,1,0,1037859,"2023-11-30T00:00:00.000Z",17896035,12,"Isaiah Jackson",1,1,2,1,2,5.7
"2625",704,1,0,2,1,0,5,4,1,1,22,3,6,9,5,4,1,1037859,"2023-11-30T00:00:00.000Z",3547250,12,"Aaron Nesmith",4,14,15,10,6,27.5
"2626",705,5,0,1,1,0,4,1,0,0,22,0,6,2,1,2,2,1037859,"2023-11-30T00:00:00.000Z",38017507,12,"Andrew Nembhard",2,3,8,7,6,14.7
"2627",706,0,0,0,0,0,0,0,0,0,0,0,0,0,0,0,0,1037859,"2023-11-30T00:00:00.000Z",304,12,"T.J. McConnell",0,0,0,0,0,0
"2628",707,0,0,0,0,0,0,0,0,0,0,0,0,0,0,0,0,1037858,"2023-11-30T00:00:00.000Z",56677722,3,"Jalen Wilson",0,0,0,0,0,0
"2629",708,6,0,4,4,2,14,8,4,4,32,2,1,22,6,0,2,1037858,"2023-11-30T00:00:00.000Z",204,4,"Gordon Hayward",0,28,34,28,12,36.2
"2630",709,2,0,4,4,3,15,9,2,2,38,1,2,23,5,0,0,1037858,"2023-11-30T00:00:00.000Z",62,4,"Miles Bridges",0,28,30,25,7,32
"2631",710,1,3,7,0,0,12,5,2,2,32,5,2,12,12,1,0,1037858,"2023-11-30T00:00:00.000Z",38017698,4,"Mark Williams",4,24,25,13,13,39.9
"2632",711,3,1,2,5,4,7,5,0,0,22,0,1,14,2,0,0,1037858,"2023-11-30T00:00:00.000Z",38017708,4,"Bryce McGowens",1,16,19,17,5,23.9
"2633",712,13,0,4,9,7,25,13,4,4,40,0,1,37,4,2,3,1037858,"2023-11-30T00:00:00.000Z",403,4,"Terry Rozier",2,41,54,50,17,64.3
"2634",713,0,0,0,0,0,0,0,0,0,13,1,4,0,1,0,2,1037858,"2023-11-30T00:00:00.000Z",422,4,"Ish Smith",0,1,1,0,1,-0.8
"2635",714,0,1,0,3,3,4,3,0,0,14,1,2,9,1,0,0,1037858,"2023-11-30T00:00:00.000Z",56677846,4,"Nick Smith Jr.",1,10,10,9,1,13.2
"2636",715,0,0,0,0,0,0,0,0,0,0,0,0,0,0,0,0,1037858,"2023-11-30T00:00:00.000Z",56677866,4,"Leaky Black",0,0,0,0,0,0
"2637",716,0,0,0,0,0,0,0,0,0,0,0,0,0,0,0,0,1037858,"2023-11-30T00:00:00.000Z",17896037,4,"James Bouknight",0,0,0,0,0,0
"2638",717,7,2,3,8,4,16,8,0,0,36,2,4,20,5,5,4,1037862,"2023-11-30T00:00:00.000Z",666400,18,"Nickeil Alexander-Walker",7,25,32,27,12,53.5
"2639",718,5,1,7,7,4,22,12,5,4,37,4,3,32,11,2,4,1037862,"2023-11-30T00:00:00.000Z",447,18,"Karl-Anthony Towns",3,43,48,37,16,57.7
"2640",719,0,3,10,0,0,11,6,4,3,38,3,4,15,13,0,0,1037862,"2023-11-30T00:00:00.000Z",176,18,"Rudy Gobert",3,28,28,15,13,39.6
"2641",720,2,0,3,3,2,6,3,0,0,29,0,0,8,3,1,1,1037862,"2023-11-30T00:00:00.000Z",68,18,"Troy Brown Jr.",1,11,13,10,5,16.6
"2642",721,7,0,3,6,2,6,2,2,2,29,0,3,8,3,2,2,1037862,"2023-11-30T00:00:00.000Z",104,18,"Mike Conley",2,11,18,15,10,26.1
"2643",722,6,0,1,1,0,7,2,0,0,19,0,0,4,1,0,0,1037862,"2023-11-30T00:00:00.000Z",12,18,"Kyle Anderson",0,5,11,10,7,14.2
"2644",723,0,1,2,4,0,9,3,0,0,22,1,2,6,3,1,0,1037862,"2023-11-30T00:00:00.000Z",667378,18,"Naz Reid",2,9,9,6,3,15.6
"2645",724,0,0,0,0,0,0,0,0,0,0,0,0,0,0,0,0,1037858,"2023-11-30T00:00:00.000Z",3547253,4,"Theo Maledon",0,0,0,0,0,0
"2646",725,0,0,0,0,0,0,0,0,0,0,0,0,0,0,0,0,1037858,"2023-11-30T00:00:00.000Z",56677823,4,"Brandon Miller",0,0,0,0,0,0
"2647",726,0,0,0,0,0,0,0,0,0,0,0,0,0,0,0,0,1037901,"2023-12-12T00:00:00.000Z",17896022,13,"Brandon Boston Jr.",0,0,0,0,0,0
"2648",727,0,0,0,0,0,0,0,0,0,0,0,0,0,0,0,0,1037901,"2023-12-12T00:00:00.000Z",38017725,13,"Moussa Diabate",0,0,0,0,0,0
"2649",728,0,0,0,0,0,0,0,0,0,0,0,0,0,0,0,0,1037901,"2023-12-12T00:00:00.000Z",56677856,13,"Jordan Miller",0,0,0,0,0,0
"2650",729,0,0,0,0,0,0,0,0,0,0,0,0,0,0,0,0,1037901,"2023-12-12T00:00:00.000Z",371,13,"Mason Plumlee",0,0,0,0,0,0
"2651",730,0,0,0,0,0,0,0,0,0,0,0,0,0,0,0,0,1037901,"2023-12-12T00:00:00.000Z",17896051,13,"Joshua Primo",0,0,0,0,0,0
"2652",731,1,0,1,2,0,3,1,0,0,19,0,2,2,1,0,0,1037901,"2023-12-12T00:00:00.000Z",30,26,"Harrison Barnes",0,3,4,3,2,4.7
"2653",732,1,0,7,5,0,14,6,6,5,31,0,2,17,7,3,0,1037901,"2023-12-12T00:00:00.000Z",38017688,26,"Keegan Murray",3,24,25,18,8,35.9
"2654",733,3,0,5,2,0,11,5,8,5,26,5,3,15,10,2,2,1037901,"2023-12-12T00:00:00.000Z",406,26,"Domantas Sabonis",2,25,28,18,13,35.5
"2655",734,3,0,4,4,1,8,1,0,0,16,0,1,3,4,1,0,1037901,"2023-12-12T00:00:00.000Z",221,26,"Kevin Huerter",1,7,10,6,7,15.3
"2656",735,3,0,3,7,3,16,5,1,1,25,0,3,14,3,0,4,1037901,"2023-12-12T00:00:00.000Z",161,26,"De'Aaron Fox",0,17,20,17,6,18.1
"2657",736,7,0,5,3,1,8,4,4,4,30,1,1,13,6,0,2,1037903,"2023-12-13T00:00:00.000Z",3547242,30,"Deni Avdija",0,19,26,20,13,28.7
"2658",737,4,1,7,8,4,19,10,4,3,29,0,1,27,7,1,1,1037903,"2023-12-13T00:00:00.000Z",265,30,"Kyle Kuzma",2,34,38,31,11,46.4
"2659",738,3,0,6,1,0,7,5,0,0,30,2,3,10,8,1,0,1037902,"2023-12-13T00:00:00.000Z",56677826,9,"Ausar Thompson",1,18,21,13,11,27.1
"2660",739,2,0,1,9,5,19,11,8,6,34,0,1,33,1,1,1,1037902,"2023-12-13T00:00:00.000Z",54,9,"Bojan Bogdanovic",1,34,36,35,3,39.2
"2661",740,2,0,2,1,0,3,1,2,2,22,2,3,4,4,0,2,1037902,"2023-12-13T00:00:00.000Z",3547267,9,"Isaiah Stewart",0,8,10,6,6,9.8
"2662",741,7,0,5,8,1,17,5,12,10,30,1,3,21,6,0,1,1037902,"2023-12-13T00:00:00.000Z",17896075,9,"Cade Cunningham",0,27,34,28,13,37.7
"2663",742,6,0,3,0,0,8,3,0,0,32,0,2,6,3,1,1,1037902,"2023-12-13T00:00:00.000Z",3547241,9,"Killian Hayes",1,9,15,12,9,20.6
"2664",743,0,1,3,0,0,7,5,0,0,16,0,6,10,3,1,1,1037902,"2023-12-13T00:00:00.000Z",3547240,9,"James Wiseman",2,13,13,10,3,18.6
"2665",744,0,0,3,2,0,4,1,0,0,27,0,1,2,3,1,0,1037902,"2023-12-13T00:00:00.000Z",17896071,9,"Isaiah Livers",1,5,5,2,3,8.6
"2666",745,1,0,3,4,2,9,5,4,3,20,1,5,15,4,0,0,1037900,"2023-12-12T00:00:00.000Z",407,10,"Dario Saric",0,19,20,16,5,21.3
"2667",746,5,0,6,4,2,14,9,1,0,29,5,2,20,11,1,3,1037900,"2023-12-12T00:00:00.000Z",56677858,10,"Brandin Podziemski",1,31,36,25,16,40.7
"2668",747,0,1,0,0,0,1,1,0,0,7,0,1,2,0,1,0,1037900,"2023-12-12T00:00:00.000Z",56677799,10,"Trayce Jackson-Davis",2,2,2,2,0,8
"2669",748,0,0,0,0,0,0,0,0,0,0,0,0,0,0,0,0,1037900,"2023-12-12T00:00:00.000Z",251,10,"Cory Joseph",0,0,0,0,0,0
"2670",749,0,0,0,0,0,0,0,0,0,0,0,0,0,0,0,0,1037900,"2023-12-12T00:00:00.000Z",2189,10,"Gary Payton II",0,0,0,0,0,0
"2671",750,0,0,0,0,0,0,0,0,0,0,0,0,0,0,0,0,1037900,"2023-12-12T00:00:00.000Z",17896070,10,"Usman Garuba",0,0,0,0,0,0
"2672",751,0,0,0,0,0,0,0,0,0,0,0,0,0,0,0,0,1037966,"2023-12-21T00:00:00.000Z",297,29,"Lauri Markkanen",0,0,0,0,0,0
"2673",752,0,0,0,0,0,0,0,0,0,0,0,0,0,0,0,0,1037966,"2023-12-21T00:00:00.000Z",19465584,29,"Micah Potter",0,0,0,0,0,0
"2674",753,0,0,0,0,0,0,0,0,0,0,0,0,0,0,0,0,1037966,"2023-12-21T00:00:00.000Z",56677842,29,"Brice Sensabaugh",0,0,0,0,0,0
"2675",754,3,0,2,3,0,6,1,0,0,26,0,3,2,2,1,1,1037980,"2023-12-23T00:00:00.000Z",202,20,"Josh Hart",1,4,7,5,5,10.9
"2676",755,1,0,2,5,1,8,2,2,2,22,0,1,7,2,0,1,1037980,"2023-12-23T00:00:00.000Z",3547269,20,"Immanuel Quickley",0,9,10,8,3,9.9
"2677",756,0,0,2,1,0,3,1,0,0,16,0,2,2,2,1,0,1037980,"2023-12-23T00:00:00.000Z",17895858,20,"Quentin Grimes",1,4,4,2,2,7.4
"2678",757,0,0,1,0,0,0,0,0,0,1,0,0,0,1,0,0,1037980,"2023-12-23T00:00:00.000Z",17896033,20,"Miles McBride",0,1,1,0,1,1.2
"2679",758,0,0,0,1,0,1,0,0,0,1,0,0,0,0,0,0,1037980,"2023-12-23T00:00:00.000Z",666474,20,"Charles Brown",0,0,0,0,0,0
"2680",760,0,0,0,0,0,0,0,0,0,1,0,1,0,0,0,0,1037980,"2023-12-23T00:00:00.000Z",19,20,"Ryan Arcidiacono",0,0,0,0,0,0
"2681",761,0,0,0,0,0,0,0,0,0,1,0,0,0,0,0,0,1037980,"2023-12-23T00:00:00.000Z",56677795,20,"Jacob Toppin",0,0,0,0,0,0
"2682",762,0,0,0,0,0,0,0,0,0,0,0,0,0,0,0,0,1037980,"2023-12-23T00:00:00.000Z",160,20,"Evan Fournier",0,0,0,0,0,0
"2683",763,0,0,0,0,0,0,0,0,0,0,0,0,0,0,0,0,1037980,"2023-12-23T00:00:00.000Z",666675,20,"DaQuan Jeffries",0,0,0,0,0,0
"2684",764,0,0,0,0,0,0,0,0,0,0,0,0,0,0,0,0,1037980,"2023-12-23T00:00:00.000Z",399,20,"Mitchell Robinson",0,0,0,0,0,0
"2685",765,0,0,0,0,0,0,0,0,0,0,0,0,0,0,0,0,1037980,"2023-12-23T00:00:00.000Z",17896063,20,"Jericho Sims",0,0,0,0,0,0
"2686",766,7,1,5,0,0,17,11,8,6,32,2,4,28,7,1,5,1037980,"2023-12-23T00:00:00.000Z",15,17,"Giannis Antetokounmpo",2,35,42,35,14,47.9
"2687",767,5,0,4,4,2,16,9,0,0,32,1,4,20,5,0,3,1037980,"2023-12-23T00:00:00.000Z",315,17,"Khris Middleton",0,25,30,25,10,30.5
"2688",768,1,1,2,2,0,7,1,4,3,35,1,3,5,3,0,0,1037980,"2023-12-23T00:00:00.000Z",283,17,"Brook Lopez",1,8,9,6,4,13.1
"2689",769,1,0,5,9,5,13,7,0,0,31,1,3,19,6,0,0,1037980,"2023-12-23T00:00:00.000Z",38,17,"Malik Beasley",0,25,26,20,7,27.7
"2690",770,7,0,6,7,3,16,6,5,4,33,3,3,19,9,1,3,1037980,"2023-12-23T00:00:00.000Z",278,17,"Damian Lillard",1,28,35,26,16,40.3
"2691",771,1,2,4,0,0,10,5,3,2,19,4,0,12,8,5,1,1037968,"2023-12-21T00:00:00.000Z",137,5,"Andre Drummond",7,20,21,13,9,43.1
"2692",772,2,1,1,1,1,3,1,2,2,19,0,1,5,1,0,0,1037968,"2023-12-21T00:00:00.000Z",87,5,"Jevon Carter",1,6,8,7,3,12.2
"2693",773,0,0,0,0,0,0,0,0,0,0,0,0,0,0,0,0,1037968,"2023-12-21T00:00:00.000Z",110,5,"Torrey Craig",0,0,0,0,0,0
"2694",774,2,0,4,2,1,8,4,0,0,34,3,0,9,7,1,1,1037968,"2023-12-21T00:00:00.000Z",38017699,27,"Jeremy Sochan",1,16,18,11,9,22.4
"2695",775,2,3,6,4,2,10,5,2,2,28,3,2,14,9,0,1,1037968,"2023-12-21T00:00:00.000Z",102,27,"Zach Collins",3,23,25,16,11,35.8
"2696",776,0,0,0,0,0,0,0,0,0,0,0,0,0,0,0,0,1038039,"2023-12-31T00:00:00.000Z",174,3,"Harry Giles III",0,0,0,0,0,0
"2697",777,0,0,0,0,0,0,0,0,0,0,0,0,0,0,0,0,1038039,"2023-12-31T00:00:00.000Z",464,3,"Lonnie Walker IV",0,0,0,0,0,0
"2698",778,0,0,0,0,0,0,0,0,0,0,0,0,0,0,0,0,1038039,"2023-12-31T00:00:00.000Z",9051997,3,"Armoni Brooks",0,0,0,0,0,0
"2699",779,3,0,3,3,0,8,3,0,0,21,2,2,6,5,0,0,1038038,"2023-12-31T00:00:00.000Z",3547293,19,"Naji Marshall",0,11,14,9,8,16.5
"2700",780,3,0,8,1,1,4,3,4,4,23,2,3,11,10,0,1,1038038,"2023-12-31T00:00:00.000Z",340,19,"Larry Nance Jr.",0,21,24,14,13,26.5
"2701",781,1,0,2,1,0,1,0,1,1,8,0,1,1,2,0,0,1038038,"2023-12-31T00:00:00.000Z",56677837,19,"Jordan Hawkins",0,3,4,2,3,4.9
"2702",782,0,0,0,0,0,0,0,0,0,0,0,0,0,0,0,0,1038038,"2023-12-31T00:00:00.000Z",3547260,19,"Kira Lewis Jr.",0,0,0,0,0,0
"2703",783,0,0,0,0,0,0,0,0,0,0,0,0,0,0,0,0,1038038,"2023-12-31T00:00:00.000Z",17896021,19,"Jeremiah Robinson-Earl",0,0,0,0,0,0
"2704",784,0,0,0,0,0,0,0,0,0,0,0,0,0,0,0,0,1038038,"2023-12-31T00:00:00.000Z",491,19,"Cody Zeller",0,0,0,0,0,0
"2705",785,0,0,0,0,0,0,0,0,0,0,0,0,0,0,0,0,1038038,"2023-12-31T00:00:00.000Z",38017663,19,"E.J. Liddell",0,0,0,0,0,0
"2706",786,0,0,0,0,0,0,0,0,0,0,0,0,0,0,0,0,1038038,"2023-12-31T00:00:00.000Z",18677986,19,"Trey Murphy III",0,0,0,0,0,0
"2707",787,0,0,0,0,0,0,0,0,0,0,0,0,0,0,0,0,1038038,"2023-12-31T00:00:00.000Z",17896017,19,"Matt Ryan",0,0,0,0,0,0
"2708",788,0,0,0,0,0,0,0,0,0,0,0,0,0,0,0,0,1038039,"2023-12-31T00:00:00.000Z",56677843,3,"Noah Clowney",0,0,0,0,0,0
"2709",789,0,0,0,0,0,0,0,0,0,0,0,0,0,0,0,0,1038039,"2023-12-31T00:00:00.000Z",17896041,3,"Keon Johnson",0,0,0,0,0,0
"2710",790,0,0,0,0,0,0,0,0,0,0,0,0,0,0,0,0,1038039,"2023-12-31T00:00:00.000Z",417,3,"Ben Simmons",0,0,0,0,0,0
"2711",791,0,0,0,0,0,0,0,0,0,0,0,0,0,0,0,0,1038039,"2023-12-31T00:00:00.000Z",56677841,3,"Dariq Whitehead",0,0,0,0,0,0
"2712",792,0,0,0,0,0,0,0,0,0,0,0,0,0,0,0,0,1038039,"2023-12-31T00:00:00.000Z",56677722,3,"Jalen Wilson",0,0,0,0,0,0
"2713",793,1,0,1,0,0,1,1,2,2,8,0,0,4,1,1,1,1038038,"2023-12-31T00:00:00.000Z",666609,14,"Rui Hachimura",1,5,6,5,2,8.7
"2714",794,0,0,2,1,0,4,2,0,0,21,0,0,4,2,1,1,1038038,"2023-12-31T00:00:00.000Z",457,14,"Jarred Vanderbilt",1,6,6,4,2,8.4
"2715",795,3,5,8,2,0,15,7,8,6,35,2,4,20,10,0,3,1038038,"2023-12-31T00:00:00.000Z",117,14,"Anthony Davis",5,30,33,23,13,48.5
"2716",796,4,2,1,7,4,9,5,1,1,34,0,2,15,1,2,2,1038038,"2023-12-31T00:00:00.000Z",383,14,"Taurean Prince",4,16,20,19,5,32.2
"2717",797,8,1,5,7,3,24,12,8,7,37,0,2,34,5,0,4,1038038,"2023-12-31T00:00:00.000Z",237,14,"LeBron James",1,39,47,42,13,51
"2718",798,9,1,1,5,1,12,7,6,5,36,1,3,20,2,1,0,1038038,"2023-12-31T00:00:00.000Z",17553995,14,"Austin Reaves",2,22,31,29,11,41.9
"2719",799,1,1,5,4,1,4,1,0,0,25,0,1,3,5,0,0,1038038,"2023-12-31T00:00:00.000Z",486,14,"Christian Wood",1,8,9,4,6,13.5
"2720",800,0,0,0,0,0,0,0,0,0,0,0,0,0,0,0,0,1038038,"2023-12-31T00:00:00.000Z",666860,14,"Cameron Reddish",0,0,0,0,0,0
"2721",801,4,0,2,2,1,2,1,0,0,12,0,2,3,2,0,0,1038114,"2024-01-10T00:00:00.000Z",38017706,21,"Jaylin Williams",0,5,9,7,6,11.4
"2722",802,0,0,0,0,0,4,1,0,0,8,0,1,2,0,0,0,1038114,"2024-01-10T00:00:00.000Z",17896078,21,"Aaron Wiggins",0,2,2,2,0,2
"2723",803,0,0,0,0,0,0,0,0,0,0,0,0,0,0,0,0,1038114,"2024-01-10T00:00:00.000Z",3547271,21,"Aleksej Pokusevski",0,0,0,0,0,0
"2724",804,0,0,0,0,0,0,0,0,0,0,0,0,0,0,0,0,1038114,"2024-01-10T00:00:00.000Z",27924547,21,"Lindy Waters III",0,0,0,0,0,0
"2725",805,0,0,0,0,0,0,0,0,0,0,0,0,0,0,0,0,1038113,"2024-01-10T00:00:00.000Z",56677788,23,"Terquavion Smith",0,0,0,0,0,0
"2726",806,0,0,0,0,0,0,0,0,0,0,0,0,0,0,0,0,1038114,"2024-01-10T00:00:00.000Z",44,21,"Davis Bertans",0,0,0,0,0,0
"2727",807,0,0,0,0,0,0,0,0,0,0,0,0,0,0,0,0,1038114,"2024-01-10T00:00:00.000Z",38017716,21,"Ousmane Dieng",0,0,0,0,0,0
"2728",808,3,1,4,9,2,10,3,6,4,32,2,3,12,6,1,0,1038115,"2024-01-10T00:00:00.000Z",89,5,"Alex Caruso",2,18,21,15,9,29.7
"2729",809,4,0,4,6,3,19,5,6,6,43,0,2,19,4,0,1,1038115,"2024-01-10T00:00:00.000Z",125,5,"DeMar DeRozan",0,23,27,23,8,28.8
"2730",810,3,1,12,5,0,17,9,0,0,40,3,4,18,15,0,0,1038115,"2024-01-10T00:00:00.000Z",460,5,"Nikola Vucevic",1,33,36,21,18,43.5
"2731",811,7,1,12,8,4,15,8,6,5,41,1,5,25,13,3,4,1038115,"2024-01-10T00:00:00.000Z",268,5,"Zach LaVine",4,38,45,32,20,59.1
"2732",812,8,1,4,11,6,17,9,7,6,43,0,1,30,4,0,4,1038115,"2024-01-10T00:00:00.000Z",666956,5,"Coby White",1,34,42,38,12,45.8
"2733",813,3,0,2,4,2,8,3,0,0,18,2,0,8,4,0,0,1038115,"2024-01-10T00:00:00.000Z",17895983,5,"Ayo Dosunmu",0,12,15,11,7,17.3
"2734",814,0,0,0,0,0,2,2,0,0,13,0,1,4,0,2,3,1038115,"2024-01-10T00:00:00.000Z",137,5,"Andre Drummond",2,4,4,4,0,7
"2735",815,0,0,0,0,0,0,0,0,0,0,0,0,0,0,0,0,1038115,"2024-01-10T00:00:00.000Z",87,5,"Jevon Carter",0,0,0,0,0,0
"2736",816,0,0,0,0,0,0,0,0,0,0,0,0,0,0,0,0,1038115,"2024-01-10T00:00:00.000Z",110,5,"Torrey Craig",0,0,0,0,0,0
"2737",817,0,1,2,1,0,4,1,0,0,17,1,2,2,3,0,0,1038110,"2024-01-10T00:00:00.000Z",666925,26,"Juan Toscano-Anderson",1,5,5,2,3,8.6
"2738",818,0,0,0,0,0,0,0,0,0,0,0,0,0,0,0,0,1038110,"2024-01-10T00:00:00.000Z",4197162,26,"Aleksandar Vezenkov",0,0,0,0,0,0
"2739",819,0,0,0,0,0,0,0,0,0,0,0,0,0,0,0,0,1038110,"2024-01-10T00:00:00.000Z",17896044,26,"Kessler Edwards",0,0,0,0,0,0
"2740",820,0,0,0,0,0,0,0,0,0,0,0,0,0,0,0,0,1038110,"2024-01-10T00:00:00.000Z",17895990,26,"Jordan Ford",0,0,0,0,0,0
"2741",821,0,0,0,0,0,0,0,0,0,0,0,0,0,0,0,0,1038109,"2024-01-10T00:00:00.000Z",176,18,"Rudy Gobert",0,0,0,0,0,0
"2742",822,0,0,0,0,0,0,0,0,0,0,0,0,0,0,0,0,1038110,"2024-01-10T00:00:00.000Z",56677862,26,"Jalen Slawson",0,0,0,0,0,0
"2743",823,1,0,0,3,1,6,2,0,0,29,0,2,5,0,3,2,1038115,"2024-01-10T00:00:00.000Z",3547248,5,"Patrick Williams",3,5,6,6,1,13.5
"2744",824,1,0,0,1,1,1,1,0,0,6,0,1,3,0,0,0,1038115,"2024-01-10T00:00:00.000Z",38017719,5,"Dalen Terry",0,3,4,4,1,4.5
"2745",825,0,0,0,0,0,0,0,0,0,0,0,0,0,0,0,0,1038115,"2024-01-10T00:00:00.000Z",17896116,5,"Terry Taylor",0,0,0,0,0,0
"2746",826,4,0,4,7,2,14,7,11,9,35,1,2,25,5,1,4,1037639,"2023-10-30T00:00:00.000Z",278,17,"Damian Lillard",1,30,34,29,9,36
"2747",827,2,1,4,3,2,7,3,0,0,25,1,2,8,5,1,1,1037639,"2023-10-30T00:00:00.000Z",112,17,"Jae Crowder",2,13,15,10,7,22
"2748",828,2,1,5,3,2,5,3,0,0,23,0,2,8,5,0,1,1037639,"2023-10-30T00:00:00.000Z",105,17,"Pat Connaughton",1,13,15,10,7,19
"2749",829,3,1,1,5,2,9,3,0,0,23,1,2,8,2,1,0,1037639,"2023-10-30T00:00:00.000Z",56677785,16,"Jaime Jaquez Jr.",2,10,13,11,5,20.9
"2750",830,0,0,0,0,0,0,0,0,0,0,0,0,0,0,0,0,1037639,"2023-10-30T00:00:00.000Z",38017734,16,"Jamal Cain",0,0,0,0,0,0
"2751",831,0,0,0,0,0,0,0,0,0,0,0,0,0,0,0,0,1037639,"2023-10-30T00:00:00.000Z",3547257,16,"R.J. Hampton",0,0,0,0,0,0
"2752",832,0,0,0,0,0,0,0,0,0,0,0,0,0,0,0,0,1037640,"2023-10-30T00:00:00.000Z",17896070,10,"Usman Garuba",0,0,0,0,0,0
"2753",833,0,0,0,0,0,0,0,0,0,0,0,0,0,0,0,0,1037640,"2023-10-30T00:00:00.000Z",17553979,10,"Jonathan Kuminga",0,0,0,0,0,0
"2754",834,0,0,0,0,0,0,0,0,0,0,0,0,0,0,0,0,1037640,"2023-10-30T00:00:00.000Z",443,10,"Klay Thompson",0,0,0,0,0,0
"2755",835,0,0,0,0,0,0,0,0,0,0,0,0,0,0,0,0,1037636,"2023-10-30T00:00:00.000Z",56677782,18,"Leonard Miller",0,0,0,0,0,0
"2756",836,0,0,0,0,0,0,0,0,0,0,0,0,0,0,0,0,1037636,"2023-10-30T00:00:00.000Z",38017700,18,"Wendell Moore Jr.",0,0,0,0,0,0
"2757",837,0,0,0,0,0,0,0,0,0,0,0,0,0,0,0,0,1037637,"2023-10-30T00:00:00.000Z",476,25,"Robert Williams III",0,0,0,0,0,0
"2758",838,0,0,0,0,0,0,0,0,0,0,0,0,0,0,0,0,1037638,"2023-10-30T00:00:00.000Z",3,15,"Steven Adams",0,0,0,0,0,0
"2759",839,0,0,0,0,0,0,0,0,0,0,0,0,0,0,0,0,1037638,"2023-10-30T00:00:00.000Z",17896067,15,"Santi Aldama",0,0,0,0,0,0
"2760",840,0,0,0,0,0,0,0,0,0,0,0,0,0,0,0,0,1037638,"2023-10-30T00:00:00.000Z",666505,15,"Brandon Clarke",0,0,0,0,0,0
"2761",841,0,0,0,0,0,0,0,0,0,0,0,0,0,0,0,0,1037638,"2023-10-30T00:00:00.000Z",254,15,"Luke Kennard",0,0,0,0,0,0
"2762",842,0,0,4,6,4,10,7,6,4,27,0,0,22,4,0,1,1037638,"2023-10-30T00:00:00.000Z",247,7,"Derrick Jones Jr.",0,26,26,22,4,25.8
"2763",843,2,0,2,8,4,8,4,4,3,31,1,1,15,3,0,1,1037638,"2023-10-30T00:00:00.000Z",666965,7,"Grant Williams",0,18,20,17,5,20.6
"2764",844,0,1,5,0,0,2,1,0,0,14,1,5,2,6,0,0,1037638,"2023-10-30T00:00:00.000Z",56677840,7,"Dereck Lively II",1,8,8,2,6,12.2
"2765",845,2,1,6,4,1,7,2,2,1,21,4,2,6,10,0,0,1037640,"2023-10-30T00:00:00.000Z",407,10,"Dario Saric",1,16,18,8,12,24
"2766",846,1,1,2,6,2,10,4,0,0,20,2,4,10,4,1,0,1037640,"2023-10-30T00:00:00.000Z",2189,10,"Gary Payton II",2,14,15,11,5,22.3
"2767",847,2,0,7,1,0,5,2,2,1,23,1,4,5,8,0,2,1037640,"2023-10-30T00:00:00.000Z",56677858,10,"Brandin Podziemski",0,13,15,7,10,15.6
"2768",848,0,0,1,0,0,2,0,0,0,5,0,0,0,1,0,0,1037640,"2023-10-30T00:00:00.000Z",398,10,"Jerome Robinson",0,1,1,0,1,1.2
"2769",849,0,0,0,2,1,3,2,0,0,5,0,0,5,0,0,0,1037640,"2023-10-30T00:00:00.000Z",45658838,10,"Lester Quinones",0,5,5,5,0,5
"2770",850,7,0,5,1,1,7,4,2,2,26,2,4,11,7,1,3,1037639,"2023-10-30T00:00:00.000Z",39398582,16,"Orlando Robinson",1,18,25,18,14,29.9
"2771",851,0,0,0,0,0,0,0,0,0,0,0,0,0,0,0,0,3277425,"2023-11-14T00:00:00.000Z",666748,4,"Cody Martin",0,0,0,0,0,0
"2772",852,0,0,0,0,0,0,0,0,0,0,0,0,0,0,0,0,3277425,"2023-11-14T00:00:00.000Z",56677823,4,"Brandon Miller",0,0,0,0,0,0
"2773",853,0,0,0,0,0,0,0,0,0,0,0,0,0,0,0,0,3277425,"2023-11-14T00:00:00.000Z",347,4,"Frank Ntilikina",0,0,0,0,0,0
"2774",854,0,0,0,0,0,0,0,0,0,0,0,0,0,0,0,0,3277425,"2023-11-14T00:00:00.000Z",403,4,"Terry Rozier",0,0,0,0,0,0
"2775",855,5,0,1,1,1,14,10,14,11,34,3,1,32,4,2,3,3277425,"2023-11-14T00:00:00.000Z",79,16,"Jimmy Butler",2,36,41,37,9,47.3
"2776",856,2,2,3,5,2,8,5,0,0,33,1,1,12,4,5,0,3277425,"2023-11-14T00:00:00.000Z",3092,16,"Haywood Highsmith",7,16,18,14,6,40.8
"2777",857,2,0,4,7,3,11,7,4,3,29,1,1,20,5,3,1,3277428,"2023-11-14T00:00:00.000Z",666679,3,"Cameron Johnson",3,25,27,22,7,37
"2778",858,0,0,2,4,1,5,2,0,0,24,2,1,5,4,1,0,3277428,"2023-11-14T00:00:00.000Z",158,3,"Dorian Finney-Smith",1,9,9,5,4,12.8
"2779",859,0,2,4,0,0,5,3,2,2,21,2,4,8,6,1,1,3277428,"2023-11-14T00:00:00.000Z",666508,3,"Nicolas Claxton",3,14,14,8,6,23.2
"2780",860,4,0,4,5,3,17,9,1,0,32,1,2,21,5,4,6,3277428,"2023-11-14T00:00:00.000Z",61,3,"Mikal Bridges",4,26,30,25,9,39
"2781",861,9,0,4,10,5,18,10,6,4,37,1,3,29,5,0,1,3277428,"2023-11-14T00:00:00.000Z",130,3,"Spencer Dinwiddie",0,34,43,38,14,47.5
"2782",862,0,1,2,3,1,6,2,2,1,24,1,2,6,3,1,0,3277429,"2023-11-14T00:00:00.000Z",666541,21,"Luguentz Dort",2,9,9,6,3,15.6
"2783",863,3,0,2,3,1,9,5,0,0,23,0,3,11,2,0,3,3277429,"2023-11-14T00:00:00.000Z",38017703,21,"Jalen Williams",0,13,16,14,5,14.9
"2784",864,3,1,7,5,1,10,3,2,2,30,0,2,9,7,2,2,3277429,"2023-11-14T00:00:00.000Z",38017685,21,"Chet Holmgren",3,16,19,12,10,28.9
"2785",865,7,2,6,2,0,11,7,5,4,25,1,0,18,7,0,3,3277429,"2023-11-14T00:00:00.000Z",17896065,21,"Josh Giddey",2,25,32,25,14,39.9
"2786",866,5,0,5,4,1,16,10,7,7,28,1,2,28,6,7,2,3277429,"2023-11-14T00:00:00.000Z",175,21,"Shai Gilgeous-Alexander",7,34,39,33,11,61.7
"2787",867,1,0,2,3,2,5,3,0,0,14,0,1,8,2,2,0,3277429,"2023-11-14T00:00:00.000Z",3547272,21,"Isaiah Joe",2,10,11,9,3,17.9
"2788",868,3,2,4,1,1,5,4,0,0,21,1,1,9,5,2,1,3277429,"2023-11-14T00:00:00.000Z",56677833,21,"Cason Wallace",4,14,17,12,8,30.5
"2789",869,4,0,1,3,2,4,2,4,2,19,0,1,8,1,1,2,3277429,"2023-11-14T00:00:00.000Z",4197029,21,"Vasilije Micic",1,9,13,12,5,16.2
"2790",870,2,0,2,3,1,4,2,0,0,8,0,0,5,2,1,1,3277429,"2023-11-14T00:00:00.000Z",17896036,21,"Tre Mann",1,7,9,7,4,12.4
"2791",871,1,0,1,1,0,1,0,0,0,5,0,0,0,1,0,0,3277429,"2023-11-14T00:00:00.000Z",3547271,21,"Aleksej Pokusevski",0,1,2,1,2,2.7
"2792",872,0,0,0,0,0,0,0,0,0,0,0,0,0,0,0,0,3277429,"2023-11-14T00:00:00.000Z",44,21,"Davis Bertans",0,0,0,0,0,0
"2793",873,0,0,0,3,1,3,1,2,2,8,0,2,5,0,0,0,3277426,"2023-11-14T00:00:00.000Z",38017689,1,"AJ Griffin",0,5,5,5,0,5
"2794",874,2,1,6,0,0,4,4,0,0,21,3,5,8,9,0,2,3277426,"2023-11-14T00:00:00.000Z",3547244,1,"Onyeka Okongwu",1,17,19,10,11,22.8
"2795",875,0,0,1,1,1,1,1,0,0,2,0,0,3,1,0,0,3277426,"2023-11-14T00:00:00.000Z",666754,1,"Garrison Mathews",0,4,4,3,1,4.2
"2796",876,2,3,5,11,5,21,13,2,2,31,1,3,33,6,0,1,1037823,"2023-11-25T00:00:00.000Z",38017685,21,"Chet Holmgren",3,39,41,35,8,51.2
"2797",877,8,0,4,1,0,12,4,2,2,26,3,4,10,7,0,1,1037823,"2023-11-25T00:00:00.000Z",17896065,21,"Josh Giddey",0,17,25,18,15,29.4
"2798",878,5,0,3,2,1,21,10,10,10,36,3,3,31,6,2,1,1037823,"2023-11-25T00:00:00.000Z",175,21,"Shai Gilgeous-Alexander",2,37,42,36,11,50.7
"2799",879,2,0,0,1,0,2,0,0,0,8,1,1,0,1,0,0,1037823,"2023-11-25T00:00:00.000Z",38017716,21,"Ousmane Dieng",0,1,3,2,3,4.2
"2800",880,1,0,1,2,1,3,1,3,2,10,0,2,5,1,0,0,1037823,"2023-11-25T00:00:00.000Z",44,21,"Davis Bertans",0,6,7,6,2,7.7
"2801",881,0,0,0,0,0,0,0,0,0,0,0,0,0,0,0,0,1037823,"2023-11-25T00:00:00.000Z",17896036,21,"Tre Mann",0,0,0,0,0,0
"2802",882,0,0,0,0,0,0,0,0,0,0,0,0,0,0,0,0,1037823,"2023-11-25T00:00:00.000Z",4197029,21,"Vasilije Micic",0,0,0,0,0,0
"2803",883,0,0,0,0,0,0,0,0,0,0,0,0,0,0,0,0,1037823,"2023-11-25T00:00:00.000Z",3547271,21,"Aleksej Pokusevski",0,0,0,0,0,0
"2804",884,0,0,0,0,0,0,0,0,0,0,0,0,0,0,0,0,1037823,"2023-11-25T00:00:00.000Z",24572055,21,"Olivier Sarr",0,0,0,0,0,0
"2805",885,0,0,0,0,0,0,0,0,0,0,0,0,0,0,0,0,1037823,"2023-11-25T00:00:00.000Z",56677853,21,"Keyontae Johnson",0,0,0,0,0,0
"2806",886,0,0,0,0,0,0,0,0,0,0,0,0,0,0,0,0,1037823,"2023-11-25T00:00:00.000Z",27924547,21,"Lindy Waters III",0,0,0,0,0,0
"2807",887,0,0,0,0,0,0,0,0,0,0,0,0,0,0,0,0,1037823,"2023-11-25T00:00:00.000Z",38017703,21,"Jalen Williams",0,0,0,0,0,0
"2808",888,3,2,3,6,3,7,4,4,3,33,4,0,14,7,0,1,1037823,"2023-11-25T00:00:00.000Z",33,23,"Nicolas Batum",2,21,24,17,10,31.9
"2809",889,6,0,5,5,1,13,6,3,3,31,0,3,16,5,0,3,1037823,"2023-11-25T00:00:00.000Z",200,23,"Tobias Harris",0,21,27,22,11,28
"2810",890,9,4,7,4,0,18,8,21,19,37,4,5,35,11,1,4,1037823,"2023-11-25T00:00:00.000Z",145,23,"Joel Embiid",5,46,55,44,20,72.7
"2811",891,5,0,5,5,2,9,3,0,0,26,1,4,8,6,0,0,1037823,"2023-11-25T00:00:00.000Z",38017706,21,"Jaylin Williams",0,14,19,13,11,22.7
"2812",892,2,0,3,12,3,14,4,2,2,26,0,3,13,3,0,0,1037823,"2023-11-25T00:00:00.000Z",3547272,21,"Isaiah Joe",0,16,18,15,5,19.6
"2813",893,1,0,1,3,1,4,2,4,2,20,2,1,7,3,0,0,1037823,"2023-11-25T00:00:00.000Z",17896078,21,"Aaron Wiggins",0,10,11,8,4,12.1
"2814",894,2,0,2,3,2,5,4,2,1,19,0,2,11,2,1,0,1037823,"2023-11-25T00:00:00.000Z",480,21,"Kenrich Williams",1,13,15,13,4,19.4
"2815",895,5,1,4,8,3,12,5,2,1,30,3,3,14,7,0,0,1037823,"2023-11-25T00:00:00.000Z",313,23,"De'Anthony Melton",1,21,26,19,12,32.9
"2816",896,3,1,7,9,3,17,8,11,9,41,1,5,28,8,0,1,1037823,"2023-11-25T00:00:00.000Z",3547254,23,"Tyrese Maxey",1,36,39,31,11,44.1
"2817",897,4,0,2,3,1,5,2,2,1,21,2,1,6,4,0,0,1037823,"2023-11-25T00:00:00.000Z",45,23,"Patrick Beverley",0,10,14,10,8,16.8
"2818",898,0,0,2,2,0,2,0,0,0,15,1,3,0,3,0,1,1037823,"2023-11-25T00:00:00.000Z",328,23,"Marcus Morris",0,3,3,0,3,2.6
"2819",899,0,1,1,3,2,5,3,2,1,21,0,5,9,1,1,0,1037823,"2023-11-25T00:00:00.000Z",108,23,"Robert Covington",2,10,10,9,1,16.2
"2820",900,0,0,1,1,1,4,2,0,0,11,2,1,5,3,0,2,1037823,"2023-11-25T00:00:00.000Z",3547270,23,"Paul Reed",0,8,8,5,3,6.6
"2821",901,0,0,0,0,0,0,0,0,0,0,0,0,0,0,0,0,7049317,"2023-12-06T00:00:00.000Z",17896041,3,"Keon Johnson",0,0,0,0,0,0
"2822",902,2,0,0,4,1,13,6,2,2,32,0,2,15,0,0,2,7049315,"2023-12-06T00:00:00.000Z",56677785,16,"Jaime Jaquez Jr.",0,15,17,17,2,16
"2823",903,4,0,1,4,1,5,2,3,3,15,1,2,8,2,0,0,7049315,"2023-12-06T00:00:00.000Z",285,16,"Kevin Love",0,10,14,12,6,16.4
"2824",904,2,0,3,4,1,6,2,2,2,31,1,3,7,4,0,1,7049315,"2023-12-06T00:00:00.000Z",391,16,"Josh Richardson",0,11,13,9,6,13.8
"2825",905,0,0,1,2,1,3,1,0,0,5,0,0,3,1,0,0,7049321,"2023-12-06T00:00:00.000Z",329,7,"Markieff Morris",0,4,4,3,1,4.2
"2826",906,0,0,0,0,0,0,0,0,0,0,0,0,0,0,0,0,7049321,"2023-12-06T00:00:00.000Z",17896028,7,"Greg Brown III",0,0,0,0,0,0
"2827",907,0,0,0,0,0,0,0,0,0,0,0,0,0,0,0,0,7049321,"2023-12-06T00:00:00.000Z",56677873,7,"Dexter Dennis",0,0,0,0,0,0
"2828",908,0,0,0,0,0,0,0,0,0,0,0,0,0,0,0,0,7049321,"2023-12-06T00:00:00.000Z",3547258,7,"Josh Green",0,0,0,0,0,0
"2829",909,0,0,0,0,0,0,0,0,0,0,0,0,0,0,0,0,7049321,"2023-12-06T00:00:00.000Z",257,7,"Maxi Kleber",0,0,0,0,0,0
"2830",910,0,0,0,0,0,0,0,0,0,0,0,0,0,0,0,0,7049321,"2023-12-06T00:00:00.000Z",666965,7,"Grant Williams",0,0,0,0,0,0
"2831",911,3,1,2,3,1,5,2,2,2,24,0,1,7,2,0,1,7049321,"2023-12-06T00:00:00.000Z",38017739,29,"Simone Fontecchio",1,9,12,10,5,15.9
"2832",912,0,0,6,2,0,11,5,0,0,23,2,2,10,8,0,2,7049321,"2023-12-06T00:00:00.000Z",101,29,"John Collins",0,18,18,10,8,17.6
"2833",913,0,0,0,0,0,0,0,0,0,0,0,0,0,0,0,0,7049317,"2023-12-06T00:00:00.000Z",417,3,"Ben Simmons",0,0,0,0,0,0
"2834",914,0,0,0,0,0,0,0,0,0,0,0,0,0,0,0,0,7049317,"2023-12-06T00:00:00.000Z",56677841,3,"Dariq Whitehead",0,0,0,0,0,0
"2835",915,0,0,0,0,0,0,0,0,0,0,0,0,0,0,0,0,7049317,"2023-12-06T00:00:00.000Z",56677722,3,"Jalen Wilson",0,0,0,0,0,0
"2836",916,5,1,3,3,1,16,8,0,0,38,1,2,17,4,1,2,7049323,"2023-12-06T00:00:00.000Z",274,13,"Kawhi Leonard",2,21,26,22,9,33.3
"2837",917,1,1,7,9,5,20,8,4,4,38,1,1,25,8,0,2,7049323,"2023-12-06T00:00:00.000Z",172,13,"Paul George",1,33,34,26,9,37.1
"2838",918,0,1,7,0,0,7,4,6,2,27,2,3,10,9,2,0,7049323,"2023-12-06T00:00:00.000Z",493,13,"Ivica Zubac",3,19,19,10,9,29.8
"2839",919,0,0,1,0,0,2,1,0,0,20,0,1,2,1,0,0,7049323,"2023-12-06T00:00:00.000Z",666743,13,"Terance Mann",0,3,3,2,1,3.2
"2840",920,11,0,1,3,2,10,6,7,6,32,0,0,20,1,3,4,7049323,"2023-12-06T00:00:00.000Z",192,13,"James Harden",3,21,32,31,12,42.7
"2841",921,1,0,4,3,1,4,1,0,0,17,0,4,3,4,0,0,7049323,"2023-12-06T00:00:00.000Z",56677849,13,"Kobe Brown",0,7,8,4,5,9.3
"2842",922,0,0,0,0,0,0,0,0,0,0,0,0,0,0,0,0,7049323,"2023-12-06T00:00:00.000Z",666511,13,"Amir Coffey",0,0,0,0,0,0
"2843",923,1,0,2,1,0,12,3,3,3,27,1,1,9,3,0,1,7049322,"2023-12-06T00:00:00.000Z",475,10,"Andrew Wiggins",0,12,13,10,4,13.1
"2844",924,9,2,4,2,0,7,3,4,4,31,6,3,10,10,0,4,7049322,"2023-12-06T00:00:00.000Z",185,10,"Draymond Green",2,20,29,19,19,37.5
"2845",925,0,0,6,0,0,6,2,2,2,16,2,2,6,8,1,0,7049322,"2023-12-06T00:00:00.000Z",282,10,"Kevon Looney",1,14,14,6,8,18.6
"2846",926,0,0,0,0,0,0,0,0,0,0,0,0,0,0,0,0,1037941,"2023-12-18T00:00:00.000Z",357,11,"Victor Oladipo",0,0,0,0,0,0
"2847",927,0,0,0,0,0,0,0,0,0,0,0,0,0,0,0,0,1037941,"2023-12-18T00:00:00.000Z",56677809,11,"Jermaine Samuels Jr.",0,0,0,0,0,0
"2848",928,0,0,0,1,0,3,0,0,0,5,0,0,0,0,0,0,1037944,"2023-12-18T00:00:00.000Z",17896071,9,"Isaiah Livers",0,0,0,0,0,0
"2849",929,2,0,5,0,0,5,5,2,0,25,2,2,10,7,0,2,1037944,"2023-12-18T00:00:00.000Z",3547240,9,"James Wiseman",0,17,19,12,9,19.4
"2850",930,1,1,1,1,1,3,2,0,0,21,0,6,5,1,1,0,1037944,"2023-12-18T00:00:00.000Z",56677792,9,"Marcus Sasser",2,6,7,6,2,13.7
"2851",931,0,0,0,0,0,0,0,0,0,0,0,0,0,0,0,0,1037944,"2023-12-18T00:00:00.000Z",3547241,9,"Killian Hayes",0,0,0,0,0,0
"2852",932,0,0,0,0,0,0,0,0,0,0,0,0,0,0,0,0,1037944,"2023-12-18T00:00:00.000Z",259,9,"Kevin Knox",0,0,0,0,0,0
"2853",933,0,0,0,0,0,0,0,0,0,0,0,0,0,0,0,0,1037944,"2023-12-18T00:00:00.000Z",3547267,9,"Isaiah Stewart",0,0,0,0,0,0
"2854",934,0,0,0,0,0,0,0,0,0,0,0,0,0,0,0,0,1037944,"2023-12-18T00:00:00.000Z",56677729,9,"Malcolm Cazalon",0,0,0,0,0,0
"2855",935,0,0,0,0,0,0,0,0,0,0,0,0,0,0,0,0,1037944,"2023-12-18T00:00:00.000Z",38017694,9,"Jalen Duren",0,0,0,0,0,0
"2856",936,9,1,7,6,2,17,9,4,4,40,1,0,24,8,0,2,1037943,"2023-12-18T00:00:00.000Z",666956,5,"Coby White",1,32,41,33,17,48.1
"2857",937,0,0,0,0,0,0,0,0,0,0,0,0,0,0,0,0,1037944,"2023-12-18T00:00:00.000Z",330,9,"Monte Morris",0,0,0,0,0,0
"2858",938,0,0,0,0,0,0,0,0,0,0,0,0,0,0,0,0,1037944,"2023-12-18T00:00:00.000Z",42097199,9,"Jared Rhoden",0,0,0,0,0,0
"2859",939,0,0,0,0,0,0,0,0,0,0,0,0,0,0,0,0,1037944,"2023-12-18T00:00:00.000Z",44477024,9,"Stanley Umude",0,0,0,0,0,0
"2860",940,2,0,0,0,0,0,0,0,0,7,0,0,0,0,0,1,1037947,"2023-12-18T00:00:00.000Z",17896036,21,"Tre Mann",0,0,2,2,2,2
"2861",941,0,0,0,0,0,0,0,0,0,0,0,0,0,0,0,0,1037947,"2023-12-18T00:00:00.000Z",44,21,"Davis Bertans",0,0,0,0,0,0
"2862",942,1,1,0,0,0,10,4,0,0,23,0,1,8,0,0,1,1037946,"2023-12-18T00:00:00.000Z",422,4,"Ish Smith",1,8,9,9,1,11.5
"2863",943,0,1,1,5,1,9,3,0,0,20,0,2,7,1,0,1,1037946,"2023-12-18T00:00:00.000Z",56677846,4,"Nick Smith Jr.",1,8,8,7,1,10.2
"2864",944,0,0,0,0,0,0,0,0,0,0,0,0,0,0,0,0,1037946,"2023-12-18T00:00:00.000Z",347,4,"Frank Ntilikina",0,0,0,0,0,0
"2865",945,0,0,0,0,0,0,0,0,0,0,0,0,0,0,0,0,1037946,"2023-12-18T00:00:00.000Z",56677848,4,"Amari Bailey",0,0,0,0,0,0
"2866",946,0,0,0,0,0,0,0,0,0,0,0,0,0,0,0,0,1037946,"2023-12-18T00:00:00.000Z",3547239,4,"LaMelo Ball",0,0,0,0,0,0
"2867",947,2,1,2,6,3,7,4,0,0,21,0,2,11,2,0,0,1037947,"2023-12-18T00:00:00.000Z",666541,21,"Luguentz Dort",1,13,15,13,4,19.4
"2868",948,5,1,4,3,1,9,3,4,3,28,0,2,10,4,2,0,1037947,"2023-12-18T00:00:00.000Z",38017703,21,"Jalen Williams",3,14,19,15,9,31.3
"2869",949,2,7,4,4,2,14,7,1,1,25,2,2,17,6,1,2,1037947,"2023-12-18T00:00:00.000Z",38017685,21,"Chet Holmgren",8,23,25,19,8,49.2
"2870",950,4,0,9,4,0,12,6,4,4,24,3,0,16,12,1,1,1037947,"2023-12-18T00:00:00.000Z",17896065,21,"Josh Giddey",1,28,32,20,16,38.4
"2871",951,0,0,0,0,0,0,0,0,0,0,0,0,0,0,0,0,1038025,"2023-12-29T00:00:00.000Z",248,6,"Damian Jones",0,0,0,0,0,0
"2872",952,0,0,0,0,0,0,0,0,0,0,0,0,0,0,0,0,1038025,"2023-12-29T00:00:00.000Z",56677847,6,"Emoni Bates",0,0,0,0,0,0
"2873",953,0,0,0,0,0,0,0,0,0,0,0,0,0,0,0,0,1038025,"2023-12-29T00:00:00.000Z",666581,6,"Darius Garland",0,0,0,0,0,0
"2874",954,4,1,9,6,2,19,9,12,9,36,1,3,29,10,1,2,1038021,"2023-12-29T00:00:00.000Z",38017683,22,"Paolo Banchero",2,39,43,33,14,51
"2875",955,0,2,4,0,0,8,4,8,5,31,3,3,13,7,1,2,1038021,"2023-12-29T00:00:00.000Z",666442,22,"Goga Bitadze",3,20,20,13,7,28.4
"2876",956,6,1,2,7,2,15,8,6,3,31,0,4,21,2,0,3,1038021,"2023-12-29T00:00:00.000Z",17896073,22,"Jalen Suggs",1,23,29,27,8,32.4
"2877",957,5,0,4,0,0,2,2,0,0,29,2,4,4,6,2,1,1038021,"2023-12-29T00:00:00.000Z",56677827,22,"Anthony Black",2,10,15,9,11,23.7
"2878",958,0,0,0,5,0,5,0,0,0,21,2,1,0,2,0,1,1038021,"2023-12-29T00:00:00.000Z",38017724,22,"Caleb Houstan",0,2,2,0,2,1.4
"2879",959,1,1,7,3,0,8,2,3,3,18,4,1,7,11,0,1,1038021,"2023-12-29T00:00:00.000Z",462,22,"Moritz Wagner",1,18,19,8,12,23.7
"2880",960,5,0,2,3,0,8,3,4,3,23,0,2,9,2,2,1,1038021,"2023-12-29T00:00:00.000Z",3547251,22,"Cole Anthony",2,11,16,14,7,23.9
"2881",961,1,0,0,4,0,5,1,0,0,12,0,1,2,0,0,0,1038021,"2023-12-29T00:00:00.000Z",666818,22,"Chuma Okeke",0,2,3,3,1,3.5
"2882",962,0,0,0,0,0,0,0,0,0,0,0,0,0,0,0,0,1038021,"2023-12-29T00:00:00.000Z",85,22,"Wendell Carter Jr.",0,0,0,0,0,0
"2883",963,0,0,0,0,0,0,0,0,0,0,0,0,0,0,0,0,1038021,"2023-12-29T00:00:00.000Z",17553983,22,"Trevelin Queen",0,0,0,0,0,0
"2884",964,0,0,0,0,0,0,0,0,0,0,0,0,0,0,0,0,1038021,"2023-12-29T00:00:00.000Z",165,22,"Markelle Fultz",0,0,0,0,0,0
"2885",965,0,0,0,0,0,0,0,0,0,0,0,0,0,0,0,0,1038021,"2023-12-29T00:00:00.000Z",196,22,"Gary Harris",0,0,0,0,0,0
"2886",966,0,0,0,0,0,0,0,0,0,0,0,0,0,0,0,0,1038021,"2023-12-29T00:00:00.000Z",38017607,22,"Kevon Harris",0,0,0,0,0,0
"2887",967,0,0,0,0,0,0,0,0,0,0,0,0,0,0,0,0,1038021,"2023-12-29T00:00:00.000Z",56677839,22,"Jett Howard",0,0,0,0,0,0
"2888",968,0,0,0,0,0,0,0,0,0,0,0,0,0,0,0,0,1038021,"2023-12-29T00:00:00.000Z",226,22,"Joe Ingles",0,0,0,0,0,0
"2889",969,0,0,0,0,0,0,0,0,0,0,0,0,0,0,0,0,1038021,"2023-12-29T00:00:00.000Z",229,22,"Jonathan Isaac",0,0,0,0,0,0
"2890",970,0,0,0,0,0,0,0,0,0,0,0,0,0,0,0,0,1038021,"2023-12-29T00:00:00.000Z",666885,22,"Admiral Schofield",0,0,0,0,0,0
"2891",971,2,0,4,5,1,17,7,5,4,37,2,4,19,6,1,2,1038021,"2023-12-29T00:00:00.000Z",666423,20,"RJ Barrett",1,25,27,21,8,30.2
"2892",972,6,1,9,4,0,25,16,8,6,36,3,5,38,12,0,5,1038021,"2023-12-29T00:00:00.000Z",387,20,"Julius Randle",1,50,56,44,18,59.4
"2893",973,3,0,2,0,0,4,2,3,3,25,1,4,7,3,3,2,1038021,"2023-12-29T00:00:00.000Z",201,20,"Isaiah Hartenstein",3,10,13,10,6,22.1
"2894",974,2,1,1,5,0,7,1,0,0,20,0,4,2,1,3,1,1038021,"2023-12-29T00:00:00.000Z",131,20,"Donte DiVincenzo",4,3,5,4,3,17.2
"2895",975,0,0,0,7,3,10,6,0,0,17,0,2,15,0,0,0,1038022,"2023-12-29T00:00:00.000Z",17896045,30,"Corey Kispert",0,15,15,15,0,15
"2896",976,1,1,2,0,0,2,1,3,3,11,0,3,5,2,1,2,1038101,"2024-01-08T00:00:00.000Z",56677825,11,"Amen Thompson",2,7,8,6,3,12.9
"2897",977,0,0,5,2,1,8,5,0,0,17,1,4,11,6,1,1,1038101,"2024-01-08T00:00:00.000Z",56677831,11,"Cam Whitmore",1,17,17,11,6,20.2
"2898",978,0,0,0,0,0,0,0,0,0,0,0,0,0,0,0,0,1038101,"2024-01-08T00:00:00.000Z",75,11,"Reggie Bullock",0,0,0,0,0,0
"2899",979,1,1,3,3,0,5,2,4,3,27,0,4,7,3,0,2,1038100,"2024-01-08T00:00:00.000Z",666541,21,"Luguentz Dort",1,10,11,8,4,13.1
"2900",980,10,0,6,1,1,13,9,2,2,34,1,3,21,7,2,3,1038100,"2024-01-08T00:00:00.000Z",38017703,21,"Jalen Williams",2,28,38,31,17,47.4
"2901",981,5,2,3,5,4,14,11,8,5,32,1,3,31,4,0,1,1038100,"2024-01-08T00:00:00.000Z",38017685,21,"Chet Holmgren",2,35,40,36,9,48.3
"2902",982,5,1,5,3,2,17,11,10,8,36,1,5,32,6,3,3,1038100,"2024-01-08T00:00:00.000Z",175,21,"Shai Gilgeous-Alexander",4,38,43,37,11,55.7
"2903",983,9,0,5,3,1,11,4,0,0,26,1,2,9,6,2,1,1038100,"2024-01-08T00:00:00.000Z",17896065,21,"Josh Giddey",2,15,24,18,15,34.7
"2904",984,0,0,0,0,0,0,0,0,0,0,0,0,0,0,0,0,1038101,"2024-01-08T00:00:00.000Z",19465326,11,"Jock Landale",0,0,0,0,0,0
"2905",985,0,0,0,0,0,0,0,0,0,0,0,0,0,0,0,0,1038101,"2024-01-08T00:00:00.000Z",296,11,"Boban Marjanovic",0,0,0,0,0,0
"2906",986,0,0,0,0,0,0,0,0,0,0,0,0,0,0,0,0,1038099,"2024-01-08T00:00:00.000Z",17553967,2,"Neemias Queta",0,0,0,0,0,0
"2907",987,3,0,3,7,4,10,6,0,0,21,1,0,16,4,0,1,1038100,"2024-01-08T00:00:00.000Z",3547272,21,"Isaiah Joe",0,20,23,19,7,24.3
"2908",988,2,3,1,4,1,7,2,0,0,24,1,1,5,2,2,1,1038100,"2024-01-08T00:00:00.000Z",56677833,21,"Cason Wallace",5,7,9,7,4,24.4
"2909",989,0,0,3,1,1,8,6,0,0,23,2,1,13,5,1,1,1038100,"2024-01-08T00:00:00.000Z",17896078,21,"Aaron Wiggins",1,18,18,13,5,21
"2910",990,0,0,0,0,0,0,0,0,0,0,0,0,0,0,0,0,1038099,"2024-01-08T00:00:00.000Z",3547279,2,"Lamar Stevens",0,0,0,0,0,0
"2911",991,0,0,0,0,0,0,0,0,0,0,0,0,0,0,0,0,1038099,"2024-01-08T00:00:00.000Z",38017707,2,"JD Davison",0,0,0,0,0,0
"2912",992,0,0,0,0,0,0,0,0,0,0,0,0,0,0,0,0,1038099,"2024-01-08T00:00:00.000Z",17896060,2,"Sam Hauser",0,0,0,0,0,0
"2913",994,0,0,0,0,0,0,0,0,0,0,0,0,0,0,0,0,1038099,"2024-01-08T00:00:00.000Z",434,2,"Jayson Tatum",0,0,0,0,0,0
"2914",995,0,0,0,0,0,0,0,0,0,0,0,0,0,0,0,0,1038099,"2024-01-08T00:00:00.000Z",56677864,2,"Jordan Walsh",0,0,0,0,0,0
"2915",996,0,0,0,0,0,0,0,0,0,0,0,0,0,0,0,0,1038100,"2024-01-08T00:00:00.000Z",17896036,21,"Tre Mann",0,0,0,0,0,0
"2916",997,0,0,0,0,0,0,0,0,0,0,0,0,0,0,0,0,1038100,"2024-01-08T00:00:00.000Z",4197029,21,"Vasilije Micic",0,0,0,0,0,0
"2917",998,0,0,0,0,0,0,0,0,0,0,0,0,0,0,0,0,1038100,"2024-01-08T00:00:00.000Z",3547271,21,"Aleksej Pokusevski",0,0,0,0,0,0
"2918",999,0,0,0,0,0,0,0,0,0,0,0,0,0,0,0,0,1038100,"2024-01-08T00:00:00.000Z",27924547,21,"Lindy Waters III",0,0,0,0,0,0
"2919",1000,0,0,0,0,0,0,0,0,0,0,0,0,0,0,0,0,1038100,"2024-01-08T00:00:00.000Z",38017706,21,"Jaylin Williams",0,0,0,0,0,0
"2920",1001,0,0,0,4,3,5,4,0,0,13,1,0,11,1,0,1,1037639,"2023-10-30T00:00:00.000Z",368,17,"Cameron Payne",0,12,12,11,1,11.2
"2921",1002,7,1,2,1,0,3,0,2,2,20,0,0,2,2,2,1,1037621,"2023-10-28T00:00:00.000Z",487,30,"Delon Wright",3,4,11,9,9,22.9
"2922",1003,2,0,3,0,0,1,1,0,0,11,0,2,2,3,0,0,1037621,"2023-10-28T00:00:00.000Z",337,30,"Mike Muscala",0,5,7,4,5,8.6
"2923",1004,0,0,0,0,0,0,0,0,0,0,0,0,0,0,0,0,1037621,"2023-10-28T00:00:00.000Z",17896106,30,"Eugene Omoruyi",0,0,0,0,0,0
"2924",1005,0,0,0,0,0,0,0,0,0,0,0,0,0,0,0,0,1037621,"2023-10-28T00:00:00.000Z",38017712,30,"Ryan Rollins",0,0,0,0,0,0
"2925",1006,0,0,0,0,0,0,0,0,0,0,0,0,0,0,0,0,1037621,"2023-10-28T00:00:00.000Z",254,15,"Luke Kennard",0,0,0,0,0,0
"2926",1007,5,2,7,5,2,16,11,0,0,37,1,3,24,8,0,1,1037624,"2023-10-28T00:00:00.000Z",17896055,28,"Scottie Barnes",2,32,37,29,13,46.1
"2927",1008,4,1,6,5,2,8,3,4,3,36,1,4,11,7,0,2,1037624,"2023-10-28T00:00:00.000Z",416,28,"Pascal Siakam",1,18,22,15,11,26.4
"2928",1009,3,1,6,0,0,5,2,3,2,25,1,2,6,7,0,2,1037624,"2023-10-28T00:00:00.000Z",373,28,"Jakob Poeltl",1,13,16,9,10,19.9
"2929",1010,0,0,1,5,3,16,6,4,2,33,1,0,17,2,1,1,1037624,"2023-10-28T00:00:00.000Z",3089,28,"Gary Trent Jr.",1,19,19,17,2,21.4
"2930",1011,10,0,1,6,4,14,5,2,1,35,3,1,15,4,2,1,1037624,"2023-10-28T00:00:00.000Z",409,28,"Dennis Schroder",2,19,29,25,14,39.8
"2931",1012,3,1,4,1,0,10,3,0,0,18,3,1,6,7,0,1,1037624,"2023-10-28T00:00:00.000Z",3547249,28,"Precious Achiuwa",1,13,16,9,10,20.9
"2932",1013,1,0,0,6,4,8,5,2,2,28,2,5,16,2,0,1,1037624,"2023-10-28T00:00:00.000Z",56677828,28,"Gradey Dick",0,18,19,17,3,18.9
"2933",1014,1,0,6,1,0,15,7,2,2,25,1,3,16,7,0,2,1037650,"2023-11-01T00:00:00.000Z",70,2,"Jaylen Brown",0,23,24,17,8,23.9
"2934",1015,4,0,10,5,3,15,9,10,9,27,2,1,30,12,0,2,1037650,"2023-11-01T00:00:00.000Z",434,2,"Jayson Tatum",0,42,46,34,16,48.4
"2935",1016,2,0,5,3,1,7,3,6,6,27,1,3,13,6,0,2,1037650,"2023-11-01T00:00:00.000Z",378,2,"Kristaps Porzingis",0,19,21,15,8,21.2
"2936",1017,4,1,7,4,3,9,6,0,0,25,0,0,15,7,0,1,1037650,"2023-11-01T00:00:00.000Z",214,2,"Jrue Holiday",1,22,26,19,11,31.4
"2937",1018,4,0,2,7,4,10,7,0,0,27,1,3,18,3,0,2,1037650,"2023-11-01T00:00:00.000Z",473,2,"Derrick White",0,21,25,22,7,25.6
"2938",1019,0,0,3,6,5,7,5,2,2,20,0,3,17,3,1,1,1037650,"2023-11-01T00:00:00.000Z",17896060,2,"Sam Hauser",1,20,20,17,3,22.6
"2939",1020,0,1,2,1,1,3,1,2,2,11,2,0,5,4,1,1,1037650,"2023-11-01T00:00:00.000Z",219,2,"Al Horford",2,9,9,5,4,14.8
"2940",1021,2,0,4,3,0,14,8,0,0,30,3,4,16,7,2,2,1037647,"2023-11-01T00:00:00.000Z",56677826,9,"Ausar Thompson",2,23,25,18,9,31.4
"2941",1022,4,0,4,4,2,8,5,0,0,33,2,5,12,6,1,2,1037647,"2023-11-01T00:00:00.000Z",3547267,9,"Isaiah Stewart",1,18,22,16,10,26.2
"2942",1023,3,2,6,2,0,10,3,5,4,33,0,3,10,6,0,5,1037647,"2023-11-01T00:00:00.000Z",24,9,"Marvin Bagley III",2,16,19,13,9,22.7
"2943",1024,4,0,5,9,5,27,11,3,3,37,0,3,30,5,1,6,1037647,"2023-11-01T00:00:00.000Z",17896075,9,"Cade Cunningham",1,35,39,34,9,39
"2944",1025,1,0,3,1,0,6,0,0,0,26,0,2,0,3,3,1,1037647,"2023-11-01T00:00:00.000Z",3547241,9,"Killian Hayes",3,3,4,1,4,13.1
"2945",1026,0,0,0,0,0,0,0,0,0,0,0,0,0,0,0,0,3277430,"2023-11-14T00:00:00.000Z",329,7,"Markieff Morris",0,0,0,0,0,0
"2946",1027,0,0,0,0,0,0,0,0,0,0,0,0,0,0,0,0,3277430,"2023-11-14T00:00:00.000Z",17896028,7,"Greg Brown III",0,0,0,0,0,0
"2947",1028,0,0,1,2,0,2,0,0,0,16,0,2,0,1,0,0,3277431,"2023-11-14T00:00:00.000Z",38017739,29,"Simone Fontecchio",0,1,1,0,1,1.2
"2948",1029,0,0,0,0,0,0,0,0,0,0,0,0,0,0,0,0,3277431,"2023-11-14T00:00:00.000Z",56677824,29,"Taylor Hendricks",0,0,0,0,0,0
"2949",1030,0,0,0,0,0,0,0,0,0,0,0,0,0,0,0,0,3277431,"2023-11-14T00:00:00.000Z",38017630,29,"Johnny Juzang",0,0,0,0,0,0
"2950",1031,0,0,0,0,0,0,0,0,0,0,0,0,0,0,0,0,3277431,"2023-11-14T00:00:00.000Z",38017705,29,"Walker Kessler",0,0,0,0,0,0
"2951",1032,0,0,0,0,0,0,0,0,0,0,0,0,0,0,0,0,3277432,"2023-11-14T00:00:00.000Z",17896022,13,"Brandon Boston Jr.",0,0,0,0,0,0
"2952",1033,0,0,0,0,0,0,0,0,0,0,0,0,0,0,0,0,3277432,"2023-11-14T00:00:00.000Z",56677856,13,"Jordan Miller",0,0,0,0,0,0
"2953",1034,0,0,0,0,0,0,0,0,0,0,0,0,0,0,0,0,3277432,"2023-11-14T00:00:00.000Z",371,13,"Mason Plumlee",0,0,0,0,0,0
"2954",1035,0,0,0,0,0,0,0,0,0,0,0,0,0,0,0,0,3277432,"2023-11-14T00:00:00.000Z",17896051,13,"Joshua Primo",0,0,0,0,0,0
"2955",1036,0,0,0,0,0,0,0,0,0,0,0,0,0,0,0,0,3277433,"2023-11-14T00:00:00.000Z",17896056,18,"Luka Garza",0,0,0,0,0,0
"2956",1037,0,0,0,0,0,0,0,0,0,0,0,0,0,0,0,0,3277433,"2023-11-14T00:00:00.000Z",666767,18,"Jordan McLaughlin",0,0,0,0,0,0
"2957",1038,0,0,0,0,0,0,0,0,0,0,0,0,0,0,0,0,3277433,"2023-11-14T00:00:00.000Z",56677782,18,"Leonard Miller",0,0,0,0,0,0
"2958",1039,0,0,0,0,0,0,0,0,0,0,0,0,0,0,0,0,3277433,"2023-11-14T00:00:00.000Z",38017700,18,"Wendell Moore Jr.",0,0,0,0,0,0
"2959",1040,0,1,0,5,2,6,3,0,0,23,0,1,8,0,0,0,1037755,"2023-11-15T00:00:00.000Z",666400,18,"Nickeil Alexander-Walker",1,8,8,8,0,11
"2960",1041,0,0,0,0,0,0,0,0,0,0,0,0,0,0,0,0,3277431,"2023-11-14T00:00:00.000Z",19465584,29,"Micah Potter",0,0,0,0,0,0
"2961",1042,0,0,0,0,0,0,0,0,0,0,0,0,0,0,0,0,3277431,"2023-11-14T00:00:00.000Z",56677842,29,"Brice Sensabaugh",0,0,0,0,0,0
"2962",1043,1,1,2,6,3,17,10,4,3,27,0,3,26,2,0,2,3277431,"2023-11-14T00:00:00.000Z",182,25,"Jerami Grant",1,28,29,27,3,30.9
"2963",1044,1,2,3,4,2,6,3,2,1,26,2,2,9,5,0,2,3277431,"2023-11-14T00:00:00.000Z",56677850,25,"Toumani Camara",2,14,15,10,6,20.5
"2964",1045,0,0,2,2,1,7,4,4,4,19,2,0,13,4,1,0,1037755,"2023-11-15T00:00:00.000Z",667378,18,"Naz Reid",1,17,17,13,4,20.8
"2965",1046,0,0,3,2,0,8,4,0,0,23,1,3,8,4,0,0,1037755,"2023-11-15T00:00:00.000Z",320,18,"Shake Milton",0,12,12,8,4,12.8
"2966",1047,3,1,1,0,0,5,2,2,2,21,1,0,6,2,2,1,1037755,"2023-11-15T00:00:00.000Z",12,18,"Kyle Anderson",3,8,11,9,5,20.9
"2967",1048,1,0,3,2,0,3,0,4,4,14,1,1,4,4,1,0,1037755,"2023-11-15T00:00:00.000Z",68,18,"Troy Brown Jr.",1,8,9,5,5,13.3
"2968",1049,0,0,0,2,0,3,1,1,0,5,1,0,2,1,0,0,1037755,"2023-11-15T00:00:00.000Z",38017715,18,"Josh Minott",0,3,3,2,1,3.2
"2969",1050,0,0,0,1,0,4,1,4,3,4,2,0,5,2,0,0,1037755,"2023-11-15T00:00:00.000Z",17896056,18,"Luka Garza",0,7,7,5,2,7.4
"2970",1051,4,0,8,5,2,19,9,5,5,36,1,4,25,9,0,1,1037828,"2023-11-25T00:00:00.000Z",172,13,"Paul George",0,34,38,29,13,40.8
"2971",1052,1,0,10,0,0,8,5,5,1,23,4,1,11,14,0,1,1037828,"2023-11-25T00:00:00.000Z",493,13,"Ivica Zubac",0,25,26,12,15,28.3
"2972",1053,1,1,1,4,0,14,7,4,3,32,2,0,17,3,0,0,1037828,"2023-11-25T00:00:00.000Z",666743,13,"Terance Mann",1,20,21,18,4,25.1
"2973",1054,7,2,4,6,2,8,2,2,2,28,0,1,8,4,1,2,1037828,"2023-11-25T00:00:00.000Z",192,13,"James Harden",3,12,19,15,11,30.3
"2974",1055,7,0,4,1,0,9,6,3,2,25,4,2,14,8,0,2,1037828,"2023-11-25T00:00:00.000Z",472,13,"Russell Westbrook",0,22,29,21,15,32.1
"2975",1056,1,0,3,3,3,4,4,4,4,24,0,2,15,3,0,1,1037828,"2023-11-25T00:00:00.000Z",380,13,"Norman Powell",0,18,19,16,4,19.1
"2976",1057,0,1,1,1,0,6,2,2,1,16,2,2,5,3,0,1,1037828,"2023-11-25T00:00:00.000Z",439,13,"Daniel Theis",1,8,8,5,3,10.6
"2977",1058,0,0,1,0,0,0,0,0,0,8,0,2,0,1,0,0,1037828,"2023-11-25T00:00:00.000Z",450,13,"PJ Tucker",0,1,1,0,1,1.2
"2978",1059,1,0,0,0,0,0,0,0,0,5,1,1,0,1,0,0,1037828,"2023-11-25T00:00:00.000Z",666511,13,"Amir Coffey",0,1,2,1,2,2.7
"2979",1060,0,0,2,1,0,2,0,0,0,5,1,0,0,3,0,0,1037828,"2023-11-25T00:00:00.000Z",56677849,13,"Kobe Brown",0,3,3,0,3,3.6
"2980",1061,0,0,0,0,0,2,0,2,1,5,2,0,1,2,1,0,1037828,"2023-11-25T00:00:00.000Z",38017725,13,"Moussa Diabate",1,3,3,1,2,6.4
"2981",1062,0,0,0,3,1,4,1,0,0,4,0,0,3,0,0,2,1037828,"2023-11-25T00:00:00.000Z",17896031,13,"Nah'Shon Hyland",0,3,3,3,0,1
"2982",1063,5,1,4,0,0,2,2,0,0,21,2,0,4,6,0,0,1037827,"2023-11-25T00:00:00.000Z",491,19,"Cody Zeller",1,10,15,9,11,21.7
"2983",1064,0,0,0,0,0,0,0,0,0,0,0,0,0,0,0,0,1037827,"2023-11-25T00:00:00.000Z",17896021,19,"Jeremiah Robinson-Earl",0,0,0,0,0,0
"2984",1065,0,0,0,0,0,0,0,0,0,0,0,0,0,0,0,0,1037827,"2023-11-25T00:00:00.000Z",666969,19,"Zion Williamson",0,0,0,0,0,0
"2985",1066,0,0,0,0,0,0,0,0,0,0,0,0,0,0,0,0,1037827,"2023-11-25T00:00:00.000Z",38017663,19,"E.J. Liddell",0,0,0,0,0,0
"2986",1067,0,0,0,0,0,0,0,0,0,0,0,0,0,0,0,0,1037827,"2023-11-25T00:00:00.000Z",303,19,"CJ McCollum",0,0,0,0,0,0
"2987",1068,0,0,0,0,0,0,0,0,0,0,0,0,0,0,0,0,1037827,"2023-11-25T00:00:00.000Z",18677986,19,"Trey Murphy III",0,0,0,0,0,0
"2988",1069,0,0,0,0,0,0,0,0,0,0,0,0,0,0,0,0,1037827,"2023-11-25T00:00:00.000Z",17896017,19,"Matt Ryan",0,0,0,0,0,0
"2989",1070,0,0,0,0,0,0,0,0,0,0,0,0,0,0,0,0,1037827,"2023-11-25T00:00:00.000Z",38017726,19,"Dereon Seabron",0,0,0,0,0,0
"2990",1071,0,0,0,0,0,0,0,0,0,0,0,0,0,0,0,0,1037828,"2023-11-25T00:00:00.000Z",17896022,13,"Brandon Boston Jr.",0,0,0,0,0,0
"2991",1072,0,0,0,0,0,0,0,0,0,0,0,0,0,0,0,0,1037828,"2023-11-25T00:00:00.000Z",56677856,13,"Jordan Miller",0,0,0,0,0,0
"2992",1073,0,0,0,0,0,0,0,0,0,0,0,0,0,0,0,0,1037828,"2023-11-25T00:00:00.000Z",24417679,13,"Xavier Moon",0,0,0,0,0,0
"2993",1074,0,0,0,0,0,0,0,0,0,0,0,0,0,0,0,0,1037828,"2023-11-25T00:00:00.000Z",371,13,"Mason Plumlee",0,0,0,0,0,0
"2994",1075,0,0,0,0,0,0,0,0,0,0,0,0,0,0,0,0,1037828,"2023-11-25T00:00:00.000Z",17896051,13,"Joshua Primo",0,0,0,0,0,0
"2995",1076,3,0,2,6,0,17,4,3,2,30,1,4,10,3,0,4,7050292,"2023-12-08T00:00:00.000Z",56677747,25,"Scoot Henderson",0,13,16,13,6,14.1
"2996",1077,0,0,0,0,0,0,0,0,0,0,0,0,0,0,0,0,7050292,"2023-12-08T00:00:00.000Z",39613724,25,"Ibou Badji",0,0,0,0,0,0
"2997",1078,0,0,0,0,0,0,0,0,0,0,0,0,0,0,0,0,7050292,"2023-12-08T00:00:00.000Z",666476,25,"Moses Brown",0,0,0,0,0,0
"2998",1079,0,0,2,5,2,8,3,2,0,31,0,4,8,2,0,2,7050291,"2023-12-08T00:00:00.000Z",38017739,29,"Simone Fontecchio",0,10,10,8,2,8.4
"2999",1080,2,4,10,5,1,12,7,5,5,35,3,1,20,13,2,2,7050291,"2023-12-08T00:00:00.000Z",101,29,"John Collins",6,33,35,22,15,54.6
"3000",1081,3,4,8,0,0,9,4,0,0,31,4,2,8,12,2,2,7050291,"2023-12-08T00:00:00.000Z",38017705,29,"Walker Kessler",6,20,23,11,15,42.9
"3001",1082,5,0,3,3,0,9,2,3,2,28,1,2,6,4,1,1,7050291,"2023-12-08T00:00:00.000Z",100,29,"Jordan Clarkson",1,10,15,11,9,20.3
"3002",1083,3,0,0,5,2,11,5,5,3,28,0,1,15,0,1,1,7050291,"2023-12-08T00:00:00.000Z",56677834,29,"Keyonte George",1,15,18,18,3,21.5
"3003",1084,2,0,4,1,1,5,4,4,4,18,0,3,13,4,1,0,7050291,"2023-12-08T00:00:00.000Z",358,29,"Kelly Olynyk",1,17,19,15,6,23.8
"3004",1085,5,1,1,4,1,11,6,3,2,22,0,0,15,1,1,2,7050291,"2023-12-08T00:00:00.000Z",666650,29,"Talen Horton-Tucker",2,16,21,20,6,27.7
"3005",1086,3,0,3,4,1,12,5,2,2,18,0,2,13,3,1,1,7050291,"2023-12-08T00:00:00.000Z",413,29,"Collin Sexton",1,16,19,16,6,23.1
"3006",1087,0,0,1,2,1,4,2,0,0,17,0,2,5,1,0,1,7050291,"2023-12-08T00:00:00.000Z",38017620,29,"Ochai Agbaji",0,6,6,5,1,5.2
"3007",1088,0,0,0,2,0,3,0,0,0,12,0,0,0,0,1,1,7050291,"2023-12-08T00:00:00.000Z",56677824,29,"Taylor Hendricks",1,0,0,0,0,2
"3008",1089,0,0,0,0,0,0,0,0,0,0,0,0,0,0,0,0,7050291,"2023-12-08T00:00:00.000Z",139,29,"Kris Dunn",0,0,0,0,0,0
"3009",1090,0,0,0,0,0,0,0,0,0,0,0,0,0,0,0,0,7050291,"2023-12-08T00:00:00.000Z",666881,29,"Luka Samanic",0,0,0,0,0,0
"3010",1091,0,0,0,0,0,0,0,0,0,0,0,0,0,0,0,0,7050291,"2023-12-08T00:00:00.000Z",11891374,29,"Omer Yurtseven",0,0,0,0,0,0
"3011",1092,0,0,0,0,0,0,0,0,0,0,0,0,0,0,0,0,7050291,"2023-12-08T00:00:00.000Z",17896023,29,"Josh Christopher",0,0,0,0,0,0
"3012",1093,0,0,0,0,0,0,0,0,0,0,0,0,0,0,0,0,7050291,"2023-12-08T00:00:00.000Z",38017630,29,"Johnny Juzang",0,0,0,0,0,0
"3013",1094,0,0,0,0,0,0,0,0,0,0,0,0,0,0,0,0,7050291,"2023-12-08T00:00:00.000Z",297,29,"Lauri Markkanen",0,0,0,0,0,0
"3014",1095,0,0,0,0,0,0,0,0,0,0,0,0,0,0,0,0,7050291,"2023-12-08T00:00:00.000Z",19465584,29,"Micah Potter",0,0,0,0,0,0
"3015",1096,0,0,0,0,0,0,0,0,0,0,0,0,0,0,0,0,7050291,"2023-12-08T00:00:00.000Z",56677842,29,"Brice Sensabaugh",0,0,0,0,0,0
"3016",1097,5,1,2,8,6,23,14,7,7,38,3,1,41,5,0,2,7050291,"2023-12-08T00:00:00.000Z",274,13,"Kawhi Leonard",1,46,51,46,10,55.5
"3017",1098,2,1,3,5,2,13,8,3,2,37,0,2,20,3,6,1,7050291,"2023-12-08T00:00:00.000Z",172,13,"Paul George",7,23,25,22,5,46.6
"3018",1099,3,2,7,0,0,15,9,0,0,42,5,5,18,12,0,1,7050291,"2023-12-08T00:00:00.000Z",493,13,"Ivica Zubac",2,30,33,21,15,41.9
"3019",1100,1,1,3,5,2,9,4,2,0,30,1,3,10,4,1,2,7050291,"2023-12-08T00:00:00.000Z",666743,13,"Terance Mann",2,14,15,11,5,20.3
"3020",1101,8,1,1,6,4,9,6,0,0,30,0,1,16,1,2,1,1037972,"2023-12-21T00:00:00.000Z",104,18,"Mike Conley",3,17,25,24,9,37.2
"3021",1102,3,0,1,5,1,6,2,0,0,15,0,2,5,1,3,1,1037972,"2023-12-21T00:00:00.000Z",666400,18,"Nickeil Alexander-Walker",3,6,9,8,4,18.7
"3022",1103,0,0,3,6,2,8,3,2,2,24,0,2,10,3,0,1,1037960,"2023-12-20T00:00:00.000Z",158,3,"Dorian Finney-Smith",0,13,13,10,3,12.6
"3023",1104,0,0,1,2,1,4,2,0,0,25,0,2,5,1,1,0,1037959,"2023-12-20T00:00:00.000Z",328,23,"Marcus Morris",1,6,6,5,1,9.2
"3024",1105,3,1,4,0,0,5,3,2,2,12,4,3,8,8,3,2,1037959,"2023-12-20T00:00:00.000Z",3547270,23,"Paul Reed",4,16,19,11,11,32.1
"3025",1106,1,0,0,0,0,0,0,0,0,2,0,0,0,0,0,0,1037959,"2023-12-20T00:00:00.000Z",17896025,23,"Jaden Springer",0,0,1,1,1,1.5
"3026",1107,0,0,0,0,0,0,0,0,0,0,0,0,0,0,0,0,1037959,"2023-12-20T00:00:00.000Z",33,23,"Nicolas Batum",0,0,0,0,0,0
"3027",1108,4,0,3,5,1,9,4,3,3,29,0,0,12,3,0,1,1037961,"2023-12-20T00:00:00.000Z",3089,28,"Gary Trent Jr.",0,15,19,16,7,20.6
"3028",1109,0,0,0,0,0,0,0,0,0,0,0,0,0,0,0,0,1037961,"2023-12-20T00:00:00.000Z",376,28,"Otto Porter Jr.",0,0,0,0,0,0
"3029",1110,0,0,0,0,0,0,0,0,0,0,0,0,0,0,0,0,1037961,"2023-12-20T00:00:00.000Z",436,28,"Garrett Temple",0,0,0,0,0,0
"3030",1111,0,0,0,0,0,0,0,0,0,0,0,0,0,0,0,0,1037961,"2023-12-20T00:00:00.000Z",489,28,"Thaddeus Young",0,0,0,0,0,0
"3031",1112,0,0,0,0,0,0,0,0,0,0,0,0,0,0,0,0,1037961,"2023-12-20T00:00:00.000Z",56677805,28,"Javon Freeman-Liberty",0,0,0,0,0,0
"3032",1113,6,3,5,10,2,11,2,0,0,28,1,2,6,6,1,2,1037960,"2023-12-20T00:00:00.000Z",351,3,"Royce O'Neale",4,12,18,12,12,32.2
"3033",1114,0,1,0,0,0,1,0,0,0,4,0,1,0,0,0,1,1037960,"2023-12-20T00:00:00.000Z",174,3,"Harry Giles III",1,0,0,0,0,2
"3034",1115,0,0,0,0,0,0,0,0,0,0,0,0,0,0,0,0,1037961,"2023-12-20T00:00:00.000Z",38017710,28,"Christian Koloko",0,0,0,0,0,0
"3035",1116,0,0,0,0,0,0,0,0,0,0,0,0,0,0,0,0,1037961,"2023-12-20T00:00:00.000Z",56677869,28,"Markquis Nowell",0,0,0,0,0,0
"3036",1117,0,0,0,0,0,0,0,0,0,0,0,0,0,0,0,0,1037961,"2023-12-20T00:00:00.000Z",2309958,28,"Jontay Porter",0,0,0,0,0,0
"3037",1118,2,0,5,7,2,13,5,0,0,32,1,1,12,6,1,0,1037961,"2023-12-20T00:00:00.000Z",375,8,"Michael Porter Jr.",1,18,20,14,8,25.2
"3038",1119,0,0,0,0,0,0,0,0,0,0,0,0,0,0,0,0,1037961,"2023-12-20T00:00:00.000Z",38017727,8,"Collin Gillespie",0,0,0,0,0,0
"3039",1120,0,0,0,0,0,0,0,0,0,0,0,0,0,0,0,0,1037961,"2023-12-20T00:00:00.000Z",215,8,"Justin Holiday",0,0,0,0,0,0
"3040",1121,0,0,0,0,0,0,0,0,0,0,0,0,0,0,0,0,1037956,"2023-12-20T00:00:00.000Z",56677842,29,"Brice Sensabaugh",0,0,0,0,0,0
"3041",1122,7,0,7,10,2,26,10,3,3,34,2,0,25,9,1,1,1037957,"2023-12-20T00:00:00.000Z",403,4,"Terry Rozier",1,34,41,32,16,48.3
"3042",1123,2,0,3,8,1,21,4,6,6,33,2,0,15,5,2,2,1037960,"2023-12-20T00:00:00.000Z",61,3,"Mikal Bridges",2,20,22,17,7,28
"3043",1124,2,0,4,6,4,14,8,1,0,28,0,3,20,4,0,0,1037960,"2023-12-20T00:00:00.000Z",666679,3,"Cameron Johnson",0,24,26,22,6,27.8
"3044",1125,2,4,4,0,0,5,3,0,0,26,4,5,6,8,0,0,1037960,"2023-12-20T00:00:00.000Z",666508,3,"Nicolas Claxton",4,14,16,8,10,30.6
"3045",1126,0,0,0,0,0,0,0,0,0,0,0,0,0,0,0,0,1038027,"2023-12-29T00:00:00.000Z",56677871,8,"Hunter Tyson",0,0,0,0,0,0
"3046",1127,1,1,3,3,0,6,2,0,0,32,1,3,4,4,3,1,1038027,"2023-12-29T00:00:00.000Z",666541,21,"Luguentz Dort",4,8,9,5,5,21.3
"3047",1128,8,2,4,7,4,18,10,5,2,38,1,3,26,5,3,3,1038038,"2023-12-31T00:00:00.000Z",227,19,"Brandon Ingram",5,31,39,34,13,56
"3048",1129,1,1,2,4,2,7,3,2,2,22,1,5,10,3,0,0,1038039,"2023-12-31T00:00:00.000Z",56677833,21,"Cason Wallace",1,13,14,11,4,18.1
"3049",1130,2,1,2,1,0,3,1,1,1,6,1,1,3,3,0,0,1038039,"2023-12-31T00:00:00.000Z",38017706,21,"Jaylin Williams",1,6,8,5,5,12.6
"3050",1131,0,0,4,0,0,0,0,0,0,11,1,0,0,5,0,2,1038039,"2023-12-31T00:00:00.000Z",17896078,21,"Aaron Wiggins",0,5,5,0,5,4
"3051",1132,4,0,2,0,0,1,1,0,0,12,1,4,2,3,1,0,1038039,"2023-12-31T00:00:00.000Z",4197029,21,"Vasilije Micic",1,5,9,6,7,14.6
"3052",1133,2,0,4,2,0,4,1,0,0,18,0,0,2,4,0,0,1038039,"2023-12-31T00:00:00.000Z",480,21,"Kenrich Williams",0,6,8,4,6,9.8
"3053",1134,0,0,0,1,1,1,1,0,0,2,0,0,3,0,0,0,1038039,"2023-12-31T00:00:00.000Z",27924547,21,"Lindy Waters III",0,3,3,3,0,3
"3054",1135,0,0,0,0,0,0,0,0,0,0,0,0,0,0,0,0,1038039,"2023-12-31T00:00:00.000Z",3547271,21,"Aleksej Pokusevski",0,0,0,0,0,0
"3055",1136,2,0,2,2,0,2,0,0,0,19,0,2,0,2,0,1,1038040,"2023-12-31T00:00:00.000Z",38017649,27,"Julian Champagnie",0,2,4,2,4,4.4
"3056",1137,5,0,3,4,1,11,4,0,0,24,0,1,9,3,0,1,1038040,"2023-12-31T00:00:00.000Z",38017699,27,"Jeremy Sochan",0,12,17,14,8,19.1
"3057",1138,3,1,5,8,3,16,8,2,2,24,2,0,21,7,0,3,1038040,"2023-12-31T00:00:00.000Z",56677822,27,"Victor Wembanyama",1,28,31,24,10,33.9
"3058",1139,1,0,4,4,2,15,9,2,2,31,1,3,22,5,2,2,1038040,"2023-12-31T00:00:00.000Z",3547246,27,"Devin Vassell",2,27,28,23,6,33.5
"3059",1140,0,0,1,5,1,9,4,3,2,23,0,0,11,1,0,1,1038040,"2023-12-31T00:00:00.000Z",38017692,27,"Malaki Branham",0,12,12,11,1,11.2
"3060",1141,4,0,5,5,1,9,3,0,0,20,2,1,7,7,0,0,1038040,"2023-12-31T00:00:00.000Z",17896059,27,"Sandro Mamukelashvili",0,14,18,11,11,21.4
"3061",1142,2,0,0,2,1,4,2,0,0,16,0,2,5,0,1,0,1038040,"2023-12-31T00:00:00.000Z",359,27,"Cedi Osman",1,5,7,7,2,11
"3062",1143,1,0,0,3,0,3,0,0,0,16,0,1,0,0,0,1,1038040,"2023-12-31T00:00:00.000Z",305,27,"Doug McDermott",0,0,1,1,1,0.5
"3063",1144,2,0,3,5,0,10,4,0,0,22,1,3,8,4,0,1,1038040,"2023-12-31T00:00:00.000Z",3547274,27,"Tre Jones",0,12,14,10,6,14.8
"3064",1145,6,0,1,2,0,3,0,2,1,17,0,2,1,1,0,1,1038040,"2023-12-31T00:00:00.000Z",38017693,27,"Blake Wesley",0,2,8,7,7,10.2
"3065",1146,1,0,3,1,1,6,3,2,1,12,1,2,8,4,2,0,1038040,"2023-12-31T00:00:00.000Z",38017730,27,"Dominick Barlow",2,12,13,9,5,20.3
"3066",1147,1,0,1,2,2,4,3,1,1,8,1,0,9,2,0,1,1038040,"2023-12-31T00:00:00.000Z",180,27,"Devonte' Graham",0,11,12,10,3,11.9
"3067",1148,0,0,2,2,0,2,0,0,0,8,1,0,0,3,1,0,1038040,"2023-12-31T00:00:00.000Z",56677817,27,"Sidy Cissoko",1,3,3,0,3,6.6
"3068",1149,0,0,0,0,0,0,0,0,0,0,0,0,0,0,0,0,1038040,"2023-12-31T00:00:00.000Z",17895854,27,"Charles Bassey",0,0,0,0,0,0
"3069",1150,0,0,0,0,0,0,0,0,0,0,0,0,0,0,0,0,1038040,"2023-12-31T00:00:00.000Z",102,27,"Zach Collins",0,0,0,0,0,0
"3070",1151,7,0,0,1,0,2,0,0,0,11,1,2,0,1,1,1,1038126,"2024-01-12T00:00:00.000Z",56677792,9,"Marcus Sasser",1,1,8,7,8,13.7
"3071",1152,1,0,3,0,0,6,4,4,3,12,1,2,11,4,1,0,1038126,"2024-01-12T00:00:00.000Z",24,9,"Marvin Bagley III",1,15,16,12,5,20.3
"3072",1153,0,0,0,0,0,0,0,0,0,0,0,0,0,0,0,0,1038126,"2024-01-12T00:00:00.000Z",197,9,"Joe Harris",0,0,0,0,0,0
"3073",1154,0,0,0,0,0,0,0,0,0,0,0,0,0,0,0,0,1038126,"2024-01-12T00:00:00.000Z",44477024,9,"Stanley Umude",0,0,0,0,0,0
"3074",1155,0,0,0,0,0,0,0,0,0,0,0,0,0,0,0,0,1038126,"2024-01-12T00:00:00.000Z",3547240,9,"James Wiseman",0,0,0,0,0,0
"3075",1156,0,0,0,0,0,0,0,0,0,0,0,0,0,0,0,0,1038126,"2024-01-12T00:00:00.000Z",54,9,"Bojan Bogdanovic",0,0,0,0,0,0
"3076",1157,0,0,0,0,0,0,0,0,0,0,0,0,0,0,0,0,1038126,"2024-01-12T00:00:00.000Z",56677729,9,"Malcolm Cazalon",0,0,0,0,0,0
"3077",1158,0,0,0,0,0,0,0,0,0,0,0,0,0,0,0,0,1038126,"2024-01-12T00:00:00.000Z",17896075,9,"Cade Cunningham",0,0,0,0,0,0
"3078",1159,0,0,0,0,0,0,0,0,0,0,0,0,0,0,0,0,1038126,"2024-01-12T00:00:00.000Z",330,9,"Monte Morris",0,0,0,0,0,0
"3079",1160,0,0,0,0,0,0,0,0,0,0,0,0,0,0,0,0,1038126,"2024-01-12T00:00:00.000Z",42097199,9,"Jared Rhoden",0,0,0,0,0,0
"3080",1161,1,0,5,0,0,2,1,0,0,20,2,1,2,7,0,1,1038126,"2024-01-12T00:00:00.000Z",3547301,11,"Jae'Sean Tate",0,9,10,3,8,10.9
"3081",1162,1,2,6,3,1,15,7,4,4,41,5,0,19,11,1,1,1038126,"2024-01-12T00:00:00.000Z",38017684,11,"Jabari Smith Jr.",3,30,31,20,12,41.7
"3082",1163,1,0,6,1,0,19,12,7,5,37,0,3,29,6,1,4,1038126,"2024-01-12T00:00:00.000Z",17896062,11,"Alperen Sengun",1,35,36,30,7,36.7
"3083",1164,1,0,1,0,0,0,0,4,4,8,1,0,4,2,0,0,1038123,"2024-01-11T00:00:00.000Z",314,24,"Chimezie Metu",0,6,7,5,3,7.9
"3084",1165,0,1,1,0,0,0,0,0,0,5,0,1,0,1,0,1,1038123,"2024-01-11T00:00:00.000Z",470,24,"Yuta Watanabe",1,1,1,0,1,3.2
"3085",1166,0,0,0,0,0,1,1,1,1,4,0,0,3,0,0,1,1038123,"2024-01-11T00:00:00.000Z",666729,24,"Nassir Little",0,3,3,3,0,2
"3086",1167,0,0,0,0,0,0,0,0,0,0,0,0,0,0,0,0,1038123,"2024-01-11T00:00:00.000Z",147,24,"Drew Eubanks",0,0,0,0,0,0
"3087",1168,0,0,0,0,0,0,0,0,0,0,0,0,0,0,0,0,1038123,"2024-01-11T00:00:00.000Z",272,24,"Damion Lee",0,0,0,0,0,0
"3088",1169,0,0,0,0,0,0,0,0,0,0,0,0,0,0,0,0,1038123,"2024-01-11T00:00:00.000Z",3547298,24,"Saben Lee",0,0,0,0,0,0
"3089",1170,0,0,0,0,0,0,0,0,0,0,0,0,0,0,0,0,1038123,"2024-01-11T00:00:00.000Z",3547253,24,"Theo Maledon",0,0,0,0,0,0
"3090",1171,3,1,3,9,2,25,9,9,8,39,2,3,28,5,1,1,1038126,"2024-01-12T00:00:00.000Z",17895966,11,"Jalen Green",2,33,36,31,8,43.5
"3091",1172,12,2,3,9,3,15,7,3,3,43,1,5,20,4,2,0,1038126,"2024-01-12T00:00:00.000Z",458,11,"Fred VanVleet",4,24,36,32,16,54.8
"3092",1173,2,0,3,7,3,10,3,9,8,31,1,1,17,4,1,0,1038125,"2024-01-12T00:00:00.000Z",3547256,1,"Saddiq Bey",1,21,23,19,6,27.8
"3093",1174,3,0,4,2,1,11,7,3,1,32,0,3,16,4,2,3,1038125,"2024-01-12T00:00:00.000Z",17896040,1,"Jalen Johnson",2,20,23,19,7,28.3
"3094",1175,1,1,2,0,0,5,3,4,1,22,3,1,7,5,1,0,1038125,"2024-01-12T00:00:00.000Z",83,1,"Clint Capela",2,12,13,8,6,20.5
"3095",1176,3,1,3,4,2,11,5,3,3,29,2,5,15,5,0,3,3277353,"2023-11-03T00:00:00.000Z",185,10,"Draymond Green",1,20,23,18,8,25.5
"3096",1177,0,0,0,0,0,0,0,0,0,0,0,0,0,0,0,0,3277353,"2023-11-03T00:00:00.000Z",17896036,21,"Tre Mann",0,0,0,0,0,0
"3097",1178,0,0,0,0,0,0,0,0,0,0,0,0,0,0,0,0,3277353,"2023-11-03T00:00:00.000Z",3547271,21,"Aleksej Pokusevski",0,0,0,0,0,0
"3098",1179,0,0,0,0,0,0,0,0,0,0,0,0,0,0,0,0,3277353,"2023-11-03T00:00:00.000Z",24572055,21,"Olivier Sarr",0,0,0,0,0,0
"3099",1180,0,0,0,0,0,0,0,0,0,0,0,0,0,0,0,0,3277353,"2023-11-03T00:00:00.000Z",27924547,21,"Lindy Waters III",0,0,0,0,0,0
"3100",1181,0,0,0,0,0,0,0,0,0,3,0,1,0,0,0,0,3277349,"2023-11-03T00:00:00.000Z",666940,6,"Dean Wade",0,0,0,0,0,0
"3101",1182,0,0,1,0,0,0,0,0,0,3,0,1,0,1,0,0,3277349,"2023-11-03T00:00:00.000Z",444,6,"Tristan Thompson",0,1,1,0,1,1.2
"3102",1183,0,0,0,0,0,0,0,0,0,0,0,0,0,0,0,0,3277349,"2023-11-03T00:00:00.000Z",56677872,6,"Craig Porter",0,0,0,0,0,0
"3103",1184,0,0,0,0,0,0,0,0,0,0,0,0,0,0,0,0,3277349,"2023-11-03T00:00:00.000Z",56677847,6,"Emoni Bates",0,0,0,0,0,0
"3104",1185,0,0,0,0,0,0,0,0,0,0,0,0,0,0,0,0,3277349,"2023-11-03T00:00:00.000Z",666676,6,"Ty Jerome",0,0,0,0,0,0
"3105",1186,0,0,0,0,0,0,0,0,0,0,0,0,0,0,0,0,3277349,"2023-11-03T00:00:00.000Z",38017662,6,"Isaiah Mobley",0,0,0,0,0,0
"3106",1187,0,0,0,0,0,0,0,0,0,0,0,0,0,0,0,0,3277349,"2023-11-03T00:00:00.000Z",404,6,"Ricky Rubio",0,0,0,0,0,0
"3107",1188,0,0,0,0,0,0,0,0,0,0,0,0,0,0,0,0,3277352,"2023-11-03T00:00:00.000Z",56677860,5,"Adama Sanogo",0,0,0,0,0,0
"3108",1189,0,0,2,2,0,10,2,0,0,17,0,1,4,2,2,0,3277350,"2023-11-03T00:00:00.000Z",377,17,"Bobby Portis",2,6,6,4,2,12.4
"3109",1190,1,0,0,0,0,1,0,0,0,12,0,2,0,0,0,1,3277350,"2023-11-03T00:00:00.000Z",368,17,"Cameron Payne",0,0,1,1,1,0.5
"3110",1191,0,0,0,0,0,0,0,0,0,0,0,0,0,0,0,0,3277350,"2023-11-03T00:00:00.000Z",56677854,17,"Chris Livingston",0,0,0,0,0,0
"3111",1192,0,0,0,0,0,0,0,0,0,0,0,0,0,0,0,0,3277350,"2023-11-03T00:00:00.000Z",284,17,"Robin Lopez",0,0,0,0,0,0
"3112",1193,0,0,0,0,0,0,0,0,0,0,0,0,0,0,0,0,3277350,"2023-11-03T00:00:00.000Z",666453,17,"Marques Bolden",0,0,0,0,0,0
"3113",1194,4,1,4,9,3,18,6,2,2,31,1,1,17,5,0,0,3277352,"2023-11-03T00:00:00.000Z",17896048,3,"Cam Thomas",1,22,26,21,9,32
"3114",1195,0,0,0,0,0,0,0,0,0,0,0,0,0,0,0,0,3277350,"2023-11-03T00:00:00.000Z",38017691,17,"TyTy Washington Jr.",0,0,0,0,0,0
"3115",1196,0,0,0,0,0,0,0,0,0,0,0,0,0,0,0,0,3277350,"2023-11-03T00:00:00.000Z",666960,17,"Lindell Wigginton",0,0,0,0,0,0
"3116",1197,5,1,8,4,0,9,2,2,2,36,2,4,6,10,3,0,3277350,"2023-11-03T00:00:00.000Z",202,20,"Josh Hart",4,16,21,11,15,37.5
"3117",1198,5,0,8,9,1,20,5,9,5,39,4,4,16,12,2,1,3277350,"2023-11-03T00:00:00.000Z",387,20,"Julius Randle",2,28,33,21,17,42.9
"3118",1199,0,0,0,0,0,0,0,0,0,0,0,0,0,0,0,0,3277350,"2023-11-03T00:00:00.000Z",19,20,"Ryan Arcidiacono",0,0,0,0,0,0
"3119",1200,0,0,0,0,0,0,0,0,0,0,0,0,0,0,0,0,3277350,"2023-11-03T00:00:00.000Z",160,20,"Evan Fournier",0,0,0,0,0,0
"3120",1201,1,0,6,6,5,10,5,2,1,34,1,3,16,7,0,0,1037752,"2023-11-15T00:00:00.000Z",313,23,"De'Anthony Melton",0,23,24,17,8,25.9
"3121",1202,4,0,3,7,3,15,6,5,5,39,0,3,20,3,0,2,1037752,"2023-11-15T00:00:00.000Z",3547254,23,"Tyrese Maxey",0,23,27,24,7,27.6
"3122",1203,1,0,1,2,0,4,0,2,0,10,0,1,0,1,0,0,1037752,"2023-11-15T00:00:00.000Z",45,23,"Patrick Beverley",0,1,2,1,2,2.7
"3123",1204,0,0,0,1,0,1,0,0,0,3,0,0,0,0,0,0,1037752,"2023-11-15T00:00:00.000Z",2175,23,"Danuel House Jr.",0,0,0,0,0,0
"3124",1205,0,0,0,1,0,1,0,0,0,3,0,0,0,0,0,0,1037752,"2023-11-15T00:00:00.000Z",260,23,"Furkan Korkmaz",0,0,0,0,0,0
"3125",1206,0,0,0,0,0,0,0,0,0,0,0,0,0,0,0,0,1037752,"2023-11-15T00:00:00.000Z",28,23,"Mo Bamba",0,0,0,0,0,0
"3126",1207,2,0,0,6,1,10,2,6,6,26,0,4,11,0,1,1,1037753,"2023-11-15T00:00:00.000Z",56677828,28,"Gradey Dick",1,11,13,13,2,16
"3127",1208,5,1,5,2,0,9,4,5,3,29,2,1,11,7,0,4,1037753,"2023-11-15T00:00:00.000Z",416,28,"Pascal Siakam",1,18,23,16,12,25.9
"3128",1209,1,2,4,0,0,10,6,2,1,27,7,4,13,11,4,0,1037753,"2023-11-15T00:00:00.000Z",373,28,"Jakob Poeltl",6,24,25,14,12,45.7
"3129",1210,7,0,4,3,3,19,11,5,4,31,5,2,29,9,1,3,1037753,"2023-11-15T00:00:00.000Z",17896055,28,"Scottie Barnes",1,38,45,36,16,50.3
"3130",1211,5,0,3,4,1,9,2,4,4,23,0,3,9,3,2,2,1037753,"2023-11-15T00:00:00.000Z",409,28,"Dennis Schroder",2,12,17,14,8,24.1
"3131",1212,5,1,1,8,0,11,3,1,1,27,2,1,7,3,0,0,1037753,"2023-11-15T00:00:00.000Z",3547275,28,"Malachi Flynn",1,10,15,12,8,21.1
"3132",1213,0,1,4,3,1,8,2,4,4,20,5,1,9,9,0,1,1037753,"2023-11-15T00:00:00.000Z",58,28,"Chris Boucher",1,18,18,9,9,21.8
"3133",1214,0,2,1,2,1,7,4,2,2,17,3,3,11,4,0,1,1037753,"2023-11-15T00:00:00.000Z",3547249,28,"Precious Achiuwa",2,15,15,11,4,20.8
"3134",1215,0,0,1,0,0,0,0,0,0,11,0,0,0,1,0,0,1037753,"2023-11-15T00:00:00.000Z",376,28,"Otto Porter Jr.",0,1,1,0,1,1.2
"3135",1216,1,1,4,4,1,10,3,0,0,18,0,0,7,4,1,1,1037753,"2023-11-15T00:00:00.000Z",666762,28,"Jalen McDaniels",2,11,12,8,5,18.3
"3136",1217,0,0,1,1,1,1,1,0,0,4,0,0,3,1,0,0,1037753,"2023-11-15T00:00:00.000Z",436,28,"Garrett Temple",0,4,4,3,1,4.2
"3137",1218,0,0,1,0,0,1,0,0,0,4,0,0,0,1,0,1,1037753,"2023-11-15T00:00:00.000Z",489,28,"Thaddeus Young",0,1,1,0,1,0.2
"3138",1219,2,0,0,0,0,1,0,2,2,3,2,0,2,2,1,0,1037753,"2023-11-15T00:00:00.000Z",56677869,28,"Markquis Nowell",1,4,6,4,4,10.4
"3139",1220,0,0,0,0,0,0,0,0,0,0,0,0,0,0,0,0,1037753,"2023-11-15T00:00:00.000Z",18,28,"OG Anunoby",0,0,0,0,0,0
"3140",1221,0,0,0,0,0,0,0,0,0,0,0,0,0,0,0,0,1037753,"2023-11-15T00:00:00.000Z",56677805,28,"Javon Freeman-Liberty",0,0,0,0,0,0
"3141",1222,1,0,1,3,1,7,2,0,0,26,1,3,5,2,0,1,1037751,"2023-11-15T00:00:00.000Z",666656,1,"De'Andre Hunter",0,7,8,6,3,7.9
"3142",1223,0,2,5,4,4,9,7,0,0,31,0,1,18,5,0,3,1037751,"2023-11-15T00:00:00.000Z",17896040,1,"Jalen Johnson",2,23,23,18,5,27
"3143",1224,1,2,3,0,0,5,4,2,0,26,0,2,8,3,2,0,1037751,"2023-11-15T00:00:00.000Z",83,1,"Clint Capela",4,11,12,9,4,25.1
"3144",1225,2,0,5,3,0,12,6,3,1,33,0,1,13,5,1,1,1037751,"2023-11-15T00:00:00.000Z",334,1,"Dejounte Murray",1,18,20,15,7,24
"3145",1226,0,0,0,0,0,0,0,0,0,0,0,0,0,0,0,0,1037832,"2023-11-26T00:00:00.000Z",229,22,"Jonathan Isaac",0,0,0,0,0,0
"3146",1227,0,0,0,0,0,0,0,0,0,0,0,0,0,0,0,0,1037832,"2023-11-26T00:00:00.000Z",666818,22,"Chuma Okeke",0,0,0,0,0,0
"3147",1228,0,0,0,0,0,0,0,0,0,0,0,0,0,0,0,0,1037832,"2023-11-26T00:00:00.000Z",666885,22,"Admiral Schofield",0,0,0,0,0,0
"3148",1229,0,0,0,0,0,0,0,0,0,0,0,0,0,0,0,0,1037832,"2023-11-26T00:00:00.000Z",85,22,"Wendell Carter Jr.",0,0,0,0,0,0
"3149",1230,0,0,0,0,0,0,0,0,0,0,0,0,0,0,0,0,1037832,"2023-11-26T00:00:00.000Z",165,22,"Markelle Fultz",0,0,0,0,0,0
"3150",1231,0,0,0,0,0,0,0,0,0,0,0,0,0,0,0,0,1037832,"2023-11-26T00:00:00.000Z",38017607,22,"Kevon Harris",0,0,0,0,0,0
"3151",1232,0,0,0,0,0,0,0,0,0,0,0,0,0,0,0,0,1037832,"2023-11-26T00:00:00.000Z",56677839,22,"Jett Howard",0,0,0,0,0,0
"3152",1233,0,0,0,0,0,0,0,0,0,0,0,0,0,0,0,0,1037832,"2023-11-26T00:00:00.000Z",17553983,22,"Trevelin Queen",0,0,0,0,0,0
"3153",1234,2,1,5,4,2,11,4,2,0,33,0,1,10,5,0,3,1037832,"2023-11-26T00:00:00.000Z",204,4,"Gordon Hayward",1,15,17,12,7,19
"3154",1235,2,1,7,4,1,17,9,6,4,37,3,2,23,10,1,3,1037832,"2023-11-26T00:00:00.000Z",62,4,"Miles Bridges",2,33,35,25,12,41
"3155",1236,1,1,5,0,0,6,5,2,2,22,1,4,12,6,1,1,1037832,"2023-11-26T00:00:00.000Z",38017698,4,"Mark Williams",2,18,19,13,7,25.7
"3156",1237,9,1,1,4,2,15,9,4,2,37,0,4,22,1,1,5,1037832,"2023-11-26T00:00:00.000Z",403,4,"Terry Rozier",2,23,32,31,10,37.7
"3157",1238,2,0,1,3,1,6,3,0,0,14,0,0,7,1,0,1,1037832,"2023-11-26T00:00:00.000Z",3547239,4,"LaMelo Ball",0,8,10,9,3,10.2
"3158",1239,6,0,2,5,2,8,4,0,0,22,2,2,10,4,0,0,1037834,"2023-11-26T00:00:00.000Z",666679,3,"Cameron Johnson",0,14,20,16,10,23.8
"3159",1240,4,0,9,10,6,11,7,0,0,36,0,2,20,9,1,1,1037834,"2023-11-26T00:00:00.000Z",351,3,"Royce O'Neale",1,29,33,24,13,38.8
"3160",1241,1,1,4,7,3,10,3,0,0,34,0,3,9,4,2,1,1037834,"2023-11-26T00:00:00.000Z",158,3,"Dorian Finney-Smith",3,13,14,10,5,23.3
"3161",1242,6,0,2,6,4,7,5,2,1,36,0,0,15,2,0,2,1037834,"2023-11-26T00:00:00.000Z",61,3,"Mikal Bridges",0,17,23,21,8,24.4
"3162",1243,7,0,3,9,3,17,7,8,7,38,2,4,24,5,1,2,1037834,"2023-11-26T00:00:00.000Z",130,3,"Spencer Dinwiddie",1,29,36,31,12,41.5
"3163",1244,0,0,1,10,6,13,6,2,2,25,0,1,20,1,2,2,1037834,"2023-11-26T00:00:00.000Z",464,3,"Lonnie Walker IV",2,21,21,20,1,25.2
"3164",1245,2,0,3,2,1,8,5,1,0,17,1,2,11,4,1,0,1037834,"2023-11-26T00:00:00.000Z",17896058,3,"Trendon Watford",1,15,17,13,6,21.8
"3165",1246,3,1,6,2,0,7,4,2,1,27,3,4,9,9,0,1,1037834,"2023-11-26T00:00:00.000Z",17896038,3,"Day'Ron Sharpe",1,18,21,12,12,26.3
"3166",1247,0,0,0,0,0,0,0,0,0,0,0,0,0,0,0,0,1037832,"2023-11-26T00:00:00.000Z",666748,4,"Cody Martin",0,0,0,0,0,0
"3167",1248,0,0,0,0,0,0,0,0,0,0,0,0,0,0,0,0,1037832,"2023-11-26T00:00:00.000Z",347,4,"Frank Ntilikina",0,0,0,0,0,0
"3168",1249,0,0,0,0,0,0,0,0,0,0,0,0,0,0,0,0,1037832,"2023-11-26T00:00:00.000Z",3547282,4,"Nick Richards",0,0,0,0,0,0
"3169",1250,3,0,1,6,2,7,3,3,1,34,0,2,9,1,1,1,1037833,"2023-11-26T00:00:00.000Z",666400,18,"Nickeil Alexander-Walker",1,10,13,12,4,16.7
"3170",1251,0,0,0,1,0,5,2,2,2,9,0,3,6,0,2,1,1037887,"2023-12-11T00:00:00.000Z",17896025,23,"Jaden Springer",2,6,6,6,0,11
"3171",1252,0,0,0,0,0,0,0,0,0,0,0,0,0,0,0,0,1037887,"2023-12-11T00:00:00.000Z",56913527,23,"Ricky Council IV",0,0,0,0,0,0
"3172",1253,0,0,0,0,0,0,0,0,0,0,0,0,0,0,0,0,1037887,"2023-12-11T00:00:00.000Z",17554001,23,"Javonte Smart",0,0,0,0,0,0
"3173",1254,0,0,0,0,0,0,0,0,0,0,0,0,0,0,0,0,1037887,"2023-12-11T00:00:00.000Z",56677788,23,"Terquavion Smith",0,0,0,0,0,0
"3174",1255,3,0,1,5,0,9,1,6,4,26,1,4,6,2,1,3,1037886,"2023-12-11T00:00:00.000Z",666908,6,"Max Strus",1,8,11,9,5,12.9
"3175",1256,0,0,2,4,2,5,3,2,1,29,4,2,9,6,3,2,1037886,"2023-12-11T00:00:00.000Z",666940,6,"Dean Wade",3,15,15,9,6,23.2
"3176",1257,1,0,5,0,0,3,2,0,0,15,2,6,4,7,1,1,1037886,"2023-12-11T00:00:00.000Z",9,6,"Jarrett Allen",1,11,12,5,8,15.9
"3177",1258,3,1,2,10,2,18,6,9,8,37,1,3,22,3,3,2,1037886,"2023-12-11T00:00:00.000Z",322,6,"Donovan Mitchell",4,25,28,25,6,40.1
"3178",1259,5,0,5,9,3,23,11,12,11,39,1,0,36,6,2,3,1037886,"2023-12-11T00:00:00.000Z",666581,6,"Darius Garland",2,42,47,41,11,53.7
"3179",1260,0,0,3,5,0,10,0,0,0,22,1,3,0,4,0,0,1037886,"2023-12-11T00:00:00.000Z",344,6,"Georges Niang",0,4,4,0,4,4.8
"3180",1261,0,0,1,4,0,4,0,4,1,26,3,2,1,4,0,1,1037886,"2023-12-11T00:00:00.000Z",3547247,6,"Isaac Okoro",0,5,5,1,4,4.8
"3181",1262,1,0,2,4,2,6,2,0,0,17,1,2,6,3,0,1,1037886,"2023-12-11T00:00:00.000Z",3547299,6,"Sam Merrill",0,9,10,7,4,10.1
"3182",1263,2,2,9,0,0,7,5,0,0,29,3,1,10,12,0,0,1037886,"2023-12-11T00:00:00.000Z",444,6,"Tristan Thompson",2,22,24,12,14,33.4
"3183",1264,0,0,0,0,0,0,0,0,0,0,0,0,0,0,0,0,1037886,"2023-12-11T00:00:00.000Z",248,6,"Damian Jones",0,0,0,0,0,0
"3184",1265,0,0,0,0,0,0,0,0,0,0,0,0,0,0,0,0,1037886,"2023-12-11T00:00:00.000Z",404,6,"Ricky Rubio",0,0,0,0,0,0
"3185",1266,7,0,6,3,1,12,7,4,2,32,0,4,17,6,1,0,1037884,"2023-12-11T00:00:00.000Z",204,4,"Gordon Hayward",1,23,30,24,13,37.7
"3186",1267,1,0,3,6,2,14,7,2,2,34,1,3,18,4,0,2,1037884,"2023-12-11T00:00:00.000Z",62,4,"Miles Bridges",0,22,23,19,5,22.3
"3187",1268,1,0,3,0,0,6,2,2,2,26,3,1,6,6,0,0,1037884,"2023-12-11T00:00:00.000Z",3547282,4,"Nick Richards",0,12,13,7,7,14.7
"3188",1269,2,0,4,8,3,14,6,1,1,30,0,5,16,4,0,2,1037884,"2023-12-11T00:00:00.000Z",56677823,4,"Brandon Miller",0,20,22,18,6,21.8
"3189",1270,13,0,1,13,8,17,10,7,6,39,1,4,34,2,0,3,1037884,"2023-12-11T00:00:00.000Z",403,4,"Terry Rozier",0,36,49,47,15,52.9
"3190",1271,1,0,0,5,1,5,1,0,0,17,0,1,3,0,1,0,1037888,"2023-12-11T00:00:00.000Z",666754,1,"Garrison Mathews",1,3,4,4,1,7.5
"3191",1272,2,1,3,4,1,11,6,4,3,40,1,2,16,4,1,0,1037888,"2023-12-11T00:00:00.000Z",3547256,1,"Saddiq Bey",2,20,22,18,6,29.8
"3192",1273,2,0,4,0,0,11,6,2,2,28,4,5,14,8,1,0,1037888,"2023-12-11T00:00:00.000Z",83,1,"Clint Capela",1,22,24,16,10,29.6
"3193",1274,3,0,2,8,3,23,8,2,2,38,4,2,21,6,1,2,1037888,"2023-12-11T00:00:00.000Z",334,1,"Dejounte Murray",1,27,30,24,9,33.7
"3194",1275,9,0,1,5,2,11,5,7,7,26,0,2,19,1,1,5,1037888,"2023-12-11T00:00:00.000Z",490,1,"Trae Young",1,20,29,28,10,31.7
"3195",1276,0,3,4,8,4,12,5,0,0,28,1,1,14,5,4,2,1037969,"2023-12-21T00:00:00.000Z",3547250,12,"Aaron Nesmith",7,19,19,14,5,39
"3196",1277,3,0,2,4,0,10,3,0,0,18,2,0,6,4,1,1,1037969,"2023-12-21T00:00:00.000Z",38017686,12,"Bennedict Mathurin",1,10,13,9,7,17.3
"3197",1278,0,0,0,0,0,0,0,0,0,0,0,0,0,0,0,0,1037969,"2023-12-21T00:00:00.000Z",56677778,12,"Oscar Tshiebwe",0,0,0,0,0,0
"3198",1279,0,0,0,0,0,0,0,0,0,0,0,0,0,0,0,0,1037969,"2023-12-21T00:00:00.000Z",56677832,12,"Jarace Walker",0,0,0,0,0,0
"3199",1280,0,0,0,0,0,0,0,0,0,0,0,0,0,0,0,0,1037969,"2023-12-21T00:00:00.000Z",56677794,12,"Isaiah Wong",0,0,0,0,0,0
"3200",1281,5,0,3,2,1,3,2,2,2,30,1,3,7,4,0,0,1037974,"2023-12-22T00:00:00.000Z",328,23,"Marcus Morris",0,11,16,12,9,19.3
"3201",1282,7,0,8,9,5,23,12,4,4,38,0,2,33,8,1,2,1037974,"2023-12-22T00:00:00.000Z",200,23,"Tobias Harris",1,41,48,40,15,54.1
"3202",1283,9,4,9,2,2,21,11,8,7,35,1,1,31,10,2,6,1037974,"2023-12-22T00:00:00.000Z",145,23,"Joel Embiid",6,41,50,40,19,68.5
"3203",1284,0,0,3,6,2,9,3,0,0,26,0,4,8,3,1,0,1037974,"2023-12-22T00:00:00.000Z",360,23,"Kelly Oubre Jr.",1,11,11,8,3,14.6
"3204",1285,10,0,4,10,4,22,13,3,3,41,0,3,33,4,0,3,1037974,"2023-12-22T00:00:00.000Z",3547254,23,"Tyrese Maxey",0,37,47,43,14,49.8
"3205",1286,1,0,0,1,1,1,1,0,0,4,0,0,3,0,0,0,1037967,"2023-12-21T00:00:00.000Z",38017662,6,"Isaiah Mobley",0,3,4,4,1,4.5
"3206",1287,0,0,1,0,0,1,1,0,0,4,0,0,2,1,0,0,1037967,"2023-12-21T00:00:00.000Z",248,6,"Damian Jones",0,3,3,2,1,3.2
"3207",1288,0,0,0,0,0,0,0,0,0,0,0,0,0,0,0,0,1037967,"2023-12-21T00:00:00.000Z",666581,6,"Darius Garland",0,0,0,0,0,0
"3208",1289,0,0,0,0,0,0,0,0,0,0,0,0,0,0,0,0,1037967,"2023-12-21T00:00:00.000Z",666676,6,"Ty Jerome",0,0,0,0,0,0
"3209",1290,0,0,0,0,0,0,0,0,0,0,0,0,0,0,0,0,1037967,"2023-12-21T00:00:00.000Z",322,6,"Donovan Mitchell",0,0,0,0,0,0
"3210",1291,1,0,1,0,0,1,1,2,1,23,0,2,3,1,0,2,1037974,"2023-12-22T00:00:00.000Z",2175,23,"Danuel House Jr.",0,4,5,4,2,3.7
"3211",1292,2,1,3,1,0,1,0,0,0,24,0,4,0,3,1,0,1037974,"2023-12-22T00:00:00.000Z",108,23,"Robert Covington",2,3,5,2,5,12.6
"3212",1293,0,0,1,0,0,1,1,0,0,7,0,0,2,1,0,0,1037974,"2023-12-22T00:00:00.000Z",260,23,"Furkan Korkmaz",0,3,3,2,1,3.2
"3213",1294,0,1,3,1,0,2,1,2,2,13,1,2,4,4,1,0,1037974,"2023-12-22T00:00:00.000Z",3547270,23,"Paul Reed",2,8,8,4,4,14.8
"3214",1295,0,0,0,0,0,0,0,0,0,1,0,0,0,0,0,0,1037974,"2023-12-22T00:00:00.000Z",3547294,23,"Kenyon Martin Jr.",0,0,0,0,0,0
"3215",1296,0,0,0,0,0,0,0,0,0,1,0,0,0,0,0,0,1037974,"2023-12-22T00:00:00.000Z",17896025,23,"Jaden Springer",0,0,0,0,0,0
"3216",1297,0,0,0,0,0,0,0,0,0,1,0,0,0,0,0,0,1037974,"2023-12-22T00:00:00.000Z",17554001,23,"Javonte Smart",0,0,0,0,0,0
"3217",1298,0,0,0,0,0,0,0,0,0,0,0,0,0,0,0,0,1037974,"2023-12-22T00:00:00.000Z",45,23,"Patrick Beverley",0,0,0,0,0,0
"3218",1299,0,0,0,0,0,0,0,0,0,0,0,0,0,0,0,0,1037974,"2023-12-22T00:00:00.000Z",313,23,"De'Anthony Melton",0,0,0,0,0,0
"3219",1300,4,2,6,0,0,7,4,0,0,31,0,2,8,6,1,4,1037982,"2023-12-23T00:00:00.000Z",204,4,"Gordon Hayward",3,14,18,12,10,26.2
"3220",1301,0,0,4,7,4,12,7,0,0,18,2,1,18,6,1,0,1038062,"2024-01-03T00:00:00.000Z",17896027,15,"Ziaire Williams",1,24,24,18,6,28.2
"3221",1302,0,0,0,0,0,0,0,0,0,0,0,0,0,0,0,0,1038062,"2024-01-03T00:00:00.000Z",3,15,"Steven Adams",0,0,0,0,0,0
"3222",1303,0,0,0,0,0,0,0,0,0,0,0,0,0,0,0,0,1038062,"2024-01-03T00:00:00.000Z",666505,15,"Brandon Clarke",0,0,0,0,0,0
"3223",1304,0,0,0,0,0,0,0,0,0,0,0,0,0,0,0,0,1038062,"2024-01-03T00:00:00.000Z",48248287,15,"Jacob Gilyard",0,0,0,0,0,0
"3224",1305,0,0,0,0,0,0,0,0,0,0,0,0,0,0,0,0,1038062,"2024-01-03T00:00:00.000Z",56677830,15,"GG Jackson",0,0,0,0,0,0
"3225",1306,0,0,0,0,0,0,0,0,0,0,0,0,0,0,0,0,1038062,"2024-01-03T00:00:00.000Z",38017728,15,"Jake LaRavia",0,0,0,0,0,0
"3226",1307,0,0,0,0,0,0,0,0,0,0,0,0,0,0,0,0,1038062,"2024-01-03T00:00:00.000Z",38017731,15,"Vince Williams Jr.",0,0,0,0,0,0
"3227",1308,3,0,7,5,2,12,5,3,2,33,0,3,14,7,1,3,1038062,"2024-01-03T00:00:00.000Z",666423,28,"RJ Barrett",1,21,24,17,10,26.9
"3228",1309,0,0,6,2,1,14,9,6,5,30,1,5,24,7,1,3,1038062,"2024-01-03T00:00:00.000Z",416,28,"Pascal Siakam",1,31,31,24,7,32.4
"3229",1310,2,5,5,0,0,7,2,4,3,33,3,3,7,8,1,1,1038062,"2024-01-03T00:00:00.000Z",373,28,"Jakob Poeltl",6,15,17,9,10,36.6
"3230",1311,8,0,2,5,2,14,7,4,4,40,0,2,20,2,1,1,1038062,"2024-01-03T00:00:00.000Z",17896055,28,"Scottie Barnes",1,22,30,28,10,36.4
"3231",1312,0,1,3,7,0,13,3,2,2,32,1,2,8,4,3,0,1038085,"2024-01-06T00:00:00.000Z",3547250,12,"Aaron Nesmith",4,12,12,8,4,24.8
"3232",1313,2,0,6,4,1,6,2,2,2,26,1,2,7,7,0,0,1038085,"2024-01-06T00:00:00.000Z",3547264,12,"Jalen Smith",0,14,16,9,9,18.4
"3233",1314,2,0,4,5,0,11,5,4,2,30,3,3,12,7,0,0,1038085,"2024-01-06T00:00:00.000Z",452,12,"Myles Turner",0,19,21,14,9,23.4
"3234",1315,3,0,2,10,3,16,6,0,0,31,0,3,15,2,0,0,1038085,"2024-01-06T00:00:00.000Z",210,12,"Buddy Hield",0,17,20,18,5,21.9
"3235",1316,7,0,5,9,2,17,5,5,5,35,1,1,17,6,5,4,1038085,"2024-01-06T00:00:00.000Z",3547245,12,"Tyrese Haliburton",5,23,30,24,13,45.7
"3236",1317,0,0,2,0,0,3,2,0,0,9,1,4,4,3,0,0,1038085,"2024-01-06T00:00:00.000Z",17896035,12,"Isaiah Jackson",0,7,7,4,3,7.6
"3237",1318,0,0,0,0,0,0,0,0,0,1,0,0,0,0,0,0,1038085,"2024-01-06T00:00:00.000Z",38017701,12,"Kendall Brown",0,0,0,0,0,0
"3238",1319,6,0,7,4,2,13,9,5,3,33,3,5,23,10,2,4,1038086,"2024-01-06T00:00:00.000Z",3547242,30,"Deni Avdija",2,33,39,29,16,46
"3239",1320,2,1,2,10,4,21,10,4,3,32,0,3,27,2,0,3,1038086,"2024-01-06T00:00:00.000Z",265,30,"Kyle Kuzma",1,29,31,29,4,32.4
"3240",1321,0,0,0,0,0,0,0,0,0,0,0,0,0,0,0,0,1038082,"2024-01-05T00:00:00.000Z",57875092,10,"Gui Santos",0,0,0,0,0,0
"3241",1322,3,0,3,8,2,19,5,0,0,36,2,0,12,5,2,1,1038082,"2024-01-05T00:00:00.000Z",54,9,"Bojan Bogdanovic",2,17,20,15,8,27.5
"3242",1323,1,0,1,2,1,3,2,0,0,22,0,2,5,1,1,0,1038082,"2024-01-05T00:00:00.000Z",17896071,9,"Isaiah Livers",1,6,7,6,2,10.7
"3243",1324,2,2,8,0,0,6,6,2,1,33,4,2,13,12,0,1,1038082,"2024-01-05T00:00:00.000Z",38017694,9,"Jalen Duren",2,25,27,15,14,35.4
"3244",1325,3,1,2,5,2,10,5,0,0,24,2,6,12,4,0,4,1038082,"2024-01-05T00:00:00.000Z",38017682,9,"Jaden Ivey",1,16,19,15,7,20.3
"3245",1326,1,0,0,6,2,7,3,0,0,20,1,0,8,1,1,2,1037606,"2023-10-25T00:00:00.000Z",666923,25,"Matisse Thybulle",1,9,10,9,2,11.7
"3246",1327,1,1,1,4,0,12,5,4,3,30,2,1,13,3,0,3,1037606,"2023-10-25T00:00:00.000Z",182,25,"Jerami Grant",1,16,17,14,4,18.1
"3247",1328,0,0,0,0,0,0,0,0,0,0,0,0,0,0,0,0,1037606,"2023-10-25T00:00:00.000Z",3547289,25,"Skylar Mays",0,0,0,0,0,0
"3248",1329,0,0,0,0,0,0,0,0,0,0,0,0,0,0,0,0,1037606,"2023-10-25T00:00:00.000Z",47957121,25,"Justin Minaya",0,0,0,0,0,0
"3249",1330,0,0,0,0,0,0,0,0,0,0,0,0,0,0,0,0,1037606,"2023-10-25T00:00:00.000Z",56783340,25,"Duop Reath",0,0,0,0,0,0
"3250",1331,0,0,0,0,0,0,0,0,0,0,0,0,0,0,0,0,1037606,"2023-10-25T00:00:00.000Z",17896120,25,"Ish Wainright",0,0,0,0,0,0
"3251",1332,6,0,4,3,2,7,5,4,4,25,1,0,16,5,0,1,1037605,"2023-10-25T00:00:00.000Z",3547274,27,"Tre Jones",0,21,27,22,11,30
"3252",1333,2,0,2,3,0,7,3,1,1,18,0,1,7,2,1,1,1037605,"2023-10-25T00:00:00.000Z",38017692,27,"Malaki Branham",1,9,11,9,4,14.4
"3253",1334,1,1,1,1,0,1,0,0,0,11,0,1,0,1,0,0,1037605,"2023-10-25T00:00:00.000Z",305,27,"Doug McDermott",1,1,2,1,2,5.7
"3254",1335,0,0,0,0,0,0,0,0,0,0,0,0,0,0,0,0,1037605,"2023-10-25T00:00:00.000Z",38017730,27,"Dominick Barlow",0,0,0,0,0,0
"3255",1336,0,0,0,0,0,0,0,0,0,0,0,0,0,0,0,0,1037605,"2023-10-25T00:00:00.000Z",17554004,7,"AJ Lawson",0,0,0,0,0,0
"3256",1337,0,0,0,0,0,3,2,3,2,6,1,0,6,1,0,2,1037606,"2023-10-25T00:00:00.000Z",38017711,25,"Jabari Walker",0,7,7,6,1,5.2
"3257",1338,0,0,1,0,0,0,0,0,0,5,0,0,0,1,0,0,1037606,"2023-10-25T00:00:00.000Z",56677791,25,"Kris Murray",0,1,1,0,1,1.2
"3258",1339,0,0,0,0,0,0,0,0,0,2,0,0,0,0,0,0,1037606,"2023-10-25T00:00:00.000Z",56677829,25,"Rayan Rupert",0,0,0,0,0,0
"3259",1340,4,0,3,3,1,5,2,2,1,16,0,0,6,3,2,2,1037607,"2023-10-26T00:00:00.000Z",315,17,"Khris Middleton",2,9,13,10,7,19.6
"3260",1341,3,2,8,3,0,22,10,9,3,35,5,4,23,13,2,7,1037607,"2023-10-26T00:00:00.000Z",15,17,"Giannis Antetokounmpo",4,36,39,26,16,48.1
"3261",1342,0,0,1,4,3,7,5,0,0,29,1,4,13,2,0,2,1037607,"2023-10-26T00:00:00.000Z",283,17,"Brook Lopez",0,15,15,13,2,13.4
"3262",1343,3,0,4,1,1,4,2,0,0,31,0,1,5,4,2,2,1037607,"2023-10-26T00:00:00.000Z",38,17,"Malik Beasley",2,9,12,8,7,18.3
"3263",1344,4,0,8,12,4,20,9,17,17,37,0,2,39,8,0,0,1037607,"2023-10-26T00:00:00.000Z",278,17,"Damian Lillard",0,47,51,43,12,54.6
"3264",1345,2,0,4,1,1,4,3,2,2,27,0,3,9,4,2,1,1037607,"2023-10-26T00:00:00.000Z",112,17,"Jae Crowder",2,13,15,11,6,21.8
"3265",1346,2,1,2,4,1,6,2,2,2,20,0,0,7,2,0,0,1037607,"2023-10-26T00:00:00.000Z",105,17,"Pat Connaughton",1,9,11,9,4,15.4
"3266",1347,0,0,1,1,0,3,2,0,0,17,1,3,4,2,0,0,1037607,"2023-10-26T00:00:00.000Z",38017676,17,"MarJon Beauchamp",0,6,6,4,2,6.4
"3267",1348,0,0,0,0,0,0,0,0,0,0,0,0,0,0,0,0,1037607,"2023-10-26T00:00:00.000Z",2148,17,"Thanasis Antetokounmpo",0,0,0,0,0,0
"3268",1349,0,0,0,0,0,0,0,0,0,0,0,0,0,0,0,0,1037607,"2023-10-26T00:00:00.000Z",38017733,17,"A.J. Green",0,0,0,0,0,0
"3269",1350,0,0,0,0,0,0,0,0,0,0,0,0,0,0,0,0,1037608,"2023-10-26T00:00:00.000Z",56677738,14,"Colin Castleton",0,0,0,0,0,0
"3270",1351,0,0,0,0,0,0,0,0,0,0,0,0,0,0,0,0,1037725,"2023-11-12T00:00:00.000Z",56677795,20,"Jacob Toppin",0,0,0,0,0,0
"3271",1352,0,0,0,0,0,0,0,0,0,0,0,0,0,0,0,0,1037725,"2023-11-12T00:00:00.000Z",17896089,20,"Duane Washington Jr.",0,0,0,0,0,0
"3272",1353,2,0,1,1,0,9,3,0,0,29,0,3,6,1,0,2,1037725,"2023-11-12T00:00:00.000Z",204,4,"Gordon Hayward",0,7,9,8,3,8.2
"3273",1354,3,1,1,5,1,8,1,2,1,22,1,4,4,2,0,2,1037725,"2023-11-12T00:00:00.000Z",666950,4,"P.J. Washington",1,6,9,7,5,11.9
"3274",1355,2,0,2,0,0,5,4,2,2,23,2,3,10,4,2,1,1037725,"2023-11-12T00:00:00.000Z",38017698,4,"Mark Williams",2,14,16,12,6,22.8
"3275",1356,6,1,4,8,4,20,13,2,2,33,3,2,32,7,1,2,1037725,"2023-11-12T00:00:00.000Z",3547239,4,"LaMelo Ball",2,39,45,38,13,53.4
"3276",1357,0,0,2,2,1,6,5,1,0,10,1,0,11,3,0,0,1037725,"2023-11-12T00:00:00.000Z",56677823,4,"Brandon Miller",0,14,14,11,3,14.6
"3277",1358,0,1,2,1,1,2,2,0,0,6,0,1,5,2,0,0,1037725,"2023-11-12T00:00:00.000Z",56677866,4,"Leaky Black",1,7,7,5,2,10.4
"3278",1359,0,0,0,0,0,0,0,0,0,0,0,0,0,0,0,0,1037724,"2023-11-11T00:00:00.000Z",3547299,6,"Sam Merrill",0,0,0,0,0,0
"3279",1360,0,0,0,0,0,0,0,0,0,0,0,0,0,0,0,0,1037724,"2023-11-11T00:00:00.000Z",38017662,6,"Isaiah Mobley",0,0,0,0,0,0
"3280",1361,0,0,0,0,0,0,0,0,0,0,0,0,0,0,0,0,1037724,"2023-11-11T00:00:00.000Z",3547247,6,"Isaac Okoro",0,0,0,0,0,0
"3281",1362,0,0,0,0,0,0,0,0,0,0,0,0,0,0,0,0,1037724,"2023-11-11T00:00:00.000Z",404,6,"Ricky Rubio",0,0,0,0,0,0
"3282",1363,0,0,0,0,0,0,0,0,0,0,0,0,0,0,0,0,1037723,"2023-11-11T00:00:00.000Z",74,16,"Thomas Bryant",0,0,0,0,0,0
"3283",1364,0,0,0,0,0,0,0,0,0,0,0,0,0,0,0,0,1037723,"2023-11-11T00:00:00.000Z",38017696,16,"Nikola Jovic",0,0,0,0,0,0
"3284",1365,0,0,0,0,0,0,0,0,0,0,0,0,0,0,0,0,1037723,"2023-11-11T00:00:00.000Z",39398582,16,"Orlando Robinson",0,0,0,0,0,0
"3285",1366,0,0,0,0,0,0,0,0,0,0,0,0,0,0,0,0,1037723,"2023-11-11T00:00:00.000Z",38017736,16,"Cole Swider",0,0,0,0,0,0
"3286",1367,0,0,0,0,0,0,0,0,0,0,0,0,0,0,0,0,1037723,"2023-11-11T00:00:00.000Z",79,16,"Jimmy Butler",0,0,0,0,0,0
"3287",1368,0,0,0,0,0,0,0,0,0,0,0,0,0,0,0,0,1037723,"2023-11-11T00:00:00.000Z",3547257,16,"R.J. Hampton",0,0,0,0,0,0
"3288",1369,0,0,0,0,0,0,0,0,0,0,0,0,0,0,0,0,1037723,"2023-11-11T00:00:00.000Z",666633,16,"Tyler Herro",0,0,0,0,0,0
"3289",1370,0,0,0,0,0,0,0,0,0,0,0,0,0,0,0,0,1037723,"2023-11-11T00:00:00.000Z",666747,16,"Caleb Martin",0,0,0,0,0,0
"3290",1371,0,0,0,0,0,3,1,0,0,3,2,0,2,2,0,0,1037725,"2023-11-12T00:00:00.000Z",56677848,4,"Amari Bailey",0,4,4,2,2,4.4
"3291",1372,0,1,2,5,2,6,2,2,0,23,2,4,6,4,0,1,1037725,"2023-11-12T00:00:00.000Z",18678001,4,"JT Thor",1,10,10,6,4,12.8
"3292",1373,4,0,0,7,2,12,2,0,0,25,2,3,6,2,0,2,1037725,"2023-11-12T00:00:00.000Z",3547253,4,"Theo Maledon",0,8,12,10,6,12.4
"3293",1374,0,0,3,0,0,9,7,2,2,22,1,4,16,4,0,2,1037725,"2023-11-12T00:00:00.000Z",3547282,4,"Nick Richards",0,20,20,16,4,18.8
"3294",1375,0,0,0,2,0,4,1,0,0,19,0,0,2,0,0,0,1037725,"2023-11-12T00:00:00.000Z",38017708,4,"Bryce McGowens",0,2,2,2,0,2
"3295",1376,0,0,0,0,0,0,0,0,0,0,0,0,0,0,0,0,3277503,"2023-11-24T00:00:00.000Z",56677809,11,"Jermaine Samuels Jr.",0,0,0,0,0,0
"3296",1377,0,0,0,0,0,0,0,0,0,0,0,0,0,0,0,0,3277503,"2023-11-24T00:00:00.000Z",56677825,11,"Amen Thompson",0,0,0,0,0,0
"3297",1378,0,0,0,0,0,0,0,0,0,0,0,0,0,0,0,0,3277503,"2023-11-24T00:00:00.000Z",56677831,11,"Cam Whitmore",0,0,0,0,0,0
"3298",1379,1,2,6,8,2,14,6,0,0,37,1,1,14,7,1,1,3277503,"2023-11-24T00:00:00.000Z",375,8,"Michael Porter Jr.",3,21,22,15,8,31.9
"3299",1380,2,0,4,4,0,12,0,4,2,39,3,1,2,7,0,1,3277503,"2023-11-24T00:00:00.000Z",177,8,"Aaron Gordon",0,9,11,4,9,12.4
"3300",1381,8,0,13,8,3,31,14,11,7,42,6,3,38,19,2,3,3277503,"2023-11-24T00:00:00.000Z",246,8,"Nikola Jokic",2,57,65,46,27,75.8
"3301",1382,3,0,2,5,1,15,7,5,5,39,3,4,20,5,3,2,3277503,"2023-11-24T00:00:00.000Z",81,8,"Kentavious Caldwell-Pope",3,25,28,23,8,37.5
"3302",1383,3,1,2,2,0,8,1,0,0,25,2,0,2,4,0,5,3277503,"2023-11-24T00:00:00.000Z",236,8,"Reggie Jackson",1,6,9,5,7,9.3
"3303",1384,5,0,1,3,1,8,3,0,0,13,0,1,7,1,0,1,3277504,"2023-11-24T00:00:00.000Z",315,17,"Khris Middleton",0,8,13,12,6,14.7
"3304",1385,3,1,6,0,0,19,11,12,9,37,3,2,31,9,3,3,3277504,"2023-11-24T00:00:00.000Z",15,17,"Giannis Antetokounmpo",4,40,43,34,12,55.3
"3305",1386,1,3,5,7,4,17,14,7,7,32,0,2,39,5,2,1,3277504,"2023-11-24T00:00:00.000Z",283,17,"Brook Lopez",5,44,45,40,6,60.5
"3306",1387,1,1,7,4,1,8,4,0,0,27,4,3,9,11,0,2,3277504,"2023-11-24T00:00:00.000Z",38,17,"Malik Beasley",1,20,21,10,12,24.7
"3307",1388,10,0,6,5,2,18,11,8,7,37,1,1,31,7,0,1,3277504,"2023-11-24T00:00:00.000Z",278,17,"Damian Lillard",0,38,48,41,17,53.4
"3308",1389,0,0,0,0,0,0,0,0,0,0,0,0,0,0,0,0,3277504,"2023-11-24T00:00:00.000Z",2148,17,"Thanasis Antetokounmpo",0,0,0,0,0,0
"3309",1390,0,0,3,0,0,9,3,1,1,26,0,1,7,3,0,0,3277503,"2023-11-24T00:00:00.000Z",38017709,8,"Christian Braun",0,10,10,7,3,10.6
"3310",1391,0,0,0,0,0,0,0,0,0,6,0,1,0,0,0,0,3277503,"2023-11-24T00:00:00.000Z",56677776,8,"Julian Strawther",0,0,0,0,0,0
"3311",1392,0,0,0,0,0,1,0,0,0,4,0,0,0,0,0,1,3277503,"2023-11-24T00:00:00.000Z",3547268,8,"Zeke Nnaji",0,0,0,0,0,-1
"3312",1393,0,0,0,0,0,0,0,0,0,3,0,0,0,0,0,1,3277503,"2023-11-24T00:00:00.000Z",38017727,8,"Collin Gillespie",0,0,0,0,0,-1
"3313",1394,0,0,0,2,1,2,1,0,0,13,0,2,3,0,1,0,3277503,"2023-11-24T00:00:00.000Z",215,8,"Justin Holiday",1,3,3,3,0,6
"3314",1395,0,0,0,0,0,0,0,0,0,0,0,0,0,0,0,0,3277503,"2023-11-24T00:00:00.000Z",250,8,"DeAndre Jordan",0,0,0,0,0,0
"3315",1396,0,0,0,0,0,0,0,0,0,0,0,0,0,0,0,0,3277503,"2023-11-24T00:00:00.000Z",17896007,8,"Braxton Key",0,0,0,0,0,0
"3316",1397,0,0,0,0,0,0,0,0,0,0,0,0,0,0,0,0,3277503,"2023-11-24T00:00:00.000Z",56677582,8,"Jalen Pickett",0,0,0,0,0,0
"3317",1398,4,0,2,6,1,17,6,2,2,35,3,3,15,5,1,0,3277500,"2023-11-24T00:00:00.000Z",56677785,16,"Jaime Jaquez Jr.",1,20,24,19,9,30
"3318",1399,0,1,1,3,1,7,4,0,0,18,0,0,9,1,0,3,3277505,"2023-11-24T00:00:00.000Z",667378,18,"Naz Reid",1,10,10,9,1,10.2
"3319",1400,0,0,0,0,0,0,0,0,0,0,0,0,0,0,0,0,3277505,"2023-11-24T00:00:00.000Z",38017715,18,"Josh Minott",0,0,0,0,0,0
"3320",1401,7,0,7,2,2,14,10,9,6,37,0,4,28,7,1,3,7996365,"2023-12-08T00:00:00.000Z",57,24,"Devin Booker",1,35,42,35,14,46.9
"3321",1402,6,0,3,1,0,6,3,2,2,20,2,2,8,5,0,2,7996365,"2023-12-08T00:00:00.000Z",18678058,24,"Jordan Goodwin",0,13,19,14,11,21
"3322",1403,1,2,4,4,0,9,4,2,2,23,0,1,10,4,2,0,7996365,"2023-12-08T00:00:00.000Z",314,24,"Chimezie Metu",4,14,15,11,5,28.3
"3323",1404,0,0,0,0,0,0,0,0,0,0,0,0,0,0,0,0,7050290,"2023-12-08T00:00:00.000Z",56677809,11,"Jermaine Samuels Jr.",0,0,0,0,0,0
"3324",1405,0,0,0,0,0,0,0,0,0,0,0,0,0,0,0,0,7050290,"2023-12-08T00:00:00.000Z",56677825,11,"Amen Thompson",0,0,0,0,0,0
"3325",1406,0,0,0,0,0,0,0,0,0,0,0,0,0,0,0,0,7050290,"2023-12-08T00:00:00.000Z",56677831,11,"Cam Whitmore",0,0,0,0,0,0
"3326",1407,0,0,0,0,0,0,0,0,0,0,0,0,0,0,0,0,7050290,"2023-12-08T00:00:00.000Z",3547281,11,"Nate Hinton",0,0,0,0,0,0
"3327",1408,0,0,0,0,0,0,0,0,0,0,0,0,0,0,0,0,7050290,"2023-12-08T00:00:00.000Z",19465326,11,"Jock Landale",0,0,0,0,0,0
"3328",1409,0,0,0,0,0,0,0,0,0,0,0,0,0,0,0,0,7050290,"2023-12-08T00:00:00.000Z",357,11,"Victor Oladipo",0,0,0,0,0,0
"3329",1410,0,0,0,0,0,0,0,0,0,0,0,0,0,0,0,0,7050282,"2023-12-08T00:00:00.000Z",666762,28,"Jalen McDaniels",0,0,0,0,0,0
"3330",1411,0,0,0,0,0,0,0,0,0,0,0,0,0,0,0,0,7050282,"2023-12-08T00:00:00.000Z",436,28,"Garrett Temple",0,0,0,0,0,0
"3331",1412,0,0,0,0,0,0,0,0,0,0,0,0,0,0,0,0,7050282,"2023-12-08T00:00:00.000Z",489,28,"Thaddeus Young",0,0,0,0,0,0
"3332",1413,0,0,0,0,0,0,0,0,0,0,0,0,0,0,0,0,7050282,"2023-12-08T00:00:00.000Z",56677828,28,"Gradey Dick",0,0,0,0,0,0
"3333",1414,0,0,0,0,0,0,0,0,0,0,0,0,0,0,0,0,7050282,"2023-12-08T00:00:00.000Z",56677805,28,"Javon Freeman-Liberty",0,0,0,0,0,0
"3334",1415,0,0,0,0,0,0,0,0,0,0,0,0,0,0,0,0,7050282,"2023-12-08T00:00:00.000Z",38017710,28,"Christian Koloko",0,0,0,0,0,0
"3335",1416,0,0,0,0,0,0,0,0,0,0,0,0,0,0,0,0,7050282,"2023-12-08T00:00:00.000Z",56677869,28,"Markquis Nowell",0,0,0,0,0,0
"3336",1417,0,0,1,0,0,1,1,0,0,4,1,2,2,2,0,0,7050289,"2023-12-08T00:00:00.000Z",56677857,5,"Julian Phillips",0,4,4,2,2,4.4
"3337",1418,1,0,0,3,1,4,1,0,0,9,0,2,3,0,0,0,7050289,"2023-12-08T00:00:00.000Z",87,5,"Jevon Carter",0,3,4,4,1,4.5
"3338",1419,0,0,2,0,0,7,3,4,1,12,6,2,7,8,0,0,7050289,"2023-12-08T00:00:00.000Z",137,5,"Andre Drummond",0,15,15,7,8,16.6
"3339",1420,0,0,0,0,0,0,0,0,0,0,0,0,0,0,0,0,7996365,"2023-12-08T00:00:00.000Z",140,24,"Kevin Durant",0,0,0,0,0,0
"3340",1421,0,0,0,0,0,0,0,0,0,0,0,0,0,0,0,0,7996365,"2023-12-08T00:00:00.000Z",272,24,"Damion Lee",0,0,0,0,0,0
"3341",1422,2,0,4,4,1,11,3,3,2,32,4,0,9,8,1,0,7996365,"2023-12-08T00:00:00.000Z",30,26,"Harrison Barnes",1,17,19,11,10,24.6
"3342",1423,0,0,2,7,1,13,6,0,0,30,2,6,13,4,1,1,7996365,"2023-12-08T00:00:00.000Z",38017688,26,"Keegan Murray",1,17,17,13,4,19.8
"3343",1424,5,0,13,0,0,11,6,4,3,38,4,4,15,17,0,4,7996365,"2023-12-08T00:00:00.000Z",406,26,"Domantas Sabonis",0,32,37,20,22,38.9
"3344",1425,1,0,3,3,0,4,0,1,1,17,0,3,1,3,1,0,7996365,"2023-12-08T00:00:00.000Z",221,26,"Kevin Huerter",1,4,5,2,4,9.1
"3345",1426,0,0,0,0,0,0,0,0,0,0,0,0,0,0,0,0,1037971,"2023-12-21T00:00:00.000Z",56677853,21,"Keyontae Johnson",0,0,0,0,0,0
"3346",1427,0,0,0,0,0,0,0,0,0,0,0,0,0,0,0,0,1037971,"2023-12-21T00:00:00.000Z",3547271,21,"Aleksej Pokusevski",0,0,0,0,0,0
"3347",1428,0,0,0,0,0,0,0,0,0,0,0,0,0,0,0,0,1037971,"2023-12-21T00:00:00.000Z",27924547,21,"Lindy Waters III",0,0,0,0,0,0
"3348",1429,0,0,0,0,0,0,0,0,0,0,0,0,0,0,0,0,1037970,"2023-12-21T00:00:00.000Z",284,17,"Robin Lopez",0,0,0,0,0,0
"3349",1430,0,0,0,0,0,0,0,0,0,0,0,0,0,0,0,0,1037970,"2023-12-21T00:00:00.000Z",666453,17,"Marques Bolden",0,0,0,0,0,0
"3350",1431,0,0,0,0,0,0,0,0,0,0,0,0,0,0,0,0,1037970,"2023-12-21T00:00:00.000Z",112,17,"Jae Crowder",0,0,0,0,0,0
"3351",1432,0,0,0,0,0,0,0,0,0,0,0,0,0,0,0,0,1037970,"2023-12-21T00:00:00.000Z",56677854,17,"Chris Livingston",0,0,0,0,0,0
"3352",1433,0,0,0,0,0,0,0,0,0,0,0,0,0,0,0,0,1037966,"2023-12-21T00:00:00.000Z",38017694,9,"Jalen Duren",0,0,0,0,0,0
"3353",1434,0,0,0,0,0,0,0,0,0,0,0,0,0,0,0,0,1037966,"2023-12-21T00:00:00.000Z",330,9,"Monte Morris",0,0,0,0,0,0
"3354",1435,0,0,0,0,0,0,0,0,0,0,0,0,0,0,0,0,1037966,"2023-12-21T00:00:00.000Z",42097199,9,"Jared Rhoden",0,0,0,0,0,0
"3355",1436,3,1,3,3,0,5,1,0,0,35,1,2,2,4,3,2,1037969,"2023-12-21T00:00:00.000Z",38017731,15,"Vince Williams Jr.",4,6,9,5,7,21.3
"3356",1437,1,0,6,4,2,10,8,3,3,33,1,4,21,7,1,7,1037969,"2023-12-21T00:00:00.000Z",231,15,"Jaren Jackson Jr.",1,28,29,22,8,26.9
"3357",1438,1,1,2,0,0,4,1,1,0,17,1,2,2,3,0,0,1037969,"2023-12-21T00:00:00.000Z",48,15,"Bismack Biyombo",1,5,6,3,4,10.1
"3358",1439,7,0,6,12,5,26,11,5,4,36,0,1,31,6,1,2,1037969,"2023-12-21T00:00:00.000Z",3547287,15,"Desmond Bane",1,37,44,38,13,49.7
"3359",1440,8,0,5,3,1,15,7,6,5,34,0,0,20,5,0,2,1037969,"2023-12-21T00:00:00.000Z",666786,15,"Ja Morant",0,25,33,28,13,36
"3360",1441,2,0,3,5,3,7,5,0,0,25,0,0,13,3,1,2,1037969,"2023-12-21T00:00:00.000Z",17896067,15,"Santi Aldama",1,16,18,15,5,20.6
"3361",1442,1,2,5,4,2,4,2,0,0,21,1,1,6,6,1,0,1037969,"2023-12-21T00:00:00.000Z",666703,15,"John Konchar",3,12,13,7,7,23.7
"3362",1443,0,0,0,0,0,0,0,0,0,0,0,0,0,0,0,0,1037969,"2023-12-21T00:00:00.000Z",48248287,15,"Jacob Gilyard",0,0,0,0,0,0
"3363",1444,1,1,3,2,0,8,3,0,0,21,5,1,6,8,1,0,1037970,"2023-12-21T00:00:00.000Z",377,17,"Bobby Portis",2,14,15,7,9,23.1
"3364",1445,0,0,0,1,0,1,0,0,0,7,0,0,0,0,0,0,1037970,"2023-12-21T00:00:00.000Z",56677852,17,"Andre Jackson Jr.",0,0,0,0,0,0
"3365",1446,3,0,1,0,0,1,1,0,0,18,1,2,2,2,0,0,1037967,"2023-12-21T00:00:00.000Z",17896097,19,"Jose Alvarado",0,4,7,5,5,8.9
"3366",1447,1,0,2,1,1,4,3,0,0,20,0,1,7,2,0,0,1037967,"2023-12-21T00:00:00.000Z",38017677,19,"Dyson Daniels",0,9,10,8,3,10.9
"3367",1448,0,0,0,0,0,0,0,0,0,0,0,0,0,0,0,0,1037967,"2023-12-21T00:00:00.000Z",38017726,19,"Dereon Seabron",0,0,0,0,0,0
"3368",1449,3,0,2,1,1,2,2,0,0,18,0,1,5,2,2,0,1037971,"2023-12-21T00:00:00.000Z",480,21,"Kenrich Williams",2,7,10,8,5,17.9
"3369",1450,1,0,2,0,0,1,1,0,0,6,0,0,2,2,0,0,1037971,"2023-12-21T00:00:00.000Z",38017706,21,"Jaylin Williams",0,4,5,3,3,5.9
"3370",1451,0,0,0,0,0,0,0,0,0,0,0,0,0,0,0,0,1038059,"2024-01-03T00:00:00.000Z",56677838,1,"Kobe Bufkin",0,0,0,0,0,0
"3371",1452,0,0,0,0,0,0,0,0,0,0,0,0,0,0,0,0,1038059,"2024-01-03T00:00:00.000Z",56677806,1,"Mouhamed Gueye",0,0,0,0,0,0
"3372",1453,0,0,0,0,0,0,0,0,0,0,0,0,0,0,0,0,1038059,"2024-01-03T00:00:00.000Z",666656,1,"De'Andre Hunter",0,0,0,0,0,0
"3373",1454,2,1,0,3,1,10,5,0,0,33,0,3,11,0,2,1,1038063,"2024-01-03T00:00:00.000Z",3547259,18,"Jaden McDaniels",3,11,13,13,2,22
"3374",1455,2,0,4,4,0,19,8,7,6,36,2,2,22,6,0,1,1038063,"2024-01-03T00:00:00.000Z",447,18,"Karl-Anthony Towns",0,28,30,24,8,31.2
"3375",1456,0,1,4,0,0,3,2,2,1,24,1,4,5,5,0,1,1038063,"2024-01-03T00:00:00.000Z",176,18,"Rudy Gobert",1,10,10,5,5,13
"3376",1457,5,1,2,7,4,22,11,10,9,37,2,1,35,4,1,6,1038063,"2024-01-03T00:00:00.000Z",3547238,18,"Anthony Edwards",2,39,44,40,9,47.3
"3377",1458,9,0,0,3,1,5,3,0,0,26,0,1,7,0,1,0,1038063,"2024-01-03T00:00:00.000Z",104,18,"Mike Conley",1,7,16,16,9,23.5
"3378",1459,1,0,0,2,0,3,1,2,2,19,0,0,4,0,0,1,1038063,"2024-01-03T00:00:00.000Z",666400,18,"Nickeil Alexander-Walker",0,4,5,5,1,4.5
"3379",1460,0,0,3,0,0,2,0,2,1,14,1,0,1,4,2,0,1038063,"2024-01-03T00:00:00.000Z",12,18,"Kyle Anderson",2,5,5,1,4,11.8
"3380",1461,1,0,0,2,1,2,1,0,0,3,0,0,3,0,0,0,1038063,"2024-01-03T00:00:00.000Z",68,18,"Troy Brown Jr.",0,3,4,4,1,4.5
"3381",1462,0,0,0,0,0,0,0,0,0,0,0,0,0,0,0,0,1038059,"2024-01-03T00:00:00.000Z",4197387,1,"Vit Krejci",0,0,0,0,0,0
"3382",1463,3,0,1,3,2,7,3,6,6,29,3,4,14,4,0,0,1038059,"2024-01-03T00:00:00.000Z",666541,21,"Luguentz Dort",0,18,21,17,7,23.3
"3383",1464,6,0,2,1,1,12,9,5,2,35,1,4,21,3,4,2,1038059,"2024-01-03T00:00:00.000Z",38017703,21,"Jalen Williams",4,24,30,27,9,43.6
"3384",1465,1,0,3,5,2,9,5,0,0,25,0,1,12,3,0,4,1038059,"2024-01-03T00:00:00.000Z",38017685,21,"Chet Holmgren",0,15,16,13,4,13.1
"3385",1466,4,0,1,3,2,7,3,2,1,22,2,1,9,3,1,2,1038059,"2024-01-03T00:00:00.000Z",17896065,21,"Josh Giddey",1,12,16,13,7,19.6
"3386",1467,8,0,12,3,2,24,11,11,9,35,1,2,33,13,0,2,1038059,"2024-01-03T00:00:00.000Z",175,21,"Shai Gilgeous-Alexander",0,46,54,41,21,58.6
"3387",1468,2,0,3,2,1,2,1,0,0,15,0,4,3,3,2,0,1038059,"2024-01-03T00:00:00.000Z",38017706,21,"Jaylin Williams",2,6,8,5,5,15.6
"3388",1469,1,0,0,5,1,8,4,0,0,18,1,2,9,1,1,2,1038059,"2024-01-03T00:00:00.000Z",3547272,21,"Isaiah Joe",1,10,11,10,2,12.7
"3389",1470,2,0,1,7,3,9,5,2,2,20,0,2,15,1,1,0,1038059,"2024-01-03T00:00:00.000Z",56677833,21,"Cason Wallace",1,16,18,17,3,22.2
"3390",1471,1,0,3,6,3,6,3,0,0,20,0,2,9,3,0,1,1038059,"2024-01-03T00:00:00.000Z",27924547,21,"Lindy Waters III",0,12,13,10,4,13.1
"3391",1472,2,0,5,5,0,10,2,3,2,33,0,4,6,5,1,3,1038062,"2024-01-03T00:00:00.000Z",420,15,"Marcus Smart",1,11,13,8,7,15
"3392",1473,0,4,3,8,4,18,7,6,6,37,1,1,24,4,1,3,1038062,"2024-01-03T00:00:00.000Z",231,15,"Jaren Jackson Jr.",5,28,28,24,4,40.8
"3393",1474,2,0,3,0,0,3,2,0,0,23,2,3,4,5,0,0,1038062,"2024-01-03T00:00:00.000Z",3547285,15,"Xavier Tillman",0,9,11,6,7,13
"3394",1475,8,0,2,6,2,18,9,2,2,38,2,4,22,4,0,0,1038062,"2024-01-03T00:00:00.000Z",3547287,15,"Desmond Bane",0,26,34,30,12,38.8
"3395",1476,0,0,0,0,0,0,0,0,0,0,0,0,0,0,0,0,1037599,"2023-10-25T00:00:00.000Z",404,6,"Ricky Rubio",0,0,0,0,0,0
"3396",1477,0,0,0,0,0,0,0,0,0,0,0,0,0,0,0,0,1037599,"2023-10-25T00:00:00.000Z",666940,6,"Dean Wade",0,0,0,0,0,0
"3397",1478,1,0,1,3,1,7,2,0,0,20,1,0,5,2,0,0,1037595,"2023-10-25T00:00:00.000Z",18678001,4,"JT Thor",0,7,8,6,3,8.9
"3398",1479,1,1,3,0,0,2,2,4,3,18,1,3,7,4,0,2,1037595,"2023-10-25T00:00:00.000Z",3547282,4,"Nick Richards",1,11,12,8,5,14.3
"3399",1480,4,0,3,2,0,5,2,0,0,16,0,3,4,3,0,1,1037595,"2023-10-25T00:00:00.000Z",3547253,4,"Theo Maledon",0,7,11,8,7,12.6
"3400",1481,0,0,0,0,0,0,0,0,0,1,0,0,0,0,0,0,1037595,"2023-10-25T00:00:00.000Z",56677846,4,"Nick Smith Jr.",0,0,0,0,0,0
"3401",1482,0,0,0,0,0,0,0,0,0,0,0,0,0,0,0,0,1037595,"2023-10-25T00:00:00.000Z",56677848,4,"Amari Bailey",0,0,0,0,0,0
"3402",1483,0,0,0,0,0,0,0,0,0,0,0,0,0,0,0,0,1037595,"2023-10-25T00:00:00.000Z",56677866,4,"Leaky Black",0,0,0,0,0,0
"3403",1484,0,0,0,0,0,0,0,0,0,0,0,0,0,0,0,0,1037595,"2023-10-25T00:00:00.000Z",17896037,4,"James Bouknight",0,0,0,0,0,0
"3404",1485,0,0,0,0,0,0,0,0,0,0,0,0,0,0,0,0,1037601,"2023-10-25T00:00:00.000Z",56677782,18,"Leonard Miller",0,0,0,0,0,0
"3405",1486,0,0,0,0,0,0,0,0,0,0,0,0,0,0,0,0,1037601,"2023-10-25T00:00:00.000Z",38017715,18,"Josh Minott",0,0,0,0,0,0
"3406",1487,0,0,0,0,0,0,0,0,0,0,0,0,0,0,0,0,1037601,"2023-10-25T00:00:00.000Z",38017700,18,"Wendell Moore Jr.",0,0,0,0,0,0
"3407",1488,0,1,5,8,4,11,6,1,1,35,1,4,17,6,0,3,1037605,"2023-10-25T00:00:00.000Z",666965,7,"Grant Williams",1,23,23,17,6,24.2
"3408",1489,2,1,5,5,2,7,2,0,0,23,2,3,6,7,0,0,1037605,"2023-10-25T00:00:00.000Z",257,7,"Maxi Kleber",1,13,15,8,9,20.4
"3409",1490,1,0,2,2,0,3,1,0,0,14,0,4,2,2,1,0,1037603,"2023-10-25T00:00:00.000Z",38017728,15,"Jake LaRavia",1,4,5,3,3,8.9
"3410",1491,3,0,1,4,2,11,3,0,0,16,1,0,8,2,0,0,1037603,"2023-10-25T00:00:00.000Z",401,15,"Derrick Rose",0,10,13,11,5,14.9
"3411",1492,0,0,0,0,0,0,0,0,0,0,0,0,0,0,0,0,1037603,"2023-10-25T00:00:00.000Z",38017732,15,"Kenneth Lofton Jr.",0,0,0,0,0,0
"3412",1493,0,0,0,0,0,0,0,0,0,0,0,0,0,0,0,0,1037603,"2023-10-25T00:00:00.000Z",666786,15,"Ja Morant",0,0,0,0,0,0
"3413",1494,0,0,0,0,0,0,0,0,0,0,0,0,0,0,0,0,1037603,"2023-10-25T00:00:00.000Z",38017731,15,"Vince Williams Jr.",0,0,0,0,0,0
"3414",1495,0,0,0,0,0,0,0,0,0,0,0,0,0,0,0,0,1037603,"2023-10-25T00:00:00.000Z",3,15,"Steven Adams",0,0,0,0,0,0
"3415",1496,0,0,0,0,0,0,0,0,0,0,0,0,0,0,0,0,1037603,"2023-10-25T00:00:00.000Z",17896067,15,"Santi Aldama",0,0,0,0,0,0
"3416",1497,0,1,0,2,0,3,0,0,0,11,0,1,0,0,0,1,1037603,"2023-10-25T00:00:00.000Z",3547260,19,"Kira Lewis Jr.",1,0,0,0,0,2
"3417",1498,0,0,7,0,0,2,1,0,0,15,1,1,2,8,1,2,1037603,"2023-10-25T00:00:00.000Z",340,19,"Larry Nance Jr.",1,10,10,2,8,12.6
"3418",1499,2,0,0,2,1,2,1,0,0,9,0,2,3,0,0,0,1037603,"2023-10-25T00:00:00.000Z",56677837,19,"Jordan Hawkins",0,3,5,5,2,6
"3419",1500,1,0,1,6,3,6,3,0,0,14,0,2,9,1,0,0,1037603,"2023-10-25T00:00:00.000Z",17896017,19,"Matt Ryan",0,10,11,10,2,11.7
"3420",1501,0,0,2,1,0,2,0,0,0,7,1,1,0,3,0,1,1037731,"2023-11-12T00:00:00.000Z",340,19,"Larry Nance Jr.",0,3,3,0,3,2.6
"3421",1502,1,0,5,5,3,8,4,0,0,26,1,2,11,6,1,1,1037731,"2023-11-12T00:00:00.000Z",17896021,19,"Jeremiah Robinson-Earl",1,17,18,12,7,21.7
"3422",1503,4,0,0,0,0,5,2,1,1,8,1,0,5,1,0,1,1037731,"2023-11-12T00:00:00.000Z",3547260,19,"Kira Lewis Jr.",0,6,10,9,5,11.2
"3423",1504,0,0,0,0,0,0,0,0,0,0,0,0,0,0,0,0,1037729,"2023-11-12T00:00:00.000Z",17896116,5,"Terry Taylor",0,0,0,0,0,0
"3424",1505,0,0,0,0,0,0,0,0,0,0,0,0,0,0,0,0,1037729,"2023-11-12T00:00:00.000Z",27,5,"Lonzo Ball",0,0,0,0,0,0
"3425",1506,0,0,0,0,0,0,0,0,0,0,0,0,0,0,0,0,1037729,"2023-11-12T00:00:00.000Z",56677874,5,"Onuralp Bitim",0,0,0,0,0,0
"3426",1507,0,0,0,0,0,0,0,0,0,0,0,0,0,0,0,0,1037728,"2023-11-12T00:00:00.000Z",56677861,12,"Ben Sheppard",0,0,0,0,0,0
"3427",1508,0,0,0,0,0,0,0,0,0,0,0,0,0,0,0,0,1037728,"2023-11-12T00:00:00.000Z",439,12,"Daniel Theis",0,0,0,0,0,0
"3428",1509,2,1,3,4,1,14,6,6,5,33,2,4,18,5,0,3,1037732,"2023-11-12T00:00:00.000Z",102,27,"Zach Collins",1,23,25,20,7,27
"3429",1510,4,0,5,9,4,12,5,0,0,33,2,0,14,7,0,1,1037732,"2023-11-12T00:00:00.000Z",3547246,27,"Devin Vassell",0,21,25,18,11,27.4
"3430",1511,3,2,4,3,2,9,6,2,2,34,1,4,16,5,0,3,1037732,"2023-11-12T00:00:00.000Z",38017699,27,"Jeremy Sochan",2,21,24,19,8,29.5
"3431",1512,0,1,0,1,1,3,1,0,0,20,1,2,3,1,0,0,1037732,"2023-11-12T00:00:00.000Z",359,27,"Cedi Osman",1,4,4,3,1,7.2
"3432",1513,7,0,1,5,4,7,4,1,1,21,0,2,13,1,0,1,1037732,"2023-11-12T00:00:00.000Z",38017692,27,"Malaki Branham",0,14,21,20,8,23.7
"3433",1514,1,0,2,0,0,2,1,2,1,6,3,2,3,5,1,1,1037732,"2023-11-12T00:00:00.000Z",17895854,27,"Charles Bassey",1,8,9,4,6,12.5
"3434",1515,5,2,3,5,0,15,4,2,2,38,0,4,10,3,0,1,1037729,"2023-11-12T00:00:00.000Z",17896075,9,"Cade Cunningham",2,13,18,15,8,26.1
"3435",1516,3,0,3,3,1,8,3,0,0,25,0,1,7,3,0,0,1037729,"2023-11-12T00:00:00.000Z",3547241,9,"Killian Hayes",0,10,13,10,6,15.1
"3436",1517,4,0,2,6,2,7,3,9,8,21,1,2,16,3,0,0,1037729,"2023-11-12T00:00:00.000Z",77,9,"Alec Burks",0,19,23,20,7,25.6
"3437",1518,0,0,0,0,0,0,0,0,0,0,0,0,0,0,0,0,1037729,"2023-11-12T00:00:00.000Z",38017694,9,"Jalen Duren",0,0,0,0,0,0
"3438",1519,0,0,0,0,0,0,0,0,0,0,0,0,0,0,0,0,1037729,"2023-11-12T00:00:00.000Z",197,9,"Joe Harris",0,0,0,0,0,0
"3439",1520,0,0,0,0,0,0,0,0,0,0,0,0,0,0,0,0,1037729,"2023-11-12T00:00:00.000Z",44477024,9,"Stanley Umude",0,0,0,0,0,0
"3440",1521,0,0,0,0,0,0,0,0,0,0,0,0,0,0,0,0,1037729,"2023-11-12T00:00:00.000Z",54,9,"Bojan Bogdanovic",0,0,0,0,0,0
"3441",1522,0,0,0,0,0,0,0,0,0,0,0,0,0,0,0,0,1037729,"2023-11-12T00:00:00.000Z",56677729,9,"Malcolm Cazalon",0,0,0,0,0,0
"3442",1523,0,0,0,0,0,0,0,0,0,0,0,0,0,0,0,0,1037729,"2023-11-12T00:00:00.000Z",17896071,9,"Isaiah Livers",0,0,0,0,0,0
"3443",1524,0,0,0,0,0,0,0,0,0,0,0,0,0,0,0,0,1037729,"2023-11-12T00:00:00.000Z",330,9,"Monte Morris",0,0,0,0,0,0
"3444",1525,2,0,4,0,0,2,1,2,1,13,1,1,3,5,0,1,1037731,"2023-11-12T00:00:00.000Z",491,19,"Cody Zeller",0,8,10,5,7,11
"3445",1526,5,0,4,1,0,25,13,9,6,34,2,2,32,6,2,5,3277507,"2023-11-24T00:00:00.000Z",666969,19,"Zion Williamson",2,38,43,37,11,47.7
"3446",1527,4,0,6,2,2,6,4,2,2,28,2,4,12,8,1,1,3277507,"2023-11-24T00:00:00.000Z",455,19,"Jonas Valanciunas",1,20,24,16,12,29.6
"3447",1528,4,1,2,4,3,7,5,2,1,24,2,5,14,4,1,3,3277507,"2023-11-24T00:00:00.000Z",17896024,19,"Herbert Jones",2,18,22,18,8,27.8
"3448",1529,5,1,6,2,1,7,3,0,0,36,2,2,7,8,1,1,3277507,"2023-11-24T00:00:00.000Z",38017677,19,"Dyson Daniels",2,15,20,12,13,29.1
"3449",1530,1,0,4,4,2,5,3,0,0,20,0,1,8,4,0,0,3277507,"2023-11-24T00:00:00.000Z",56677837,19,"Jordan Hawkins",0,12,13,9,5,14.3
"3450",1531,1,0,4,2,0,6,1,2,2,16,1,0,4,5,1,1,3277507,"2023-11-24T00:00:00.000Z",17896097,19,"Jose Alvarado",1,9,10,5,6,13.5
"3451",1532,0,0,0,0,0,0,0,0,0,0,0,0,0,0,0,0,3277506,"2023-11-24T00:00:00.000Z",17896070,10,"Usman Garuba",0,0,0,0,0,0
"3452",1533,0,0,0,0,0,0,0,0,0,0,0,0,0,0,0,0,3277506,"2023-11-24T00:00:00.000Z",45658838,10,"Lester Quinones",0,0,0,0,0,0
"3453",1534,0,0,0,0,0,0,0,0,0,0,0,0,0,0,0,0,3277506,"2023-11-24T00:00:00.000Z",398,10,"Jerome Robinson",0,0,0,0,0,0
"3454",1535,4,0,8,7,3,13,8,5,3,34,4,3,22,12,2,3,3277506,"2023-11-24T00:00:00.000Z",666682,27,"Keldon Johnson",2,34,38,26,16,45.4
"3455",1536,6,2,4,3,1,8,3,0,0,32,0,0,7,4,1,0,1037826,"2023-11-25T00:00:00.000Z",383,14,"Taurean Prince",3,11,17,13,10,29.8
"3456",1537,6,2,5,9,1,23,8,7,5,35,1,1,22,6,2,4,1037826,"2023-11-25T00:00:00.000Z",237,14,"LeBron James",4,28,34,28,12,46.2
"3457",1538,3,3,8,0,0,20,13,7,6,38,5,3,32,13,2,5,1037826,"2023-11-25T00:00:00.000Z",117,14,"Anthony Davis",5,45,48,35,16,62.1
"3458",1539,3,0,4,4,2,7,5,0,0,33,1,3,12,5,0,1,1037826,"2023-11-25T00:00:00.000Z",38017697,14,"Max Christie",0,17,20,15,8,21.5
"3459",1540,5,0,5,6,2,12,4,0,0,32,0,3,10,5,2,4,1037826,"2023-11-25T00:00:00.000Z",405,14,"D'Angelo Russell",2,15,20,15,10,25.5
"3460",1541,1,1,3,0,0,5,5,0,0,21,0,3,10,3,0,1,1037826,"2023-11-25T00:00:00.000Z",666626,14,"Jaxson Hayes",1,13,14,11,4,17.1
"3461",1542,0,0,0,0,0,0,0,0,0,0,0,0,0,0,0,0,1037826,"2023-11-25T00:00:00.000Z",56677867,14,"Alex Fudge",0,0,0,0,0,0
"3462",1543,0,0,0,0,0,0,0,0,0,0,0,0,0,0,0,0,1037826,"2023-11-25T00:00:00.000Z",56677868,14,"D'Moi Hodge",0,0,0,0,0,0
"3463",1544,0,0,0,0,0,0,0,0,0,0,0,0,0,0,0,0,1037826,"2023-11-25T00:00:00.000Z",56677835,14,"Jalen Hood-Schifino",0,0,0,0,0,0
"3464",1545,0,0,0,0,0,0,0,0,0,0,0,0,0,0,0,0,1037826,"2023-11-25T00:00:00.000Z",56677836,14,"Maxwell Lewis",0,0,0,0,0,0
"3465",1546,0,0,1,3,1,5,2,1,0,24,1,3,5,2,0,1,1037823,"2023-11-25T00:00:00.000Z",666541,21,"Luguentz Dort",0,7,7,5,2,6.4
"3466",1547,3,0,0,2,0,2,0,0,0,22,2,4,0,2,1,0,3277507,"2023-11-24T00:00:00.000Z",450,13,"PJ Tucker",1,2,5,3,5,9.9
"3467",1548,0,0,0,0,0,0,0,0,0,0,0,0,0,0,0,0,3277507,"2023-11-24T00:00:00.000Z",56677849,13,"Kobe Brown",0,0,0,0,0,0
"3468",1549,0,0,0,0,0,0,0,0,0,0,0,0,0,0,0,0,3277507,"2023-11-24T00:00:00.000Z",666511,13,"Amir Coffey",0,0,0,0,0,0
"3469",1550,0,0,0,0,0,0,0,0,0,0,0,0,0,0,0,0,3277507,"2023-11-24T00:00:00.000Z",38017725,13,"Moussa Diabate",0,0,0,0,0,0
"3470",1551,0,0,0,0,0,0,0,0,0,0,0,0,0,0,0,0,8258317,"2023-12-09T00:00:00.000Z",56677738,14,"Colin Castleton",0,0,0,0,0,0
"3471",1552,0,0,0,0,0,0,0,0,0,0,0,0,0,0,0,0,8258317,"2023-12-09T00:00:00.000Z",56677867,14,"Alex Fudge",0,0,0,0,0,0
"3472",1553,0,0,0,0,0,0,0,0,0,0,0,0,0,0,0,0,8258317,"2023-12-09T00:00:00.000Z",56677868,14,"D'Moi Hodge",0,0,0,0,0,0
"3473",1554,0,0,0,0,0,0,0,0,0,0,0,0,0,0,0,0,8258317,"2023-12-09T00:00:00.000Z",1603383,14,"Gabe Vincent",0,0,0,0,0,0
"3474",1555,4,0,4,9,2,11,3,0,0,32,1,3,8,5,1,2,8258317,"2023-12-09T00:00:00.000Z",210,12,"Buddy Hield",1,13,17,12,9,21
"3475",1556,0,0,1,7,3,11,5,0,0,29,1,5,13,2,0,0,8258317,"2023-12-09T00:00:00.000Z",3547243,12,"Obi Toppin",0,15,15,13,2,15.4
"3476",1557,1,0,6,5,1,11,3,4,3,25,1,6,10,7,1,2,8258317,"2023-12-09T00:00:00.000Z",452,12,"Myles Turner",1,17,18,11,8,20.9
"3477",1558,1,1,2,2,0,9,2,0,0,20,0,2,4,2,2,0,8258317,"2023-12-09T00:00:00.000Z",69,12,"Bruce Brown",3,6,7,5,3,16.9
"3478",1559,11,1,1,8,2,14,8,3,2,35,0,1,20,1,1,3,8258317,"2023-12-09T00:00:00.000Z",3547245,12,"Tyrese Haliburton",2,21,32,31,12,40.7
"3479",1560,0,1,2,5,1,11,5,9,9,30,0,4,20,2,1,0,8258317,"2023-12-09T00:00:00.000Z",38017686,12,"Bennedict Mathurin",2,22,22,20,2,28.4
"3480",1561,0,4,4,0,0,6,2,6,6,19,1,3,10,5,0,1,8258317,"2023-12-09T00:00:00.000Z",17896035,12,"Isaiah Jackson",4,15,15,10,5,27
"3481",1562,1,0,2,5,1,10,4,7,6,27,1,5,15,3,1,1,8258317,"2023-12-09T00:00:00.000Z",3547250,12,"Aaron Nesmith",1,18,19,16,4,22.1
"3482",1563,9,0,1,0,0,11,3,2,2,18,3,4,8,4,3,0,8258317,"2023-12-09T00:00:00.000Z",304,12,"T.J. McConnell",3,12,21,17,13,35.3
"3483",1564,0,0,0,0,0,0,0,0,0,1,0,0,0,0,0,0,8258317,"2023-12-09T00:00:00.000Z",56677832,12,"Jarace Walker",0,0,0,0,0,0
"3484",1565,0,0,0,0,0,1,0,0,0,1,0,0,0,0,0,0,8258317,"2023-12-09T00:00:00.000Z",38017701,12,"Kendall Brown",0,0,0,0,0,0
"3485",1566,0,0,0,0,0,0,0,0,0,1,0,0,0,0,0,0,8258317,"2023-12-09T00:00:00.000Z",56677794,12,"Isaiah Wong",0,0,0,0,0,0
"3486",1567,0,0,0,0,0,0,0,0,0,1,0,0,0,0,0,0,8258317,"2023-12-09T00:00:00.000Z",56677861,12,"Ben Sheppard",0,0,0,0,0,0
"3487",1568,0,0,0,0,0,0,0,2,1,1,1,0,1,1,0,0,8258317,"2023-12-09T00:00:00.000Z",56677778,12,"Oscar Tshiebwe",0,2,2,1,1,2.2
"3488",1569,0,0,0,0,0,0,0,0,0,0,0,0,0,0,0,0,8258317,"2023-12-09T00:00:00.000Z",3547207,12,"Jordan Nwora",0,0,0,0,0,0
"3489",1570,0,0,0,0,0,0,0,0,0,0,0,0,0,0,0,0,8258317,"2023-12-09T00:00:00.000Z",38017507,12,"Andrew Nembhard",0,0,0,0,0,0
"3490",1571,0,0,0,0,0,0,0,0,0,0,0,0,0,0,0,0,8258317,"2023-12-09T00:00:00.000Z",3547264,12,"Jalen Smith",0,0,0,0,0,0
"3491",1572,1,2,2,3,0,5,2,0,0,20,0,0,4,2,1,0,1037887,"2023-12-11T00:00:00.000Z",33,23,"Nicolas Batum",3,6,7,5,3,16.9
"3492",1573,6,0,4,2,1,5,2,6,5,30,0,1,10,4,0,0,1037887,"2023-12-11T00:00:00.000Z",200,23,"Tobias Harris",0,14,20,16,10,23.8
"3493",1574,6,1,10,5,2,20,14,4,4,30,0,4,34,10,2,7,1037887,"2023-12-11T00:00:00.000Z",145,23,"Joel Embiid",3,44,50,40,16,57
"3494",1575,5,0,2,7,1,11,2,0,0,27,1,3,5,3,5,2,1037887,"2023-12-11T00:00:00.000Z",313,23,"De'Anthony Melton",5,8,13,10,8,29.1
"3495",1576,0,0,7,0,0,3,3,2,2,28,3,5,8,10,0,2,1037976,"2023-12-22T00:00:00.000Z",83,1,"Clint Capela",0,18,18,8,10,18
"3496",1577,6,0,7,9,3,20,10,3,1,34,1,0,24,8,3,2,1037976,"2023-12-22T00:00:00.000Z",334,1,"Dejounte Murray",3,32,38,30,14,49.6
"3497",1578,13,0,3,13,7,22,10,3,3,40,0,1,30,3,2,6,1037976,"2023-12-22T00:00:00.000Z",490,1,"Trae Young",2,33,46,43,16,53.1
"3498",1579,1,0,0,1,1,2,1,0,0,12,1,4,3,1,0,1,1037976,"2023-12-22T00:00:00.000Z",319,1,"Patty Mills",0,4,5,4,2,4.7
"3499",1580,5,0,1,18,6,24,8,2,1,35,1,3,23,2,1,0,1037976,"2023-12-22T00:00:00.000Z",53,1,"Bogdan Bogdanovic",1,25,30,28,7,35.9
"3500",1581,0,0,0,0,0,0,0,0,0,0,0,0,0,0,0,0,1037977,"2023-12-22T00:00:00.000Z",47738533,11,"Jeenathan Williams",0,0,0,0,0,0
"3501",1582,1,0,2,1,0,4,1,2,1,22,2,3,3,4,0,1,1037977,"2023-12-22T00:00:00.000Z",247,7,"Derrick Jones Jr.",0,7,8,4,5,8.3
"3502",1583,2,1,4,3,0,5,0,0,0,26,0,2,0,4,2,0,1037977,"2023-12-22T00:00:00.000Z",666965,7,"Grant Williams",3,4,6,2,6,16.8
"3503",1584,0,0,2,4,1,4,1,2,1,12,0,0,4,2,0,0,1037977,"2023-12-22T00:00:00.000Z",329,7,"Markieff Morris",0,6,6,4,2,6.4
"3504",1585,0,1,6,0,0,5,5,2,1,22,5,4,11,11,1,1,1037979,"2023-12-22T00:00:00.000Z",3547095,24,"Udoka Azubuike",2,22,22,11,11,29.2
"3505",1586,0,0,1,1,0,6,1,2,1,14,2,2,3,3,1,1,1037979,"2023-12-22T00:00:00.000Z",18678058,24,"Jordan Goodwin",1,6,6,3,3,8.6
"3506",1587,0,0,3,2,0,6,3,4,4,13,1,1,10,4,0,1,1037979,"2023-12-22T00:00:00.000Z",314,24,"Chimezie Metu",0,14,14,10,4,13.8
"3507",1588,0,0,2,3,0,4,1,0,0,12,0,2,2,2,0,0,1037979,"2023-12-22T00:00:00.000Z",470,24,"Yuta Watanabe",0,4,4,2,2,4.4
"3508",1589,4,1,2,3,0,8,2,2,2,20,1,2,6,3,0,1,1037979,"2023-12-22T00:00:00.000Z",3547298,24,"Saben Lee",1,9,13,10,7,17.6
"3509",1590,0,0,0,3,0,8,3,0,0,16,0,3,6,0,1,1,1037979,"2023-12-22T00:00:00.000Z",666729,24,"Nassir Little",1,6,6,6,0,8
"3510",1591,0,0,0,0,0,2,1,0,0,3,1,0,2,1,0,0,1037979,"2023-12-22T00:00:00.000Z",666451,24,"Bol Bol",0,3,3,2,1,3.2
"3511",1592,0,0,0,0,0,0,0,0,0,0,0,0,0,0,0,0,1037979,"2023-12-22T00:00:00.000Z",32,24,"Keita Bates-Diop",0,0,0,0,0,0
"3512",1593,0,0,0,0,0,0,0,0,0,0,0,0,0,0,0,0,1037979,"2023-12-22T00:00:00.000Z",37,24,"Bradley Beal",0,0,0,0,0,0
"3513",1594,0,0,0,0,0,0,0,0,0,0,0,0,0,0,0,0,1037978,"2023-12-22T00:00:00.000Z",475,10,"Andrew Wiggins",0,0,0,0,0,0
"3514",1595,4,0,2,0,0,5,2,3,3,20,2,1,7,4,1,0,1037978,"2023-12-22T00:00:00.000Z",3547242,30,"Deni Avdija",1,11,15,11,8,20.8
"3515",1596,3,0,9,5,1,11,3,1,0,25,0,2,7,9,0,3,1037978,"2023-12-22T00:00:00.000Z",265,30,"Kyle Kuzma",0,16,19,10,12,19.3
"3516",1597,1,0,3,0,0,7,5,6,5,23,1,1,15,4,1,1,1037978,"2023-12-22T00:00:00.000Z",666577,30,"Daniel Gafford",1,19,20,16,5,23.3
"3517",1598,3,0,2,12,3,21,7,9,8,27,1,3,25,3,2,1,1037978,"2023-12-22T00:00:00.000Z",666848,30,"Jordan Poole",2,28,31,28,6,38.1
"3518",1599,6,0,2,2,2,8,6,0,0,25,1,0,14,3,1,0,1037978,"2023-12-22T00:00:00.000Z",249,30,"Tyus Jones",1,17,23,20,9,29.6
"3519",1600,2,1,3,2,1,8,3,0,0,32,0,1,7,3,1,2,1037978,"2023-12-22T00:00:00.000Z",56677844,30,"Bilal Coulibaly",2,10,12,9,5,17.6
"3520",1601,0,0,0,0,0,0,0,0,0,0,0,0,0,0,0,0,1038070,"2024-01-04T00:00:00.000Z",251,10,"Cory Joseph",0,0,0,0,0,0
"3521",1602,0,0,0,0,0,0,0,0,0,0,0,0,0,0,0,0,1038070,"2024-01-04T00:00:00.000Z",17553992,10,"Moses Moody",0,0,0,0,0,0
"3522",1603,0,0,0,0,0,0,0,0,0,0,0,0,0,0,0,0,1038070,"2024-01-04T00:00:00.000Z",17896070,10,"Usman Garuba",0,0,0,0,0,0
"3523",1604,0,0,0,0,0,0,0,0,0,0,0,0,0,0,0,0,1038070,"2024-01-04T00:00:00.000Z",2189,10,"Gary Payton II",0,0,0,0,0,0
"3524",1605,0,0,0,0,0,0,0,0,0,0,0,0,0,0,0,0,1038070,"2024-01-04T00:00:00.000Z",57875092,10,"Gui Santos",0,0,0,0,0,0
"3525",1606,0,0,4,5,2,6,3,0,0,31,0,3,8,4,0,0,1038070,"2024-01-04T00:00:00.000Z",375,8,"Michael Porter Jr.",0,12,12,8,4,12.8
"3526",1607,2,1,4,4,2,17,11,7,6,35,5,2,30,9,0,0,1038070,"2024-01-04T00:00:00.000Z",177,8,"Aaron Gordon",1,39,41,32,11,46.8
"3527",1608,10,1,7,2,2,16,13,7,6,38,2,2,34,9,2,4,1038070,"2024-01-04T00:00:00.000Z",246,8,"Nikola Jokic",3,43,53,44,19,64.8
"3528",1609,4,1,2,2,0,8,4,0,0,35,1,0,8,3,1,1,1038070,"2024-01-04T00:00:00.000Z",81,8,"Kentavious Caldwell-Pope",2,11,15,12,7,22.6
"3529",1610,6,0,2,6,1,16,8,9,8,32,0,4,25,2,2,0,1038070,"2024-01-04T00:00:00.000Z",335,8,"Jamal Murray",2,27,33,31,8,42.4
"3530",1611,3,0,0,0,0,6,1,0,0,16,0,0,2,0,0,1,1038070,"2024-01-04T00:00:00.000Z",236,8,"Reggie Jackson",0,2,5,5,3,5.5
"3531",1612,1,1,0,2,0,4,1,0,0,19,0,3,2,0,1,1,1038070,"2024-01-04T00:00:00.000Z",38017709,8,"Christian Braun",2,2,3,3,1,8.5
"3532",1613,0,0,0,0,0,0,0,0,0,0,0,0,0,0,0,0,1038070,"2024-01-04T00:00:00.000Z",45658838,10,"Lester Quinones",0,0,0,0,0,0
"3533",1614,0,0,0,0,0,0,0,0,0,0,0,0,0,0,0,0,1038070,"2024-01-04T00:00:00.000Z",398,10,"Jerome Robinson",0,0,0,0,0,0
"3534",1615,0,0,4,4,2,10,6,6,5,19,1,1,19,5,0,0,1038070,"2024-01-04T00:00:00.000Z",38017721,8,"Peyton Watson",0,24,24,19,5,25
"3535",1616,1,0,0,1,0,1,0,0,0,9,1,0,0,1,1,0,1038070,"2024-01-04T00:00:00.000Z",56677776,8,"Julian Strawther",1,1,2,1,2,5.7
"3536",1617,1,0,2,0,0,1,1,0,0,6,1,0,2,3,0,0,1038070,"2024-01-04T00:00:00.000Z",3547268,8,"Zeke Nnaji",0,5,6,3,4,7.1
"3537",1618,0,0,0,0,0,0,0,0,0,0,0,0,0,0,0,0,1038070,"2024-01-04T00:00:00.000Z",38017727,8,"Collin Gillespie",0,0,0,0,0,0
"3538",1619,0,0,0,0,0,0,0,0,0,0,0,0,0,0,0,0,1038070,"2024-01-04T00:00:00.000Z",215,8,"Justin Holiday",0,0,0,0,0,0
"3539",1620,0,0,0,0,0,0,0,0,0,0,0,0,0,0,0,0,1038070,"2024-01-04T00:00:00.000Z",17896103,8,"Jay Huff",0,0,0,0,0,0
"3540",1621,0,0,0,0,0,0,0,0,0,0,0,0,0,0,0,0,1038070,"2024-01-04T00:00:00.000Z",250,8,"DeAndre Jordan",0,0,0,0,0,0
"3541",1622,0,0,0,0,0,0,0,0,0,0,0,0,0,0,0,0,1038070,"2024-01-04T00:00:00.000Z",17896007,8,"Braxton Key",0,0,0,0,0,0
"3542",1623,0,0,0,0,0,0,0,0,0,0,0,0,0,0,0,0,1038070,"2024-01-04T00:00:00.000Z",666489,8,"Vlatko Cancar",0,0,0,0,0,0
"3543",1624,0,0,0,0,0,0,0,0,0,0,0,0,0,0,0,0,1038070,"2024-01-04T00:00:00.000Z",56677582,8,"Jalen Pickett",0,0,0,0,0,0
"3544",1625,0,0,0,0,0,0,0,0,0,0,0,0,0,0,0,0,1038070,"2024-01-04T00:00:00.000Z",56677871,8,"Hunter Tyson",0,0,0,0,0,0
"3545",1626,0,0,0,0,0,0,0,0,0,0,0,0,0,0,0,0,1037632,"2023-10-29T00:00:00.000Z",38017714,26,"Keon Ellis",0,0,0,0,0,0
"3546",1627,0,0,0,0,0,0,0,0,0,0,0,0,0,0,0,0,1037632,"2023-10-29T00:00:00.000Z",56677845,26,"Colby Jones",0,0,0,0,0,0
"3547",1628,0,0,0,0,0,0,0,0,0,0,0,0,0,0,0,0,1037632,"2023-10-29T00:00:00.000Z",273,26,"Alex Len",0,0,0,0,0,0
"3548",1629,1,0,3,1,0,1,0,0,0,7,1,2,0,4,1,1,1037629,"2023-10-29T00:00:00.000Z",56677852,17,"Andre Jackson Jr.",1,4,5,1,5,8.3
"3549",1630,2,0,0,0,0,1,1,0,0,8,0,2,2,0,1,3,1037629,"2023-10-29T00:00:00.000Z",2148,17,"Thanasis Antetokounmpo",1,2,4,4,2,5
"3550",1631,0,0,1,2,2,2,2,1,1,6,0,0,7,1,0,0,1037629,"2023-10-29T00:00:00.000Z",38017733,17,"A.J. Green",0,8,8,7,1,8.2
"3551",1632,0,0,0,0,0,0,0,0,0,0,0,0,0,0,0,0,1037629,"2023-10-29T00:00:00.000Z",56677854,17,"Chris Livingston",0,0,0,0,0,0
"3552",1633,2,0,4,4,2,13,7,5,4,35,1,3,20,5,0,3,1037630,"2023-10-29T00:00:00.000Z",38017690,25,"Shaedon Sharpe",0,25,27,22,7,26
"3553",1634,3,1,1,4,0,7,2,0,0,26,0,5,4,1,0,4,1037630,"2023-10-29T00:00:00.000Z",56677747,25,"Scoot Henderson",1,5,8,7,4,8.7
"3554",1635,1,1,4,3,1,9,4,3,3,24,3,4,12,7,4,2,1037630,"2023-10-29T00:00:00.000Z",38017711,25,"Jabari Walker",5,19,20,13,8,34.9
"3555",1636,0,0,0,0,0,0,0,0,0,0,0,0,0,0,0,0,1037630,"2023-10-29T00:00:00.000Z",47957121,25,"Justin Minaya",0,0,0,0,0,0
"3556",1637,0,0,0,0,0,0,0,0,0,0,0,0,0,0,0,0,1037630,"2023-10-29T00:00:00.000Z",56783340,25,"Duop Reath",0,0,0,0,0,0
"3557",1638,0,0,0,0,0,0,0,0,0,0,0,0,0,0,0,0,1037630,"2023-10-29T00:00:00.000Z",419,25,"Anfernee Simons",0,0,0,0,0,0
"3558",1639,0,0,0,0,0,0,0,0,0,0,0,0,0,0,0,0,1037630,"2023-10-29T00:00:00.000Z",17896120,25,"Ish Wainright",0,0,0,0,0,0
"3559",1640,2,0,0,2,0,3,1,0,0,32,0,4,2,0,1,0,1037632,"2023-10-29T00:00:00.000Z",1603383,14,"Gabe Vincent",1,2,4,4,2,8
"3560",1641,0,0,1,1,0,2,0,0,0,5,0,0,0,1,0,0,1037632,"2023-10-29T00:00:00.000Z",666860,14,"Cameron Reddish",0,1,1,0,1,1.2
"3561",1642,1,0,5,2,2,3,3,3,3,14,0,0,11,5,0,0,1037632,"2023-10-29T00:00:00.000Z",486,14,"Christian Wood",0,16,17,12,6,18.5
"3562",1643,0,0,0,0,0,0,0,0,0,0,0,0,0,0,0,0,1037632,"2023-10-29T00:00:00.000Z",56677738,14,"Colin Castleton",0,0,0,0,0,0
"3563",1644,0,0,0,0,0,0,0,0,0,0,0,0,0,0,0,0,1037632,"2023-10-29T00:00:00.000Z",56677867,14,"Alex Fudge",0,0,0,0,0,0
"3564",1645,0,0,0,0,0,0,0,0,0,0,0,0,0,0,0,0,1037632,"2023-10-29T00:00:00.000Z",56677868,14,"D'Moi Hodge",0,0,0,0,0,0
"3565",1646,0,0,0,0,0,0,0,0,0,0,0,0,0,0,0,0,1037632,"2023-10-29T00:00:00.000Z",56677835,14,"Jalen Hood-Schifino",0,0,0,0,0,0
"3566",1647,0,0,0,0,0,0,0,0,0,0,0,0,0,0,0,0,1037632,"2023-10-29T00:00:00.000Z",457,14,"Jarred Vanderbilt",0,0,0,0,0,0
"3567",1648,3,1,2,1,0,1,0,0,0,26,1,1,0,3,1,0,1037631,"2023-10-29T00:00:00.000Z",108,13,"Robert Covington",2,3,6,3,6,14.1
"3568",1649,4,0,3,7,3,13,6,7,6,28,0,2,21,3,2,3,1037631,"2023-10-29T00:00:00.000Z",274,13,"Kawhi Leonard",2,24,28,25,7,33.6
"3569",1650,0,1,6,0,0,7,6,6,4,22,2,4,16,8,0,1,1037631,"2023-10-29T00:00:00.000Z",493,13,"Ivica Zubac",1,24,24,16,8,27.6
"3570",1651,0,0,0,1,0,2,0,0,0,4,0,1,0,0,0,0,1037754,"2023-11-15T00:00:00.000Z",56677857,5,"Julian Phillips",0,0,0,0,0,0
"3571",1652,0,0,0,0,0,0,0,0,0,0,0,0,0,0,0,0,1037752,"2023-11-15T00:00:00.000Z",3547279,2,"Lamar Stevens",0,0,0,0,0,0
"3572",1653,0,0,0,0,0,0,0,0,0,0,0,0,0,0,0,0,1037752,"2023-11-15T00:00:00.000Z",70,2,"Jaylen Brown",0,0,0,0,0,0
"3573",1654,0,0,0,0,0,0,0,0,0,0,0,0,0,0,0,0,1037752,"2023-11-15T00:00:00.000Z",38017707,2,"JD Davison",0,0,0,0,0,0
"3574",1655,0,0,0,0,0,0,0,0,0,0,0,0,0,0,0,0,1037752,"2023-11-15T00:00:00.000Z",3547295,2,"Nathan Knight",0,0,0,0,0,0
"3575",1656,0,0,0,0,0,0,0,0,0,0,0,0,0,0,0,0,1037752,"2023-11-15T00:00:00.000Z",378,2,"Kristaps Porzingis",0,0,0,0,0,0
"3576",1657,0,0,0,0,0,0,0,0,0,0,0,0,0,0,0,0,1037752,"2023-11-15T00:00:00.000Z",56677864,2,"Jordan Walsh",0,0,0,0,0,0
"3577",1658,0,0,0,0,0,0,0,0,0,0,0,0,0,0,0,0,1037754,"2023-11-15T00:00:00.000Z",27,5,"Lonzo Ball",0,0,0,0,0,0
"3578",1659,0,0,0,0,0,0,0,0,0,0,0,0,0,0,0,0,1037754,"2023-11-15T00:00:00.000Z",125,5,"DeMar DeRozan",0,0,0,0,0,0
"3579",1660,0,0,0,0,0,0,0,0,0,0,0,0,0,0,0,0,1037754,"2023-11-15T00:00:00.000Z",45969255,5,"Justin Lewis",0,0,0,0,0,0
"3580",1661,0,0,0,0,0,0,0,0,0,0,0,0,0,0,0,0,1037754,"2023-11-15T00:00:00.000Z",56677860,5,"Adama Sanogo",0,0,0,0,0,0
"3581",1662,0,0,0,0,0,0,0,0,0,0,0,0,0,0,0,0,1037754,"2023-11-15T00:00:00.000Z",38017719,5,"Dalen Terry",0,0,0,0,0,0
"3582",1663,3,0,2,4,0,16,5,3,3,30,0,0,13,2,0,1,1037754,"2023-11-15T00:00:00.000Z",17896026,22,"Franz Wagner",0,15,18,16,5,18.9
"3583",1664,3,0,8,4,2,12,4,10,7,33,1,0,17,9,1,1,1037754,"2023-11-15T00:00:00.000Z",38017683,22,"Paolo Banchero",1,26,29,20,12,34.3
"3584",1665,2,0,5,0,0,10,6,4,3,26,6,5,15,11,2,0,1037754,"2023-11-15T00:00:00.000Z",666442,22,"Goga Bitadze",2,26,28,17,13,37.2
"3585",1666,5,0,2,7,2,8,2,4,4,26,0,4,10,2,3,4,1037754,"2023-11-15T00:00:00.000Z",17896073,22,"Jalen Suggs",3,12,17,15,7,24.9
"3586",1667,2,0,2,2,0,8,3,2,1,27,2,3,7,4,0,2,1037754,"2023-11-15T00:00:00.000Z",56677827,22,"Anthony Black",0,11,13,9,6,12.8
"3587",1668,1,0,2,3,1,3,1,0,0,18,0,1,3,2,0,0,1037754,"2023-11-15T00:00:00.000Z",226,22,"Joe Ingles",0,5,6,4,3,6.9
"3588",1669,0,0,0,0,0,0,0,0,0,0,0,0,0,0,0,0,1037752,"2023-11-15T00:00:00.000Z",56677788,23,"Terquavion Smith",0,0,0,0,0,0
"3589",1670,2,1,1,8,2,9,3,0,0,35,1,2,8,2,0,0,1037752,"2023-11-15T00:00:00.000Z",17896060,2,"Sam Hauser",1,10,12,10,4,16.4
"3590",1671,6,0,6,10,4,23,10,6,5,39,2,1,29,8,2,3,1037752,"2023-11-15T00:00:00.000Z",434,2,"Jayson Tatum",2,37,43,35,14,50.6
"3591",1672,3,5,7,8,4,9,5,0,0,29,1,2,14,8,0,0,1037752,"2023-11-15T00:00:00.000Z",219,2,"Al Horford",5,22,25,17,11,43.1
"3592",1673,5,0,3,8,4,12,7,10,9,36,0,3,27,3,1,2,1037752,"2023-11-15T00:00:00.000Z",473,2,"Derrick White",1,30,35,32,8,39.1
"3593",1674,3,2,8,9,2,18,8,1,0,36,2,0,18,10,1,1,1037752,"2023-11-15T00:00:00.000Z",214,2,"Jrue Holiday",3,28,31,21,13,42.5
"3594",1675,3,0,1,3,1,5,2,0,0,23,1,0,5,2,0,0,1037752,"2023-11-15T00:00:00.000Z",3547276,2,"Payton Pritchard",0,7,10,8,5,11.9
"3595",1676,0,0,0,0,0,0,0,0,0,1,0,0,0,0,1,0,1037856,"2023-11-29T00:00:00.000Z",17896031,13,"Nah'Shon Hyland",1,0,0,0,0,3
"3596",1677,0,0,0,0,0,0,0,0,0,1,0,0,0,0,0,0,1037856,"2023-11-29T00:00:00.000Z",666511,13,"Amir Coffey",0,0,0,0,0,0
"3597",1678,0,0,0,0,0,0,0,0,0,0,0,0,0,0,0,0,1037856,"2023-11-29T00:00:00.000Z",450,13,"PJ Tucker",0,0,0,0,0,0
"3598",1679,0,0,0,0,0,0,0,0,0,0,0,0,0,0,0,0,1037856,"2023-11-29T00:00:00.000Z",17896022,13,"Brandon Boston Jr.",0,0,0,0,0,0
"3599",1680,0,0,0,0,0,0,0,0,0,0,0,0,0,0,0,0,1037856,"2023-11-29T00:00:00.000Z",38017725,13,"Moussa Diabate",0,0,0,0,0,0
"3600",1681,0,0,0,0,0,0,0,0,0,0,0,0,0,0,0,0,1037856,"2023-11-29T00:00:00.000Z",56677856,13,"Jordan Miller",0,0,0,0,0,0
"3601",1682,0,0,0,0,0,0,0,0,0,0,0,0,0,0,0,0,1037856,"2023-11-29T00:00:00.000Z",24417679,13,"Xavier Moon",0,0,0,0,0,0
"3602",1683,0,0,0,0,0,0,0,0,0,0,0,0,0,0,0,0,1037856,"2023-11-29T00:00:00.000Z",371,13,"Mason Plumlee",0,0,0,0,0,0
"3603",1684,0,0,0,0,0,0,0,0,0,0,0,0,0,0,0,0,1037856,"2023-11-29T00:00:00.000Z",17896051,13,"Joshua Primo",0,0,0,0,0,0
"3604",1685,3,0,3,6,1,11,4,0,0,36,0,6,9,3,2,2,1037857,"2023-11-30T00:00:00.000Z",666908,6,"Max Strus",2,12,15,12,6,21.1
"3605",1686,3,0,6,1,0,14,9,2,2,34,2,1,20,8,2,3,1037857,"2023-11-30T00:00:00.000Z",17896076,6,"Evan Mobley",2,28,31,23,11,37.1
"3606",1687,2,2,4,0,0,9,6,0,0,38,6,3,12,10,0,1,1037857,"2023-11-30T00:00:00.000Z",9,6,"Jarrett Allen",2,22,24,14,12,32
"3607",1688,6,0,4,9,1,20,7,8,8,33,3,1,23,7,4,1,1037857,"2023-11-30T00:00:00.000Z",322,6,"Donovan Mitchell",4,30,36,29,13,51.4
"3608",1689,7,0,3,8,2,18,6,1,1,37,1,0,15,4,1,8,1037857,"2023-11-30T00:00:00.000Z",666581,6,"Darius Garland",1,19,26,22,11,25.3
"3609",1690,2,0,1,4,1,9,2,0,0,26,1,3,5,2,0,2,1037857,"2023-11-30T00:00:00.000Z",277,6,"Caris LeVert",0,7,9,7,4,8.4
"3610",1691,2,0,0,3,1,6,3,1,1,19,1,0,8,1,2,0,1037857,"2023-11-30T00:00:00.000Z",344,6,"Georges Niang",2,9,11,10,3,18.2
"3611",1692,0,0,0,1,1,2,1,0,0,17,0,1,3,0,1,0,1037857,"2023-11-30T00:00:00.000Z",3547247,6,"Isaac Okoro",1,3,3,3,0,6
"3612",1693,0,0,0,0,0,0,0,0,0,0,0,0,0,0,0,0,1037857,"2023-11-30T00:00:00.000Z",248,6,"Damian Jones",0,0,0,0,0,0
"3613",1694,0,0,0,0,0,0,0,0,0,0,0,0,0,0,0,0,1037857,"2023-11-30T00:00:00.000Z",3547299,6,"Sam Merrill",0,0,0,0,0,0
"3614",1695,0,0,0,0,0,0,0,0,0,0,0,0,0,0,0,0,1037857,"2023-11-30T00:00:00.000Z",56677872,6,"Craig Porter",0,0,0,0,0,0
"3615",1696,0,0,0,0,0,0,0,0,0,0,0,0,0,0,0,0,1037857,"2023-11-30T00:00:00.000Z",444,6,"Tristan Thompson",0,0,0,0,0,0
"3616",1697,0,0,0,0,0,0,0,0,0,0,0,0,0,0,0,0,1037857,"2023-11-30T00:00:00.000Z",56677847,6,"Emoni Bates",0,0,0,0,0,0
"3617",1698,0,0,0,0,0,0,0,0,0,0,0,0,0,0,0,0,1037857,"2023-11-30T00:00:00.000Z",666676,6,"Ty Jerome",0,0,0,0,0,0
"3618",1699,0,0,0,0,0,0,0,0,0,0,0,0,0,0,0,0,1037857,"2023-11-30T00:00:00.000Z",38017662,6,"Isaiah Mobley",0,0,0,0,0,0
"3619",1700,0,0,0,0,0,0,0,0,0,0,0,0,0,0,0,0,1037857,"2023-11-30T00:00:00.000Z",404,6,"Ricky Rubio",0,0,0,0,0,0
"3620",1701,2,0,2,0,0,8,6,8,5,37,2,4,17,4,2,2,1037929,"2023-12-16T00:00:00.000Z",666747,16,"Caleb Martin",2,21,23,19,6,28.8
"3621",1702,1,0,1,2,0,4,1,0,0,11,1,2,2,2,0,0,1037929,"2023-12-16T00:00:00.000Z",39398582,16,"Orlando Robinson",0,4,5,3,3,5.9
"3622",1703,6,0,1,9,3,9,3,0,0,24,0,0,9,1,0,2,1037929,"2023-12-16T00:00:00.000Z",397,16,"Duncan Robinson",0,10,16,15,7,17.2
"3623",1704,7,1,3,3,1,7,3,4,3,32,0,2,10,3,0,0,1037929,"2023-12-16T00:00:00.000Z",286,16,"Kyle Lowry",1,13,20,17,10,27.1
"3624",1705,4,0,4,3,1,14,8,1,1,35,1,1,18,5,2,2,1037929,"2023-12-16T00:00:00.000Z",56677785,16,"Jaime Jaquez Jr.",2,23,27,22,9,34
"3625",1706,1,0,6,10,6,12,8,0,0,26,1,2,22,7,1,1,1037929,"2023-12-16T00:00:00.000Z",285,16,"Kevin Love",1,29,30,23,8,33.9
"3626",1707,0,0,0,0,0,0,0,0,0,0,0,0,0,0,0,0,1037927,"2023-12-16T00:00:00.000Z",3547239,4,"LaMelo Ball",0,0,0,0,0,0
"3627",1708,0,0,0,0,0,0,0,0,0,0,0,0,0,0,0,0,1037927,"2023-12-16T00:00:00.000Z",204,4,"Gordon Hayward",0,0,0,0,0,0
"3628",1709,0,0,0,0,0,0,0,0,0,0,0,0,0,0,0,0,1037927,"2023-12-16T00:00:00.000Z",666748,4,"Cody Martin",0,0,0,0,0,0
"3629",1710,0,0,0,0,0,0,0,0,0,0,0,0,0,0,0,0,1037927,"2023-12-16T00:00:00.000Z",347,4,"Frank Ntilikina",0,0,0,0,0,0
"3630",1711,0,0,0,0,0,0,0,0,0,0,0,0,0,0,0,0,1037927,"2023-12-16T00:00:00.000Z",666950,4,"P.J. Washington",0,0,0,0,0,0
"3631",1712,0,0,0,0,0,0,0,0,0,0,0,0,0,0,0,0,1037927,"2023-12-16T00:00:00.000Z",56913527,23,"Ricky Council IV",0,0,0,0,0,0
"3632",1713,0,0,0,0,0,0,0,0,0,0,0,0,0,0,0,0,1037927,"2023-12-16T00:00:00.000Z",17554001,23,"Javonte Smart",0,0,0,0,0,0
"3633",1714,0,0,0,0,0,0,0,0,0,0,0,0,0,0,0,0,1037927,"2023-12-16T00:00:00.000Z",56677788,23,"Terquavion Smith",0,0,0,0,0,0
"3634",1715,10,1,4,12,7,21,11,6,6,38,0,3,35,4,0,5,1037928,"2023-12-16T00:00:00.000Z",490,1,"Trae Young",1,39,49,45,14,52.8
"3635",1716,0,0,2,0,0,2,0,0,0,7,1,0,0,3,1,1,1037928,"2023-12-16T00:00:00.000Z",3547297,1,"Trent Forrest",1,3,3,0,3,5.6
"3636",1717,2,0,2,3,1,4,1,0,0,13,0,2,3,2,0,1,1037928,"2023-12-16T00:00:00.000Z",319,1,"Patty Mills",0,5,7,5,4,7.4
"3637",1718,0,0,0,2,2,2,2,0,0,14,0,4,6,0,0,1,1037928,"2023-12-16T00:00:00.000Z",666754,1,"Garrison Mathews",0,6,6,6,0,5
"3638",1719,1,1,6,0,0,7,5,5,3,16,2,2,13,8,0,0,1037928,"2023-12-16T00:00:00.000Z",666564,1,"Bruno Fernando",1,21,22,14,9,27.1
"3639",1720,1,0,2,1,0,2,1,0,0,21,0,3,2,2,0,0,1037928,"2023-12-16T00:00:00.000Z",301,1,"Wesley Matthews",0,4,5,3,3,5.9
"3640",1721,0,0,0,0,0,0,0,0,0,0,0,0,0,0,0,0,1037928,"2023-12-16T00:00:00.000Z",53,1,"Bogdan Bogdanovic",0,0,0,0,0,0
"3641",1722,0,0,0,0,0,0,0,0,0,0,0,0,0,0,0,0,1037928,"2023-12-16T00:00:00.000Z",56677855,1,"Seth Lundy",0,0,0,0,0,0
"3642",1723,0,0,0,0,0,0,0,0,0,0,0,0,0,0,0,0,1037928,"2023-12-16T00:00:00.000Z",56677838,1,"Kobe Bufkin",0,0,0,0,0,0
"3643",1724,0,0,0,0,0,0,0,0,0,0,0,0,0,0,0,0,1037928,"2023-12-16T00:00:00.000Z",83,1,"Clint Capela",0,0,0,0,0,0
"3644",1725,5,0,6,10,4,15,7,4,4,39,1,3,22,7,1,1,1037929,"2023-12-16T00:00:00.000Z",666956,5,"Coby White",1,29,34,27,12,39.9
"3645",1726,0,0,0,0,0,0,0,0,0,0,0,0,0,0,0,0,1038036,"2023-12-30T00:00:00.000Z",185,10,"Draymond Green",0,0,0,0,0,0
"3646",1727,0,0,0,0,0,0,0,0,0,0,0,0,0,0,0,0,1038036,"2023-12-30T00:00:00.000Z",251,10,"Cory Joseph",0,0,0,0,0,0
"3647",1728,0,0,0,0,0,0,0,0,0,0,0,0,0,0,0,0,1038036,"2023-12-30T00:00:00.000Z",17553992,10,"Moses Moody",0,0,0,0,0,0
"3648",1729,0,0,0,0,0,0,0,0,0,0,0,0,0,0,0,0,1038036,"2023-12-30T00:00:00.000Z",45658838,10,"Lester Quinones",0,0,0,0,0,0
"3649",1730,3,2,2,2,0,4,1,2,2,24,0,4,4,2,1,1,1038034,"2023-12-30T00:00:00.000Z",45,23,"Patrick Beverley",3,6,9,7,5,18.9
"3650",1731,2,0,3,5,3,6,3,0,0,19,0,1,9,3,0,1,1038034,"2023-12-30T00:00:00.000Z",33,23,"Nicolas Batum",0,12,14,11,5,14.6
"3651",1732,1,0,2,2,0,5,2,0,0,17,0,3,4,2,0,1,1038034,"2023-12-30T00:00:00.000Z",328,23,"Marcus Morris",0,6,7,5,3,6.9
"3652",1733,2,0,3,0,0,3,2,1,1,13,2,0,5,5,0,1,1038034,"2023-12-30T00:00:00.000Z",28,23,"Mo Bamba",0,10,12,7,7,13
"3653",1734,0,0,1,1,0,1,0,0,0,5,0,0,0,1,0,0,1038034,"2023-12-30T00:00:00.000Z",108,23,"Robert Covington",0,1,1,0,1,1.2
"3654",1735,0,0,1,1,0,2,1,0,0,8,0,0,2,1,0,0,1038034,"2023-12-30T00:00:00.000Z",3547294,23,"Kenyon Martin Jr.",0,3,3,2,1,3.2
"3655",1736,0,0,0,0,0,1,1,0,0,2,0,0,2,0,0,0,1038034,"2023-12-30T00:00:00.000Z",260,23,"Furkan Korkmaz",0,2,2,2,0,2
"3656",1737,0,0,0,0,0,0,0,0,0,0,0,0,0,0,0,0,1038034,"2023-12-30T00:00:00.000Z",2175,23,"Danuel House Jr.",0,0,0,0,0,0
"3657",1738,0,0,0,0,0,0,0,0,0,0,0,0,0,0,0,0,1038034,"2023-12-30T00:00:00.000Z",56913527,23,"Ricky Council IV",0,0,0,0,0,0
"3658",1739,0,0,0,0,0,0,0,0,0,0,0,0,0,0,0,0,1038034,"2023-12-30T00:00:00.000Z",145,23,"Joel Embiid",0,0,0,0,0,0
"3659",1740,0,0,0,0,0,0,0,0,0,0,0,0,0,0,0,0,1038034,"2023-12-30T00:00:00.000Z",38017732,23,"Kenneth Lofton Jr.",0,0,0,0,0,0
"3660",1741,0,0,0,0,0,0,0,0,0,0,0,0,0,0,0,0,1038034,"2023-12-30T00:00:00.000Z",56677788,23,"Terquavion Smith",0,0,0,0,0,0
"3661",1742,0,0,0,0,0,0,0,0,0,0,0,0,0,0,0,0,1038034,"2023-12-30T00:00:00.000Z",17896025,23,"Jaden Springer",0,0,0,0,0,0
"3662",1743,4,1,2,3,1,13,5,3,3,28,3,2,14,5,1,0,1038036,"2023-12-30T00:00:00.000Z",475,10,"Andrew Wiggins",2,19,23,18,9,32
"3663",1744,0,0,4,2,1,4,2,0,0,31,0,2,5,4,0,2,1038021,"2023-12-29T00:00:00.000Z",202,20,"Josh Hart",0,9,9,5,4,7.8
"3664",1745,1,0,1,7,3,10,4,1,1,28,0,4,12,1,0,1,1038021,"2023-12-29T00:00:00.000Z",3547269,20,"Immanuel Quickley",0,13,14,13,2,13.7
"3665",1746,0,0,2,3,1,3,1,0,0,14,0,1,3,2,1,0,1038021,"2023-12-29T00:00:00.000Z",17895858,20,"Quentin Grimes",1,5,5,3,2,8.4
"3666",1747,0,1,4,0,0,1,1,0,0,15,0,4,2,4,0,0,1038021,"2023-12-29T00:00:00.000Z",173,20,"Taj Gibson",1,6,6,2,4,9.8
"3667",1748,0,0,0,0,0,0,0,0,0,0,0,0,0,0,0,0,1038021,"2023-12-29T00:00:00.000Z",19,20,"Ryan Arcidiacono",0,0,0,0,0,0
"3668",1749,0,0,0,0,0,0,0,0,0,0,0,0,0,0,0,0,1038021,"2023-12-29T00:00:00.000Z",160,20,"Evan Fournier",0,0,0,0,0,0
"3669",1750,0,0,0,0,0,0,0,0,0,0,0,0,0,0,0,0,1038021,"2023-12-29T00:00:00.000Z",666675,20,"DaQuan Jeffries",0,0,0,0,0,0
"3670",1751,2,0,6,6,4,11,7,5,4,29,3,2,22,9,1,3,1038132,"2024-01-12T00:00:00.000Z",297,29,"Lauri Markkanen",1,31,33,24,11,35.8
"3671",1752,1,0,6,1,0,3,2,0,0,14,1,4,4,7,0,1,1038132,"2024-01-12T00:00:00.000Z",101,29,"John Collins",0,11,12,5,8,12.9
"3672",1753,5,0,2,3,3,10,5,8,7,20,0,0,20,2,2,2,1038132,"2024-01-12T00:00:00.000Z",413,29,"Collin Sexton",2,22,27,25,7,33.9
"3673",1754,5,2,3,1,0,4,3,0,0,17,2,3,6,5,1,2,1038132,"2024-01-12T00:00:00.000Z",139,29,"Kris Dunn",3,11,16,11,10,26.5
"3674",1755,1,3,4,0,0,5,5,4,2,20,2,4,12,6,1,0,1038132,"2024-01-12T00:00:00.000Z",38017705,29,"Walker Kessler",4,18,19,13,7,32.7
"3675",1756,5,0,1,9,5,16,8,0,0,31,0,1,21,1,0,0,1038132,"2024-01-12T00:00:00.000Z",100,29,"Jordan Clarkson",0,22,27,26,6,29.7
"3676",1757,6,0,3,5,0,10,3,3,3,24,0,0,9,3,0,3,1038132,"2024-01-12T00:00:00.000Z",56677834,29,"Keyonte George",0,12,18,15,9,18.6
"3677",1758,1,2,4,7,2,8,3,0,0,22,1,1,8,5,0,0,1038132,"2024-01-12T00:00:00.000Z",38017620,29,"Ochai Agbaji",2,13,14,9,6,21.5
"3678",1759,5,0,8,2,1,7,4,4,2,21,2,3,11,10,1,1,1038132,"2024-01-12T00:00:00.000Z",358,29,"Kelly Olynyk",1,21,26,16,15,32.5
"3679",1760,0,0,1,0,0,2,1,2,2,6,0,2,4,1,0,1,1038132,"2024-01-12T00:00:00.000Z",666881,29,"Luka Samanic",0,5,5,4,1,4.2
"3680",1761,0,0,2,0,0,2,2,0,0,5,2,1,4,4,0,0,1038132,"2024-01-12T00:00:00.000Z",11891374,29,"Omer Yurtseven",0,8,8,4,4,8.8
"3681",1762,1,0,1,2,2,2,2,0,0,4,0,1,6,1,1,0,1038132,"2024-01-12T00:00:00.000Z",56677824,29,"Taylor Hendricks",1,7,8,7,2,11.7
"3682",1763,2,0,0,2,1,4,2,0,0,4,0,1,5,0,0,0,1038132,"2024-01-12T00:00:00.000Z",56677842,29,"Brice Sensabaugh",0,5,7,7,2,8
"3683",1764,0,0,0,0,0,0,0,0,0,0,0,0,0,0,0,0,1038132,"2024-01-12T00:00:00.000Z",666650,29,"Talen Horton-Tucker",0,0,0,0,0,0
"3684",1765,0,0,0,0,0,0,0,0,0,0,0,0,0,0,0,0,1038132,"2024-01-12T00:00:00.000Z",38017630,29,"Johnny Juzang",0,0,0,0,0,0
"3685",1766,0,0,0,0,0,0,0,0,0,0,0,0,0,0,0,0,1038132,"2024-01-12T00:00:00.000Z",19465584,29,"Micah Potter",0,0,0,0,0,0
"3686",1767,0,0,0,0,0,0,0,0,0,0,0,0,0,0,0,0,1038132,"2024-01-12T00:00:00.000Z",17896042,29,"Jason Preston",0,0,0,0,0,0
"3687",1768,2,3,7,2,0,9,2,0,0,30,0,4,4,7,1,2,1038132,"2024-01-12T00:00:00.000Z",666423,28,"RJ Barrett",4,11,13,6,9,25.4
"3688",1769,2,0,4,6,5,14,8,8,6,30,0,1,27,4,0,2,1038132,"2024-01-12T00:00:00.000Z",416,28,"Pascal Siakam",0,31,33,29,6,32.8
"3689",1770,2,0,2,0,0,1,0,0,0,12,0,5,0,2,0,0,1038132,"2024-01-12T00:00:00.000Z",489,28,"Thaddeus Young",0,2,4,2,4,5.4
"3690",1771,3,3,2,4,2,13,6,11,5,28,1,3,19,3,0,3,1038132,"2024-01-12T00:00:00.000Z",17896055,28,"Scottie Barnes",3,22,25,22,6,33.1
"3691",1772,0,0,2,3,3,8,4,4,4,25,1,1,15,3,0,1,1038132,"2024-01-12T00:00:00.000Z",3547269,28,"Immanuel Quickley",0,18,18,15,3,17.6
"3692",1773,6,2,4,4,1,8,3,2,2,31,2,1,9,6,2,0,1038132,"2024-01-12T00:00:00.000Z",2309958,28,"Jontay Porter",4,15,21,15,12,37.2
"3693",1774,2,0,0,2,1,6,2,0,0,22,1,1,5,1,0,1,1038132,"2024-01-12T00:00:00.000Z",3089,28,"Gary Trent Jr.",0,6,8,7,3,8.2
"3694",1775,4,0,0,7,4,9,4,0,0,23,0,2,12,0,1,1,1038132,"2024-01-12T00:00:00.000Z",409,28,"Dennis Schroder",1,12,16,16,4,20
"3695",1776,7,0,1,7,3,10,5,2,2,33,0,4,15,1,1,2,1037695,"2023-11-06T00:00:00.000Z",81,8,"Kentavious Caldwell-Pope",1,16,23,22,8,27.7
"3696",1777,0,3,3,0,0,3,3,4,2,30,4,3,8,7,1,5,1037690,"2023-11-06T00:00:00.000Z",493,13,"Ivica Zubac",4,15,15,8,7,23.4
"3697",1778,6,0,3,4,2,9,6,3,3,31,0,2,17,3,1,2,1037690,"2023-11-06T00:00:00.000Z",192,13,"James Harden",1,20,26,23,9,30.6
"3698",1779,4,0,4,3,1,13,8,0,0,31,0,2,17,4,0,4,1037690,"2023-11-06T00:00:00.000Z",472,13,"Russell Westbrook",0,21,25,21,8,23.8
"3699",1780,4,0,1,4,1,9,2,0,0,22,0,2,5,1,1,3,1037690,"2023-11-06T00:00:00.000Z",17896031,13,"Nah'Shon Hyland",1,6,10,9,5,12.2
"3700",1781,1,0,2,0,0,1,1,0,0,11,0,0,2,2,1,1,1037690,"2023-11-06T00:00:00.000Z",371,13,"Mason Plumlee",1,4,5,3,3,7.9
"3701",1782,0,1,1,6,4,7,5,0,0,22,0,1,14,1,0,3,1037690,"2023-11-06T00:00:00.000Z",380,13,"Norman Powell",1,15,15,14,1,15.2
"3702",1783,0,0,0,0,0,1,1,2,2,6,0,0,4,0,0,0,1037690,"2023-11-06T00:00:00.000Z",38017725,13,"Moussa Diabate",0,4,4,4,0,4
"3703",1784,0,0,0,0,0,0,0,0,0,5,0,0,0,0,0,0,1037690,"2023-11-06T00:00:00.000Z",666511,13,"Amir Coffey",0,0,0,0,0,0
"3704",1785,0,0,0,1,0,1,0,0,0,5,0,0,0,0,0,0,1037690,"2023-11-06T00:00:00.000Z",56677849,13,"Kobe Brown",0,0,0,0,0,0
"3705",1786,0,0,0,0,0,0,0,0,0,0,0,0,0,0,0,0,1037691,"2023-11-06T00:00:00.000Z",38017630,29,"Johnny Juzang",0,0,0,0,0,0
"3706",1787,1,0,1,9,4,18,8,0,0,45,1,3,20,2,1,3,1037693,"2023-11-06T00:00:00.000Z",3547259,18,"Jaden McDaniels",1,22,23,21,3,23.9
"3707",1788,3,0,10,7,1,10,3,0,0,28,0,6,7,10,0,7,1037693,"2023-11-06T00:00:00.000Z",447,18,"Karl-Anthony Towns",0,17,20,10,13,16.5
"3708",1789,1,1,10,0,0,6,6,11,2,41,2,4,14,12,0,2,1037693,"2023-11-06T00:00:00.000Z",176,18,"Rudy Gobert",1,26,27,15,13,30.9
"3709",1790,7,0,9,8,2,25,15,7,6,38,0,5,38,9,1,3,1037693,"2023-11-06T00:00:00.000Z",3547238,18,"Anthony Edwards",1,47,54,45,16,59.3
"3710",1791,3,0,2,3,2,5,3,0,0,36,0,1,8,2,2,0,1037693,"2023-11-06T00:00:00.000Z",104,18,"Mike Conley",2,10,13,11,5,20.9
"3711",1792,3,0,1,4,2,6,3,1,0,20,0,3,8,1,1,1,1037693,"2023-11-06T00:00:00.000Z",666400,18,"Nickeil Alexander-Walker",1,9,12,11,4,15.7
"3712",1793,1,0,6,3,1,6,3,2,2,28,0,1,9,6,0,1,1037692,"2023-11-06T00:00:00.000Z",66,11,"Dillon Brooks",0,15,16,10,7,16.7
"3713",1794,0,1,4,5,3,8,5,0,0,22,0,4,13,4,0,0,1037692,"2023-11-06T00:00:00.000Z",38017684,11,"Jabari Smith Jr.",1,17,17,13,4,20.8
"3714",1795,12,0,6,2,0,13,7,4,3,26,2,3,17,8,1,1,1037692,"2023-11-06T00:00:00.000Z",17896062,11,"Alperen Sengun",1,25,37,29,20,46.6
"3715",1796,2,1,2,5,3,9,5,12,10,26,0,0,23,2,1,3,1037692,"2023-11-06T00:00:00.000Z",17895966,11,"Jalen Green",2,25,27,25,4,31.4
"3716",1797,5,0,4,5,3,8,3,2,2,27,0,1,11,4,0,1,1037692,"2023-11-06T00:00:00.000Z",458,11,"Fred VanVleet",0,15,20,16,9,22.3
"3717",1798,0,0,1,0,0,2,2,4,2,5,0,1,6,1,1,0,1037692,"2023-11-06T00:00:00.000Z",188,11,"Jeff Green",1,7,7,6,1,10.2
"3718",1799,2,0,1,1,0,1,0,0,0,12,0,1,0,1,0,0,1037692,"2023-11-06T00:00:00.000Z",75,11,"Reggie Bullock",0,1,3,2,3,4.2
"3719",1800,0,0,0,0,0,0,0,0,0,0,0,0,0,0,0,0,1037690,"2023-11-06T00:00:00.000Z",56677795,20,"Jacob Toppin",0,0,0,0,0,0
"3720",1801,4,0,4,3,0,8,4,2,2,29,0,5,10,4,1,2,1037800,"2023-11-22T00:00:00.000Z",17896073,22,"Jalen Suggs",1,14,18,14,8,21.8
"3721",1802,1,0,1,0,0,1,0,0,0,15,0,2,0,1,0,3,1037800,"2023-11-22T00:00:00.000Z",56677827,22,"Anthony Black",0,1,2,1,2,-0.3
"3722",1803,3,0,3,6,1,7,1,2,2,23,0,2,5,3,3,0,1037800,"2023-11-22T00:00:00.000Z",196,22,"Gary Harris",3,8,11,8,6,22.1
"3723",1804,0,0,2,4,1,11,6,8,7,29,3,3,20,5,0,0,1037800,"2023-11-22T00:00:00.000Z",3547251,22,"Cole Anthony",0,25,25,20,5,26
"3724",1805,0,0,0,0,0,0,0,0,0,0,0,0,0,0,0,0,1037800,"2023-11-22T00:00:00.000Z",38017724,22,"Caleb Houstan",0,0,0,0,0,0
"3725",1806,6,0,8,1,0,8,2,0,0,30,1,1,4,9,0,3,1037799,"2023-11-22T00:00:00.000Z",204,4,"Gordon Hayward",0,13,19,10,15,20.8
"3726",1807,0,0,9,7,3,19,11,10,8,37,2,2,33,11,2,2,1037799,"2023-11-22T00:00:00.000Z",62,4,"Miles Bridges",2,44,44,33,11,50.2
"3727",1808,0,3,9,0,0,10,4,6,3,35,5,4,11,14,0,0,1037799,"2023-11-22T00:00:00.000Z",38017698,4,"Mark Williams",3,25,25,11,14,36.8
"3728",1809,3,0,0,6,3,12,6,0,0,31,0,2,15,0,1,0,1037799,"2023-11-22T00:00:00.000Z",56677823,4,"Brandon Miller",1,15,18,18,3,22.5
"3729",1810,13,0,6,16,6,31,13,3,2,40,2,2,34,8,1,4,1037799,"2023-11-22T00:00:00.000Z",3547239,4,"LaMelo Ball",1,42,55,47,21,62.1
"3730",1811,4,0,0,0,0,1,0,0,0,20,0,1,0,0,1,1,1037799,"2023-11-22T00:00:00.000Z",422,4,"Ish Smith",1,0,4,4,4,8
"3731",1812,0,1,2,4,3,5,4,2,2,23,1,1,13,3,1,1,1037799,"2023-11-22T00:00:00.000Z",38017708,4,"Bryce McGowens",2,16,16,13,3,21.6
"3732",1813,0,0,0,0,0,0,0,0,0,0,0,0,0,0,0,0,1037799,"2023-11-22T00:00:00.000Z",17896037,4,"James Bouknight",0,0,0,0,0,0
"3733",1814,0,0,0,0,0,0,0,0,0,0,0,0,0,0,0,0,1037799,"2023-11-22T00:00:00.000Z",3547253,4,"Theo Maledon",0,0,0,0,0,0
"3734",1815,1,0,6,2,2,7,4,3,3,21,1,4,13,7,0,3,1037800,"2023-11-22T00:00:00.000Z",38017709,8,"Christian Braun",0,20,21,14,8,19.9
"3735",1816,2,0,1,4,1,6,2,2,2,17,1,5,7,2,0,0,1037800,"2023-11-22T00:00:00.000Z",56677776,8,"Julian Strawther",0,9,11,9,4,12.4
"3736",1817,0,0,1,3,0,4,0,0,0,8,0,0,0,1,0,1,1037800,"2023-11-22T00:00:00.000Z",56677582,8,"Jalen Pickett",0,1,1,0,1,0.2
"3737",1818,0,0,0,0,0,1,1,2,0,10,1,1,2,1,0,0,1037800,"2023-11-22T00:00:00.000Z",38017721,8,"Peyton Watson",0,3,3,2,1,3.2
"3738",1819,2,0,0,0,0,2,1,2,1,12,1,1,3,1,0,0,1037800,"2023-11-22T00:00:00.000Z",3547268,8,"Zeke Nnaji",0,4,6,5,3,7.2
"3739",1820,0,0,0,0,0,0,0,0,0,0,0,0,0,0,0,0,1037800,"2023-11-22T00:00:00.000Z",215,8,"Justin Holiday",0,0,0,0,0,0
"3740",1821,0,0,0,0,0,0,0,0,0,0,0,0,0,0,0,0,1037800,"2023-11-22T00:00:00.000Z",38017727,8,"Collin Gillespie",0,0,0,0,0,0
"3741",1822,0,0,0,0,0,0,0,0,0,0,0,0,0,0,0,0,1037800,"2023-11-22T00:00:00.000Z",250,8,"DeAndre Jordan",0,0,0,0,0,0
"3742",1823,0,0,0,0,0,0,0,0,0,0,0,0,0,0,0,0,1037800,"2023-11-22T00:00:00.000Z",17896007,8,"Braxton Key",0,0,0,0,0,0
"3743",1824,0,0,0,0,0,0,0,0,0,0,0,0,0,0,0,0,1037800,"2023-11-22T00:00:00.000Z",56677871,8,"Hunter Tyson",0,0,0,0,0,0
"3744",1825,0,0,0,0,0,0,0,0,0,0,0,0,0,0,0,0,1037800,"2023-11-22T00:00:00.000Z",666489,8,"Vlatko Cancar",0,0,0,0,0,0
"3745",1826,0,0,6,0,0,7,5,6,5,26,2,2,15,8,1,1,7050282,"2023-12-08T00:00:00.000Z",3547282,4,"Nick Richards",1,23,23,15,8,26.6
"3746",1827,0,0,0,0,0,0,0,0,0,7,0,0,0,0,0,0,7050282,"2023-12-08T00:00:00.000Z",38017708,4,"Bryce McGowens",0,0,0,0,0,0
"3747",1828,0,0,0,0,0,0,0,0,0,0,0,0,0,0,0,0,7050282,"2023-12-08T00:00:00.000Z",3547239,4,"LaMelo Ball",0,0,0,0,0,0
"3748",1829,0,0,0,0,0,0,0,0,0,0,0,0,0,0,0,0,7050282,"2023-12-08T00:00:00.000Z",56677866,4,"Leaky Black",0,0,0,0,0,0
"3749",1830,0,0,0,0,0,0,0,0,0,0,0,0,0,0,0,0,7050282,"2023-12-08T00:00:00.000Z",17896037,4,"James Bouknight",0,0,0,0,0,0
"3750",1831,0,0,0,0,0,0,0,0,0,0,0,0,0,0,0,0,7050282,"2023-12-08T00:00:00.000Z",3547253,4,"Theo Maledon",0,0,0,0,0,0
"3751",1832,1,0,0,0,0,5,2,2,2,12,1,2,6,1,0,1,7050284,"2023-12-08T00:00:00.000Z",3547297,1,"Trent Forrest",0,7,8,7,2,7.7
"3752",1833,0,0,0,0,0,0,0,0,0,0,0,0,0,0,0,0,7050284,"2023-12-08T00:00:00.000Z",38017689,1,"AJ Griffin",0,0,0,0,0,0
"3753",1834,0,0,3,0,0,7,4,2,1,23,2,1,9,5,0,4,7050283,"2023-12-08T00:00:00.000Z",24,9,"Marvin Bagley III",0,14,14,9,5,11
"3754",1835,4,1,6,2,0,11,7,3,2,32,1,1,16,7,0,2,7050283,"2023-12-08T00:00:00.000Z",3547241,9,"Killian Hayes",1,23,27,20,11,31.4
"3755",1836,6,0,2,6,2,15,8,4,3,32,0,1,21,2,1,3,7050283,"2023-12-08T00:00:00.000Z",17896075,9,"Cade Cunningham",1,23,29,27,8,32.4
"3756",1837,0,0,2,4,0,7,2,4,4,21,0,2,8,2,0,0,7050283,"2023-12-08T00:00:00.000Z",38017682,9,"Jaden Ivey",0,10,10,8,2,10.4
"3757",1838,0,1,0,0,0,1,0,0,0,4,0,0,0,0,0,0,7050283,"2023-12-08T00:00:00.000Z",197,9,"Joe Harris",1,0,0,0,0,3
"3758",1839,0,0,2,3,2,7,4,4,4,12,1,1,14,3,0,1,7050283,"2023-12-08T00:00:00.000Z",77,9,"Alec Burks",0,17,17,14,3,16.6
"3759",1840,0,0,1,0,0,0,0,0,0,5,0,0,0,1,0,1,7050283,"2023-12-08T00:00:00.000Z",259,9,"Kevin Knox",0,1,1,0,1,0.2
"3760",1841,2,0,1,5,3,7,4,0,0,25,0,4,11,1,2,2,7050282,"2023-12-08T00:00:00.000Z",666950,4,"P.J. Washington",2,12,14,13,3,19.2
"3761",1842,0,0,0,0,0,0,0,0,0,0,0,0,0,0,0,0,7050282,"2023-12-08T00:00:00.000Z",18678001,4,"JT Thor",0,0,0,0,0,0
"3762",1843,0,0,0,0,0,0,0,0,0,0,0,0,0,0,0,0,7050282,"2023-12-08T00:00:00.000Z",56677848,4,"Amari Bailey",0,0,0,0,0,0
"3763",1844,0,0,0,0,0,0,0,0,0,0,0,0,0,0,0,0,7050282,"2023-12-08T00:00:00.000Z",666748,4,"Cody Martin",0,0,0,0,0,0
"3764",1845,0,0,0,0,0,0,0,0,0,0,0,0,0,0,0,0,7050282,"2023-12-08T00:00:00.000Z",347,4,"Frank Ntilikina",0,0,0,0,0,0
"3765",1846,0,0,0,0,0,0,0,0,0,0,0,0,0,0,0,0,7050282,"2023-12-08T00:00:00.000Z",56677846,4,"Nick Smith Jr.",0,0,0,0,0,0
"3766",1847,4,0,3,6,0,12,3,5,5,36,0,3,11,3,1,0,7050282,"2023-12-08T00:00:00.000Z",18,28,"OG Anunoby",1,14,18,15,7,23.6
"3767",1848,4,0,4,1,0,15,11,4,3,33,1,2,25,5,1,1,7050282,"2023-12-08T00:00:00.000Z",416,28,"Pascal Siakam",1,30,34,29,9,39
"3768",1849,3,2,3,3,2,15,9,1,1,31,1,0,21,4,0,2,7050285,"2023-12-08T00:00:00.000Z",61,3,"Mikal Bridges",2,25,28,24,7,34.3
"3769",1850,0,0,3,5,1,8,3,0,0,25,2,3,7,5,0,1,7050285,"2023-12-08T00:00:00.000Z",666679,3,"Cameron Johnson",0,12,12,7,5,12
"3770",1851,0,0,1,0,0,0,0,0,0,3,0,0,0,1,0,0,1037968,"2023-12-21T00:00:00.000Z",17896059,27,"Sandro Mamukelashvili",0,1,1,0,1,1.2
"3771",1852,0,0,0,0,0,0,0,0,0,0,0,0,0,0,0,0,1037968,"2023-12-21T00:00:00.000Z",180,27,"Devonte' Graham",0,0,0,0,0,0
"3772",1853,0,0,0,0,0,0,0,0,0,0,0,0,0,0,0,0,1037984,"2023-12-23T00:00:00.000Z",17896017,19,"Matt Ryan",0,0,0,0,0,0
"3773",1854,1,0,1,2,1,2,1,2,2,15,0,0,5,1,1,1,1037984,"2023-12-23T00:00:00.000Z",213,11,"Aaron Holiday",1,6,7,6,2,9.7
"3774",1855,0,0,2,2,0,11,4,0,0,20,2,5,8,4,2,0,1037984,"2023-12-23T00:00:00.000Z",38017695,11,"Tari Eason",2,12,12,8,4,18.8
"3775",1856,2,0,2,1,0,3,1,0,0,21,1,1,2,3,0,0,1037984,"2023-12-23T00:00:00.000Z",188,11,"Jeff Green",0,5,7,4,5,8.6
"3776",1857,0,0,0,0,0,0,0,0,0,0,0,0,0,0,0,0,1037984,"2023-12-23T00:00:00.000Z",3547281,11,"Nate Hinton",0,0,0,0,0,0
"3777",1858,0,0,0,0,0,0,0,0,0,0,0,0,0,0,0,0,1037984,"2023-12-23T00:00:00.000Z",19465326,11,"Jock Landale",0,0,0,0,0,0
"3778",1859,0,0,8,5,2,6,3,0,0,22,0,0,8,8,0,0,1037980,"2023-12-23T00:00:00.000Z",105,17,"Pat Connaughton",0,16,16,8,8,17.6
"3779",1860,2,0,0,0,0,0,0,0,0,11,2,1,0,2,0,1,1037980,"2023-12-23T00:00:00.000Z",56677852,17,"Andre Jackson Jr.",0,2,4,2,4,4.4
"3780",1861,0,0,1,0,0,0,0,0,0,1,0,0,0,1,0,0,1037980,"2023-12-23T00:00:00.000Z",38017676,17,"MarJon Beauchamp",0,1,1,0,1,1.2
"3781",1862,0,0,0,0,0,0,0,0,0,1,0,0,0,0,0,0,1037980,"2023-12-23T00:00:00.000Z",56677854,17,"Chris Livingston",0,0,0,0,0,0
"3782",1863,0,0,0,0,0,0,0,0,0,1,0,0,0,0,0,0,1037980,"2023-12-23T00:00:00.000Z",38017733,17,"A.J. Green",0,0,0,0,0,0
"3783",1864,0,0,0,0,0,0,0,0,0,0,0,0,0,0,0,0,1037980,"2023-12-23T00:00:00.000Z",2148,17,"Thanasis Antetokounmpo",0,0,0,0,0,0
"3784",1865,2,1,3,6,3,9,3,0,0,21,2,6,9,5,1,3,1037972,"2023-12-21T00:00:00.000Z",667378,18,"Naz Reid",2,14,16,11,7,21
"3785",1866,0,0,0,0,0,0,0,0,0,0,0,0,0,0,0,0,1037972,"2023-12-21T00:00:00.000Z",38017700,18,"Wendell Moore Jr.",0,0,0,0,0,0
"3786",1867,0,0,0,0,0,0,0,0,0,0,0,0,0,0,0,0,1037972,"2023-12-21T00:00:00.000Z",56677851,18,"Jaylen Clark",0,0,0,0,0,0
"3787",1868,0,0,0,0,0,0,0,0,0,0,0,0,0,0,0,0,1037972,"2023-12-21T00:00:00.000Z",1603383,14,"Gabe Vincent",0,0,0,0,0,0
"3788",1869,1,0,1,2,0,3,0,0,0,14,0,3,0,1,1,0,1037985,"2023-12-23T00:00:00.000Z",666754,1,"Garrison Mathews",1,1,2,1,2,5.7
"3789",1870,2,0,5,9,3,11,4,4,3,38,1,2,14,6,2,1,1037985,"2023-12-23T00:00:00.000Z",3547256,1,"Saddiq Bey",2,20,22,16,8,29.2
"3790",1871,1,2,7,0,0,11,8,4,4,30,5,2,20,12,0,1,1037985,"2023-12-23T00:00:00.000Z",83,1,"Clint Capela",2,32,33,21,13,40.9
"3791",1872,4,0,3,6,4,15,10,2,2,36,1,4,26,4,2,3,1037985,"2023-12-23T00:00:00.000Z",334,1,"Dejounte Murray",2,30,34,30,8,39.8
"3792",1873,13,1,5,10,3,24,11,7,5,41,0,3,30,5,1,2,1037985,"2023-12-23T00:00:00.000Z",490,1,"Trae Young",2,35,48,43,18,59.5
"3793",1874,3,0,3,8,2,15,6,3,2,34,1,2,16,4,0,0,1037985,"2023-12-23T00:00:00.000Z",53,1,"Bogdan Bogdanovic",0,20,23,19,7,25.3
"3794",1875,4,2,3,2,0,10,5,0,0,28,4,4,10,7,2,3,1037985,"2023-12-23T00:00:00.000Z",3547244,1,"Onyeka Okongwu",4,17,21,14,11,33.4
"3795",1876,4,2,2,12,6,18,8,2,2,39,1,4,24,3,2,4,1038068,"2024-01-03T00:00:00.000Z",17896073,22,"Jalen Suggs",4,27,31,28,7,41.6
"3796",1877,6,1,2,3,0,7,2,2,1,38,0,5,5,2,2,0,1038068,"2024-01-03T00:00:00.000Z",17553983,22,"Trevelin Queen",3,7,13,11,8,25.4
"3797",1878,4,0,1,1,1,7,4,0,0,25,1,1,9,2,0,1,1038068,"2024-01-03T00:00:00.000Z",56677827,22,"Anthony Black",0,11,15,13,6,16.4
"3798",1879,1,0,2,6,4,6,4,3,3,31,0,2,15,2,4,1,1038068,"2024-01-03T00:00:00.000Z",38017724,22,"Caleb Houstan",4,17,18,16,3,29.9
"3799",1880,0,0,0,0,0,0,0,0,0,0,0,0,0,0,0,0,1038064,"2024-01-03T00:00:00.000Z",151,7,"Dante Exum",0,0,0,0,0,0
"3800",1881,0,0,0,2,0,2,0,0,0,7,0,0,0,0,0,0,1038062,"2024-01-03T00:00:00.000Z",38017729,15,"David Roddy",0,0,0,0,0,0
"3801",1882,0,0,0,0,0,0,0,0,0,0,0,0,0,0,0,0,1038062,"2024-01-03T00:00:00.000Z",376,28,"Otto Porter Jr.",0,0,0,0,0,0
"3802",1883,0,0,2,0,0,3,2,0,0,15,0,0,4,2,0,2,1038067,"2024-01-03T00:00:00.000Z",457,14,"Jarred Vanderbilt",0,6,6,4,2,4.4
"3803",1884,3,1,4,2,0,10,5,3,3,24,4,1,13,8,0,2,1038067,"2024-01-03T00:00:00.000Z",486,14,"Christian Wood",1,21,24,16,11,28.1
"3804",1885,0,0,1,0,0,4,0,0,0,6,1,1,0,2,0,0,1038067,"2024-01-03T00:00:00.000Z",56677835,14,"Jalen Hood-Schifino",0,2,2,0,2,2.4
"3805",1886,0,0,0,0,0,0,0,0,0,1,0,0,0,0,0,0,1038067,"2024-01-03T00:00:00.000Z",666626,14,"Jaxson Hayes",0,0,0,0,0,0
"3806",1887,0,0,0,0,0,0,0,0,0,0,0,0,0,0,0,0,1038066,"2024-01-03T00:00:00.000Z",666881,29,"Luka Samanic",0,0,0,0,0,0
"3807",1888,3,0,6,3,3,7,3,0,0,21,1,4,9,7,0,1,1038068,"2024-01-03T00:00:00.000Z",85,22,"Wendell Carter Jr.",0,16,19,12,10,20.9
"3808",1889,2,0,2,1,0,2,0,2,2,13,1,2,2,3,0,3,1038068,"2024-01-03T00:00:00.000Z",462,22,"Moritz Wagner",0,5,7,4,5,5.6
"3809",1890,3,1,6,4,3,5,4,0,0,27,1,2,11,7,0,0,1038068,"2024-01-03T00:00:00.000Z",666818,22,"Chuma Okeke",1,18,21,14,10,26.9
"3810",1891,1,0,0,0,0,0,0,0,0,6,0,1,0,0,0,0,1038068,"2024-01-03T00:00:00.000Z",666885,22,"Admiral Schofield",0,0,1,1,1,1.5
"3811",1892,0,0,0,0,0,0,0,0,0,0,0,0,0,0,0,0,1038068,"2024-01-03T00:00:00.000Z",3547251,22,"Cole Anthony",0,0,0,0,0,0
"3812",1893,0,0,0,0,0,0,0,0,0,0,0,0,0,0,0,0,1038068,"2024-01-03T00:00:00.000Z",165,22,"Markelle Fultz",0,0,0,0,0,0
"3813",1894,0,0,0,0,0,0,0,0,0,0,0,0,0,0,0,0,1038068,"2024-01-03T00:00:00.000Z",38017607,22,"Kevon Harris",0,0,0,0,0,0
"3814",1895,0,0,0,0,0,0,0,0,0,0,0,0,0,0,0,0,1038068,"2024-01-03T00:00:00.000Z",56677839,22,"Jett Howard",0,0,0,0,0,0
"3815",1896,0,0,0,0,0,0,0,0,0,0,0,0,0,0,0,0,1038068,"2024-01-03T00:00:00.000Z",226,22,"Joe Ingles",0,0,0,0,0,0
"3816",1897,0,0,0,0,0,0,0,0,0,0,0,0,0,0,0,0,1038068,"2024-01-03T00:00:00.000Z",229,22,"Jonathan Isaac",0,0,0,0,0,0
"3817",1898,0,0,0,0,0,0,0,0,0,0,0,0,0,0,0,0,1038087,"2024-01-06T00:00:00.000Z",313,23,"De'Anthony Melton",0,0,0,0,0,0
"3818",1899,2,0,6,6,1,9,3,0,0,33,1,1,7,7,1,4,1038087,"2024-01-06T00:00:00.000Z",38017739,29,"Simone Fontecchio",1,14,16,9,9,17.4
"3819",1900,1,1,9,9,5,19,12,5,4,35,4,2,33,13,0,1,1038087,"2024-01-06T00:00:00.000Z",297,29,"Lauri Markkanen",1,46,47,34,14,52.1
"3820",1901,3,2,3,5,2,10,4,4,4,38,2,3,14,5,1,4,1037637,"2023-10-30T00:00:00.000Z",38017690,25,"Shaedon Sharpe",3,19,22,17,8,29.5
"3821",1902,7,0,4,6,0,12,4,4,3,35,0,6,11,4,2,4,1037637,"2023-10-30T00:00:00.000Z",56677747,25,"Scoot Henderson",2,15,22,18,11,28.3
"3822",1903,5,0,2,7,3,21,9,1,0,29,1,2,21,3,0,1,1037637,"2023-10-30T00:00:00.000Z",65,25,"Malcolm Brogdon",0,24,29,26,8,31.1
"3823",1904,0,1,5,2,0,4,1,2,1,23,2,2,3,7,0,1,1037637,"2023-10-30T00:00:00.000Z",56677850,25,"Toumani Camara",1,10,10,3,7,13.4
"3824",1905,0,1,3,0,0,3,2,0,0,16,0,2,4,3,0,1,1037637,"2023-10-30T00:00:00.000Z",38017711,25,"Jabari Walker",1,7,7,4,3,9.6
"3825",1906,1,0,0,3,1,4,2,0,0,11,0,0,5,0,1,0,1037637,"2023-10-30T00:00:00.000Z",3547289,25,"Skylar Mays",1,5,6,6,1,9.5
"3826",1907,0,0,0,0,0,0,0,0,0,0,0,0,0,0,0,0,1037637,"2023-10-30T00:00:00.000Z",666476,25,"Moses Brown",0,0,0,0,0,0
"3827",1908,0,0,0,0,0,0,0,0,0,0,0,0,0,0,0,0,1037637,"2023-10-30T00:00:00.000Z",47957121,25,"Justin Minaya",0,0,0,0,0,0
"3828",1909,0,0,0,0,0,0,0,0,0,0,0,0,0,0,0,0,1037637,"2023-10-30T00:00:00.000Z",56677791,25,"Kris Murray",0,0,0,0,0,0
"3829",1910,0,0,0,0,0,0,0,0,0,0,0,0,0,0,0,0,1037637,"2023-10-30T00:00:00.000Z",56677829,25,"Rayan Rupert",0,0,0,0,0,0
"3830",1911,0,0,0,0,0,1,0,0,0,1,0,0,0,0,0,0,1037638,"2023-10-30T00:00:00.000Z",48248287,15,"Jacob Gilyard",0,0,0,0,0,0
"3831",1912,0,0,0,0,0,0,0,0,0,0,0,0,0,0,0,0,1037637,"2023-10-30T00:00:00.000Z",56783340,25,"Duop Reath",0,0,0,0,0,0
"3832",1913,5,0,2,2,0,4,1,4,3,17,0,2,5,2,1,1,1037639,"2023-10-30T00:00:00.000Z",315,17,"Khris Middleton",1,7,12,10,7,16.9
"3833",1914,2,1,6,3,1,21,12,11,8,32,1,3,33,7,0,2,1037639,"2023-10-30T00:00:00.000Z",15,17,"Giannis Antetokounmpo",1,40,42,35,9,45.4
"3834",1915,3,1,4,4,1,9,5,0,0,29,3,3,11,7,1,2,1037639,"2023-10-30T00:00:00.000Z",283,17,"Brook Lopez",2,18,21,14,10,27.9
"3835",1916,2,0,2,0,0,2,1,0,0,17,3,2,2,5,0,1,1037624,"2023-10-28T00:00:00.000Z",45,23,"Patrick Beverley",0,7,9,4,7,10
"3836",1917,2,0,3,6,1,8,2,2,0,32,0,3,5,3,2,2,1037639,"2023-10-30T00:00:00.000Z",38,17,"Malik Beasley",2,8,10,7,5,15.6
"3837",1918,0,0,0,0,0,1,0,0,0,5,0,1,0,0,0,0,1037624,"2023-10-28T00:00:00.000Z",184,23,"Danny Green",0,0,0,0,0,0
"3838",1919,0,0,3,0,0,4,2,0,0,13,2,4,4,5,1,1,1037624,"2023-10-28T00:00:00.000Z",3547270,23,"Paul Reed",1,9,9,4,5,12
"3839",1920,0,1,2,1,0,3,1,0,0,11,0,1,2,2,0,0,1037624,"2023-10-28T00:00:00.000Z",2175,23,"Danuel House Jr.",1,4,4,2,2,7.4
"3840",1921,3,1,3,0,0,8,5,2,1,35,2,3,11,5,0,0,1037623,"2023-10-28T00:00:00.000Z",3547247,6,"Isaac Okoro",1,16,19,14,8,24.5
"3841",1922,3,1,3,5,2,5,2,0,0,37,0,2,6,3,0,0,1037623,"2023-10-28T00:00:00.000Z",666940,6,"Dean Wade",1,9,12,9,6,17.1
"3842",1923,3,3,9,1,1,22,12,10,8,33,5,4,33,14,0,2,1037623,"2023-10-28T00:00:00.000Z",17896076,6,"Evan Mobley",3,47,50,36,17,61.3
"3843",1924,6,0,10,9,4,20,7,3,3,42,1,2,21,11,0,1,1037623,"2023-10-28T00:00:00.000Z",666908,6,"Max Strus",0,32,38,27,17,42.2
"3844",1925,8,0,3,10,4,28,12,9,3,44,2,2,31,5,1,2,1037623,"2023-10-28T00:00:00.000Z",277,6,"Caris LeVert",1,36,44,39,13,50
"3845",1926,0,0,0,0,0,0,0,0,0,0,0,0,0,0,0,0,3277425,"2023-11-14T00:00:00.000Z",62,4,"Miles Bridges",0,0,0,0,0,0
"3846",1927,0,0,0,0,0,0,0,0,0,0,0,0,0,0,0,0,3277425,"2023-11-14T00:00:00.000Z",204,4,"Gordon Hayward",0,0,0,0,0,0
"3847",1928,0,0,0,0,0,0,0,0,0,0,0,0,0,0,0,0,3277425,"2023-11-14T00:00:00.000Z",666748,4,"Cody Martin",0,0,0,0,0,0
"3848",1929,0,0,0,0,0,0,0,0,0,0,0,0,0,0,0,0,3277425,"2023-11-14T00:00:00.000Z",56677823,4,"Brandon Miller",0,0,0,0,0,0
"3849",1930,0,0,0,0,0,0,0,0,0,0,0,0,0,0,0,0,3277425,"2023-11-14T00:00:00.000Z",347,4,"Frank Ntilikina",0,0,0,0,0,0
"3850",1931,0,0,0,0,0,0,0,0,0,0,0,0,0,0,0,0,3277425,"2023-11-14T00:00:00.000Z",403,4,"Terry Rozier",0,0,0,0,0,0
"3851",1932,5,0,1,1,1,14,10,14,11,34,3,1,32,4,2,3,3277425,"2023-11-14T00:00:00.000Z",79,16,"Jimmy Butler",2,36,41,37,9,47.3
"3852",1933,2,2,3,5,2,8,5,0,0,33,1,1,12,4,5,0,3277425,"2023-11-14T00:00:00.000Z",3092,16,"Haywood Highsmith",7,16,18,14,6,40.8
"3853",1934,2,0,4,7,3,11,7,4,3,29,1,1,20,5,3,1,3277428,"2023-11-14T00:00:00.000Z",666679,3,"Cameron Johnson",3,25,27,22,7,37
"3854",1935,0,0,2,4,1,5,2,0,0,24,2,1,5,4,1,0,3277428,"2023-11-14T00:00:00.000Z",158,3,"Dorian Finney-Smith",1,9,9,5,4,12.8
"3855",1936,0,2,4,0,0,5,3,2,2,21,2,4,8,6,1,1,3277428,"2023-11-14T00:00:00.000Z",666508,3,"Nicolas Claxton",3,14,14,8,6,23.2
"3856",1937,4,0,4,5,3,17,9,1,0,32,1,2,21,5,4,6,3277428,"2023-11-14T00:00:00.000Z",61,3,"Mikal Bridges",4,26,30,25,9,39
"3857",1938,9,0,4,10,5,18,10,6,4,37,1,3,29,5,0,1,3277428,"2023-11-14T00:00:00.000Z",130,3,"Spencer Dinwiddie",0,34,43,38,14,47.5
"3858",1939,0,1,2,3,1,6,2,2,1,24,1,2,6,3,1,0,3277429,"2023-11-14T00:00:00.000Z",666541,21,"Luguentz Dort",2,9,9,6,3,15.6
"3859",1940,3,0,2,3,1,9,5,0,0,23,0,3,11,2,0,3,3277429,"2023-11-14T00:00:00.000Z",38017703,21,"Jalen Williams",0,13,16,14,5,14.9
"3860",1941,3,1,7,5,1,10,3,2,2,30,0,2,9,7,2,2,3277429,"2023-11-14T00:00:00.000Z",38017685,21,"Chet Holmgren",3,16,19,12,10,28.9
"3861",1942,7,2,6,2,0,11,7,5,4,25,1,0,18,7,0,3,3277429,"2023-11-14T00:00:00.000Z",17896065,21,"Josh Giddey",2,25,32,25,14,39.9
"3862",1943,5,0,5,4,1,16,10,7,7,28,1,2,28,6,7,2,3277429,"2023-11-14T00:00:00.000Z",175,21,"Shai Gilgeous-Alexander",7,34,39,33,11,61.7
"3863",1944,1,0,2,3,2,5,3,0,0,14,0,1,8,2,2,0,3277429,"2023-11-14T00:00:00.000Z",3547272,21,"Isaiah Joe",2,10,11,9,3,17.9
"3864",1945,3,2,4,1,1,5,4,0,0,21,1,1,9,5,2,1,3277429,"2023-11-14T00:00:00.000Z",56677833,21,"Cason Wallace",4,14,17,12,8,30.5
"3865",1946,4,0,1,3,2,4,2,4,2,19,0,1,8,1,1,2,3277429,"2023-11-14T00:00:00.000Z",4197029,21,"Vasilije Micic",1,9,13,12,5,16.2
"3866",1947,2,0,2,3,1,4,2,0,0,8,0,0,5,2,1,1,3277429,"2023-11-14T00:00:00.000Z",17896036,21,"Tre Mann",1,7,9,7,4,12.4
"3867",1948,1,0,1,1,0,1,0,0,0,5,0,0,0,1,0,0,3277429,"2023-11-14T00:00:00.000Z",3547271,21,"Aleksej Pokusevski",0,1,2,1,2,2.7
"3868",1949,0,0,0,0,0,0,0,0,0,0,0,0,0,0,0,0,3277429,"2023-11-14T00:00:00.000Z",44,21,"Davis Bertans",0,0,0,0,0,0
"3869",1950,0,0,0,3,1,3,1,2,2,8,0,2,5,0,0,0,3277426,"2023-11-14T00:00:00.000Z",38017689,1,"AJ Griffin",0,5,5,5,0,5
"3870",1951,2,0,2,1,1,2,2,0,0,18,0,3,5,2,2,1,1037853,"2023-11-29T00:00:00.000Z",358,29,"Kelly Olynyk",2,7,9,7,4,15.4
"3871",1952,3,0,2,4,1,5,2,0,0,21,1,1,5,3,0,1,1037853,"2023-11-29T00:00:00.000Z",38017620,29,"Ochai Agbaji",0,8,11,8,6,12.1
"3872",1953,0,1,1,1,1,2,2,0,0,6,1,0,5,2,0,1,1037853,"2023-11-29T00:00:00.000Z",666881,29,"Luka Samanic",1,7,7,5,2,9.4
"3873",1954,0,0,0,0,0,0,0,0,0,0,0,0,0,0,0,0,1037853,"2023-11-29T00:00:00.000Z",19465584,29,"Micah Potter",0,0,0,0,0,0
"3874",1955,5,0,2,1,0,4,3,3,3,27,2,4,9,4,1,3,1037854,"2023-11-29T00:00:00.000Z",3547270,23,"Paul Reed",1,13,18,14,9,21.3
"3875",1956,2,0,2,1,0,4,2,0,0,17,0,4,4,2,0,2,1037854,"2023-11-29T00:00:00.000Z",3547294,23,"Kenyon Martin Jr.",0,6,8,6,4,7.4
"3876",1957,0,0,0,0,0,0,0,0,0,2,0,0,0,0,0,0,1037854,"2023-11-29T00:00:00.000Z",260,23,"Furkan Korkmaz",0,0,0,0,0,0
"3877",1958,0,0,0,0,0,0,0,0,0,0,0,0,0,0,0,0,1037854,"2023-11-29T00:00:00.000Z",145,23,"Joel Embiid",0,0,0,0,0,0
"3878",1959,0,0,0,0,0,0,0,0,0,0,0,0,0,0,0,0,1037854,"2023-11-29T00:00:00.000Z",56913527,23,"Ricky Council IV",0,0,0,0,0,0
"3879",1960,0,0,0,0,0,0,0,0,0,0,0,0,0,0,0,0,1037854,"2023-11-29T00:00:00.000Z",2175,23,"Danuel House Jr.",0,0,0,0,0,0
"3880",1961,0,0,0,0,0,0,0,0,0,0,0,0,0,0,0,0,1037854,"2023-11-29T00:00:00.000Z",360,23,"Kelly Oubre Jr.",0,0,0,0,0,0
"3881",1962,0,0,0,0,0,0,0,0,0,0,0,0,0,0,0,0,1037854,"2023-11-29T00:00:00.000Z",17554001,23,"Javonte Smart",0,0,0,0,0,0
"3882",1963,0,0,0,0,0,0,0,0,0,0,0,0,0,0,0,0,1037854,"2023-11-29T00:00:00.000Z",56677788,23,"Terquavion Smith",0,0,0,0,0,0
"3883",1964,0,0,0,0,0,0,0,0,0,0,0,0,0,0,0,0,1037854,"2023-11-29T00:00:00.000Z",17896025,23,"Jaden Springer",0,0,0,0,0,0
"3884",1965,4,0,2,5,3,7,4,0,0,27,1,2,11,3,2,0,1037855,"2023-11-29T00:00:00.000Z",215,8,"Justin Holiday",2,14,18,15,7,26.6
"3885",1966,5,0,8,12,7,17,11,3,1,34,2,2,30,10,1,0,1037855,"2023-11-29T00:00:00.000Z",375,8,"Michael Porter Jr.",1,40,45,35,15,52.5
"3886",1967,15,0,4,2,1,19,12,8,7,33,6,2,32,10,1,0,1037855,"2023-11-29T00:00:00.000Z",246,8,"Nikola Jokic",1,42,57,47,25,69.5
"3887",1968,2,0,1,3,2,6,4,0,0,32,0,0,10,1,0,0,1037855,"2023-11-29T00:00:00.000Z",81,8,"Kentavious Caldwell-Pope",0,11,13,12,3,14.2
"3888",1969,6,0,6,8,3,14,4,5,5,22,0,2,16,6,0,0,1037855,"2023-11-29T00:00:00.000Z",335,8,"Jamal Murray",0,22,28,22,12,32.2
"3889",1970,2,1,2,7,2,14,6,0,0,24,0,3,14,2,0,0,1037855,"2023-11-29T00:00:00.000Z",236,8,"Reggie Jackson",1,16,18,16,4,22.4
"3890",1971,0,1,1,0,0,4,2,4,3,18,2,2,7,3,0,0,1037855,"2023-11-29T00:00:00.000Z",3547268,8,"Zeke Nnaji",1,10,10,7,3,13.6
"3891",1972,1,0,2,2,1,7,4,2,2,19,1,2,11,3,0,2,1037855,"2023-11-29T00:00:00.000Z",38017709,8,"Christian Braun",0,14,15,12,4,14.1
"3892",1973,1,0,1,2,0,4,0,0,0,13,0,1,0,1,0,0,1037855,"2023-11-29T00:00:00.000Z",56677776,8,"Julian Strawther",0,1,2,1,2,2.7
"3893",1974,0,0,0,0,0,1,1,2,0,6,1,0,2,1,0,0,1037855,"2023-11-29T00:00:00.000Z",250,8,"DeAndre Jordan",0,3,3,2,1,3.2
"3894",1975,0,0,0,0,0,0,0,0,0,3,0,1,0,0,0,0,1037855,"2023-11-29T00:00:00.000Z",56677871,8,"Hunter Tyson",0,0,0,0,0,0
"3895",1976,0,0,0,0,0,0,0,0,0,0,0,0,0,0,0,0,1037925,"2023-12-15T00:00:00.000Z",356,24,"Josh Okogie",0,0,0,0,0,0
"3896",1977,3,1,1,2,1,10,6,8,8,29,1,2,21,2,0,1,1037925,"2023-12-15T00:00:00.000Z",666423,20,"RJ Barrett",1,23,26,24,5,29.9
"3897",1978,6,1,7,3,1,16,10,2,2,35,1,4,23,8,0,5,1037925,"2023-12-15T00:00:00.000Z",387,20,"Julius Randle",1,31,37,29,14,39.6
"3898",1979,0,0,2,0,0,4,2,1,1,18,1,3,5,3,0,0,1037925,"2023-12-15T00:00:00.000Z",17896063,20,"Jericho Sims",0,8,8,5,3,8.6
"3899",1980,1,0,1,2,1,3,2,0,0,19,0,4,5,1,1,0,1037925,"2023-12-15T00:00:00.000Z",131,20,"Donte DiVincenzo",1,6,7,6,2,10.7
"3900",1981,9,0,5,9,9,23,17,9,7,35,1,0,50,6,5,2,1037925,"2023-12-15T00:00:00.000Z",73,20,"Jalen Brunson",5,56,65,59,15,83.7
"3901",1982,2,0,0,3,0,8,3,0,0,29,2,0,6,2,0,0,1037925,"2023-12-15T00:00:00.000Z",202,20,"Josh Hart",0,8,10,8,4,11.4
"3902",1983,2,3,7,0,0,2,2,4,3,31,1,3,7,8,1,2,1037925,"2023-12-15T00:00:00.000Z",201,20,"Isaiah Hartenstein",4,15,17,9,10,29.6
"3903",1984,3,0,5,3,1,8,3,4,3,24,0,2,10,5,2,1,1037925,"2023-12-15T00:00:00.000Z",3547269,20,"Immanuel Quickley",2,15,18,13,8,25.5
"3904",1985,1,0,0,6,3,7,3,0,0,15,2,2,9,2,0,0,1037925,"2023-12-15T00:00:00.000Z",17895858,20,"Quentin Grimes",0,11,12,10,3,12.9
"3905",1986,0,0,0,1,1,1,1,0,0,2,0,0,3,0,0,0,1037925,"2023-12-15T00:00:00.000Z",17896033,20,"Miles McBride",0,3,3,3,0,3
"3906",1987,0,0,0,0,0,0,0,0,0,1,0,0,0,0,0,0,1037925,"2023-12-15T00:00:00.000Z",666675,20,"DaQuan Jeffries",0,0,0,0,0,0
"3907",1988,1,0,1,0,0,0,0,0,0,1,0,0,0,1,0,0,1037925,"2023-12-15T00:00:00.000Z",19,20,"Ryan Arcidiacono",0,1,2,1,2,2.7
"3908",1989,0,0,0,0,0,0,0,0,0,1,0,0,0,0,0,0,1037925,"2023-12-15T00:00:00.000Z",173,20,"Taj Gibson",0,0,0,0,0,0
"3909",1990,0,0,0,0,0,0,0,0,0,0,0,0,0,0,0,0,1037925,"2023-12-15T00:00:00.000Z",160,20,"Evan Fournier",0,0,0,0,0,0
"3910",1991,0,0,0,0,0,0,0,0,0,0,0,0,0,0,0,0,1037925,"2023-12-15T00:00:00.000Z",666474,20,"Charles Brown",0,0,0,0,0,0
"3911",1992,0,0,0,0,0,0,0,0,0,0,0,0,0,0,0,0,1037925,"2023-12-15T00:00:00.000Z",59421201,20,"Jaylen Martin",0,0,0,0,0,0
"3912",1993,0,0,0,0,0,0,0,0,0,0,0,0,0,0,0,0,1037925,"2023-12-15T00:00:00.000Z",399,20,"Mitchell Robinson",0,0,0,0,0,0
"3913",1994,0,0,0,0,0,0,0,0,0,0,0,0,0,0,0,0,1037925,"2023-12-15T00:00:00.000Z",56677795,20,"Jacob Toppin",0,0,0,0,0,0
"3914",1995,1,0,7,5,2,8,4,0,0,26,1,4,10,8,0,1,1037926,"2023-12-16T00:00:00.000Z",56677852,17,"Andre Jackson Jr.",0,18,19,11,9,20.1
"3915",1996,6,0,7,0,0,9,7,13,8,26,1,1,22,8,1,0,1037926,"2023-12-16T00:00:00.000Z",15,17,"Giannis Antetokounmpo",1,30,36,28,14,43.6
"3916",1997,1,5,1,2,1,3,2,0,0,26,0,3,5,1,0,2,1037926,"2023-12-16T00:00:00.000Z",283,17,"Brook Lopez",5,6,7,6,2,20.7
"3917",1998,1,0,5,2,1,8,4,2,2,33,1,0,11,6,2,3,1037926,"2023-12-16T00:00:00.000Z",38017676,17,"MarJon Beauchamp",2,17,18,12,7,22.7
"3918",1999,5,1,4,14,6,22,11,5,5,30,0,3,33,4,0,2,1037926,"2023-12-16T00:00:00.000Z",278,17,"Damian Lillard",1,37,42,38,9,46.3
"3919",2000,1,0,9,7,4,18,11,5,5,27,3,3,31,12,1,4,1037926,"2023-12-16T00:00:00.000Z",377,17,"Bobby Portis",1,43,44,32,13,45.9
"3920",2001,10,1,3,1,0,12,8,3,3,27,3,5,19,6,1,3,1038031,"2023-12-30T00:00:00.000Z",358,29,"Kelly Olynyk",2,25,35,29,16,44.2
"3921",2002,0,1,0,3,0,4,0,2,0,15,0,1,0,0,0,0,1038031,"2023-12-30T00:00:00.000Z",38017620,29,"Ochai Agbaji",1,0,0,0,0,3
"3922",2003,0,0,0,0,0,0,0,0,0,0,0,0,0,0,0,0,1038031,"2023-12-30T00:00:00.000Z",666650,29,"Talen Horton-Tucker",0,0,0,0,0,0
"3923",2004,0,0,0,0,0,0,0,0,0,0,0,0,0,0,0,0,1038031,"2023-12-30T00:00:00.000Z",666881,29,"Luka Samanic",0,0,0,0,0,0
"3924",2005,0,0,0,0,0,0,0,0,0,0,0,0,0,0,0,0,1038031,"2023-12-30T00:00:00.000Z",11891374,29,"Omer Yurtseven",0,0,0,0,0,0
"3925",2006,0,0,0,0,0,0,0,0,0,0,0,0,0,0,0,0,1038031,"2023-12-30T00:00:00.000Z",17896023,29,"Josh Christopher",0,0,0,0,0,0
"3926",2007,0,0,0,0,0,0,0,0,0,0,0,0,0,0,0,0,1038031,"2023-12-30T00:00:00.000Z",56677824,29,"Taylor Hendricks",0,0,0,0,0,0
"3927",2008,0,0,0,0,0,0,0,0,0,0,0,0,0,0,0,0,1038031,"2023-12-30T00:00:00.000Z",38017630,29,"Johnny Juzang",0,0,0,0,0,0
"3928",2009,0,0,0,0,0,0,0,0,0,0,0,0,0,0,0,0,1038031,"2023-12-30T00:00:00.000Z",19465584,29,"Micah Potter",0,0,0,0,0,0
"3929",2010,1,1,6,4,0,5,1,2,2,26,0,2,4,6,2,2,1038031,"2023-12-30T00:00:00.000Z",3092,16,"Haywood Highsmith",3,10,11,5,7,19.7
"3930",2011,1,0,1,0,0,4,3,0,0,11,0,2,6,1,0,1,1038031,"2023-12-30T00:00:00.000Z",38017734,16,"Jamal Cain",0,7,8,7,2,7.7
"3931",2012,0,0,0,0,0,0,0,0,0,0,0,0,0,0,0,0,1038031,"2023-12-30T00:00:00.000Z",74,16,"Thomas Bryant",0,0,0,0,0,0
"3932",2013,0,0,0,0,0,0,0,0,0,0,0,0,0,0,0,0,1038031,"2023-12-30T00:00:00.000Z",56677842,29,"Brice Sensabaugh",0,0,0,0,0,0
"3933",2014,1,1,2,0,0,3,2,4,4,23,0,2,8,2,0,2,1038031,"2023-12-30T00:00:00.000Z",79,16,"Jimmy Butler",1,10,11,9,3,12.9
"3934",2015,1,0,1,2,2,2,2,0,0,10,1,5,6,2,0,1,1038031,"2023-12-30T00:00:00.000Z",38017696,16,"Nikola Jovic",0,8,9,7,3,8.9
"3935",2016,3,3,13,0,0,13,7,20,14,36,3,1,28,16,3,4,1038031,"2023-12-30T00:00:00.000Z",4,16,"Bam Adebayo",6,44,47,31,19,65.7
"3936",2017,6,1,4,7,2,22,9,5,5,39,2,2,25,6,1,1,1038031,"2023-12-30T00:00:00.000Z",666633,16,"Tyler Herro",2,31,37,31,12,46.2
"3937",2018,0,0,2,1,0,1,0,0,0,8,0,1,0,2,0,1,1038031,"2023-12-30T00:00:00.000Z",3547257,16,"R.J. Hampton",0,2,2,0,2,1.4
"3938",2019,1,0,1,4,0,9,2,5,5,35,0,4,9,1,0,2,1038031,"2023-12-30T00:00:00.000Z",56677785,16,"Jaime Jaquez Jr.",0,10,11,10,2,9.7
"3939",2020,2,0,4,8,2,11,4,4,2,20,2,1,12,6,0,1,1038031,"2023-12-30T00:00:00.000Z",285,16,"Kevin Love",0,18,20,14,8,21.2
"3940",2021,3,0,7,6,2,14,7,5,3,37,0,2,19,7,0,4,1038032,"2023-12-30T00:00:00.000Z",54,9,"Bojan Bogdanovic",0,26,29,22,10,27.9
"3941",2022,2,1,2,8,3,14,7,0,0,31,0,2,17,2,1,1,1038032,"2023-12-30T00:00:00.000Z",259,9,"Kevin Knox",2,19,21,19,4,27.4
"3942",2023,2,0,15,0,0,11,6,6,6,34,2,5,18,17,0,1,1038032,"2023-12-30T00:00:00.000Z",38017694,9,"Jalen Duren",0,35,37,20,19,40.4
"3943",2024,4,0,1,3,1,5,1,12,9,29,4,2,12,5,1,1,1038032,"2023-12-30T00:00:00.000Z",38017682,9,"Jaden Ivey",1,17,21,16,9,26
"3944",2025,12,0,3,4,2,20,9,10,10,38,0,4,30,3,1,0,1038032,"2023-12-30T00:00:00.000Z",17896075,9,"Cade Cunningham",1,33,45,42,15,54.6
"3945",2026,1,0,0,1,0,2,1,0,0,9,0,1,2,0,0,0,1037600,"2023-10-25T00:00:00.000Z",19465585,16,"Dru Smith",0,2,3,3,1,3.5
"3946",2027,0,0,0,0,0,0,0,0,0,0,0,0,0,0,0,0,1037600,"2023-10-25T00:00:00.000Z",38017734,16,"Jamal Cain",0,0,0,0,0,0
"3947",2028,0,0,0,0,0,0,0,0,0,0,0,0,0,0,0,0,1037600,"2023-10-25T00:00:00.000Z",3547257,16,"R.J. Hampton",0,0,0,0,0,0
"3948",2029,0,0,0,0,0,0,0,0,0,0,0,0,0,0,0,0,1037600,"2023-10-25T00:00:00.000Z",38017696,16,"Nikola Jovic",0,0,0,0,0,0
"3949",2030,0,0,0,0,0,0,0,0,0,0,0,0,0,0,0,0,1037600,"2023-10-25T00:00:00.000Z",39398582,16,"Orlando Robinson",0,0,0,0,0,0
"3950",2031,0,0,0,0,0,0,0,0,0,0,0,0,0,0,0,0,1037600,"2023-10-25T00:00:00.000Z",3092,16,"Haywood Highsmith",0,0,0,0,0,0
"3951",2032,0,0,0,0,0,0,0,0,0,0,0,0,0,0,0,0,1037600,"2023-10-25T00:00:00.000Z",391,16,"Josh Richardson",0,0,0,0,0,0
"3952",2033,0,0,0,0,0,0,0,0,0,0,0,0,0,0,0,0,1037600,"2023-10-25T00:00:00.000Z",38017736,16,"Cole Swider",0,0,0,0,0,0
"3953",2034,3,5,4,2,1,7,1,2,1,27,3,2,4,7,0,2,1037600,"2023-10-25T00:00:00.000Z",56677826,9,"Ausar Thompson",5,11,14,7,10,29.9
"3954",2035,2,0,8,3,2,11,6,0,0,35,6,3,14,14,0,1,1037600,"2023-10-25T00:00:00.000Z",3547267,9,"Isaiah Stewart",0,28,30,16,16,32.8
"3955",2036,4,4,8,0,0,11,8,3,1,32,6,4,17,14,0,4,1037600,"2023-10-25T00:00:00.000Z",38017694,9,"Jalen Duren",4,31,35,21,18,47.8
"3956",2037,3,1,1,6,0,12,4,3,2,30,0,2,10,1,2,1,1037600,"2023-10-25T00:00:00.000Z",3547241,9,"Killian Hayes",3,11,14,13,4,23.7
"3957",2038,9,1,3,9,4,27,13,0,0,36,0,5,30,3,1,3,1037600,"2023-10-25T00:00:00.000Z",17896075,9,"Cade Cunningham",2,33,42,39,12,50.1
"3958",2039,3,1,6,0,0,3,3,2,2,16,2,1,8,8,0,1,1037600,"2023-10-25T00:00:00.000Z",24,9,"Marvin Bagley III",1,16,19,11,11,24.1
"3959",2040,3,0,2,2,0,7,1,3,2,17,0,3,4,2,0,3,1037600,"2023-10-25T00:00:00.000Z",38017682,9,"Jaden Ivey",0,6,9,7,5,7.9
"3960",2041,0,1,5,5,2,8,2,2,1,25,0,1,7,5,0,0,1037600,"2023-10-25T00:00:00.000Z",77,9,"Alec Burks",1,12,12,7,5,16
"3961",2042,1,0,2,3,2,4,3,0,0,10,0,0,8,2,0,1,1037600,"2023-10-25T00:00:00.000Z",56677792,9,"Marcus Sasser",0,10,11,9,3,10.9
"3962",2043,0,0,0,2,0,2,0,0,0,12,0,2,0,0,0,0,1037600,"2023-10-25T00:00:00.000Z",197,9,"Joe Harris",0,0,0,0,0,0
"3963",2044,0,0,0,0,0,0,0,0,0,0,0,0,0,0,0,0,1037600,"2023-10-25T00:00:00.000Z",56677729,9,"Malcolm Cazalon",0,0,0,0,0,0
"3964",2045,0,0,0,0,0,0,0,0,0,0,0,0,0,0,0,0,1037600,"2023-10-25T00:00:00.000Z",42097199,9,"Jared Rhoden",0,0,0,0,0,0
"3965",2046,4,0,4,2,0,12,6,9,8,35,2,4,20,6,3,3,1037599,"2023-10-25T00:00:00.000Z",61,3,"Mikal Bridges",3,26,30,24,10,39.2
"3966",2047,3,0,3,4,1,10,5,2,1,26,2,1,12,5,2,2,1037599,"2023-10-25T00:00:00.000Z",666679,3,"Cameron Johnson",2,17,20,15,8,26.5
"3967",2048,4,3,3,0,0,10,3,1,1,28,4,1,7,7,0,0,1037599,"2023-10-25T00:00:00.000Z",666508,3,"Nicolas Claxton",3,14,18,11,11,30.4
"3968",2049,3,0,1,3,1,3,1,2,2,24,0,2,5,1,0,1,1037599,"2023-10-25T00:00:00.000Z",130,3,"Spencer Dinwiddie",0,6,9,8,4,9.7
"3969",2050,9,1,9,0,0,6,2,0,0,23,1,2,4,10,0,2,1037599,"2023-10-25T00:00:00.000Z",417,3,"Ben Simmons",1,14,23,13,19,30.5
"3970",2051,1,0,2,4,0,11,3,0,0,16,0,0,6,2,2,0,3277402,"2023-11-10T00:00:00.000Z",38017692,27,"Malaki Branham",2,8,9,7,3,15.9
"3971",2052,2,0,1,3,1,4,2,2,1,12,0,0,6,1,0,0,1037707,"2023-11-08T00:00:00.000Z",38017679,7,"Jaden Hardy",0,7,9,8,3,10.2
"3972",2053,7,2,8,4,0,15,4,8,6,39,6,2,14,14,4,0,1037707,"2023-11-08T00:00:00.000Z",17896055,28,"Scottie Barnes",6,28,35,21,21,59.3
"3973",2054,5,1,2,4,1,13,7,4,3,30,0,4,18,2,2,2,1037707,"2023-11-08T00:00:00.000Z",409,28,"Dennis Schroder",3,20,25,23,7,34.9
"3974",2055,1,0,2,8,4,11,6,0,0,26,0,0,16,2,1,0,1037707,"2023-11-08T00:00:00.000Z",3089,28,"Gary Trent Jr.",1,18,19,17,3,22.9
"3975",2056,0,0,0,0,0,1,0,0,0,6,0,1,0,0,0,2,1037707,"2023-11-08T00:00:00.000Z",56677828,28,"Gradey Dick",0,0,0,0,0,-2
"3976",2057,3,0,4,4,2,5,2,2,2,15,0,2,8,4,0,0,1037707,"2023-11-08T00:00:00.000Z",3547275,28,"Malachi Flynn",0,12,15,11,7,17.3
"3977",2058,0,0,3,2,0,3,0,0,0,15,0,1,0,3,1,0,1037707,"2023-11-08T00:00:00.000Z",376,28,"Otto Porter Jr.",1,3,3,0,3,6.6
"3978",2059,2,0,5,2,0,13,7,5,4,27,1,1,18,6,0,3,1037702,"2023-11-08T00:00:00.000Z",237,14,"LeBron James",0,24,26,20,8,25.2
"3979",2060,2,2,6,8,3,17,7,0,0,37,2,1,17,8,0,0,1037708,"2023-11-08T00:00:00.000Z",375,8,"Michael Porter Jr.",2,25,27,19,10,35.6
"3980",2061,3,1,7,2,1,14,5,4,3,34,4,2,14,11,3,2,1037708,"2023-11-08T00:00:00.000Z",177,8,"Aaron Gordon",4,25,28,17,14,41.7
"3981",2062,5,1,10,8,1,25,14,10,6,37,3,3,35,13,3,3,1037708,"2023-11-08T00:00:00.000Z",246,8,"Nikola Jokic",4,48,53,40,18,67.1
"3982",2063,3,0,2,3,0,8,3,4,4,35,1,3,10,3,1,0,1037708,"2023-11-08T00:00:00.000Z",81,8,"Kentavious Caldwell-Pope",1,13,16,13,6,21.1
"3983",2064,6,0,2,7,3,17,8,2,1,32,0,5,20,2,0,0,1037708,"2023-11-08T00:00:00.000Z",236,8,"Reggie Jackson",0,22,28,26,8,31.4
"3984",2065,1,0,0,2,1,2,1,0,0,16,0,2,3,0,0,1,1037708,"2023-11-08T00:00:00.000Z",38017727,8,"Collin Gillespie",0,3,4,4,1,3.5
"3985",2066,2,0,2,2,1,3,1,2,1,16,0,1,4,2,0,0,1037708,"2023-11-08T00:00:00.000Z",38017709,8,"Christian Braun",0,6,8,6,4,9.4
"3986",2067,0,0,0,0,0,0,0,0,0,0,0,0,0,0,0,0,3277397,"2023-11-10T00:00:00.000Z",17554001,23,"Javonte Smart",0,0,0,0,0,0
"3987",2068,0,0,0,0,0,0,0,0,0,0,0,0,0,0,0,0,3277397,"2023-11-10T00:00:00.000Z",56677788,23,"Terquavion Smith",0,0,0,0,0,0
"3988",2069,2,1,2,1,1,7,3,5,3,21,0,5,10,2,2,0,3277400,"2023-11-10T00:00:00.000Z",66,11,"Dillon Brooks",3,12,14,12,4,24.4
"3989",2070,2,0,6,4,1,8,2,1,1,23,1,3,6,7,0,2,3277400,"2023-11-10T00:00:00.000Z",38017684,11,"Jabari Smith Jr.",0,13,15,8,9,15.4
"3990",2071,3,1,4,2,0,15,11,5,2,34,4,3,24,8,2,4,3277400,"2023-11-10T00:00:00.000Z",17896062,11,"Alperen Sengun",3,32,35,27,11,43.1
"3991",2072,1,0,4,8,2,18,7,10,9,35,0,1,25,4,0,1,3277400,"2023-11-10T00:00:00.000Z",17895966,11,"Jalen Green",0,29,30,26,5,30.3
"3992",2073,8,1,2,9,4,15,7,2,2,40,1,2,20,3,1,1,3277400,"2023-11-10T00:00:00.000Z",458,11,"Fred VanVleet",2,23,31,28,11,40.6
"3993",2074,2,0,3,4,1,7,3,0,0,24,0,4,7,3,3,0,3277400,"2023-11-10T00:00:00.000Z",3547301,11,"Jae'Sean Tate",3,10,12,9,5,22.6
"3994",2075,2,0,0,3,1,5,1,2,2,14,0,0,5,0,1,0,3277400,"2023-11-10T00:00:00.000Z",213,11,"Aaron Holiday",1,5,7,7,2,11
"3995",2076,0,0,0,0,0,0,0,0,0,0,0,0,0,0,0,0,1037824,"2023-11-25T00:00:00.000Z",417,3,"Ben Simmons",0,0,0,0,0,0
"3996",2077,0,0,0,0,0,0,0,0,0,0,0,0,0,0,0,0,1037824,"2023-11-25T00:00:00.000Z",421,3,"Dennis Smith Jr.",0,0,0,0,0,0
"3997",2078,0,0,0,0,0,0,0,0,0,0,0,0,0,0,0,0,1037824,"2023-11-25T00:00:00.000Z",17896048,3,"Cam Thomas",0,0,0,0,0,0
"3998",2079,0,0,0,0,0,0,0,0,0,0,0,0,0,0,0,0,1037824,"2023-11-25T00:00:00.000Z",56677722,3,"Jalen Wilson",0,0,0,0,0,0
"3999",2080,4,0,4,3,2,15,8,0,0,31,1,1,18,5,1,2,1037824,"2023-11-25T00:00:00.000Z",56677785,16,"Jaime Jaquez Jr.",1,23,27,22,9,31
"4000",2081,0,1,3,3,2,7,3,0,0,15,1,2,8,4,0,1,1037824,"2023-11-25T00:00:00.000Z",3092,16,"Haywood Highsmith",1,12,12,8,4,14.8
"4001",2082,0,1,3,7,2,8,3,2,2,26,0,1,10,3,0,2,1037827,"2023-11-25T00:00:00.000Z",38017739,29,"Simone Fontecchio",1,13,13,10,3,14.6
"4002",2083,0,0,7,2,0,11,5,2,2,24,2,1,12,9,0,3,1037827,"2023-11-25T00:00:00.000Z",101,29,"John Collins",0,21,21,12,9,19.8
"4003",2084,0,2,5,3,0,6,3,0,0,27,2,0,6,7,1,0,1037827,"2023-11-25T00:00:00.000Z",11891374,29,"Omer Yurtseven",3,13,13,6,7,23.4
"4004",2085,2,0,2,0,0,7,4,0,0,19,1,3,8,3,2,2,1037827,"2023-11-25T00:00:00.000Z",139,29,"Kris Dunn",2,11,13,10,5,18.6
"4005",2086,5,0,6,9,4,13,4,5,3,27,0,2,15,6,0,5,1037827,"2023-11-25T00:00:00.000Z",56677834,29,"Keyonte George",0,21,26,20,11,24.7
"4006",2087,6,0,1,8,3,13,5,4,3,28,2,0,16,3,0,2,1037827,"2023-11-25T00:00:00.000Z",413,29,"Collin Sexton",0,19,25,22,9,26.6
"4007",2088,0,2,5,1,0,10,5,1,1,21,6,5,11,11,1,3,1037827,"2023-11-25T00:00:00.000Z",38017705,29,"Walker Kessler",3,22,22,11,11,30.2
"4008",2089,4,0,3,3,1,5,2,0,0,22,0,1,5,3,0,2,1037827,"2023-11-25T00:00:00.000Z",666650,29,"Talen Horton-Tucker",0,8,12,9,7,12.6
"4009",2090,3,0,1,7,2,8,3,1,1,22,0,1,9,1,3,1,1037827,"2023-11-25T00:00:00.000Z",38017620,29,"Ochai Agbaji",3,10,13,12,4,22.7
"4010",2091,3,1,5,3,3,6,4,2,2,24,1,0,13,6,1,3,1037827,"2023-11-25T00:00:00.000Z",358,29,"Kelly Olynyk",2,19,22,16,9,27.7
"4011",2092,0,0,0,0,0,0,0,0,0,0,0,0,0,0,0,0,1037827,"2023-11-25T00:00:00.000Z",666881,29,"Luka Samanic",0,0,0,0,0,0
"4012",2093,0,0,0,0,0,0,0,0,0,0,0,0,0,0,0,0,1037827,"2023-11-25T00:00:00.000Z",17896023,29,"Josh Christopher",0,0,0,0,0,0
"4013",2094,0,1,2,0,0,3,2,1,1,18,1,1,5,3,0,2,1037826,"2023-11-25T00:00:00.000Z",3547247,6,"Isaac Okoro",1,8,8,5,3,9.6
"4014",2095,1,0,1,1,1,7,5,0,0,17,0,2,11,1,0,1,1037826,"2023-11-25T00:00:00.000Z",56677872,6,"Craig Porter",0,12,13,12,2,12.7
"4015",2096,0,0,0,0,0,0,0,0,0,0,0,0,0,0,0,0,1037826,"2023-11-25T00:00:00.000Z",444,6,"Tristan Thompson",0,0,0,0,0,0
"4016",2097,0,0,0,0,0,0,0,0,0,0,0,0,0,0,0,0,1037826,"2023-11-25T00:00:00.000Z",56677847,6,"Emoni Bates",0,0,0,0,0,0
"4017",2098,0,0,0,0,0,0,0,0,0,0,0,0,0,0,0,0,1037826,"2023-11-25T00:00:00.000Z",666676,6,"Ty Jerome",0,0,0,0,0,0
"4018",2099,0,0,0,0,0,0,0,0,0,0,0,0,0,0,0,0,1037826,"2023-11-25T00:00:00.000Z",38017662,6,"Isaiah Mobley",0,0,0,0,0,0
"4019",2100,0,0,0,0,0,0,0,0,0,0,0,0,0,0,0,0,1037826,"2023-11-25T00:00:00.000Z",404,6,"Ricky Rubio",0,0,0,0,0,0
"4020",2101,3,0,9,0,0,7,4,0,0,39,1,1,8,10,0,3,1037911,"2023-12-14T00:00:00.000Z",9,6,"Jarrett Allen",0,18,21,11,13,21.5
"4021",2102,0,0,0,0,0,0,0,0,0,0,0,0,0,0,0,0,1037912,"2023-12-14T00:00:00.000Z",45969255,5,"Justin Lewis",0,0,0,0,0,0
"4022",2103,0,0,0,0,0,0,0,0,0,0,0,0,0,0,0,0,1037912,"2023-12-14T00:00:00.000Z",56677860,5,"Adama Sanogo",0,0,0,0,0,0
"4023",2104,6,0,7,8,2,24,12,5,5,40,1,2,31,8,1,3,1037911,"2023-12-14T00:00:00.000Z",322,6,"Donovan Mitchell",1,39,45,37,14,49.6
"4024",2105,0,0,0,0,0,0,0,0,0,0,0,0,0,0,0,0,1037912,"2023-12-14T00:00:00.000Z",3092,16,"Haywood Highsmith",0,0,0,0,0,0
"4025",2106,0,0,0,0,0,0,0,0,0,0,0,0,0,0,0,0,1037912,"2023-12-14T00:00:00.000Z",38017696,16,"Nikola Jovic",0,0,0,0,0,0
"4026",2107,0,0,0,0,0,0,0,0,0,0,0,0,0,0,0,0,1037912,"2023-12-14T00:00:00.000Z",391,16,"Josh Richardson",0,0,0,0,0,0
"4027",2108,0,0,0,0,0,0,0,0,0,0,0,0,0,0,0,0,1037912,"2023-12-14T00:00:00.000Z",19465585,16,"Dru Smith",0,0,0,0,0,0
"4028",2109,4,0,3,3,1,14,6,11,10,41,2,2,23,5,0,3,1037912,"2023-12-14T00:00:00.000Z",125,5,"DeMar DeRozan",0,28,32,27,9,32
"4029",2110,3,0,1,7,3,19,8,0,0,36,1,2,19,2,2,5,1037911,"2023-12-14T00:00:00.000Z",666581,6,"Darius Garland",2,21,24,22,5,26.9
"4030",2111,5,1,2,6,3,16,9,6,5,35,1,2,26,3,3,1,1037911,"2023-12-14T00:00:00.000Z",277,6,"Caris LeVert",4,29,34,31,8,48.1
"4031",2112,2,0,3,1,1,2,2,2,2,18,1,3,7,4,1,1,1037911,"2023-12-14T00:00:00.000Z",3547247,6,"Isaac Okoro",1,11,13,9,6,16.8
"4032",2113,0,0,2,2,0,4,1,2,2,22,0,2,4,2,0,1,1037911,"2023-12-14T00:00:00.000Z",344,6,"Georges Niang",0,6,6,4,2,5.4
"4033",2114,0,0,1,0,0,1,1,0,0,3,1,1,2,2,0,1,1037911,"2023-12-14T00:00:00.000Z",444,6,"Tristan Thompson",0,4,4,2,2,3.4
"4034",2115,0,0,0,0,0,0,0,0,0,0,0,0,0,0,0,0,1037911,"2023-12-14T00:00:00.000Z",248,6,"Damian Jones",0,0,0,0,0,0
"4035",2116,0,0,0,0,0,0,0,0,0,0,0,0,0,0,0,0,1037911,"2023-12-14T00:00:00.000Z",3547299,6,"Sam Merrill",0,0,0,0,0,0
"4036",2117,0,0,0,0,0,0,0,0,0,0,0,0,0,0,0,0,1037911,"2023-12-14T00:00:00.000Z",56677872,6,"Craig Porter",0,0,0,0,0,0
"4037",2118,0,0,0,0,0,0,0,0,0,0,0,0,0,0,0,0,1037912,"2023-12-14T00:00:00.000Z",4,16,"Bam Adebayo",0,0,0,0,0,0
"4038",2119,0,0,0,0,0,0,0,0,0,0,0,0,0,0,0,0,1037912,"2023-12-14T00:00:00.000Z",38017736,16,"Cole Swider",0,0,0,0,0,0
"4039",2120,0,0,0,0,0,0,0,0,0,0,0,0,0,0,0,0,1037912,"2023-12-14T00:00:00.000Z",666633,16,"Tyler Herro",0,0,0,0,0,0
"4040",2121,0,0,4,6,1,8,1,0,0,30,0,3,3,4,2,0,1037913,"2023-12-14T00:00:00.000Z",247,7,"Derrick Jones Jr.",2,7,7,3,4,13.8
"4041",2122,1,0,3,7,1,11,2,0,0,36,0,3,5,3,1,1,1037913,"2023-12-14T00:00:00.000Z",666965,7,"Grant Williams",1,8,9,6,4,12.1
"4042",2123,0,2,3,0,0,9,7,2,1,32,3,3,15,6,1,2,1037913,"2023-12-14T00:00:00.000Z",56677840,7,"Dereck Lively II",3,21,21,15,6,29.2
"4043",2124,4,0,4,3,2,6,5,2,2,28,0,2,14,4,0,2,1037913,"2023-12-14T00:00:00.000Z",151,7,"Dante Exum",0,18,22,18,8,22.8
"4044",2125,13,0,5,7,2,27,15,7,7,39,1,2,39,6,2,8,1037913,"2023-12-14T00:00:00.000Z",132,7,"Luka Doncic",2,45,58,52,19,63.7
"4045",2126,0,0,0,0,0,0,0,0,0,0,0,0,0,0,0,0,1038036,"2023-12-30T00:00:00.000Z",24489167,7,"Brandon Williams",0,0,0,0,0,0
"4046",2127,0,0,2,1,0,1,0,0,0,8,0,0,0,2,0,0,1038037,"2023-12-31T00:00:00.000Z",319,1,"Patty Mills",0,2,2,0,2,2.4
"4047",2128,0,0,0,0,0,0,0,0,0,0,0,0,0,0,0,0,1038037,"2023-12-31T00:00:00.000Z",301,1,"Wesley Matthews",0,0,0,0,0,0
"4048",2129,0,0,0,0,0,0,0,0,0,0,0,0,0,0,0,0,1038037,"2023-12-31T00:00:00.000Z",56677838,1,"Kobe Bufkin",0,0,0,0,0,0
"4049",2130,6,0,7,0,0,3,1,0,0,33,2,3,2,9,4,1,1038033,"2023-12-30T00:00:00.000Z",201,20,"Isaiah Hartenstein",4,11,17,8,15,32.8
"4050",2131,0,0,0,0,0,0,0,0,0,0,0,0,0,0,0,0,1038037,"2023-12-31T00:00:00.000Z",56677806,1,"Mouhamed Gueye",0,0,0,0,0,0
"4051",2132,0,0,0,0,0,0,0,0,0,0,0,0,0,0,0,0,1038037,"2023-12-31T00:00:00.000Z",666656,1,"De'Andre Hunter",0,0,0,0,0,0
"4052",2133,0,0,0,0,0,0,0,0,0,0,0,0,0,0,0,0,1038037,"2023-12-31T00:00:00.000Z",4197387,1,"Vit Krejci",0,0,0,0,0,0
"4053",2134,0,0,0,0,0,0,0,0,0,0,0,0,0,0,0,0,1038037,"2023-12-31T00:00:00.000Z",56677855,1,"Seth Lundy",0,0,0,0,0,0
"4054",2135,0,0,0,0,0,0,0,0,0,0,0,0,0,0,0,0,1038037,"2023-12-31T00:00:00.000Z",3547244,1,"Onyeka Okongwu",0,0,0,0,0,0
"4055",2136,0,0,0,0,0,0,0,0,0,0,0,0,0,0,0,0,1038028,"2023-12-29T00:00:00.000Z",56677848,4,"Amari Bailey",0,0,0,0,0,0
"4056",2137,0,0,0,0,0,0,0,0,0,0,0,0,0,0,0,0,1038028,"2023-12-29T00:00:00.000Z",3547239,4,"LaMelo Ball",0,0,0,0,0,0
"4057",2138,0,0,0,0,0,0,0,0,0,0,0,0,0,0,0,0,1038028,"2023-12-29T00:00:00.000Z",56677866,4,"Leaky Black",0,0,0,0,0,0
"4058",2139,0,0,0,0,0,0,0,0,0,0,0,0,0,0,0,0,1038028,"2023-12-29T00:00:00.000Z",204,4,"Gordon Hayward",0,0,0,0,0,0
"4059",2140,0,0,0,0,0,0,0,0,0,0,0,0,0,0,0,0,1038028,"2023-12-29T00:00:00.000Z",347,4,"Frank Ntilikina",0,0,0,0,0,0
"4060",2141,0,0,0,0,0,0,0,0,0,0,0,0,0,0,0,0,1038028,"2023-12-29T00:00:00.000Z",38017698,4,"Mark Williams",0,0,0,0,0,0
"4061",2142,2,1,4,11,7,21,15,1,1,36,2,2,38,6,4,1,1038033,"2023-12-30T00:00:00.000Z",131,20,"Donte DiVincenzo",5,44,46,40,8,62.2
"4062",2143,2,0,3,8,5,9,6,0,0,20,0,2,17,3,0,1,1038041,"2023-12-31T00:00:00.000Z",254,15,"Luke Kennard",0,20,22,19,5,22.6
"4063",2144,0,0,0,0,0,0,0,0,0,5,0,0,0,0,0,0,1038041,"2023-12-31T00:00:00.000Z",666703,15,"John Konchar",0,0,0,0,0,0
"4064",2145,0,0,1,2,2,2,2,2,1,16,0,1,7,1,0,2,1038039,"2023-12-31T00:00:00.000Z",3547272,21,"Isaiah Joe",0,8,8,7,1,6.2
"4065",2146,0,0,0,0,0,0,0,0,0,0,0,0,0,0,0,0,1038039,"2023-12-31T00:00:00.000Z",44,21,"Davis Bertans",0,0,0,0,0,0
"4066",2147,3,1,4,5,4,10,7,0,0,30,0,4,18,4,0,0,1038039,"2023-12-31T00:00:00.000Z",666541,21,"Luguentz Dort",1,22,25,21,7,30.3
"4067",2148,0,0,0,0,0,0,0,0,0,0,0,0,0,0,0,0,1038039,"2023-12-31T00:00:00.000Z",17896036,21,"Tre Mann",0,0,0,0,0,0
"4068",2149,5,1,3,3,1,14,7,4,2,29,0,1,17,3,0,3,1038039,"2023-12-31T00:00:00.000Z",38017703,21,"Jalen Williams",1,20,25,22,8,28.1
"4069",2150,3,2,10,5,3,10,7,2,1,32,0,3,18,10,0,3,1038039,"2023-12-31T00:00:00.000Z",38017685,21,"Chet Holmgren",2,28,31,21,13,37.5
"4070",2151,0,0,0,0,0,0,0,0,0,0,0,0,0,0,0,0,1037601,"2023-10-25T00:00:00.000Z",666767,18,"Jordan McLaughlin",0,0,0,0,0,0
"4071",2152,0,0,0,0,0,0,0,0,0,0,0,0,0,0,0,0,1037599,"2023-10-25T00:00:00.000Z",3547299,6,"Sam Merrill",0,0,0,0,0,0
"4072",2153,0,0,0,0,0,0,0,0,0,0,0,0,0,0,0,0,1037599,"2023-10-25T00:00:00.000Z",38017662,6,"Isaiah Mobley",0,0,0,0,0,0
"4073",2154,0,0,0,0,0,0,0,0,0,0,0,0,0,0,0,0,1037599,"2023-10-25T00:00:00.000Z",444,6,"Tristan Thompson",0,0,0,0,0,0
"4074",2155,0,0,0,0,0,0,0,0,0,0,0,0,0,0,0,0,1037599,"2023-10-25T00:00:00.000Z",9,6,"Jarrett Allen",0,0,0,0,0,0
"4075",2156,0,0,0,0,0,0,0,0,0,0,0,0,0,0,0,0,1037599,"2023-10-25T00:00:00.000Z",56677872,6,"Craig Porter",0,0,0,0,0,0
"4076",2157,0,0,0,0,0,0,0,0,0,0,0,0,0,0,0,0,1037599,"2023-10-25T00:00:00.000Z",404,6,"Ricky Rubio",0,0,0,0,0,0
"4077",2158,0,0,0,0,0,0,0,0,0,0,0,0,0,0,0,0,1037599,"2023-10-25T00:00:00.000Z",666940,6,"Dean Wade",0,0,0,0,0,0
"4078",2159,1,0,1,3,1,7,2,0,0,20,1,0,5,2,0,0,1037595,"2023-10-25T00:00:00.000Z",18678001,4,"JT Thor",0,7,8,6,3,8.9
"4079",2160,1,1,3,0,0,2,2,4,3,18,1,3,7,4,0,2,1037595,"2023-10-25T00:00:00.000Z",3547282,4,"Nick Richards",1,11,12,8,5,14.3
"4080",2161,4,0,3,2,0,5,2,0,0,16,0,3,4,3,0,1,1037595,"2023-10-25T00:00:00.000Z",3547253,4,"Theo Maledon",0,7,11,8,7,12.6
"4081",2162,0,0,0,0,0,0,0,0,0,1,0,0,0,0,0,0,1037595,"2023-10-25T00:00:00.000Z",56677846,4,"Nick Smith Jr.",0,0,0,0,0,0
"4082",2163,0,0,0,0,0,0,0,0,0,0,0,0,0,0,0,0,1037595,"2023-10-25T00:00:00.000Z",56677848,4,"Amari Bailey",0,0,0,0,0,0
"4083",2164,0,0,0,0,0,0,0,0,0,0,0,0,0,0,0,0,1037595,"2023-10-25T00:00:00.000Z",56677866,4,"Leaky Black",0,0,0,0,0,0
"4084",2165,0,0,0,0,0,0,0,0,0,0,0,0,0,0,0,0,1037595,"2023-10-25T00:00:00.000Z",17896037,4,"James Bouknight",0,0,0,0,0,0
"4085",2166,0,0,0,0,0,0,0,0,0,0,0,0,0,0,0,0,1037601,"2023-10-25T00:00:00.000Z",56677782,18,"Leonard Miller",0,0,0,0,0,0
"4086",2167,0,0,0,0,0,0,0,0,0,0,0,0,0,0,0,0,1037601,"2023-10-25T00:00:00.000Z",38017715,18,"Josh Minott",0,0,0,0,0,0
"4087",2168,0,0,0,0,0,0,0,0,0,0,0,0,0,0,0,0,1037601,"2023-10-25T00:00:00.000Z",38017700,18,"Wendell Moore Jr.",0,0,0,0,0,0
"4088",2169,0,1,5,8,4,11,6,1,1,35,1,4,17,6,0,3,1037605,"2023-10-25T00:00:00.000Z",666965,7,"Grant Williams",1,23,23,17,6,24.2
"4089",2170,2,1,5,5,2,7,2,0,0,23,2,3,6,7,0,0,1037605,"2023-10-25T00:00:00.000Z",257,7,"Maxi Kleber",1,13,15,8,9,20.4
"4090",2171,1,0,2,2,0,3,1,0,0,14,0,4,2,2,1,0,1037603,"2023-10-25T00:00:00.000Z",38017728,15,"Jake LaRavia",1,4,5,3,3,8.9
"4091",2172,3,0,1,4,2,11,3,0,0,16,1,0,8,2,0,0,1037603,"2023-10-25T00:00:00.000Z",401,15,"Derrick Rose",0,10,13,11,5,14.9
"4092",2173,0,0,0,0,0,0,0,0,0,0,0,0,0,0,0,0,1037603,"2023-10-25T00:00:00.000Z",38017732,15,"Kenneth Lofton Jr.",0,0,0,0,0,0
"4093",2174,0,0,0,0,0,0,0,0,0,0,0,0,0,0,0,0,1037603,"2023-10-25T00:00:00.000Z",666786,15,"Ja Morant",0,0,0,0,0,0
"4094",2175,0,0,0,0,0,0,0,0,0,0,0,0,0,0,0,0,1037603,"2023-10-25T00:00:00.000Z",38017731,15,"Vince Williams Jr.",0,0,0,0,0,0
"4095",2176,1,0,3,0,0,2,1,0,0,7,1,1,2,4,0,0,1037739,"2023-11-13T00:00:00.000Z",306,26,"JaVale McGee",0,6,7,3,5,8.3
"4096",2177,0,0,0,0,0,0,0,0,0,1,0,0,0,0,0,0,1037739,"2023-11-13T00:00:00.000Z",17896044,26,"Kessler Edwards",0,0,0,0,0,0
"4097",2178,0,0,0,0,0,0,0,0,0,1,0,0,0,0,0,0,1037739,"2023-11-13T00:00:00.000Z",56677845,26,"Colby Jones",0,0,0,0,0,0
"4098",2179,0,0,0,1,0,1,0,0,0,1,0,0,0,0,0,0,1037739,"2023-11-13T00:00:00.000Z",17895990,26,"Jordan Ford",0,0,0,0,0,0
"4099",2180,0,0,0,0,0,0,0,0,0,0,0,0,0,0,0,0,1037738,"2023-11-13T00:00:00.000Z",27,5,"Lonzo Ball",0,0,0,0,0,0
"4100",2181,0,0,0,0,0,0,0,0,0,0,0,0,0,0,0,0,1037738,"2023-11-13T00:00:00.000Z",56677874,5,"Onuralp Bitim",0,0,0,0,0,0
"4101",2182,0,0,0,0,0,0,0,0,0,0,0,0,0,0,0,0,1037738,"2023-11-13T00:00:00.000Z",45969255,5,"Justin Lewis",0,0,0,0,0,0
"4102",2183,0,0,0,0,0,0,0,0,0,0,0,0,0,0,0,0,1037738,"2023-11-13T00:00:00.000Z",56677860,5,"Adama Sanogo",0,0,0,0,0,0
"4103",2184,0,0,0,0,0,0,0,0,0,0,0,0,0,0,0,0,1037738,"2023-11-13T00:00:00.000Z",38017719,5,"Dalen Terry",0,0,0,0,0,0
"4104",2185,0,0,0,1,0,1,0,0,0,1,0,0,0,0,0,0,1037736,"2023-11-13T00:00:00.000Z",17896033,20,"Miles McBride",0,0,0,0,0,0
"4105",2186,0,0,0,0,0,0,0,0,0,1,0,0,0,0,0,0,1037736,"2023-11-13T00:00:00.000Z",17896063,20,"Jericho Sims",0,0,0,0,0,0
"4106",2187,0,0,0,0,0,0,0,0,0,0,0,0,0,0,0,0,1037736,"2023-11-13T00:00:00.000Z",666423,20,"RJ Barrett",0,0,0,0,0,0
"4107",2188,0,0,0,0,0,0,0,0,0,0,0,0,0,0,0,0,1037736,"2023-11-13T00:00:00.000Z",666675,20,"DaQuan Jeffries",0,0,0,0,0,0
"4108",2189,0,0,0,0,0,0,0,0,0,0,0,0,0,0,0,0,1037736,"2023-11-13T00:00:00.000Z",666474,20,"Charles Brown",0,0,0,0,0,0
"4109",2190,0,0,0,0,0,0,0,0,0,0,0,0,0,0,0,0,1037736,"2023-11-13T00:00:00.000Z",160,20,"Evan Fournier",0,0,0,0,0,0
"4110",2191,0,0,0,0,0,0,0,0,0,0,0,0,0,0,0,0,1037736,"2023-11-13T00:00:00.000Z",56677795,20,"Jacob Toppin",0,0,0,0,0,0
"4111",2192,0,0,0,0,0,0,0,0,0,0,0,0,0,0,0,0,1037736,"2023-11-13T00:00:00.000Z",17896089,20,"Duane Washington Jr.",0,0,0,0,0,0
"4112",2193,0,0,0,0,0,0,0,0,0,0,0,0,0,0,0,0,1037736,"2023-11-13T00:00:00.000Z",666971,20,"Dylan Windler",0,0,0,0,0,0
"4113",2194,4,1,4,5,3,8,4,2,2,26,1,2,13,5,1,2,1037739,"2023-11-13T00:00:00.000Z",324,26,"Malik Monk",2,18,22,17,9,29
"4114",2195,0,0,2,5,3,6,4,0,0,17,0,1,11,2,0,0,1037739,"2023-11-13T00:00:00.000Z",4197162,26,"Aleksandar Vezenkov",0,13,13,11,2,13.4
"4115",2196,0,0,0,0,0,0,0,0,0,0,0,0,0,0,0,0,1037739,"2023-11-13T00:00:00.000Z",17553994,26,"Davion Mitchell",0,0,0,0,0,0
"4116",2197,0,0,0,0,0,0,0,0,0,0,0,0,0,0,0,0,1037739,"2023-11-13T00:00:00.000Z",290,26,"Trey Lyles",0,0,0,0,0,0
"4117",2198,0,0,0,0,0,0,0,0,0,0,0,0,0,0,0,0,1037739,"2023-11-13T00:00:00.000Z",17895941,26,"Filip Petrusev",0,0,0,0,0,0
"4118",2199,0,0,0,0,0,0,0,0,0,0,0,0,0,0,0,0,1037739,"2023-11-13T00:00:00.000Z",56677862,26,"Jalen Slawson",0,0,0,0,0,0
"4119",2200,3,0,3,9,5,12,7,0,0,34,2,3,19,5,1,1,1037739,"2023-11-13T00:00:00.000Z",666908,6,"Max Strus",1,24,27,22,8,31.5
"4120",2201,0,0,0,0,0,0,0,0,0,0,0,0,0,0,0,0,1037850,"2023-11-29T00:00:00.000Z",666609,14,"Rui Hachimura",0,0,0,0,0,0
"4121",2202,0,0,0,0,0,0,0,0,0,0,0,0,0,0,0,0,1037850,"2023-11-29T00:00:00.000Z",457,14,"Jarred Vanderbilt",0,0,0,0,0,0
"4122",2203,0,0,0,0,0,0,0,0,0,0,0,0,0,0,0,0,1037850,"2023-11-29T00:00:00.000Z",1603383,14,"Gabe Vincent",0,0,0,0,0,0
"4123",2204,0,0,0,0,0,0,0,0,0,0,0,0,0,0,0,0,1037851,"2023-11-29T00:00:00.000Z",56677839,22,"Jett Howard",0,0,0,0,0,0
"4124",2205,0,0,0,0,0,0,0,0,0,0,0,0,0,0,0,0,1037851,"2023-11-29T00:00:00.000Z",17553983,22,"Trevelin Queen",0,0,0,0,0,0
"4125",2206,5,0,1,2,1,12,9,4,3,28,3,1,22,4,2,0,1037851,"2023-11-29T00:00:00.000Z",3547242,30,"Deni Avdija",2,26,31,27,9,40.3
"4126",2207,6,0,3,4,1,20,9,6,5,34,0,1,24,3,0,4,1037851,"2023-11-29T00:00:00.000Z",265,30,"Kyle Kuzma",0,27,33,30,9,32.6
"4127",2208,12,0,5,2,1,11,3,1,1,34,1,2,8,6,1,0,1037852,"2023-11-29T00:00:00.000Z",409,28,"Dennis Schroder",1,14,26,20,18,36.2
"4128",2209,1,0,4,1,1,10,5,4,3,18,6,2,14,10,2,1,1037852,"2023-11-29T00:00:00.000Z",3547249,28,"Precious Achiuwa",2,24,25,15,11,32.5
"4129",2210,1,0,4,3,0,3,0,2,2,14,1,0,2,5,0,1,1037852,"2023-11-29T00:00:00.000Z",3547275,28,"Malachi Flynn",0,7,8,3,6,8.5
"4130",2211,0,0,0,0,0,0,0,0,0,3,0,0,0,0,0,0,1037852,"2023-11-29T00:00:00.000Z",58,28,"Chris Boucher",0,0,0,0,0,0
"4131",2212,0,0,0,0,0,0,0,0,0,0,0,0,0,0,0,0,1037852,"2023-11-29T00:00:00.000Z",56677828,28,"Gradey Dick",0,0,0,0,0,0
"4132",2213,4,2,2,0,0,2,2,0,0,26,1,3,4,3,1,0,1037851,"2023-11-29T00:00:00.000Z",666577,30,"Daniel Gafford",3,7,11,8,7,22.6
"4133",2214,2,1,5,7,4,12,5,6,5,26,0,3,19,5,2,2,1037851,"2023-11-29T00:00:00.000Z",666848,30,"Jordan Poole",3,24,26,21,7,35
"4134",2215,4,0,3,2,0,10,3,2,1,21,0,1,7,3,2,0,1037851,"2023-11-29T00:00:00.000Z",249,30,"Tyus Jones",2,10,14,11,7,22.6
"4135",2216,0,0,4,1,1,5,2,2,2,25,1,1,7,5,0,2,1037851,"2023-11-29T00:00:00.000Z",56677844,30,"Bilal Coulibaly",0,12,12,7,5,11
"4136",2217,3,0,0,1,0,2,1,2,2,5,0,0,4,0,2,0,1037851,"2023-11-29T00:00:00.000Z",18677954,30,"Jared Butler",2,4,7,7,3,14.5
"4137",2218,0,0,0,0,0,0,0,0,0,0,0,0,0,0,0,0,1037851,"2023-11-29T00:00:00.000Z",38017704,30,"Patrick Baldwin Jr.",0,0,0,0,0,0
"4138",2219,0,0,0,0,0,0,0,0,0,0,0,0,0,0,0,0,1037852,"2023-11-29T00:00:00.000Z",376,28,"Otto Porter Jr.",0,0,0,0,0,0
"4139",2220,0,0,0,0,0,0,0,0,0,0,0,0,0,0,0,0,1037852,"2023-11-29T00:00:00.000Z",436,28,"Garrett Temple",0,0,0,0,0,0
"4140",2221,0,0,0,0,0,0,0,0,0,0,0,0,0,0,0,0,1037852,"2023-11-29T00:00:00.000Z",489,28,"Thaddeus Young",0,0,0,0,0,0
"4141",2222,0,0,0,0,0,0,0,0,0,0,0,0,0,0,0,0,1037852,"2023-11-29T00:00:00.000Z",56677805,28,"Javon Freeman-Liberty",0,0,0,0,0,0
"4142",2223,0,0,0,0,0,0,0,0,0,0,0,0,0,0,0,0,1037852,"2023-11-29T00:00:00.000Z",38017717,28,"Ron Harper Jr.",0,0,0,0,0,0
"4143",2224,0,0,0,0,0,0,0,0,0,0,0,0,0,0,0,0,1037852,"2023-11-29T00:00:00.000Z",38017710,28,"Christian Koloko",0,0,0,0,0,0
"4144",2225,0,0,0,0,0,0,0,0,0,0,0,0,0,0,0,0,1037852,"2023-11-29T00:00:00.000Z",56677869,28,"Markquis Nowell",0,0,0,0,0,0
"4145",2226,0,0,0,0,0,0,0,0,0,0,0,0,0,0,0,0,1037934,"2023-12-16T00:00:00.000Z",161,26,"De'Aaron Fox",0,0,0,0,0,0
"4146",2227,4,0,6,6,5,16,12,7,7,30,1,1,36,7,2,0,1037935,"2023-12-16T00:00:00.000Z",274,13,"Kawhi Leonard",2,43,47,40,11,56.4
"4147",2228,7,0,4,6,3,18,11,0,0,31,0,4,25,4,2,2,1037935,"2023-12-16T00:00:00.000Z",172,13,"Paul George",2,29,36,32,11,44.3
"4148",2229,2,2,7,0,0,9,5,4,3,28,4,2,13,11,1,0,1037935,"2023-12-16T00:00:00.000Z",493,13,"Ivica Zubac",3,24,26,15,13,38.2
"4149",2230,4,0,1,4,2,8,4,3,3,27,0,1,13,1,0,0,1037935,"2023-12-16T00:00:00.000Z",666743,13,"Terance Mann",0,14,18,17,5,20.2
"4150",2231,12,2,4,4,1,6,2,7,5,28,0,3,10,4,1,1,1037935,"2023-12-16T00:00:00.000Z",192,13,"James Harden",3,14,26,22,16,40.8
"4151",2232,0,1,2,2,1,10,6,3,3,24,0,1,16,2,0,1,1037935,"2023-12-16T00:00:00.000Z",380,13,"Norman Powell",1,18,18,16,2,20.4
"4152",2233,0,0,1,3,1,3,1,0,0,17,0,3,3,1,0,0,1037935,"2023-12-16T00:00:00.000Z",666511,13,"Amir Coffey",0,4,4,3,1,4.2
"4153",2234,0,0,1,0,0,3,1,6,5,15,0,4,7,1,1,0,1037935,"2023-12-16T00:00:00.000Z",439,13,"Daniel Theis",1,8,8,7,1,11.2
"4154",2235,2,0,2,3,1,3,1,0,0,5,0,1,3,2,0,0,1037935,"2023-12-16T00:00:00.000Z",17896022,13,"Brandon Boston Jr.",0,5,7,5,4,8.4
"4155",2236,0,0,1,0,0,0,0,0,0,5,0,0,0,1,0,1,1037935,"2023-12-16T00:00:00.000Z",56677856,13,"Jordan Miller",0,1,1,0,1,0.2
"4156",2237,0,1,0,1,0,2,1,0,0,5,0,0,2,0,0,3,1037935,"2023-12-16T00:00:00.000Z",17896051,13,"Joshua Primo",1,2,2,2,0,2
"4157",2238,1,0,2,0,0,0,0,0,0,5,0,0,0,2,0,0,1037935,"2023-12-16T00:00:00.000Z",24417679,13,"Xavier Moon",0,2,3,1,3,3.9
"4158",2239,0,0,0,3,2,3,2,0,0,5,0,0,6,0,0,0,1037935,"2023-12-16T00:00:00.000Z",56677849,13,"Kobe Brown",0,6,6,6,0,6
"4159",2240,0,0,2,5,1,9,3,0,0,25,0,0,7,2,0,0,1037934,"2023-12-16T00:00:00.000Z",38017739,29,"Simone Fontecchio",0,9,9,7,2,9.4
"4160",2241,3,0,5,5,2,13,7,2,2,28,1,2,18,6,0,2,1037934,"2023-12-16T00:00:00.000Z",297,29,"Lauri Markkanen",0,24,27,21,9,27.7
"4161",2242,13,1,5,2,1,7,4,0,0,29,0,3,9,5,1,1,1037934,"2023-12-16T00:00:00.000Z",358,29,"Kelly Olynyk",2,14,27,22,18,39.5
"4162",2243,1,0,2,6,2,18,10,7,6,33,1,2,28,3,1,1,1037934,"2023-12-16T00:00:00.000Z",413,29,"Collin Sexton",1,31,32,29,4,35.1
"4163",2244,3,1,3,4,1,10,5,0,0,27,1,1,11,4,1,6,1037934,"2023-12-16T00:00:00.000Z",139,29,"Kris Dunn",2,15,18,14,7,20.3
"4164",2245,1,1,2,0,0,0,0,4,2,19,1,2,2,3,0,1,1037934,"2023-12-16T00:00:00.000Z",38017705,29,"Walker Kessler",1,5,6,3,4,9.1
"4165",2246,5,0,2,4,2,11,4,3,2,26,1,0,12,3,3,1,1037934,"2023-12-16T00:00:00.000Z",666650,29,"Talen Horton-Tucker",3,15,20,17,8,31.1
"4166",2247,0,0,1,3,1,7,2,0,0,23,3,2,5,4,1,0,1037934,"2023-12-16T00:00:00.000Z",38017620,29,"Ochai Agbaji",1,9,9,5,4,12.8
"4167",2248,2,0,1,5,2,7,3,0,0,20,1,1,8,2,0,1,1037929,"2023-12-16T00:00:00.000Z",391,16,"Josh Richardson",0,10,12,10,4,12.4
"4168",2249,0,1,2,4,2,14,7,1,1,26,3,1,17,5,0,0,1037930,"2023-12-16T00:00:00.000Z",3547250,12,"Aaron Nesmith",1,22,22,17,5,26
"4169",2250,3,0,2,2,1,3,2,0,0,24,0,2,5,2,2,1,1037930,"2023-12-16T00:00:00.000Z",56677832,12,"Jarace Walker",2,7,10,8,5,16.9
"4170",2251,5,1,5,5,2,19,10,3,2,34,1,0,24,6,4,2,1038050,"2024-01-01T00:00:00.000Z",274,13,"Kawhi Leonard",5,30,35,29,11,51.7
"4171",2252,2,0,3,8,3,14,7,6,6,34,0,4,23,3,1,3,1038050,"2024-01-01T00:00:00.000Z",172,13,"Paul George",1,26,28,25,5,29.6
"4172",2253,1,0,11,0,0,4,3,0,0,29,1,4,6,12,0,1,1038050,"2024-01-01T00:00:00.000Z",493,13,"Ivica Zubac",0,18,19,7,13,20.9
"4173",2254,0,0,2,2,1,7,5,1,1,18,1,2,12,3,0,1,1038050,"2024-01-01T00:00:00.000Z",666743,13,"Terance Mann",0,15,15,12,3,14.6
"4174",2255,10,2,4,5,3,8,5,2,2,31,0,1,15,4,1,2,1038050,"2024-01-01T00:00:00.000Z",192,13,"James Harden",3,19,29,25,14,41.8
"4175",2256,3,0,2,1,0,10,4,0,0,18,2,0,8,4,2,2,1038050,"2024-01-01T00:00:00.000Z",472,13,"Russell Westbrook",2,12,15,11,7,21.3
"4176",2257,2,0,2,5,4,11,9,0,0,33,0,4,22,2,2,1,1038050,"2024-01-01T00:00:00.000Z",380,13,"Norman Powell",2,24,26,24,4,32.4
"4177",2258,2,0,0,2,1,3,2,0,0,18,1,2,5,1,0,0,1038050,"2024-01-01T00:00:00.000Z",666511,13,"Amir Coffey",0,6,8,7,3,9.2
"4178",2259,0,0,1,1,0,3,2,2,2,16,0,3,6,1,0,2,1038050,"2024-01-01T00:00:00.000Z",439,13,"Daniel Theis",0,7,7,6,1,5.2
"4179",2260,0,0,0,0,0,1,0,0,0,3,0,0,0,0,0,0,1038050,"2024-01-01T00:00:00.000Z",17896022,13,"Brandon Boston Jr.",0,0,0,0,0,0
"4180",2261,0,0,0,0,0,0,0,0,0,3,0,0,0,0,0,1,1038050,"2024-01-01T00:00:00.000Z",56677849,13,"Kobe Brown",0,0,0,0,0,-1
"4181",2262,0,0,1,0,0,0,0,0,0,3,0,0,0,1,0,0,1038050,"2024-01-01T00:00:00.000Z",38017725,13,"Moussa Diabate",0,1,1,0,1,1.2
"4182",2263,0,0,0,0,0,0,0,0,0,0,0,0,0,0,0,0,1038050,"2024-01-01T00:00:00.000Z",17896031,13,"Nah'Shon Hyland",0,0,0,0,0,0
"4183",2264,0,0,0,0,0,0,0,0,0,0,0,0,0,0,0,0,1038050,"2024-01-01T00:00:00.000Z",371,13,"Mason Plumlee",0,0,0,0,0,0
"4184",2265,0,0,0,0,0,0,0,0,0,0,0,0,0,0,0,0,1038050,"2024-01-01T00:00:00.000Z",450,13,"PJ Tucker",0,0,0,0,0,0
"4185",2266,5,0,2,4,2,8,3,2,2,21,0,0,10,2,0,2,1038048,"2024-01-01T00:00:00.000Z",65,25,"Malcolm Brogdon",0,12,17,15,7,17.9
"4186",2267,6,2,3,3,1,18,7,4,2,34,0,1,17,3,1,5,1038048,"2024-01-01T00:00:00.000Z",56677747,25,"Scoot Henderson",3,20,26,23,9,33.6
"4187",2268,1,1,5,0,0,2,2,0,0,23,0,6,4,5,0,2,1038048,"2024-01-01T00:00:00.000Z",39613724,25,"Ibou Badji",1,9,10,5,6,12.5
"4188",2269,1,0,0,5,0,8,2,2,2,18,1,0,6,1,0,1,1038048,"2024-01-01T00:00:00.000Z",38017690,25,"Shaedon Sharpe",0,7,8,7,2,7.7
"4189",2270,0,0,7,2,0,7,3,6,4,25,2,2,10,9,1,1,1038048,"2024-01-01T00:00:00.000Z",38017711,25,"Jabari Walker",1,19,19,10,9,22.8
"4190",2271,3,1,1,3,1,8,3,0,0,18,1,1,7,2,0,1,1038048,"2024-01-01T00:00:00.000Z",3547289,25,"Skylar Mays",1,9,12,10,5,15.9
"4191",2272,1,1,1,2,0,5,3,0,0,19,1,2,6,2,1,0,1038048,"2024-01-01T00:00:00.000Z",56677791,25,"Kris Murray",2,8,9,7,3,15.9
"4192",2273,0,1,1,4,2,5,2,2,2,12,0,2,8,1,0,1,1038048,"2024-01-01T00:00:00.000Z",17896120,25,"Ish Wainright",1,9,9,8,1,11.2
"4193",2274,0,0,0,0,0,0,0,0,0,0,0,0,0,0,0,0,1038048,"2024-01-01T00:00:00.000Z",56677850,25,"Toumani Camara",0,0,0,0,0,0
"4194",2275,0,0,0,0,0,0,0,0,0,0,0,0,0,0,0,0,1038048,"2024-01-01T00:00:00.000Z",22,25,"Deandre Ayton",0,0,0,0,0,0
"4195",2276,0,0,0,0,0,0,0,0,0,0,0,0,0,0,0,0,1037622,"2023-10-28T00:00:00.000Z",18677986,19,"Trey Murphy III",0,0,0,0,0,0
"4196",2277,0,0,0,0,0,0,0,0,0,0,0,0,0,0,0,0,1037622,"2023-10-28T00:00:00.000Z",38017726,19,"Dereon Seabron",0,0,0,0,0,0
"4197",2278,2,1,3,6,1,16,7,4,3,30,0,0,18,3,1,3,1037622,"2023-10-28T00:00:00.000Z",666423,20,"RJ Barrett",2,21,23,20,5,27.6
"4198",2279,4,0,12,5,0,15,4,2,2,34,0,4,10,12,0,8,1037622,"2023-10-28T00:00:00.000Z",387,20,"Julius Randle",0,22,26,14,16,22.4
"4199",2280,0,2,5,0,0,8,4,0,0,29,10,1,8,15,0,0,1037622,"2023-10-28T00:00:00.000Z",399,20,"Mitchell Robinson",2,23,23,8,15,32
"4200",2281,1,0,2,6,1,9,2,0,0,26,0,1,5,2,2,0,1037622,"2023-10-28T00:00:00.000Z",17895858,20,"Quentin Grimes",2,7,8,6,3,14.9
"4201",2282,0,0,3,2,0,6,1,3,3,12,1,2,5,4,1,1,1037624,"2023-10-28T00:00:00.000Z",58,28,"Chris Boucher",1,9,9,5,4,11.8
"4202",2283,0,0,0,0,0,0,0,0,0,0,0,0,0,0,0,0,1037624,"2023-10-28T00:00:00.000Z",56677805,28,"Javon Freeman-Liberty",0,0,0,0,0,0
"4203",2284,0,0,0,0,0,0,0,0,0,0,0,0,0,0,0,0,1037624,"2023-10-28T00:00:00.000Z",28,23,"Mo Bamba",0,0,0,0,0,0
"4204",2285,0,0,0,0,0,0,0,0,0,0,0,0,0,0,0,0,1037624,"2023-10-28T00:00:00.000Z",260,23,"Furkan Korkmaz",0,0,0,0,0,0
"4205",2286,0,0,0,0,0,0,0,0,0,0,0,0,0,0,0,0,1037624,"2023-10-28T00:00:00.000Z",17895941,23,"Filip Petrusev",0,0,0,0,0,0
"4206",2287,2,2,3,0,0,7,6,0,0,19,2,3,12,5,0,0,1037626,"2023-10-28T00:00:00.000Z",147,24,"Drew Eubanks",2,17,19,14,7,27
"4207",2288,5,0,3,5,2,9,2,6,6,25,2,2,12,5,1,2,1037626,"2023-10-28T00:00:00.000Z",18678058,24,"Jordan Goodwin",1,17,22,17,10,26.5
"4208",2289,0,1,3,4,1,7,2,2,2,20,1,2,7,4,2,0,1037626,"2023-10-28T00:00:00.000Z",470,24,"Yuta Watanabe",3,11,11,7,4,20.8
"4209",2290,0,0,1,5,0,8,3,0,0,21,0,2,6,1,1,0,1037626,"2023-10-28T00:00:00.000Z",666729,24,"Nassir Little",1,7,7,6,1,10.2
"4210",2291,0,2,1,0,0,0,0,0,0,4,0,0,0,1,0,2,1037626,"2023-10-28T00:00:00.000Z",666451,24,"Bol Bol",2,1,1,0,1,5.2
"4211",2292,2,1,0,1,0,2,1,0,0,4,0,0,2,0,0,0,1037626,"2023-10-28T00:00:00.000Z",3547298,24,"Saben Lee",1,2,4,4,2,8
"4212",2293,1,0,1,0,0,2,1,0,0,3,0,0,2,1,0,0,1037626,"2023-10-28T00:00:00.000Z",314,24,"Chimezie Metu",0,3,4,3,2,4.7
"4213",2294,0,0,0,0,0,0,0,0,0,0,0,0,0,0,0,0,1037626,"2023-10-28T00:00:00.000Z",37,24,"Bradley Beal",0,0,0,0,0,0
"4214",2295,0,0,0,0,0,0,0,0,0,0,0,0,0,0,0,0,1037626,"2023-10-28T00:00:00.000Z",57,24,"Devin Booker",0,0,0,0,0,0
"4215",2296,0,0,0,0,0,0,0,0,0,0,0,0,0,0,0,0,1037626,"2023-10-28T00:00:00.000Z",272,24,"Damion Lee",0,0,0,0,0,0
"4216",2297,4,1,1,7,2,12,4,0,0,19,0,1,10,1,0,1,1037623,"2023-10-28T00:00:00.000Z",210,12,"Buddy Hield",1,11,15,14,5,19.2
"4217",2298,0,0,5,9,5,16,10,2,1,30,4,1,26,9,0,0,1037623,"2023-10-28T00:00:00.000Z",3547250,12,"Aaron Nesmith",0,35,35,26,9,36.8
"4218",2299,3,0,4,3,2,7,5,2,1,19,2,2,13,6,0,1,1037623,"2023-10-28T00:00:00.000Z",3547264,12,"Jalen Smith",0,19,22,16,9,23.7
"4219",2300,0,0,0,0,0,0,0,0,0,0,0,0,0,0,0,0,1037623,"2023-10-28T00:00:00.000Z",3547207,12,"Jordan Nwora",0,0,0,0,0,0
"4220",2301,0,0,0,0,0,0,0,0,0,0,0,0,0,0,0,0,1037753,"2023-11-15T00:00:00.000Z",18,28,"OG Anunoby",0,0,0,0,0,0
"4221",2302,0,0,0,0,0,0,0,0,0,0,0,0,0,0,0,0,1037753,"2023-11-15T00:00:00.000Z",56677805,28,"Javon Freeman-Liberty",0,0,0,0,0,0
"4222",2303,0,0,0,2,0,3,0,0,0,8,0,0,0,0,0,1,1037752,"2023-11-15T00:00:00.000Z",328,23,"Marcus Morris",0,0,0,0,0,-1
"4223",2304,0,0,2,1,1,5,4,0,0,20,0,2,9,2,2,2,1037752,"2023-11-15T00:00:00.000Z",17896025,23,"Jaden Springer",2,11,11,9,2,15.4
"4224",2305,2,1,3,1,1,5,4,2,1,14,3,1,10,6,0,1,1037752,"2023-11-15T00:00:00.000Z",3547270,23,"Paul Reed",1,16,18,12,8,22.2
"4225",2306,0,0,0,0,0,0,0,0,0,0,0,0,0,0,0,0,1037752,"2023-11-15T00:00:00.000Z",3547294,23,"Kenyon Martin Jr.",0,0,0,0,0,0
"4226",2307,0,0,0,0,0,0,0,0,0,0,0,0,0,0,0,0,1037752,"2023-11-15T00:00:00.000Z",33,23,"Nicolas Batum",0,0,0,0,0,0
"4227",2308,0,0,0,0,0,0,0,0,0,0,0,0,0,0,0,0,1037752,"2023-11-15T00:00:00.000Z",56913527,23,"Ricky Council IV",0,0,0,0,0,0
"4228",2309,0,0,0,0,0,0,0,0,0,0,0,0,0,0,0,0,1037752,"2023-11-15T00:00:00.000Z",360,23,"Kelly Oubre Jr.",0,0,0,0,0,0
"4229",2310,0,0,0,0,0,0,0,0,0,0,0,0,0,0,0,0,1037752,"2023-11-15T00:00:00.000Z",17554001,23,"Javonte Smart",0,0,0,0,0,0
"4230",2311,0,0,0,0,0,0,0,0,0,0,0,0,0,0,0,0,1037751,"2023-11-15T00:00:00.000Z",56677806,1,"Mouhamed Gueye",0,0,0,0,0,0
"4231",2312,0,0,0,0,0,0,0,0,0,0,0,0,0,0,0,0,1037751,"2023-11-15T00:00:00.000Z",56677855,1,"Seth Lundy",0,0,0,0,0,0
"4232",2313,0,0,0,0,0,0,0,0,0,0,0,0,0,0,0,0,1037751,"2023-11-15T00:00:00.000Z",56677875,1,"Miles Norris",0,0,0,0,0,0
"4233",2314,5,1,6,5,1,10,4,0,0,33,2,4,9,8,0,2,1037751,"2023-11-15T00:00:00.000Z",202,20,"Josh Hart",1,17,22,14,13,27.1
"4234",2315,8,0,8,5,3,24,12,2,2,39,2,4,29,10,1,1,1037751,"2023-11-15T00:00:00.000Z",387,20,"Julius Randle",1,39,47,37,18,55
"4235",2316,0,1,9,0,0,3,3,0,0,31,6,0,6,15,3,1,1037751,"2023-11-15T00:00:00.000Z",399,20,"Mitchell Robinson",4,21,21,6,15,35
"4236",2317,1,0,1,7,3,10,4,0,0,28,0,3,11,1,1,3,1037751,"2023-11-15T00:00:00.000Z",17895858,20,"Quentin Grimes",1,12,13,12,2,13.7
"4237",2318,8,0,0,10,6,19,8,2,2,41,0,2,24,0,0,3,1037751,"2023-11-15T00:00:00.000Z",73,20,"Jalen Brunson",0,24,32,32,8,33
"4238",2319,0,0,0,0,0,0,0,0,0,0,0,0,0,0,0,0,1037751,"2023-11-15T00:00:00.000Z",19,20,"Ryan Arcidiacono",0,0,0,0,0,0
"4239",2320,0,0,0,0,0,2,1,1,0,4,0,0,2,0,1,1,1037750,"2023-11-15T00:00:00.000Z",38017679,7,"Jaden Hardy",1,2,2,2,0,4
"4240",2321,1,0,2,1,0,2,1,2,0,7,0,0,2,2,0,0,1037750,"2023-11-15T00:00:00.000Z",56677859,7,"Olivier-Maxence Prosper",0,4,5,3,3,5.9
"4241",2322,0,0,0,0,0,1,0,0,0,2,0,0,0,0,0,1,1037750,"2023-11-15T00:00:00.000Z",217,7,"Richaun Holmes",0,0,0,0,0,-1
"4242",2323,0,0,0,0,0,0,0,0,0,0,0,0,0,0,0,0,1037750,"2023-11-15T00:00:00.000Z",329,7,"Markieff Morris",0,0,0,0,0,0
"4243",2324,0,0,0,0,0,0,0,0,0,0,0,0,0,0,0,0,1037750,"2023-11-15T00:00:00.000Z",17896028,7,"Greg Brown III",0,0,0,0,0,0
"4244",2325,0,0,0,0,0,0,0,0,0,0,0,0,0,0,0,0,1037750,"2023-11-15T00:00:00.000Z",56677873,7,"Dexter Dennis",0,0,0,0,0,0
"4245",2326,0,0,0,0,0,0,0,0,0,0,0,0,0,0,0,0,1037864,"2023-11-30T00:00:00.000Z",319,1,"Patty Mills",0,0,0,0,0,0
"4246",2327,0,0,0,0,0,0,0,0,0,0,0,0,0,0,0,0,1037865,"2023-11-30T00:00:00.000Z",475,10,"Andrew Wiggins",0,0,0,0,0,0
"4247",2328,0,0,6,2,2,17,9,4,3,35,1,2,23,7,2,0,1037865,"2023-11-30T00:00:00.000Z",274,13,"Kawhi Leonard",2,30,30,23,7,37.4
"4248",2329,10,0,1,10,3,18,6,0,0,37,0,5,15,1,0,1,1037865,"2023-11-30T00:00:00.000Z",172,13,"Paul George",0,16,26,25,11,30.2
"4249",2330,0,1,9,0,0,11,7,5,4,26,4,1,18,13,0,0,1037865,"2023-11-30T00:00:00.000Z",493,13,"Ivica Zubac",1,31,31,18,13,36.6
"4250",2331,1,0,2,4,1,10,4,0,0,34,3,1,9,5,1,2,1037865,"2023-11-30T00:00:00.000Z",666743,13,"Terance Mann",1,14,15,10,6,17.5
"4251",2332,7,0,3,10,5,13,6,2,1,37,0,3,18,3,1,1,1037865,"2023-11-30T00:00:00.000Z",192,13,"James Harden",1,21,28,25,10,34.1
"4252",2333,0,0,1,1,0,1,0,0,0,6,0,2,0,1,0,0,1037865,"2023-11-30T00:00:00.000Z",56677849,13,"Kobe Brown",0,1,1,0,1,1.2
"4253",2334,0,0,0,0,0,0,0,0,0,1,0,2,0,0,0,0,1037865,"2023-11-30T00:00:00.000Z",666511,13,"Amir Coffey",0,0,0,0,0,0
"4254",2335,0,0,0,0,0,0,0,0,0,0,0,0,0,0,0,0,1037865,"2023-11-30T00:00:00.000Z",17896070,10,"Usman Garuba",0,0,0,0,0,0
"4255",2336,0,0,0,0,0,0,0,0,0,0,0,0,0,0,0,0,1037865,"2023-11-30T00:00:00.000Z",367,10,"Chris Paul",0,0,0,0,0,0
"4256",2337,0,0,0,0,0,0,0,0,0,0,0,0,0,0,0,0,1037865,"2023-11-30T00:00:00.000Z",2189,10,"Gary Payton II",0,0,0,0,0,0
"4257",2338,6,0,5,3,0,13,5,6,4,26,6,1,14,11,0,0,1037865,"2023-11-30T00:00:00.000Z",472,13,"Russell Westbrook",0,25,31,20,17,36.2
"4258",2339,0,0,0,0,0,2,1,3,3,18,0,1,5,0,1,2,1037865,"2023-11-30T00:00:00.000Z",380,13,"Norman Powell",1,5,5,5,0,6
"4259",2340,2,0,1,1,1,9,4,2,1,15,1,2,10,2,0,0,1037865,"2023-11-30T00:00:00.000Z",439,13,"Daniel Theis",0,12,14,12,4,15.4
"4260",2341,0,0,0,1,0,1,0,0,0,4,0,1,0,0,0,0,1037865,"2023-11-30T00:00:00.000Z",17896031,13,"Nah'Shon Hyland",0,0,0,0,0,0
"4261",2342,0,0,0,0,0,0,0,2,2,1,0,0,2,0,0,0,1037865,"2023-11-30T00:00:00.000Z",38017725,13,"Moussa Diabate",0,2,2,2,0,2
"4262",2343,0,0,0,0,0,0,0,0,0,0,0,0,0,0,0,0,1037865,"2023-11-30T00:00:00.000Z",24417679,13,"Xavier Moon",0,0,0,0,0,0
"4263",2344,0,0,0,0,0,0,0,0,0,0,0,0,0,0,0,0,1037865,"2023-11-30T00:00:00.000Z",450,13,"PJ Tucker",0,0,0,0,0,0
"4264",2345,0,0,0,0,0,0,0,0,0,0,0,0,0,0,0,0,1037865,"2023-11-30T00:00:00.000Z",17896022,13,"Brandon Boston Jr.",0,0,0,0,0,0
"4265",2346,0,0,0,0,0,0,0,0,0,0,0,0,0,0,0,0,1037865,"2023-11-30T00:00:00.000Z",56677856,13,"Jordan Miller",0,0,0,0,0,0
"4266",2347,5,0,5,4,2,7,4,4,3,27,0,2,13,5,1,0,1037865,"2023-11-30T00:00:00.000Z",407,10,"Dario Saric",1,18,23,18,10,29.5
"4267",2348,2,0,2,2,0,2,0,2,1,22,0,1,1,2,0,0,1037865,"2023-11-30T00:00:00.000Z",251,10,"Cory Joseph",0,3,5,3,4,6.4
"4268",2349,3,1,5,5,3,8,6,4,2,23,1,0,17,6,1,1,1037865,"2023-11-30T00:00:00.000Z",17553979,10,"Jonathan Kuminga",2,23,26,20,9,33.7
"4269",2350,0,0,0,0,0,0,0,0,0,0,0,0,0,0,0,0,1037865,"2023-11-30T00:00:00.000Z",56677799,10,"Trayce Jackson-Davis",0,0,0,0,0,0
"4270",1,0,0,0,0,0,0,0,0,0,0,0,0,0,0,0,0,1037942,"2023-12-18T00:00:00.000Z",38017701,12,"Kendall Brown",0,0,0,0,0,0
"4271",2,0,0,0,0,0,0,0,0,0,0,0,0,0,0,0,0,1037942,"2023-12-18T00:00:00.000Z",38017507,12,"Andrew Nembhard",0,0,0,0,0,0
"4272",3,5,2,8,9,2,25,13,4,4,40,0,1,32,8,3,1,1037945,"2023-12-18T00:00:00.000Z",3547238,18,"Anthony Edwards",5,40,45,37,13,63.1
"4273",4,0,0,0,0,0,0,0,0,0,0,0,0,0,0,0,0,1037942,"2023-12-18T00:00:00.000Z",56677861,12,"Ben Sheppard",0,0,0,0,0,0
"4274",5,0,0,0,0,0,0,0,0,0,0,0,0,0,0,0,0,1037942,"2023-12-18T00:00:00.000Z",3547264,12,"Jalen Smith",0,0,0,0,0,0
"4275",6,6,0,1,5,4,5,4,0,0,33,0,1,12,1,1,4,1037945,"2023-12-18T00:00:00.000Z",104,18,"Mike Conley",1,13,19,18,7,21.2
"4276",7,1,1,3,6,1,13,5,4,4,21,1,2,15,4,1,1,1037945,"2023-12-18T00:00:00.000Z",667378,18,"Naz Reid",2,19,20,16,5,26.3
"4277",8,5,1,2,0,0,4,2,2,1,22,0,2,5,2,0,1,1037945,"2023-12-18T00:00:00.000Z",12,18,"Kyle Anderson",1,7,12,10,7,16.9
"4278",9,3,0,0,4,2,5,2,2,2,22,1,2,8,1,1,0,1037945,"2023-12-18T00:00:00.000Z",666400,18,"Nickeil Alexander-Walker",1,9,12,11,4,16.7
"4279",10,1,0,1,1,1,1,1,0,0,5,0,0,3,1,0,1,1037945,"2023-12-18T00:00:00.000Z",68,18,"Troy Brown Jr.",0,4,5,4,2,4.7
"4280",11,0,0,0,0,0,0,0,0,0,0,0,0,0,0,0,0,1037945,"2023-12-18T00:00:00.000Z",666767,18,"Jordan McLaughlin",0,0,0,0,0,0
"4281",12,0,0,0,0,0,0,0,0,0,0,0,0,0,0,0,0,1037945,"2023-12-18T00:00:00.000Z",320,18,"Shake Milton",0,0,0,0,0,0
"4282",13,0,0,0,0,0,0,0,0,0,0,0,0,0,0,0,0,1037941,"2023-12-18T00:00:00.000Z",357,11,"Victor Oladipo",0,0,0,0,0,0
"4283",14,0,0,0,0,0,0,0,0,0,0,0,0,0,0,0,0,1037941,"2023-12-18T00:00:00.000Z",56677809,11,"Jermaine Samuels Jr.",0,0,0,0,0,0
"4284",15,0,0,0,1,0,3,0,0,0,5,0,0,0,0,0,0,1037944,"2023-12-18T00:00:00.000Z",17896071,9,"Isaiah Livers",0,0,0,0,0,0
"4285",16,2,0,5,0,0,5,5,2,0,25,2,2,10,7,0,2,1037944,"2023-12-18T00:00:00.000Z",3547240,9,"James Wiseman",0,17,19,12,9,19.4
"4286",17,1,1,1,1,1,3,2,0,0,21,0,6,5,1,1,0,1037944,"2023-12-18T00:00:00.000Z",56677792,9,"Marcus Sasser",2,6,7,6,2,13.7
"4287",18,0,0,0,0,0,0,0,0,0,0,0,0,0,0,0,0,1037944,"2023-12-18T00:00:00.000Z",3547241,9,"Killian Hayes",0,0,0,0,0,0
"4288",19,0,0,0,0,0,0,0,0,0,0,0,0,0,0,0,0,1037944,"2023-12-18T00:00:00.000Z",259,9,"Kevin Knox",0,0,0,0,0,0
"4289",20,0,0,0,0,0,0,0,0,0,0,0,0,0,0,0,0,1037944,"2023-12-18T00:00:00.000Z",3547267,9,"Isaiah Stewart",0,0,0,0,0,0
"4290",21,0,0,0,0,0,0,0,0,0,0,0,0,0,0,0,0,1037944,"2023-12-18T00:00:00.000Z",56677729,9,"Malcolm Cazalon",0,0,0,0,0,0
"4291",22,0,0,0,0,0,0,0,0,0,0,0,0,0,0,0,0,1037944,"2023-12-18T00:00:00.000Z",38017694,9,"Jalen Duren",0,0,0,0,0,0
"4292",23,9,1,7,6,2,17,9,4,4,40,1,0,24,8,0,2,1037943,"2023-12-18T00:00:00.000Z",666956,5,"Coby White",1,32,41,33,17,48.1
"4293",24,0,0,0,0,0,0,0,0,0,0,0,0,0,0,0,0,1037944,"2023-12-18T00:00:00.000Z",330,9,"Monte Morris",0,0,0,0,0,0
"4294",25,0,0,0,0,0,0,0,0,0,0,0,0,0,0,0,0,1037944,"2023-12-18T00:00:00.000Z",42097199,9,"Jared Rhoden",0,0,0,0,0,0
"4295",26,3,0,3,8,2,13,5,2,1,30,1,3,13,4,2,1,1038061,"2024-01-03T00:00:00.000Z",351,3,"Royce O'Neale",2,17,20,16,7,27.3
"4296",27,1,1,8,0,0,7,4,6,3,20,4,5,11,12,1,1,1038061,"2024-01-03T00:00:00.000Z",17896038,3,"Day'Ron Sharpe",2,23,24,12,13,31.9
"4297",28,0,0,0,0,0,0,0,0,0,5,0,0,0,0,1,0,1038061,"2024-01-03T00:00:00.000Z",56677722,3,"Jalen Wilson",1,0,0,0,0,3
"4298",29,5,0,0,2,0,7,0,4,4,18,0,1,4,0,1,1,1038061,"2024-01-03T00:00:00.000Z",17896048,3,"Cam Thomas",1,4,9,9,5,13.5
"4299",30,1,0,4,2,2,6,3,4,3,20,4,1,11,8,1,0,1038061,"2024-01-03T00:00:00.000Z",17896058,3,"Trendon Watford",1,19,20,12,9,25.1
"4300",31,0,0,1,0,0,0,0,0,0,3,0,0,0,1,0,0,1038061,"2024-01-03T00:00:00.000Z",9051997,3,"Armoni Brooks",0,1,1,0,1,1.2
"4301",32,0,0,0,0,0,0,0,0,0,0,0,0,0,0,0,0,1038061,"2024-01-03T00:00:00.000Z",174,3,"Harry Giles III",0,0,0,0,0,0
"4302",33,0,0,0,0,0,0,0,0,0,0,0,0,0,0,0,0,1038061,"2024-01-03T00:00:00.000Z",421,3,"Dennis Smith Jr.",0,0,0,0,0,0
"4303",34,0,0,0,0,0,0,0,0,0,0,0,0,0,0,0,0,1038061,"2024-01-03T00:00:00.000Z",56677843,3,"Noah Clowney",0,0,0,0,0,0
"4304",35,0,0,0,0,0,0,0,0,0,0,0,0,0,0,0,0,1038061,"2024-01-03T00:00:00.000Z",17896041,3,"Keon Johnson",0,0,0,0,0,0
"4305",36,0,0,0,0,0,0,0,0,0,0,0,0,0,0,0,0,1038061,"2024-01-03T00:00:00.000Z",417,3,"Ben Simmons",0,0,0,0,0,0
"4306",37,0,0,0,0,0,0,0,0,0,0,0,0,0,0,0,0,1038061,"2024-01-03T00:00:00.000Z",464,3,"Lonnie Walker IV",0,0,0,0,0,0
"4307",38,0,0,0,0,0,0,0,0,0,0,0,0,0,0,0,0,1038061,"2024-01-03T00:00:00.000Z",56677841,3,"Dariq Whitehead",0,0,0,0,0,0
"4308",39,0,0,0,0,0,0,0,0,0,0,0,0,0,0,0,0,1038084,"2024-01-05T00:00:00.000Z",436,28,"Garrett Temple",0,0,0,0,0,0
"4309",40,0,0,0,0,0,0,0,0,0,0,0,0,0,0,0,0,1038084,"2024-01-05T00:00:00.000Z",3089,28,"Gary Trent Jr.",0,0,0,0,0,0
"4310",41,0,0,0,0,0,0,0,0,0,0,0,0,0,0,0,0,1038084,"2024-01-05T00:00:00.000Z",489,28,"Thaddeus Young",0,0,0,0,0,0
"4311",42,1,0,1,2,1,2,1,0,0,27,4,0,3,5,0,2,1038089,"2024-01-07T00:00:00.000Z",3547247,6,"Isaac Okoro",0,8,9,4,6,8.5
"4312",43,1,0,2,2,0,3,0,0,0,11,0,2,0,2,0,1,1038089,"2024-01-07T00:00:00.000Z",666940,6,"Dean Wade",0,2,3,1,3,2.9
"4313",44,2,1,11,0,0,19,11,7,7,31,5,3,29,16,1,1,1038089,"2024-01-07T00:00:00.000Z",9,6,"Jarrett Allen",2,45,47,31,18,56.2
"4314",45,4,0,4,9,2,11,3,0,0,37,1,2,8,5,2,2,1038089,"2024-01-07T00:00:00.000Z",666908,6,"Max Strus",2,13,17,12,9,24
"4315",46,9,0,2,10,1,18,7,4,2,37,0,1,17,2,1,4,1038089,"2024-01-07T00:00:00.000Z",322,6,"Donovan Mitchell",1,19,28,26,11,31.9
"4316",47,3,0,2,5,4,13,9,3,1,26,0,2,23,2,2,4,1038089,"2024-01-07T00:00:00.000Z",277,6,"Caris LeVert",2,25,28,26,5,31.9
"4317",48,3,0,3,9,5,11,5,3,3,23,0,0,18,3,0,0,1038089,"2024-01-07T00:00:00.000Z",3547299,6,"Sam Merrill",0,21,24,21,6,26.1
"4318",49,2,0,2,0,0,4,3,4,2,17,2,4,8,4,0,1,1038089,"2024-01-07T00:00:00.000Z",444,6,"Tristan Thompson",0,12,14,10,6,14.8
"4319",50,1,1,4,6,3,7,4,0,0,27,0,2,11,4,0,1,1038089,"2024-01-07T00:00:00.000Z",344,6,"Georges Niang",1,15,16,12,5,19.3
"4320",51,0,1,2,0,0,4,3,0,0,12,3,2,6,5,0,1,1037660,"2023-11-02T00:00:00.000Z",3547270,23,"Paul Reed",1,11,11,6,5,14
"4321",52,2,1,7,0,0,8,4,1,1,28,2,2,9,9,0,4,1037660,"2023-11-02T00:00:00.000Z",373,28,"Jakob Poeltl",1,18,20,11,11,21.8
"4322",53,8,0,6,7,2,16,9,4,4,35,2,4,24,8,0,1,1037660,"2023-11-02T00:00:00.000Z",17896055,28,"Scottie Barnes",0,32,40,32,16,44.6
"4323",54,10,0,3,2,1,9,4,6,4,31,0,0,13,3,1,3,1037660,"2023-11-02T00:00:00.000Z",409,28,"Dennis Schroder",1,16,26,23,13,31.6
"4324",55,0,0,5,5,2,8,2,4,2,23,0,1,8,5,1,3,1037660,"2023-11-02T00:00:00.000Z",3089,28,"Gary Trent Jr.",1,13,13,8,5,14
"4325",56,1,0,0,0,0,2,0,0,0,14,0,1,0,0,0,1,1037660,"2023-11-02T00:00:00.000Z",56677828,28,"Gradey Dick",0,0,1,1,1,0.5
"4326",57,1,0,2,3,2,5,2,0,0,17,1,2,6,3,2,1,1037660,"2023-11-02T00:00:00.000Z",3547275,28,"Malachi Flynn",2,9,10,7,4,16.1
"4327",58,0,1,2,2,0,4,2,2,2,13,2,3,6,4,0,1,1037660,"2023-11-02T00:00:00.000Z",58,28,"Chris Boucher",1,10,10,6,4,12.8
"4328",59,2,0,2,8,6,10,7,0,0,35,0,0,20,2,0,3,1037661,"2023-11-02T00:00:00.000Z",17896017,19,"Matt Ryan",0,22,24,22,4,22.4
"4329",60,3,4,5,1,0,7,6,9,9,34,0,4,21,5,3,0,1037661,"2023-11-02T00:00:00.000Z",17896024,19,"Herbert Jones",7,26,29,24,8,52.5
"4330",61,5,3,9,3,2,16,9,4,3,33,4,5,23,13,0,2,1037661,"2023-11-02T00:00:00.000Z",455,19,"Jonas Valanciunas",3,36,41,28,18,53.1
"4331",62,0,0,1,5,1,7,1,3,3,29,0,0,6,1,0,1,1037661,"2023-11-02T00:00:00.000Z",56677837,19,"Jordan Hawkins",0,7,7,6,1,6.2
"4332",63,5,0,3,10,3,23,10,11,10,35,1,3,33,4,0,4,1037661,"2023-11-02T00:00:00.000Z",303,19,"CJ McCollum",0,37,42,38,9,41.3
"4333",64,6,0,6,2,2,4,3,2,2,25,1,2,10,7,1,1,1037661,"2023-11-02T00:00:00.000Z",38017677,19,"Dyson Daniels",1,17,23,16,13,29.4
"4334",65,4,0,3,1,0,5,1,4,4,20,0,1,6,3,1,1,1037661,"2023-11-02T00:00:00.000Z",3547260,19,"Kira Lewis Jr.",1,9,13,10,7,17.6
"4335",66,1,0,0,2,0,6,2,0,0,16,1,2,4,1,0,0,1037661,"2023-11-02T00:00:00.000Z",340,19,"Larry Nance Jr.",0,5,6,5,2,6.7
"4336",67,0,0,0,0,0,0,0,0,0,0,0,0,0,0,0,0,1037660,"2023-11-02T00:00:00.000Z",38017717,28,"Ron Harper Jr.",0,0,0,0,0,0
"4337",68,0,0,0,0,0,0,0,0,0,0,0,0,0,0,0,0,1037660,"2023-11-02T00:00:00.000Z",38017710,28,"Christian Koloko",0,0,0,0,0,0
"4338",69,0,0,0,0,0,0,0,0,0,0,0,0,0,0,0,0,1037660,"2023-11-02T00:00:00.000Z",56677869,28,"Markquis Nowell",0,0,0,0,0,0
"4339",70,0,0,0,0,0,0,0,0,0,0,0,0,0,0,0,0,1037660,"2023-11-02T00:00:00.000Z",376,28,"Otto Porter Jr.",0,0,0,0,0,0
"4340",71,5,0,3,5,2,21,9,2,1,38,1,4,21,4,4,2,1037662,"2023-11-02T00:00:00.000Z",17896026,22,"Franz Wagner",4,25,30,26,9,43.3
"4341",72,5,2,7,2,1,13,9,15,11,36,2,4,30,9,3,6,1037662,"2023-11-02T00:00:00.000Z",38017683,22,"Paolo Banchero",5,39,44,35,14,57.3
"4342",73,2,1,8,6,3,12,5,2,1,29,2,4,14,10,0,2,1037662,"2023-11-02T00:00:00.000Z",85,22,"Wendell Carter Jr.",1,24,26,16,12,30
"4343",74,1,1,0,2,0,2,0,0,0,14,0,1,0,0,0,0,1037662,"2023-11-02T00:00:00.000Z",196,22,"Gary Harris",1,0,1,1,1,4.5
"4344",75,3,0,2,0,0,7,1,4,4,21,2,4,6,4,4,3,1037662,"2023-11-02T00:00:00.000Z",17896073,22,"Jalen Suggs",4,10,13,9,7,24.3
"4345",76,0,2,4,0,0,10,4,0,0,24,3,5,8,7,0,0,1037787,"2023-11-20T00:00:00.000Z",56677826,9,"Ausar Thompson",2,15,15,8,7,22.4
"4346",77,1,2,10,2,1,8,4,2,2,35,1,3,11,11,0,1,1037787,"2023-11-20T00:00:00.000Z",3547267,9,"Isaiah Stewart",2,22,23,12,12,30.7
"4347",78,1,0,5,0,0,13,7,5,4,26,3,4,18,8,0,1,1037787,"2023-11-20T00:00:00.000Z",24,9,"Marvin Bagley III",0,26,27,19,9,28.1
"4348",79,9,1,3,4,2,17,7,11,11,38,0,2,27,3,3,5,1037787,"2023-11-20T00:00:00.000Z",17896075,9,"Cade Cunningham",4,30,39,36,12,51.1
"4349",80,3,0,2,1,1,8,7,2,2,30,1,2,17,3,1,4,1037787,"2023-11-20T00:00:00.000Z",38017682,9,"Jaden Ivey",1,20,23,20,6,24.1
"4350",81,2,0,3,4,0,5,1,2,1,17,0,1,3,3,1,1,1037787,"2023-11-20T00:00:00.000Z",77,9,"Alec Burks",1,6,8,5,5,11.6
"4351",82,0,0,0,0,0,0,0,0,0,0,0,0,0,0,0,0,1037787,"2023-11-20T00:00:00.000Z",38017694,9,"Jalen Duren",0,0,0,0,0,0
"4352",83,2,1,3,1,0,5,3,2,1,32,1,3,7,4,0,0,1037788,"2023-11-20T00:00:00.000Z",3547242,30,"Deni Avdija",1,11,13,9,6,17.8
"4353",84,13,1,3,5,2,15,10,0,0,31,0,2,22,3,2,2,1037788,"2023-11-20T00:00:00.000Z",265,30,"Kyle Kuzma",3,25,38,35,16,52.1
"4354",85,0,0,0,0,0,0,0,0,0,5,0,1,0,0,0,0,1037786,"2023-11-20T00:00:00.000Z",18678001,4,"JT Thor",0,0,0,0,0,0
"4355",86,0,0,0,0,0,0,0,0,0,0,0,0,0,0,0,0,1037786,"2023-11-20T00:00:00.000Z",56677846,4,"Nick Smith Jr.",0,0,0,0,0,0
"4356",87,0,0,0,0,0,0,0,0,0,0,0,0,0,0,0,0,1037786,"2023-11-20T00:00:00.000Z",56677848,4,"Amari Bailey",0,0,0,0,0,0
"4357",88,0,0,0,0,0,0,0,0,0,0,0,0,0,0,0,0,1037786,"2023-11-20T00:00:00.000Z",56677866,4,"Leaky Black",0,0,0,0,0,0
"4358",89,0,0,0,0,0,0,0,0,0,0,0,0,0,0,0,0,1037786,"2023-11-20T00:00:00.000Z",666748,4,"Cody Martin",0,0,0,0,0,0
"4359",90,0,0,0,0,0,0,0,0,0,0,0,0,0,0,0,0,1037786,"2023-11-20T00:00:00.000Z",347,4,"Frank Ntilikina",0,0,0,0,0,0
"4360",91,0,0,0,0,0,0,0,0,0,0,0,0,0,0,0,0,1037786,"2023-11-20T00:00:00.000Z",3547282,4,"Nick Richards",0,0,0,0,0,0
"4361",92,0,0,0,0,0,0,0,0,0,0,0,0,0,0,0,0,1037786,"2023-11-20T00:00:00.000Z",403,4,"Terry Rozier",0,0,0,0,0,0
"4362",93,1,0,1,9,1,9,1,0,0,38,0,3,3,1,0,1,1037786,"2023-11-20T00:00:00.000Z",17896060,2,"Sam Hauser",0,4,5,4,2,4.7
"4363",94,6,2,13,15,7,28,15,10,8,44,0,1,45,13,0,3,1037786,"2023-11-20T00:00:00.000Z",434,2,"Jayson Tatum",2,58,64,51,19,72.6
"4364",95,0,3,5,8,1,14,5,10,6,34,3,2,17,8,2,0,1037786,"2023-11-20T00:00:00.000Z",378,2,"Kristaps Porzingis",5,25,25,17,8,41.6
"4365",96,3,0,3,5,0,17,5,4,3,34,1,5,13,4,0,2,1037786,"2023-11-20T00:00:00.000Z",70,2,"Jaylen Brown",0,17,20,16,7,20.3
"4366",97,5,2,3,3,1,11,5,2,0,37,3,1,11,6,1,7,1037786,"2023-11-20T00:00:00.000Z",214,2,"Jrue Holiday",3,17,22,16,11,27.7
"4367",98,3,0,4,8,5,14,8,0,0,33,2,1,21,6,2,0,1037786,"2023-11-20T00:00:00.000Z",3547276,2,"Payton Pritchard",2,27,30,24,9,38.7
"4368",99,1,0,5,0,0,0,0,2,1,17,2,2,1,7,0,0,1037786,"2023-11-20T00:00:00.000Z",666468,2,"Oshae Brissett",0,8,9,2,8,10.9
"4369",100,0,1,3,0,0,2,2,0,0,19,0,0,4,3,0,0,1037786,"2023-11-20T00:00:00.000Z",261,2,"Luke Kornet",1,7,7,4,3,10.6
"4370",101,0,0,0,0,0,0,0,0,0,0,0,0,0,0,0,0,7050289,"2023-12-08T00:00:00.000Z",45969255,5,"Justin Lewis",0,0,0,0,0,0
"4371",102,0,0,0,0,0,0,0,0,0,0,0,0,0,0,0,0,7050286,"2023-12-08T00:00:00.000Z",277,6,"Caris LeVert",0,0,0,0,0,0
"4372",103,0,0,0,0,0,0,0,0,0,0,0,0,0,0,0,0,7050286,"2023-12-08T00:00:00.000Z",17896076,6,"Evan Mobley",0,0,0,0,0,0
"4373",104,0,0,0,0,0,0,0,0,0,0,0,0,0,0,0,0,7050286,"2023-12-08T00:00:00.000Z",404,6,"Ricky Rubio",0,0,0,0,0,0
"4374",105,0,0,0,0,0,0,0,0,0,0,0,0,0,0,0,0,7050289,"2023-12-08T00:00:00.000Z",56677860,5,"Adama Sanogo",0,0,0,0,0,0
"4375",106,3,2,0,3,0,5,0,0,0,29,2,3,0,2,2,1,7996365,"2023-12-08T00:00:00.000Z",356,24,"Josh Okogie",4,2,5,3,5,17.9
"4376",107,2,0,3,3,1,6,2,2,0,17,1,0,5,4,0,0,7996365,"2023-12-08T00:00:00.000Z",32,24,"Keita Bates-Diop",0,9,11,7,6,12.8
"4377",108,3,0,8,4,2,13,6,4,1,30,1,3,15,9,1,0,7996365,"2023-12-08T00:00:00.000Z",349,24,"Jusuf Nurkic",1,24,27,18,12,33.3
"4378",109,3,1,0,7,3,13,7,2,2,38,0,3,19,0,2,4,7996365,"2023-12-08T00:00:00.000Z",178,24,"Eric Gordon",3,19,22,22,3,28.5
"4379",110,7,0,7,2,2,14,10,9,6,37,0,4,28,7,1,3,7996365,"2023-12-08T00:00:00.000Z",57,24,"Devin Booker",1,35,42,35,14,46.9
"4380",111,6,0,3,1,0,6,3,2,2,20,2,2,8,5,0,2,7996365,"2023-12-08T00:00:00.000Z",18678058,24,"Jordan Goodwin",0,13,19,14,11,21
"4381",112,1,2,4,4,0,9,4,2,2,23,0,1,10,4,2,0,7996365,"2023-12-08T00:00:00.000Z",314,24,"Chimezie Metu",4,14,15,11,5,28.3
"4382",113,0,0,0,0,0,0,0,0,0,0,0,0,0,0,0,0,7050290,"2023-12-08T00:00:00.000Z",56677809,11,"Jermaine Samuels Jr.",0,0,0,0,0,0
"4383",114,0,0,0,0,0,0,0,0,0,0,0,0,0,0,0,0,7050290,"2023-12-08T00:00:00.000Z",56677825,11,"Amen Thompson",0,0,0,0,0,0
"4384",115,0,0,0,0,0,0,0,0,0,0,0,0,0,0,0,0,7050290,"2023-12-08T00:00:00.000Z",56677831,11,"Cam Whitmore",0,0,0,0,0,0
"4385",116,0,0,4,7,5,8,5,2,1,23,4,3,16,8,2,0,7050289,"2023-12-08T00:00:00.000Z",110,5,"Torrey Craig",2,24,24,16,8,31.6
"4386",117,1,1,5,5,3,7,3,0,0,36,3,0,9,8,3,2,7050292,"2023-12-08T00:00:00.000Z",666923,25,"Matisse Thybulle",4,17,18,10,9,30.1
"4387",118,0,0,3,10,2,20,6,0,0,32,6,5,14,9,1,0,7050292,"2023-12-08T00:00:00.000Z",56677850,25,"Toumani Camara",1,23,23,14,9,27.8
"4388",119,1,0,4,6,2,9,4,0,0,21,2,4,10,6,2,1,7050292,"2023-12-08T00:00:00.000Z",56783340,25,"Duop Reath",2,16,17,11,7,23.7
"4389",120,5,0,7,10,5,15,7,6,5,32,2,4,24,9,1,2,7050292,"2023-12-08T00:00:00.000Z",38017690,25,"Shaedon Sharpe",1,33,38,29,14,43.3
"4390",121,8,0,3,10,4,21,10,6,6,36,2,4,30,5,1,6,7050292,"2023-12-08T00:00:00.000Z",419,25,"Anfernee Simons",1,35,43,38,13,45
"4391",122,0,0,0,0,0,0,0,0,0,0,0,0,0,0,0,0,7050290,"2023-12-08T00:00:00.000Z",17896007,8,"Braxton Key",0,0,0,0,0,0
"4392",123,1,0,4,10,4,12,6,0,0,33,1,5,16,5,2,3,7050290,"2023-12-08T00:00:00.000Z",66,11,"Dillon Brooks",2,21,22,17,6,26.5
"4393",124,5,0,6,2,0,9,3,4,3,25,4,1,9,10,0,1,7050290,"2023-12-08T00:00:00.000Z",38017684,11,"Jabari Smith Jr.",0,19,24,14,15,27.5
"4394",125,7,1,8,1,0,14,7,5,3,34,2,3,17,10,0,1,7050290,"2023-12-08T00:00:00.000Z",17896062,11,"Alperen Sengun",1,27,34,24,17,41.5
"4395",126,0,0,0,0,0,0,0,0,0,0,0,0,0,0,0,0,1037998,"2023-12-26T00:00:00.000Z",174,3,"Harry Giles III",0,0,0,0,0,0
"4396",127,0,0,0,0,0,0,0,0,0,0,0,0,0,0,0,0,1037998,"2023-12-26T00:00:00.000Z",17896058,3,"Trendon Watford",0,0,0,0,0,0
"4397",128,0,0,0,0,0,0,0,0,0,0,0,0,0,0,0,0,1037998,"2023-12-26T00:00:00.000Z",56677722,3,"Jalen Wilson",0,0,0,0,0,0
"4398",129,0,0,0,0,0,0,0,0,0,0,0,0,0,0,0,0,1037998,"2023-12-26T00:00:00.000Z",9051997,3,"Armoni Brooks",0,0,0,0,0,0
"4399",130,1,1,3,6,4,9,6,0,0,25,1,5,16,4,2,0,1038004,"2023-12-26T00:00:00.000Z",38017649,27,"Julian Champagnie",3,20,21,17,5,31.3
"4400",131,3,0,3,4,3,10,7,2,2,27,2,2,19,5,0,0,1038004,"2023-12-26T00:00:00.000Z",38017699,27,"Jeremy Sochan",0,24,27,22,8,29.5
"4401",132,4,5,5,4,1,15,6,3,2,24,2,1,15,7,1,4,1038004,"2023-12-26T00:00:00.000Z",56677822,27,"Victor Wembanyama",6,22,26,19,11,43.4
"4402",133,3,0,3,10,5,18,8,1,1,34,1,2,22,4,3,1,1038004,"2023-12-26T00:00:00.000Z",3547246,27,"Devin Vassell",3,26,29,25,7,39.3
"4403",134,4,0,4,0,0,3,0,0,0,17,0,1,0,4,0,2,1038004,"2023-12-26T00:00:00.000Z",38017692,27,"Malaki Branham",0,4,8,4,8,8.8
"4404",135,3,0,2,7,3,20,9,6,5,30,2,0,26,4,0,1,1038004,"2023-12-26T00:00:00.000Z",666682,27,"Keldon Johnson",0,30,33,29,7,34.3
"4405",136,4,2,3,0,0,6,3,0,0,18,1,4,6,4,0,1,1038004,"2023-12-26T00:00:00.000Z",102,27,"Zach Collins",2,10,14,10,8,21.8
"4406",137,1,0,5,6,4,13,9,1,1,33,1,4,23,6,4,5,1037999,"2023-12-26T00:00:00.000Z",56677827,22,"Anthony Black",4,29,30,24,7,38.7
"4407",138,1,0,0,1,1,2,1,0,0,19,0,3,3,0,1,1,1037999,"2023-12-26T00:00:00.000Z",196,22,"Gary Harris",1,3,4,4,1,6.5
"4408",139,1,0,5,0,0,9,5,2,1,15,0,1,11,5,0,0,1037999,"2023-12-26T00:00:00.000Z",462,22,"Moritz Wagner",0,16,17,12,6,18.5
"4409",140,4,0,3,3,1,11,4,2,2,23,0,2,11,3,1,1,1037999,"2023-12-26T00:00:00.000Z",3547251,22,"Cole Anthony",1,14,18,15,7,22.6
"4410",141,0,0,1,0,0,0,0,0,0,12,0,0,0,1,0,0,1037999,"2023-12-26T00:00:00.000Z",38017724,22,"Caleb Houstan",0,1,1,0,1,1.2
"4411",142,3,1,3,0,0,5,4,2,2,12,4,0,10,7,0,0,1037999,"2023-12-26T00:00:00.000Z",666442,22,"Goga Bitadze",1,17,20,13,10,25.9
"4412",143,0,0,0,0,0,0,0,0,0,0,0,0,0,0,0,0,1037999,"2023-12-26T00:00:00.000Z",666818,22,"Chuma Okeke",0,0,0,0,0,0
"4413",144,0,0,0,0,0,0,0,0,0,0,0,0,0,0,0,0,1037999,"2023-12-26T00:00:00.000Z",165,22,"Markelle Fultz",0,0,0,0,0,0
"4414",145,0,0,0,0,0,0,0,0,0,0,0,0,0,0,0,0,1037999,"2023-12-26T00:00:00.000Z",38017607,22,"Kevon Harris",0,0,0,0,0,0
"4415",146,6,0,2,3,2,17,8,7,7,40,0,3,25,2,1,1,1038000,"2023-12-26T00:00:00.000Z",125,5,"DeMar DeRozan",1,27,33,31,8,38.4
"4416",147,0,0,0,1,0,7,2,2,2,25,1,2,6,1,1,1,1038000,"2023-12-26T00:00:00.000Z",3547248,5,"Patrick Williams",1,7,7,6,1,9.2
"4417",148,1,2,15,0,0,13,11,2,2,39,10,4,24,25,3,2,1038000,"2023-12-26T00:00:00.000Z",137,5,"Andre Drummond",5,49,50,25,26,68.5
"4418",149,5,0,3,5,1,10,2,6,6,29,2,2,11,5,2,1,1038000,"2023-12-26T00:00:00.000Z",89,5,"Alex Caruso",2,16,21,16,10,29.5
"4419",150,5,0,5,7,0,22,7,8,5,37,0,2,19,5,0,1,1038000,"2023-12-26T00:00:00.000Z",666956,5,"Coby White",0,24,29,24,10,31.5
"4420",151,1,0,0,2,2,6,5,0,0,12,1,0,12,1,1,0,1038123,"2024-01-11T00:00:00.000Z",3547289,14,"Skylar Mays",1,13,14,13,2,17.7
"4421",152,0,0,0,0,0,3,1,0,0,5,0,0,2,0,0,0,1038123,"2024-01-11T00:00:00.000Z",56677835,14,"Jalen Hood-Schifino",0,2,2,2,0,2
"4422",153,1,0,0,1,1,1,1,0,0,5,0,1,3,0,0,0,1038123,"2024-01-11T00:00:00.000Z",666971,14,"Dylan Windler",0,3,4,4,1,4.5
"4423",154,0,0,0,0,0,0,0,0,0,0,0,0,0,0,0,0,1038123,"2024-01-11T00:00:00.000Z",56677836,14,"Maxwell Lewis",0,0,0,0,0,0
"4424",155,0,0,0,0,0,0,0,0,0,0,0,0,0,0,0,0,1038123,"2024-01-11T00:00:00.000Z",486,14,"Christian Wood",0,0,0,0,0,0
"4425",156,0,0,0,0,0,0,0,0,0,0,0,0,0,0,0,0,1038123,"2024-01-11T00:00:00.000Z",56677738,14,"Colin Castleton",0,0,0,0,0,0
"4426",157,0,0,0,0,0,0,0,0,0,0,0,0,0,0,0,0,1038123,"2024-01-11T00:00:00.000Z",666609,14,"Rui Hachimura",0,0,0,0,0,0
"4427",158,0,0,0,0,0,0,0,0,0,0,0,0,0,0,0,0,1038123,"2024-01-11T00:00:00.000Z",1603383,14,"Gabe Vincent",0,0,0,0,0,0
"4428",159,5,1,5,5,2,12,7,2,2,32,0,0,18,5,3,1,1038123,"2024-01-11T00:00:00.000Z",140,24,"Kevin Durant",4,23,28,23,10,42.5
"4429",160,3,0,4,6,1,8,2,0,0,30,1,3,5,5,0,0,1038123,"2024-01-11T00:00:00.000Z",8,24,"Grayson Allen",0,10,13,8,8,15.5
"4430",161,1,2,3,6,1,8,2,2,1,32,1,3,6,4,2,2,1038121,"2024-01-11T00:00:00.000Z",56677850,25,"Toumani Camara",4,10,11,7,5,22.3
"4431",162,2,1,2,3,1,10,4,0,0,25,0,2,9,2,1,0,1038121,"2024-01-11T00:00:00.000Z",182,25,"Jerami Grant",2,11,13,11,4,20.4
"4432",163,2,1,5,4,1,9,3,2,1,24,2,2,8,7,0,0,1038121,"2024-01-11T00:00:00.000Z",56783340,25,"Duop Reath",1,15,17,10,9,22.4
"4433",164,2,0,4,9,1,21,4,6,4,31,2,3,13,6,1,3,1038121,"2024-01-11T00:00:00.000Z",56677747,25,"Scoot Henderson",1,19,21,15,8,23.2
"4434",165,2,0,2,8,4,13,4,4,2,20,1,2,14,3,0,3,1038121,"2024-01-11T00:00:00.000Z",419,25,"Anfernee Simons",0,17,19,16,5,17.6
"4435",166,1,0,0,0,0,1,0,0,0,5,0,1,0,0,1,1,1038123,"2024-01-11T00:00:00.000Z",18678058,24,"Jordan Goodwin",1,0,1,1,1,3.5
"4436",167,0,0,0,1,0,3,1,0,0,5,0,0,2,0,0,0,1038123,"2024-01-11T00:00:00.000Z",32,24,"Keita Bates-Diop",0,2,2,2,0,2
"4437",168,0,0,0,0,0,0,0,0,0,0,0,0,0,0,0,0,1038122,"2024-01-11T00:00:00.000Z",257,7,"Maxi Kleber",0,0,0,0,0,0
"4438",169,0,0,0,0,0,0,0,0,0,0,0,0,0,0,0,0,1038122,"2024-01-11T00:00:00.000Z",56677840,7,"Dereck Lively II",0,0,0,0,0,0
"4439",170,0,0,0,0,0,0,0,0,0,0,0,0,0,0,0,0,1038122,"2024-01-11T00:00:00.000Z",56677859,7,"Olivier-Maxence Prosper",0,0,0,0,0,0
"4440",171,2,2,5,6,1,10,4,1,1,39,1,1,10,6,0,1,1038122,"2024-01-11T00:00:00.000Z",18,20,"OG Anunoby",2,16,18,12,8,25.2
"4441",172,2,0,8,0,0,6,3,4,3,28,4,2,9,12,1,2,1038123,"2024-01-11T00:00:00.000Z",349,24,"Jusuf Nurkic",1,21,23,11,14,27.4
"4442",173,4,0,4,10,8,21,14,1,1,32,2,3,37,6,1,3,1038123,"2024-01-11T00:00:00.000Z",37,24,"Bradley Beal",1,43,47,41,10,50.2
"4443",174,5,0,5,6,2,22,11,7,7,34,0,2,31,5,3,3,1038123,"2024-01-11T00:00:00.000Z",57,24,"Devin Booker",3,36,41,36,10,50.5
"4444",175,0,0,1,9,1,11,2,0,0,23,2,0,5,3,0,0,1038123,"2024-01-11T00:00:00.000Z",178,24,"Eric Gordon",0,8,8,5,3,8.6
"4445",176,2,0,0,0,0,3,1,0,0,14,2,5,2,2,0,0,1037702,"2023-11-08T00:00:00.000Z",56677738,14,"Colin Castleton",0,4,6,4,4,7.4
"4446",177,0,0,0,0,0,0,0,0,0,0,0,0,0,0,0,0,1037702,"2023-11-08T00:00:00.000Z",117,14,"Anthony Davis",0,0,0,0,0,0
"4447",178,0,0,0,0,0,0,0,0,0,0,0,0,0,0,0,0,1037699,"2023-11-08T00:00:00.000Z",666679,3,"Cameron Johnson",0,0,0,0,0,0
"4448",179,0,0,0,0,0,0,0,0,0,0,0,0,0,0,0,0,1037699,"2023-11-08T00:00:00.000Z",17896041,3,"Keon Johnson",0,0,0,0,0,0
"4449",180,0,0,0,0,0,0,0,0,0,0,0,0,0,0,0,0,1037699,"2023-11-08T00:00:00.000Z",417,3,"Ben Simmons",0,0,0,0,0,0
"4450",181,3,1,3,1,0,3,1,1,1,21,3,3,3,6,1,0,1037699,"2023-11-08T00:00:00.000Z",450,13,"PJ Tucker",2,9,12,6,9,20.7
"4451",182,0,0,1,2,0,6,2,0,0,6,1,0,4,2,0,1,1037699,"2023-11-08T00:00:00.000Z",17896031,13,"Nah'Shon Hyland",0,6,6,4,2,5.4
"4452",183,1,0,4,2,0,2,0,0,0,19,0,1,0,4,0,2,1037699,"2023-11-08T00:00:00.000Z",666743,13,"Terance Mann",0,4,5,1,5,4.3
"4453",184,1,2,1,5,2,8,4,0,0,23,0,2,10,1,3,1,1037699,"2023-11-08T00:00:00.000Z",380,13,"Norman Powell",5,11,12,11,2,26.7
"4454",185,0,0,0,0,0,0,0,0,0,0,0,0,0,0,0,0,1037699,"2023-11-08T00:00:00.000Z",17896022,13,"Brandon Boston Jr.",0,0,0,0,0,0
"4455",186,0,0,0,0,0,0,0,0,0,0,0,0,0,0,0,0,1037699,"2023-11-08T00:00:00.000Z",56677856,13,"Jordan Miller",0,0,0,0,0,0
"4456",187,0,0,0,0,0,0,0,0,0,0,0,0,0,0,0,0,1037699,"2023-11-08T00:00:00.000Z",371,13,"Mason Plumlee",0,0,0,0,0,0
"4457",188,0,0,0,0,0,0,0,0,0,0,0,0,0,0,0,0,1037699,"2023-11-08T00:00:00.000Z",17896051,13,"Joshua Primo",0,0,0,0,0,0
"4458",189,1,2,3,7,2,9,3,0,0,37,1,4,8,4,0,1,1037704,"2023-11-08T00:00:00.000Z",3547267,9,"Isaiah Stewart",2,12,13,9,5,19.3
"4459",190,5,0,9,1,0,10,5,1,1,28,3,5,11,12,0,2,1037704,"2023-11-08T00:00:00.000Z",38017694,9,"Jalen Duren",0,23,28,16,17,30.9
"4460",191,8,0,6,8,2,27,11,10,9,39,2,2,33,8,0,5,1037704,"2023-11-08T00:00:00.000Z",17896075,9,"Cade Cunningham",0,41,49,41,16,49.6
"4461",192,4,0,5,3,0,15,6,2,2,29,0,1,14,5,1,1,1037704,"2023-11-08T00:00:00.000Z",3547241,9,"Killian Hayes",1,19,23,18,9,28
"4462",193,2,1,0,0,0,6,5,2,2,20,2,4,12,2,0,1,1037704,"2023-11-08T00:00:00.000Z",24,9,"Marvin Bagley III",1,14,16,14,4,19.4
"4463",194,0,0,0,0,0,0,0,0,0,0,0,0,0,0,0,0,1037704,"2023-11-08T00:00:00.000Z",56677729,9,"Malcolm Cazalon",0,0,0,0,0,0
"4464",195,0,0,0,0,0,0,0,0,0,0,0,0,0,0,0,0,1037704,"2023-11-08T00:00:00.000Z",197,9,"Joe Harris",0,0,0,0,0,0
"4465",196,0,0,0,0,0,0,0,0,0,0,0,0,0,0,0,0,1037704,"2023-11-08T00:00:00.000Z",38017682,9,"Jaden Ivey",0,0,0,0,0,0
"4466",197,0,0,0,0,0,0,0,0,0,0,0,0,0,0,0,0,1037697,"2023-11-08T00:00:00.000Z",56677832,12,"Jarace Walker",0,0,0,0,0,0
"4467",198,0,0,0,0,0,0,0,0,0,0,0,0,0,0,0,0,1037697,"2023-11-08T00:00:00.000Z",38017701,12,"Kendall Brown",0,0,0,0,0,0
"4468",199,0,0,0,0,0,0,0,0,0,0,0,0,0,0,0,0,1037697,"2023-11-08T00:00:00.000Z",56677842,29,"Brice Sensabaugh",0,0,0,0,0,0
"4469",200,2,1,2,7,2,13,4,2,1,35,0,2,11,2,1,4,1037698,"2023-11-08T00:00:00.000Z",70,2,"Jaylen Brown",2,13,15,13,4,18.4
"4470",201,1,0,2,3,2,10,4,6,3,22,1,5,13,3,1,4,1037838,"2023-11-27T00:00:00.000Z",56677747,25,"Scoot Henderson",1,16,17,14,4,17.1
"4471",202,3,2,7,5,2,26,10,9,9,39,1,0,31,8,1,2,1037841,"2023-11-27T00:00:00.000Z",274,13,"Kawhi Leonard",3,39,42,34,11,52.1
"4472",203,4,1,5,4,0,13,2,2,2,37,3,5,6,8,1,3,1037841,"2023-11-27T00:00:00.000Z",172,13,"Paul George",2,14,18,10,12,24.6
"4473",204,2,0,4,8,3,9,4,4,3,28,0,3,14,4,2,0,1037840,"2023-11-27T00:00:00.000Z",38017739,29,"Simone Fontecchio",2,18,20,16,6,27.8
"4474",205,0,0,2,6,2,10,4,3,2,29,1,1,12,3,0,1,1037840,"2023-11-27T00:00:00.000Z",101,29,"John Collins",0,15,15,12,3,14.6
"4475",206,2,2,5,2,1,4,2,2,2,22,5,4,7,10,0,2,1037840,"2023-11-27T00:00:00.000Z",11891374,29,"Omer Yurtseven",2,17,19,9,12,26
"4476",207,10,0,4,9,2,16,4,6,6,32,0,1,16,4,0,1,1037840,"2023-11-27T00:00:00.000Z",100,29,"Jordan Clarkson",0,20,30,26,14,34.8
"4477",208,3,0,4,8,3,14,6,6,4,31,1,0,19,5,2,2,1037840,"2023-11-27T00:00:00.000Z",56677834,29,"Keyonte George",2,24,27,22,8,33.5
"4478",209,0,0,0,6,3,7,4,1,1,16,0,1,12,0,0,0,1037840,"2023-11-27T00:00:00.000Z",38017620,29,"Ochai Agbaji",0,12,12,12,0,12
"4479",210,0,0,0,0,0,0,0,0,0,0,0,0,0,0,0,0,1037840,"2023-11-27T00:00:00.000Z",139,29,"Kris Dunn",0,0,0,0,0,0
"4480",211,0,0,0,0,0,0,0,0,0,0,0,0,0,0,0,0,1037840,"2023-11-27T00:00:00.000Z",56677824,29,"Taylor Hendricks",0,0,0,0,0,0
"4481",212,1,1,6,0,0,15,9,8,5,32,8,2,23,14,0,1,1037841,"2023-11-27T00:00:00.000Z",493,13,"Ivica Zubac",1,37,38,24,15,43.3
"4482",213,0,1,2,1,0,3,2,2,1,30,1,2,5,3,0,1,1037841,"2023-11-27T00:00:00.000Z",666743,13,"Terance Mann",1,8,8,5,3,10.6
"4483",214,4,0,2,5,3,7,3,2,2,36,0,3,11,2,1,3,1037841,"2023-11-27T00:00:00.000Z",192,13,"James Harden",1,13,17,15,6,19.4
"4484",215,3,1,10,0,0,9,5,6,4,27,1,4,14,11,0,2,1037841,"2023-11-27T00:00:00.000Z",472,13,"Russell Westbrook",1,25,28,17,14,32.7
"4485",216,1,2,0,0,0,4,2,0,0,12,1,3,4,1,0,1,1037841,"2023-11-27T00:00:00.000Z",439,13,"Daniel Theis",2,5,6,5,2,11.7
"4486",217,1,1,1,5,1,8,2,5,5,21,1,3,10,2,1,0,1037841,"2023-11-27T00:00:00.000Z",380,13,"Norman Powell",2,12,13,11,3,19.9
"4487",218,1,0,0,0,0,0,0,0,0,6,0,1,0,0,2,0,1037841,"2023-11-27T00:00:00.000Z",450,13,"PJ Tucker",2,0,1,1,1,7.5
"4488",219,0,0,0,0,0,0,0,0,0,0,0,0,0,0,0,0,1037841,"2023-11-27T00:00:00.000Z",56677849,13,"Kobe Brown",0,0,0,0,0,0
"4489",220,0,0,0,0,0,0,0,0,0,0,0,0,0,0,0,0,1037841,"2023-11-27T00:00:00.000Z",666511,13,"Amir Coffey",0,0,0,0,0,0
"4490",221,0,0,0,0,0,0,0,0,0,0,0,0,0,0,0,0,1037841,"2023-11-27T00:00:00.000Z",38017725,13,"Moussa Diabate",0,0,0,0,0,0
"4491",222,0,0,0,0,0,0,0,0,0,0,0,0,0,0,0,0,1037841,"2023-11-27T00:00:00.000Z",17896031,13,"Nah'Shon Hyland",0,0,0,0,0,0
"4492",223,0,0,0,0,0,0,0,0,0,0,0,0,0,0,0,0,1037841,"2023-11-27T00:00:00.000Z",56677856,13,"Jordan Miller",0,0,0,0,0,0
"4493",224,0,0,0,0,0,0,0,0,0,0,0,0,0,0,0,0,1037841,"2023-11-27T00:00:00.000Z",24417679,13,"Xavier Moon",0,0,0,0,0,0
"4494",225,0,0,0,0,0,0,0,0,0,0,0,0,0,0,0,0,1037841,"2023-11-27T00:00:00.000Z",17896022,13,"Brandon Boston Jr.",0,0,0,0,0,0
"4495",226,0,0,0,0,0,0,0,0,0,0,0,0,0,0,0,0,1037932,"2023-12-16T00:00:00.000Z",4197029,21,"Vasilije Micic",0,0,0,0,0,0
"4496",227,0,0,0,0,0,0,0,0,0,0,0,0,0,0,0,0,1037928,"2023-12-16T00:00:00.000Z",38017689,1,"AJ Griffin",0,0,0,0,0,0
"4497",228,0,0,0,0,0,0,0,0,0,0,0,0,0,0,0,0,1037928,"2023-12-16T00:00:00.000Z",56677806,1,"Mouhamed Gueye",0,0,0,0,0,0
"4498",229,0,0,0,0,0,0,0,0,0,0,0,0,0,0,0,0,1037932,"2023-12-16T00:00:00.000Z",24572055,21,"Olivier Sarr",0,0,0,0,0,0
"4499",230,0,0,0,0,0,0,0,0,0,0,0,0,0,0,0,0,1037932,"2023-12-16T00:00:00.000Z",56677853,21,"Keyontae Johnson",0,0,0,0,0,0
"4500",231,0,0,0,0,0,0,0,0,0,0,0,0,0,0,0,0,1037932,"2023-12-16T00:00:00.000Z",3547271,21,"Aleksej Pokusevski",0,0,0,0,0,0
"4501",232,0,0,0,0,0,0,0,0,0,0,0,0,0,0,0,0,1037932,"2023-12-16T00:00:00.000Z",27924547,21,"Lindy Waters III",0,0,0,0,0,0
"4502",233,4,0,1,0,0,7,3,0,0,18,0,0,6,1,1,0,1037927,"2023-12-16T00:00:00.000Z",422,4,"Ish Smith",1,7,11,10,5,16.2
"4503",234,1,0,0,4,1,8,4,0,0,26,1,2,9,1,0,0,1037927,"2023-12-16T00:00:00.000Z",56677846,4,"Nick Smith Jr.",0,10,11,10,2,11.7
"4504",235,0,0,1,5,3,5,3,0,0,7,0,1,9,1,0,0,1037927,"2023-12-16T00:00:00.000Z",17896037,4,"James Bouknight",0,10,10,9,1,10.2
"4505",236,0,0,0,2,0,3,1,2,1,7,0,0,3,0,0,1,1037927,"2023-12-16T00:00:00.000Z",56677848,4,"Amari Bailey",0,3,3,3,0,2
"4506",237,2,1,1,0,0,1,1,0,0,7,0,0,2,1,1,1,1037927,"2023-12-16T00:00:00.000Z",56677866,4,"Leaky Black",2,3,5,4,3,11.2
"4507",238,2,0,3,3,2,8,5,0,0,21,3,3,12,6,1,2,1037931,"2023-12-16T00:00:00.000Z",407,10,"Dario Saric",1,18,20,14,8,23.2
"4508",239,1,0,3,1,1,9,4,5,5,26,2,0,14,5,1,0,1037931,"2023-12-16T00:00:00.000Z",475,10,"Andrew Wiggins",1,19,20,15,6,24.5
"4509",240,1,0,1,0,0,3,1,0,0,12,2,0,2,3,0,0,1037931,"2023-12-16T00:00:00.000Z",17553992,10,"Moses Moody",0,5,6,3,4,7.1
"4510",241,0,0,0,0,0,0,0,0,0,0,0,0,0,0,0,0,1037931,"2023-12-16T00:00:00.000Z",185,10,"Draymond Green",0,0,0,0,0,0
"4511",242,0,0,0,0,0,0,0,0,0,0,0,0,0,0,0,0,1037931,"2023-12-16T00:00:00.000Z",56677799,10,"Trayce Jackson-Davis",0,0,0,0,0,0
"4512",243,0,0,0,0,0,0,0,0,0,0,0,0,0,0,0,0,1037931,"2023-12-16T00:00:00.000Z",251,10,"Cory Joseph",0,0,0,0,0,0
"4513",244,2,0,2,5,3,11,6,1,1,33,2,1,16,4,1,0,1037934,"2023-12-16T00:00:00.000Z",30,26,"Harrison Barnes",1,20,22,18,6,26.8
"4514",245,2,0,7,15,12,23,16,4,3,36,1,1,47,8,2,0,1037934,"2023-12-16T00:00:00.000Z",38017688,26,"Keegan Murray",2,55,57,49,10,65.6
"4515",246,8,0,8,1,0,10,9,4,2,35,2,1,20,10,2,6,1037934,"2023-12-16T00:00:00.000Z",406,26,"Domantas Sabonis",2,30,38,28,18,44
"4516",247,5,0,2,4,2,6,4,2,1,25,1,4,11,3,0,0,1037934,"2023-12-16T00:00:00.000Z",221,26,"Kevin Huerter",0,14,19,16,8,22.1
"4517",248,7,0,1,3,0,3,0,2,2,26,0,2,2,1,1,3,1037934,"2023-12-16T00:00:00.000Z",38017714,26,"Keon Ellis",1,3,10,9,8,13.7
"4518",249,0,1,7,2,0,2,0,0,0,18,1,4,0,8,0,2,1037934,"2023-12-16T00:00:00.000Z",290,26,"Trey Lyles",1,8,8,0,8,10.6
"4519",250,0,0,1,0,0,2,0,0,0,4,0,0,0,1,0,1,1037934,"2023-12-16T00:00:00.000Z",17896030,26,"Chris Duarte",0,1,1,0,1,0.2
"4520",251,0,0,1,4,0,5,1,0,0,19,0,1,2,1,0,0,1038062,"2024-01-03T00:00:00.000Z",254,15,"Luke Kennard",0,3,3,2,1,3.2
"4521",252,0,0,0,0,0,0,0,0,0,0,0,0,0,0,0,0,1038054,"2024-01-02T00:00:00.000Z",3547271,21,"Aleksej Pokusevski",0,0,0,0,0,0
"4522",253,2,1,0,2,0,4,2,0,0,21,2,4,4,2,1,2,1038051,"2024-01-02T00:00:00.000Z",17896025,23,"Jaden Springer",2,6,8,6,4,13.4
"4523",254,0,0,4,0,0,3,1,0,0,13,0,2,2,4,2,0,1038051,"2024-01-02T00:00:00.000Z",3547270,23,"Paul Reed",2,6,6,2,4,12.8
"4524",255,1,0,0,0,0,3,0,0,0,9,0,0,0,0,0,0,1038051,"2024-01-02T00:00:00.000Z",3547294,23,"Kenyon Martin Jr.",0,0,1,1,1,1.5
"4525",256,0,0,2,0,0,1,0,0,0,7,0,3,0,2,1,2,1038051,"2024-01-02T00:00:00.000Z",28,23,"Mo Bamba",1,2,2,0,2,3.4
"4526",257,0,0,0,1,0,1,0,0,0,6,0,0,0,0,0,0,1038051,"2024-01-02T00:00:00.000Z",56913527,23,"Ricky Council IV",0,0,0,0,0,0
"4527",258,0,0,2,0,0,2,0,0,0,4,0,0,0,2,0,2,1038051,"2024-01-02T00:00:00.000Z",38017732,23,"Kenneth Lofton Jr.",0,2,2,0,2,0.4
"4528",259,0,0,0,0,0,0,0,0,0,0,0,0,0,0,0,0,1038051,"2024-01-02T00:00:00.000Z",108,23,"Robert Covington",0,0,0,0,0,0
"4529",260,5,1,4,2,2,9,5,0,0,25,1,2,12,5,0,1,1038053,"2024-01-02T00:00:00.000Z",227,19,"Brandon Ingram",1,17,22,17,10,27.5
"4530",261,5,1,2,0,0,9,5,0,0,26,1,3,10,3,0,4,1038053,"2024-01-02T00:00:00.000Z",666969,19,"Zion Williamson",1,13,18,15,8,20.1
"4531",262,0,1,9,1,1,5,5,0,0,20,3,0,11,12,1,1,1038053,"2024-01-02T00:00:00.000Z",455,19,"Jonas Valanciunas",2,23,23,11,12,30.4
"4532",263,1,1,2,4,2,10,5,2,2,24,2,1,14,4,2,3,1038053,"2024-01-02T00:00:00.000Z",17896024,19,"Herbert Jones",3,18,19,15,5,26.3
"4533",264,5,0,4,8,4,11,6,0,0,24,2,0,16,6,0,2,1038053,"2024-01-02T00:00:00.000Z",303,19,"CJ McCollum",0,22,27,21,11,28.7
"4534",265,1,1,1,2,0,6,2,2,2,16,1,0,6,2,1,0,1038053,"2024-01-02T00:00:00.000Z",3547293,19,"Naji Marshall",2,8,9,7,3,15.9
"4535",266,2,0,2,6,3,9,4,3,2,22,1,2,13,3,2,1,1038053,"2024-01-02T00:00:00.000Z",17896097,19,"Jose Alvarado",2,16,18,15,5,24.6
"4536",267,0,0,6,2,1,4,2,2,1,20,2,2,6,8,2,1,1038053,"2024-01-02T00:00:00.000Z",340,19,"Larry Nance Jr.",2,14,14,6,8,20.6
"4537",268,1,2,0,8,2,13,3,4,3,26,0,0,11,0,0,0,1038053,"2024-01-02T00:00:00.000Z",56677837,19,"Jordan Hawkins",2,11,12,12,1,18.5
"4538",269,3,2,1,4,1,5,2,2,2,20,1,0,7,2,2,1,1038053,"2024-01-02T00:00:00.000Z",38017677,19,"Dyson Daniels",4,9,12,10,5,24.9
"4539",270,0,0,1,0,0,3,1,3,2,8,1,2,4,2,0,0,1038053,"2024-01-02T00:00:00.000Z",491,19,"Cody Zeller",0,6,6,4,2,6.4
"4540",271,1,2,2,2,1,6,4,4,3,28,0,1,12,2,0,1,1038052,"2024-01-02T00:00:00.000Z",38017699,27,"Jeremy Sochan",2,14,15,13,3,20.9
"4541",272,1,4,7,5,2,16,8,4,2,26,0,0,20,7,0,1,1038052,"2024-01-02T00:00:00.000Z",56677822,27,"Victor Wembanyama",4,27,28,21,8,40.9
"4542",273,2,0,1,1,0,3,1,0,0,13,3,4,2,4,0,0,1038054,"2024-01-02T00:00:00.000Z",480,21,"Kenrich Williams",0,6,8,4,6,9.8
"4543",274,3,0,0,2,1,3,2,0,0,17,1,3,5,1,1,0,1038054,"2024-01-02T00:00:00.000Z",56677833,21,"Cason Wallace",1,6,9,8,4,13.7
"4544",275,1,0,1,1,0,3,1,2,2,13,0,1,4,1,1,0,1038054,"2024-01-02T00:00:00.000Z",17896078,21,"Aaron Wiggins",1,5,6,5,2,9.7
"4545",276,0,0,4,0,0,4,3,2,2,15,1,4,8,5,1,2,1037651,"2023-11-01T00:00:00.000Z",74,16,"Thomas Bryant",1,13,13,8,5,15
"4546",277,0,0,0,0,0,0,0,0,0,0,0,0,0,0,0,0,1037651,"2023-11-01T00:00:00.000Z",38017696,16,"Nikola Jovic",0,0,0,0,0,0
"4547",278,0,0,0,0,0,0,0,0,0,0,0,0,0,0,0,0,1037651,"2023-11-01T00:00:00.000Z",39398582,16,"Orlando Robinson",0,0,0,0,0,0
"4548",279,0,0,0,0,0,0,0,0,0,0,0,0,0,0,0,0,1037651,"2023-11-01T00:00:00.000Z",19465585,16,"Dru Smith",0,0,0,0,0,0
"4549",280,0,0,0,0,0,0,0,0,0,0,0,0,0,0,0,0,1037651,"2023-11-01T00:00:00.000Z",38017734,16,"Jamal Cain",0,0,0,0,0,0
"4550",281,0,0,0,0,0,0,0,0,0,0,0,0,0,0,0,0,1037651,"2023-11-01T00:00:00.000Z",3547257,16,"R.J. Hampton",0,0,0,0,0,0
"4551",282,0,0,0,0,0,0,0,0,0,0,0,0,0,0,0,0,1037651,"2023-11-01T00:00:00.000Z",285,16,"Kevin Love",0,0,0,0,0,0
"4552",283,0,0,0,0,0,0,0,0,0,0,0,0,0,0,0,0,1037651,"2023-11-01T00:00:00.000Z",666747,16,"Caleb Martin",0,0,0,0,0,0
"4553",284,0,2,3,3,1,9,4,0,0,18,2,3,9,5,0,0,1037655,"2023-11-01T00:00:00.000Z",3547268,8,"Zeke Nnaji",2,14,14,9,5,21
"4554",285,1,0,2,1,0,3,2,0,0,16,0,2,4,2,0,2,1037655,"2023-11-01T00:00:00.000Z",38017721,8,"Peyton Watson",0,6,7,5,3,5.9
"4555",286,0,2,0,6,1,7,2,1,0,16,0,0,5,0,1,0,1037655,"2023-11-01T00:00:00.000Z",56677776,8,"Julian Strawther",3,5,5,5,0,14
"4556",287,3,0,0,0,0,2,0,0,0,5,0,2,0,0,0,0,1037655,"2023-11-01T00:00:00.000Z",17896007,8,"Braxton Key",0,0,3,3,3,4.5
"4557",288,0,0,2,1,0,2,1,0,0,5,0,1,2,2,0,0,1037655,"2023-11-01T00:00:00.000Z",56677582,8,"Jalen Pickett",0,4,4,2,2,4.4
"4558",289,0,0,1,1,0,2,1,0,0,4,0,2,2,1,0,0,1037655,"2023-11-01T00:00:00.000Z",56677871,8,"Hunter Tyson",0,3,3,2,1,3.2
"4559",290,0,0,0,0,0,0,0,0,0,0,0,0,0,0,0,0,1037655,"2023-11-01T00:00:00.000Z",250,8,"DeAndre Jordan",0,0,0,0,0,0
"4560",291,0,0,0,0,0,0,0,0,0,0,0,0,0,0,0,0,1037655,"2023-11-01T00:00:00.000Z",666489,8,"Vlatko Cancar",0,0,0,0,0,0
"4561",292,0,0,0,0,0,0,0,0,0,0,0,0,0,0,0,0,1037655,"2023-11-01T00:00:00.000Z",38017727,8,"Collin Gillespie",0,0,0,0,0,0
"4562",293,0,0,0,0,0,0,0,0,0,0,0,0,0,0,0,0,1037655,"2023-11-01T00:00:00.000Z",17896103,8,"Jay Huff",0,0,0,0,0,0
"4563",294,0,0,0,0,0,0,0,0,0,0,0,0,0,0,0,0,1037653,"2023-11-01T00:00:00.000Z",3547293,19,"Naji Marshall",0,0,0,0,0,0
"4564",295,0,0,0,0,0,0,0,0,0,0,0,0,0,0,0,0,1037653,"2023-11-01T00:00:00.000Z",18677986,19,"Trey Murphy III",0,0,0,0,0,0
"4565",296,0,0,0,0,0,0,0,0,0,0,0,0,0,0,0,0,1037653,"2023-11-01T00:00:00.000Z",38017726,19,"Dereon Seabron",0,0,0,0,0,0
"4566",297,1,0,10,6,4,11,6,3,3,28,1,5,19,11,1,0,1037657,"2023-11-01T00:00:00.000Z",297,29,"Lauri Markkanen",1,30,31,20,12,36.7
"4567",298,2,0,2,5,2,12,5,6,4,28,2,2,16,4,2,1,1037657,"2023-11-01T00:00:00.000Z",101,29,"John Collins",2,20,22,18,6,28.8
"4568",299,4,0,2,4,1,9,4,11,8,25,1,1,17,3,3,3,1037651,"2023-11-01T00:00:00.000Z",464,3,"Lonnie Walker IV",3,20,24,21,7,32.6
"4569",300,4,0,3,2,1,6,4,2,2,14,1,2,11,4,1,1,1037651,"2023-11-01T00:00:00.000Z",17896058,3,"Trendon Watford",1,15,19,15,8,23.8
"4570",301,1,0,0,2,1,2,1,0,0,12,0,3,3,0,0,0,1037775,"2023-11-18T00:00:00.000Z",48248287,15,"Jacob Gilyard",0,3,4,4,1,4.5
"4571",302,1,0,0,4,2,5,3,0,0,11,0,1,8,0,0,0,1037774,"2023-11-18T00:00:00.000Z",38017733,17,"A.J. Green",0,8,9,9,1,9.5
"4572",303,0,0,0,0,0,0,0,0,0,0,0,0,0,0,0,0,1037774,"2023-11-18T00:00:00.000Z",2148,17,"Thanasis Antetokounmpo",0,0,0,0,0,0
"4573",304,7,0,3,5,4,9,5,4,3,35,0,2,17,3,0,1,1037773,"2023-11-18T00:00:00.000Z",397,16,"Duncan Robinson",0,20,27,24,10,30.1
"4574",305,5,0,3,7,2,10,3,0,0,32,0,3,8,3,3,1,1037773,"2023-11-18T00:00:00.000Z",286,16,"Kyle Lowry",3,11,16,13,8,27.1
"4575",306,0,0,2,1,1,4,2,2,1,27,1,4,6,3,0,3,1037773,"2023-11-18T00:00:00.000Z",56677785,16,"Jaime Jaquez Jr.",0,9,9,6,3,6.6
"4576",307,2,0,5,6,1,7,2,2,0,12,1,2,5,6,0,0,1037773,"2023-11-18T00:00:00.000Z",285,16,"Kevin Love",0,11,13,7,8,15.2
"4577",308,0,0,0,0,0,0,0,0,0,0,0,0,0,0,0,0,1037776,"2023-11-18T00:00:00.000Z",44,21,"Davis Bertans",0,0,0,0,0,0
"4578",309,0,0,0,0,0,0,0,0,0,0,0,0,0,0,0,0,1037776,"2023-11-18T00:00:00.000Z",17896036,21,"Tre Mann",0,0,0,0,0,0
"4579",310,0,0,0,0,0,0,0,0,0,0,0,0,0,0,0,0,1037776,"2023-11-18T00:00:00.000Z",3547271,21,"Aleksej Pokusevski",0,0,0,0,0,0
"4580",311,2,1,4,10,4,11,5,0,0,38,3,1,14,7,0,1,1037774,"2023-11-18T00:00:00.000Z",666965,7,"Grant Williams",1,21,23,16,9,27.4
"4581",312,2,1,7,0,0,4,3,0,0,24,3,5,6,10,0,3,1037774,"2023-11-18T00:00:00.000Z",56677840,7,"Dereck Lively II",1,16,18,8,12,21
"4582",313,6,0,3,10,3,29,16,4,4,34,1,4,39,4,1,2,1037774,"2023-11-18T00:00:00.000Z",228,7,"Kyrie Irving",1,43,49,45,10,53.8
"4583",314,9,0,8,9,4,26,15,4,1,35,1,1,35,9,0,3,1037774,"2023-11-18T00:00:00.000Z",132,7,"Luka Doncic",0,44,53,44,18,56.3
"4584",315,3,0,3,3,1,3,1,0,0,20,1,1,3,4,0,0,1037774,"2023-11-18T00:00:00.000Z",3547258,7,"Josh Green",0,7,10,6,7,12.3
"4585",316,2,0,2,10,4,14,6,1,1,26,0,0,17,2,0,1,1037774,"2023-11-18T00:00:00.000Z",191,7,"Tim Hardaway Jr.",0,19,21,19,4,21.4
"4586",317,1,0,3,0,0,2,1,1,1,24,0,3,3,3,0,0,1037774,"2023-11-18T00:00:00.000Z",379,7,"Dwight Powell",0,6,7,4,4,8.1
"4587",318,1,0,1,2,0,5,3,0,0,11,0,0,6,1,0,0,1037774,"2023-11-18T00:00:00.000Z",151,7,"Dante Exum",0,7,8,7,2,8.7
"4588",319,0,0,1,1,0,2,1,0,0,9,0,0,2,1,0,0,1037774,"2023-11-18T00:00:00.000Z",114,7,"Seth Curry",0,3,3,2,1,3.2
"4589",320,0,0,0,0,0,0,0,0,0,0,0,0,0,0,0,0,1037774,"2023-11-18T00:00:00.000Z",38017679,7,"Jaden Hardy",0,0,0,0,0,0
"4590",321,0,0,0,0,0,0,0,0,0,0,0,0,0,0,0,0,1037776,"2023-11-18T00:00:00.000Z",398,10,"Jerome Robinson",0,0,0,0,0,0
"4591",322,2,0,6,4,1,6,1,0,0,27,1,2,3,7,0,0,1037776,"2023-11-18T00:00:00.000Z",666541,21,"Luguentz Dort",0,10,12,5,9,14.4
"4592",323,3,0,6,2,0,16,8,6,6,41,0,2,22,6,1,1,1037776,"2023-11-18T00:00:00.000Z",38017703,21,"Jalen Williams",1,28,31,25,9,35.7
"4593",324,5,1,6,5,2,22,14,7,6,37,4,2,36,10,2,4,1037776,"2023-11-18T00:00:00.000Z",38017685,21,"Chet Holmgren",3,46,51,41,15,60.5
"4594",325,2,2,3,2,1,10,4,2,2,22,2,2,11,5,1,0,1037776,"2023-11-18T00:00:00.000Z",17896065,21,"Josh Giddey",3,16,18,13,7,29
"4595",326,2,0,1,5,0,12,2,2,1,20,1,3,5,2,1,0,7050283,"2023-12-08T00:00:00.000Z",56677826,9,"Ausar Thompson",1,7,9,7,4,13.4
"4596",327,0,0,3,0,0,0,0,4,2,16,2,2,2,5,0,1,7050283,"2023-12-08T00:00:00.000Z",3547240,9,"James Wiseman",0,7,7,2,5,7
"4597",328,4,1,0,5,2,13,7,1,1,27,0,5,17,0,1,2,7981426,"2023-12-08T00:00:00.000Z",70,2,"Jaylen Brown",2,17,21,21,4,27
"4598",329,5,0,6,9,3,18,8,8,6,38,0,3,25,6,1,0,7981426,"2023-12-08T00:00:00.000Z",434,2,"Jayson Tatum",1,31,36,30,11,42.7
"4599",330,1,0,2,6,3,13,7,4,4,29,1,2,21,3,2,2,7981426,"2023-12-08T00:00:00.000Z",378,2,"Kristaps Porzingis",2,24,25,22,4,30.1
"4600",331,3,2,1,10,6,16,10,4,4,32,2,4,30,3,2,0,7981426,"2023-12-08T00:00:00.000Z",473,2,"Derrick White",4,33,36,33,6,50.1
"4601",332,5,1,6,3,1,11,7,1,1,35,0,1,16,6,2,1,7981426,"2023-12-08T00:00:00.000Z",214,2,"Jrue Holiday",3,22,27,21,11,38.7
"4602",333,1,1,2,5,0,5,0,2,1,21,1,1,1,3,0,0,7981426,"2023-12-08T00:00:00.000Z",17896060,2,"Sam Hauser",1,4,5,2,4,9.1
"4603",334,1,0,1,3,0,5,0,0,0,12,0,2,0,1,0,0,7050283,"2023-12-08T00:00:00.000Z",17896071,9,"Isaiah Livers",0,1,2,1,2,2.7
"4604",335,1,0,0,1,0,3,2,0,0,5,0,0,4,0,0,0,7050283,"2023-12-08T00:00:00.000Z",56677792,9,"Marcus Sasser",0,4,5,5,1,5.5
"4605",336,0,0,0,0,0,0,0,0,0,0,0,0,0,0,0,0,7050283,"2023-12-08T00:00:00.000Z",56677729,9,"Malcolm Cazalon",0,0,0,0,0,0
"4606",337,0,0,0,0,0,0,0,0,0,0,0,0,0,0,0,0,7050283,"2023-12-08T00:00:00.000Z",38017694,9,"Jalen Duren",0,0,0,0,0,0
"4607",338,0,0,0,0,0,0,0,0,0,0,0,0,0,0,0,0,7050283,"2023-12-08T00:00:00.000Z",330,9,"Monte Morris",0,0,0,0,0,0
"4608",339,0,0,0,0,0,0,0,0,0,0,0,0,0,0,0,0,7050283,"2023-12-08T00:00:00.000Z",42097199,9,"Jared Rhoden",0,0,0,0,0,0
"4609",340,0,0,0,0,0,0,0,0,0,0,0,0,0,0,0,0,7050283,"2023-12-08T00:00:00.000Z",44477024,9,"Stanley Umude",0,0,0,0,0,0
"4610",341,0,0,0,0,0,0,0,0,0,0,0,0,0,0,0,0,7981426,"2023-12-08T00:00:00.000Z",56677864,2,"Jordan Walsh",0,0,0,0,0,0
"4611",342,3,0,2,5,2,16,9,4,3,31,1,0,23,3,1,0,7981426,"2023-12-08T00:00:00.000Z",666423,20,"RJ Barrett",1,26,29,26,6,34.1
"4612",343,3,1,4,4,3,15,7,4,3,34,1,2,20,5,1,6,7981426,"2023-12-08T00:00:00.000Z",387,20,"Julius Randle",2,25,28,23,8,30.5
"4613",344,2,0,3,0,0,6,5,2,0,19,5,2,10,8,1,1,7981426,"2023-12-08T00:00:00.000Z",399,20,"Mitchell Robinson",1,18,20,12,10,24.6
"4614",345,2,0,4,5,2,6,2,0,0,22,0,2,6,4,0,1,7981426,"2023-12-08T00:00:00.000Z",131,20,"Donte DiVincenzo",0,10,12,8,6,12.8
"4615",346,4,0,1,5,0,17,8,9,7,34,0,3,23,1,1,1,7981426,"2023-12-08T00:00:00.000Z",73,20,"Jalen Brunson",1,24,28,27,5,32.2
"4616",347,0,0,0,0,0,0,0,0,0,0,0,0,0,0,0,0,7981426,"2023-12-08T00:00:00.000Z",19,20,"Ryan Arcidiacono",0,0,0,0,0,0
"4617",348,0,0,0,0,0,0,0,0,0,0,0,0,0,0,0,0,7981426,"2023-12-08T00:00:00.000Z",17896063,20,"Jericho Sims",0,0,0,0,0,0
"4618",349,0,0,0,0,0,0,0,0,0,0,0,0,0,0,0,0,7981426,"2023-12-08T00:00:00.000Z",666474,20,"Charles Brown",0,0,0,0,0,0
"4619",350,0,0,0,0,0,0,0,0,0,0,0,0,0,0,0,0,7981426,"2023-12-08T00:00:00.000Z",59421201,20,"Jaylen Martin",0,0,0,0,0,0
"4620",351,7,0,1,1,0,7,3,1,0,27,3,1,6,4,2,0,1038004,"2023-12-26T00:00:00.000Z",3547274,27,"Tre Jones",2,10,17,13,11,27.3
"4621",352,3,0,2,1,0,2,0,4,1,13,0,0,1,2,0,0,1038004,"2023-12-26T00:00:00.000Z",359,27,"Cedi Osman",0,3,6,4,5,7.9
"4622",353,0,0,0,0,0,0,0,0,0,0,0,0,0,0,0,0,1038005,"2023-12-26T00:00:00.000Z",47957121,25,"Justin Minaya",0,0,0,0,0,0
"4623",354,0,0,0,0,0,0,0,0,0,0,0,0,0,0,0,0,1038005,"2023-12-26T00:00:00.000Z",56677829,25,"Rayan Rupert",0,0,0,0,0,0
"4624",355,0,0,0,2,0,2,0,0,0,11,0,0,0,0,0,0,1038004,"2023-12-26T00:00:00.000Z",305,27,"Doug McDermott",0,0,0,0,0,0
"4625",356,0,0,0,0,0,0,0,0,0,0,0,0,0,0,0,0,1038004,"2023-12-26T00:00:00.000Z",19465584,29,"Micah Potter",0,0,0,0,0,0
"4626",357,3,0,5,5,1,16,8,8,7,36,0,4,24,5,1,4,1038007,"2023-12-27T00:00:00.000Z",17896026,22,"Franz Wagner",1,29,32,27,8,33.5
"4627",358,4,1,9,8,1,21,6,7,6,38,0,0,19,9,1,1,1038007,"2023-12-27T00:00:00.000Z",38017683,22,"Paolo Banchero",2,28,32,23,13,40.8
"4628",359,1,2,2,2,0,4,1,2,2,22,2,0,4,4,0,1,1038007,"2023-12-27T00:00:00.000Z",85,22,"Wendell Carter Jr.",2,8,9,5,5,15.3
"4629",360,1,1,1,2,1,12,8,3,3,28,1,5,20,2,1,3,1038007,"2023-12-27T00:00:00.000Z",17896073,22,"Jalen Suggs",2,22,23,21,3,26.9
"4630",361,4,1,3,3,1,6,1,0,0,24,1,2,3,4,1,0,1038007,"2023-12-27T00:00:00.000Z",56677827,22,"Anthony Black",2,7,11,7,8,19.8
"4631",362,1,0,4,4,1,7,2,1,0,23,2,1,5,6,0,4,1038007,"2023-12-27T00:00:00.000Z",3547251,22,"Cole Anthony",0,11,12,6,7,9.7
"4632",363,2,0,4,4,2,4,2,1,1,26,2,2,7,6,0,2,1038007,"2023-12-27T00:00:00.000Z",38017724,22,"Caleb Houstan",0,13,15,9,8,15.2
"4633",364,0,1,3,2,1,3,1,0,0,15,1,2,3,4,0,0,1038007,"2023-12-27T00:00:00.000Z",666818,22,"Chuma Okeke",1,7,7,3,4,10.8
"4634",365,0,4,1,0,0,1,1,0,0,9,0,0,2,1,0,0,1038007,"2023-12-27T00:00:00.000Z",666442,22,"Goga Bitadze",4,3,3,2,1,15.2
"4635",366,0,0,0,1,0,1,0,0,0,1,0,0,0,0,1,0,1038007,"2023-12-27T00:00:00.000Z",17553983,22,"Trevelin Queen",1,0,0,0,0,3
"4636",367,0,0,0,1,1,1,1,0,0,1,0,0,3,0,0,0,1038007,"2023-12-27T00:00:00.000Z",56677839,22,"Jett Howard",0,3,3,3,0,3
"4637",368,0,0,0,0,0,0,0,0,0,1,0,0,0,0,0,0,1038007,"2023-12-27T00:00:00.000Z",666885,22,"Admiral Schofield",0,0,0,0,0,0
"4638",369,1,0,3,1,0,4,3,0,0,12,0,0,6,3,1,1,1038009,"2023-12-27T00:00:00.000Z",61,3,"Mikal Bridges",1,9,10,7,4,13.1
"4639",370,2,0,1,3,1,4,1,0,0,10,0,1,3,1,0,0,1038009,"2023-12-27T00:00:00.000Z",351,3,"Royce O'Neale",0,4,6,5,3,7.2
"4640",371,4,1,2,1,1,6,5,2,1,16,2,3,12,4,0,0,1038009,"2023-12-27T00:00:00.000Z",17896038,3,"Day'Ron Sharpe",1,16,20,16,8,25.8
"4641",372,0,0,0,2,0,9,4,0,0,12,0,1,8,0,1,0,1038009,"2023-12-27T00:00:00.000Z",17896048,3,"Cam Thomas",1,8,8,8,0,11
"4642",373,8,0,6,4,0,17,7,0,0,30,1,0,14,7,1,2,1038009,"2023-12-27T00:00:00.000Z",421,3,"Dennis Smith Jr.",1,21,29,22,15,35.4
"4643",374,4,0,5,1,0,9,6,6,5,28,0,1,17,5,2,1,1038009,"2023-12-27T00:00:00.000Z",17896058,3,"Trendon Watford",2,22,26,21,9,34
"4644",375,0,0,2,0,0,3,0,2,1,7,2,2,1,4,0,1,1038009,"2023-12-27T00:00:00.000Z",174,3,"Harry Giles III",0,5,5,1,4,4.8
"4645",376,0,0,3,0,0,0,0,0,0,8,0,0,0,3,0,0,1037596,"2023-10-25T00:00:00.000Z",337,30,"Mike Muscala",0,3,3,0,3,3.6
"4646",377,1,0,1,0,0,3,2,0,0,8,1,0,4,2,0,1,1037596,"2023-10-25T00:00:00.000Z",17896106,30,"Eugene Omoruyi",0,6,7,5,3,6.9
"4647",378,1,0,3,0,0,3,0,2,1,6,0,0,1,3,0,1,1037596,"2023-10-25T00:00:00.000Z",38017712,30,"Ryan Rollins",0,4,5,2,4,5.1
"4648",379,2,0,0,1,1,3,1,0,0,10,0,4,3,0,1,2,1037601,"2023-10-25T00:00:00.000Z",3547275,28,"Malachi Flynn",1,3,5,5,2,7
"4649",380,1,0,0,0,0,1,0,0,0,2,0,1,0,0,0,0,1037601,"2023-10-25T00:00:00.000Z",56677828,28,"Gradey Dick",0,0,1,1,1,1.5
"4650",381,0,0,0,1,1,2,1,0,0,4,0,0,3,0,0,0,1037596,"2023-10-25T00:00:00.000Z",18677954,30,"Jared Butler",0,3,3,3,0,3
"4651",382,0,0,0,0,0,0,0,0,0,0,0,0,0,0,0,0,1037596,"2023-10-25T00:00:00.000Z",38124126,30,"John Butler Jr.",0,0,0,0,0,0
"4652",383,0,0,0,0,0,0,0,0,0,0,0,0,0,0,0,0,1037596,"2023-10-25T00:00:00.000Z",38017687,30,"Johnny Davis",0,0,0,0,0,0
"4653",384,0,0,0,0,0,0,0,0,0,0,0,0,0,0,0,0,1037596,"2023-10-25T00:00:00.000Z",3547302,30,"Anthony Gill",0,0,0,0,0,0
"4654",385,0,0,0,0,0,0,0,0,0,0,0,0,0,0,0,0,1037596,"2023-10-25T00:00:00.000Z",414,30,"Landry Shamet",0,0,0,0,0,0
"4655",386,0,0,0,0,0,0,0,0,0,0,0,0,0,0,0,0,1037601,"2023-10-25T00:00:00.000Z",58,28,"Chris Boucher",0,0,0,0,0,0
"4656",387,2,1,3,3,1,20,9,3,1,33,2,1,20,5,1,0,1037602,"2023-10-25T00:00:00.000Z",125,5,"DeMar DeRozan",2,25,27,22,7,35
"4657",388,4,0,1,4,0,10,4,0,0,30,2,3,8,3,2,0,1037602,"2023-10-25T00:00:00.000Z",3547248,5,"Patrick Williams",2,11,15,12,7,23.6
"4658",389,4,2,8,2,0,8,5,1,1,32,1,2,11,9,3,4,1037602,"2023-10-25T00:00:00.000Z",460,5,"Nikola Vucevic",5,20,24,15,13,38.8
"4659",390,3,0,4,9,2,16,4,6,6,25,0,3,16,4,0,4,1037602,"2023-10-25T00:00:00.000Z",268,5,"Zach LaVine",0,20,23,19,7,21.3
"4660",391,4,0,3,7,2,14,4,6,5,30,1,3,15,4,0,0,1037602,"2023-10-25T00:00:00.000Z",666956,5,"Coby White",0,19,23,19,8,25.8
"4661",392,2,0,1,4,1,4,1,0,0,16,0,0,3,1,0,0,1037602,"2023-10-25T00:00:00.000Z",87,5,"Jevon Carter",0,4,6,5,3,7.2
"4662",393,3,0,2,4,1,5,2,2,1,19,0,1,6,2,2,1,1037602,"2023-10-25T00:00:00.000Z",89,5,"Alex Caruso",2,8,11,9,5,17.9
"4663",394,1,0,3,4,3,6,4,0,0,22,4,2,11,7,0,1,1037602,"2023-10-25T00:00:00.000Z",110,5,"Torrey Craig",0,18,19,12,8,19.9
"4664",395,1,0,2,0,0,4,3,0,0,16,3,1,6,5,1,1,1037602,"2023-10-25T00:00:00.000Z",137,5,"Andre Drummond",1,11,12,7,6,15.5
"4665",396,0,0,4,3,1,7,4,0,0,29,0,2,9,4,0,1,1037603,"2023-10-25T00:00:00.000Z",17896027,15,"Ziaire Williams",0,13,13,9,4,12.8
"4666",397,3,5,4,5,0,9,2,4,4,36,1,5,8,5,0,3,1037603,"2023-10-25T00:00:00.000Z",231,15,"Jaren Jackson Jr.",5,13,16,11,8,30.5
"4667",398,4,1,8,5,1,16,7,2,2,34,4,2,17,12,3,0,1037603,"2023-10-25T00:00:00.000Z",3547285,15,"Xavier Tillman",4,29,33,21,16,49.4
"4668",399,5,1,5,10,5,22,11,5,4,36,0,1,31,5,2,2,1037603,"2023-10-25T00:00:00.000Z",3547287,15,"Desmond Bane",3,36,41,36,10,51.5
"4669",400,3,0,0,6,2,11,6,6,3,32,0,3,17,0,2,5,1037603,"2023-10-25T00:00:00.000Z",420,15,"Marcus Smart",2,17,20,20,3,22.5
"4670",401,0,0,0,0,0,0,0,0,0,0,0,0,0,0,0,0,3277428,"2023-11-14T00:00:00.000Z",85,22,"Wendell Carter Jr.",0,0,0,0,0,0
"4671",402,0,0,0,0,0,0,0,0,0,0,0,0,0,0,0,0,3277428,"2023-11-14T00:00:00.000Z",165,22,"Markelle Fultz",0,0,0,0,0,0
"4672",403,0,0,0,0,0,0,0,0,0,0,0,0,0,0,0,0,3277428,"2023-11-14T00:00:00.000Z",196,22,"Gary Harris",0,0,0,0,0,0
"4673",404,0,0,0,0,0,0,0,0,0,0,0,0,0,0,0,0,3277428,"2023-11-14T00:00:00.000Z",38017607,22,"Kevon Harris",0,0,0,0,0,0
"4674",405,0,0,0,0,0,0,0,0,0,0,0,0,0,0,0,0,3277428,"2023-11-14T00:00:00.000Z",17553983,22,"Trevelin Queen",0,0,0,0,0,0
"4675",406,0,0,0,0,0,0,0,0,0,0,0,0,0,0,0,0,3277428,"2023-11-14T00:00:00.000Z",666885,22,"Admiral Schofield",0,0,0,0,0,0
"4676",407,0,0,0,5,2,5,2,0,0,14,0,0,6,0,0,0,3277429,"2023-11-14T00:00:00.000Z",359,27,"Cedi Osman",0,6,6,6,0,6
"4677",408,0,0,1,4,0,13,5,2,1,26,1,2,11,2,1,3,3277429,"2023-11-14T00:00:00.000Z",38017692,27,"Malaki Branham",1,13,13,11,2,13.4
"4678",409,1,0,1,2,1,4,2,0,0,18,0,0,5,1,0,4,3277429,"2023-11-14T00:00:00.000Z",305,27,"Doug McDermott",0,6,7,6,2,3.7
"4679",410,7,0,1,2,0,3,1,3,2,17,0,2,4,1,0,2,3277429,"2023-11-14T00:00:00.000Z",180,27,"Devonte' Graham",0,5,12,11,8,13.7
"4680",411,0,0,0,0,0,0,0,0,0,0,0,0,0,0,0,0,3277429,"2023-11-14T00:00:00.000Z",17896059,27,"Sandro Mamukelashvili",0,0,0,0,0,0
"4681",412,0,0,0,0,0,0,0,0,0,0,0,0,0,0,0,0,3277429,"2023-11-14T00:00:00.000Z",56677865,27,"Charles Bediako",0,0,0,0,0,0
"4682",413,0,0,0,0,0,0,0,0,0,0,0,0,0,0,0,0,3277429,"2023-11-14T00:00:00.000Z",56677817,27,"Sidy Cissoko",0,0,0,0,0,0
"4683",414,0,0,0,0,0,0,0,0,0,0,0,0,0,0,0,0,3277429,"2023-11-14T00:00:00.000Z",666682,27,"Keldon Johnson",0,0,0,0,0,0
"4684",415,0,0,0,0,0,0,0,0,0,0,0,0,0,0,0,0,3277429,"2023-11-14T00:00:00.000Z",3547274,27,"Tre Jones",0,0,0,0,0,0
"4685",416,0,0,0,0,0,0,0,0,0,0,0,0,0,0,0,0,3277429,"2023-11-14T00:00:00.000Z",56677870,27,"Sir'Jabari Rice",0,0,0,0,0,0
"4686",417,0,0,0,0,0,0,0,0,0,0,0,0,0,0,0,0,3277429,"2023-11-14T00:00:00.000Z",38017693,27,"Blake Wesley",0,0,0,0,0,0
"4687",418,0,0,0,0,0,0,0,0,0,0,0,0,0,0,0,0,3277428,"2023-11-14T00:00:00.000Z",17896041,3,"Keon Johnson",0,0,0,0,0,0
"4688",419,0,0,0,0,0,0,0,0,0,0,0,0,0,0,0,0,3277428,"2023-11-14T00:00:00.000Z",417,3,"Ben Simmons",0,0,0,0,0,0
"4689",420,0,0,0,0,0,0,0,0,0,0,0,0,0,0,0,0,3277428,"2023-11-14T00:00:00.000Z",56677841,3,"Dariq Whitehead",0,0,0,0,0,0
"4690",421,7,0,8,5,1,20,11,2,2,36,1,0,25,9,2,2,3277430,"2023-11-14T00:00:00.000Z",227,19,"Brandon Ingram",2,34,41,32,16,50.3
"4691",422,0,0,0,0,0,0,0,0,0,0,0,0,0,0,0,0,3277428,"2023-11-14T00:00:00.000Z",56677722,3,"Jalen Wilson",0,0,0,0,0,0
"4692",423,5,0,4,0,0,15,8,7,3,27,3,3,19,7,2,2,3277430,"2023-11-14T00:00:00.000Z",666969,19,"Zion Williamson",2,26,31,24,12,38.9
"4693",424,4,2,3,2,0,5,3,0,0,22,0,1,6,3,1,0,3277430,"2023-11-14T00:00:00.000Z",455,19,"Jonas Valanciunas",3,9,13,10,7,24.6
"4694",425,5,0,5,8,3,16,8,3,2,36,3,2,21,8,0,0,3277428,"2023-11-14T00:00:00.000Z",17896026,22,"Franz Wagner",0,29,34,26,13,38.1
"4695",426,2,4,2,5,4,8,7,4,4,35,0,5,22,2,1,0,1037876,"2023-12-02T00:00:00.000Z",3547243,12,"Obi Toppin",5,24,26,24,4,42.4
"4696",427,1,2,8,4,1,12,8,0,0,30,2,4,17,10,0,2,1037876,"2023-12-02T00:00:00.000Z",452,12,"Myles Turner",2,27,28,18,11,34.5
"4697",428,2,0,4,6,4,16,11,5,4,37,0,0,30,4,0,1,1037876,"2023-12-02T00:00:00.000Z",69,12,"Bruce Brown",0,34,36,32,6,36.8
"4698",429,11,0,1,4,0,9,1,2,2,23,0,1,4,1,1,0,1037876,"2023-12-02T00:00:00.000Z",38017507,12,"Andrew Nembhard",1,5,16,15,12,24.7
"4699",430,4,0,4,3,2,10,6,3,2,25,1,4,16,5,0,4,1037876,"2023-12-02T00:00:00.000Z",38017686,12,"Bennedict Mathurin",0,21,25,20,9,24
"4700",431,1,1,3,0,0,3,3,2,2,8,0,1,8,3,0,0,1037876,"2023-12-02T00:00:00.000Z",17896035,12,"Isaiah Jackson",1,11,12,9,4,16.1
"4701",432,1,1,4,6,4,9,7,4,2,29,0,4,20,4,0,0,1037876,"2023-12-02T00:00:00.000Z",3547250,12,"Aaron Nesmith",1,24,25,21,5,29.3
"4702",433,11,0,2,0,0,11,10,0,0,25,0,0,20,2,0,1,1037876,"2023-12-02T00:00:00.000Z",304,12,"T.J. McConnell",0,22,33,31,13,37.9
"4703",434,3,0,1,4,2,15,8,0,0,35,1,3,18,2,1,3,1037876,"2023-12-02T00:00:00.000Z",666747,16,"Caleb Martin",1,20,23,21,5,24.9
"4704",435,5,0,1,5,3,6,4,3,3,19,0,4,14,1,0,0,1037876,"2023-12-02T00:00:00.000Z",285,16,"Kevin Love",0,15,20,19,6,22.7
"4705",436,0,0,0,2,0,2,0,0,0,4,0,0,0,0,0,1,1037874,"2023-12-02T00:00:00.000Z",666818,22,"Chuma Okeke",0,0,0,0,0,-1
"4706",437,1,0,1,2,0,2,0,0,0,4,0,0,0,1,0,0,1037874,"2023-12-02T00:00:00.000Z",666885,22,"Admiral Schofield",0,1,2,1,2,2.7
"4707",438,0,0,0,0,0,0,0,0,0,0,0,0,0,0,0,0,1037874,"2023-12-02T00:00:00.000Z",85,22,"Wendell Carter Jr.",0,0,0,0,0,0
"4708",439,3,1,2,4,2,9,6,2,2,24,0,1,16,2,0,2,1037876,"2023-12-02T00:00:00.000Z",391,16,"Josh Richardson",1,18,21,19,5,23.9
"4709",440,0,0,0,0,0,0,0,0,0,0,0,0,0,0,0,0,1037876,"2023-12-02T00:00:00.000Z",4,16,"Bam Adebayo",0,0,0,0,0,0
"4710",441,0,0,0,0,0,0,0,0,0,0,0,0,0,0,0,0,1037876,"2023-12-02T00:00:00.000Z",3547257,16,"R.J. Hampton",0,0,0,0,0,0
"4711",442,0,0,0,0,0,0,0,0,0,0,0,0,0,0,0,0,1037876,"2023-12-02T00:00:00.000Z",666633,16,"Tyler Herro",0,0,0,0,0,0
"4712",443,0,0,0,0,0,0,0,0,0,0,0,0,0,0,0,0,1037876,"2023-12-02T00:00:00.000Z",19465585,16,"Dru Smith",0,0,0,0,0,0
"4713",444,0,0,0,0,0,0,0,0,0,4,0,2,0,0,0,0,1037876,"2023-12-02T00:00:00.000Z",56677861,12,"Ben Sheppard",0,0,0,0,0,0
"4714",445,0,0,0,0,0,0,0,0,0,0,0,0,0,0,0,0,1037875,"2023-12-02T00:00:00.000Z",44477024,9,"Stanley Umude",0,0,0,0,0,0
"4715",446,0,0,1,0,0,1,0,0,0,3,1,0,0,2,0,0,1037875,"2023-12-02T00:00:00.000Z",444,6,"Tristan Thompson",0,2,2,0,2,2.4
"4716",447,0,0,0,0,0,0,0,0,0,0,0,0,0,0,0,0,1037875,"2023-12-02T00:00:00.000Z",56677847,6,"Emoni Bates",0,0,0,0,0,0
"4717",448,0,0,0,0,0,0,0,0,0,0,0,0,0,0,0,0,1037876,"2023-12-02T00:00:00.000Z",56677778,12,"Oscar Tshiebwe",0,0,0,0,0,0
"4718",449,0,0,0,0,0,0,0,0,0,0,0,0,0,0,0,0,1037875,"2023-12-02T00:00:00.000Z",666676,6,"Ty Jerome",0,0,0,0,0,0
"4719",450,0,0,0,0,0,0,0,0,0,0,0,0,0,0,0,0,1037875,"2023-12-02T00:00:00.000Z",404,6,"Ricky Rubio",0,0,0,0,0,0
"4720",451,5,0,5,2,0,7,3,5,5,30,1,0,11,6,0,0,1037991,"2023-12-23T00:00:00.000Z",17553979,10,"Jonathan Kuminga",0,17,22,16,11,25.7
"4721",452,7,0,5,0,0,3,2,2,2,22,6,2,6,11,0,3,1037991,"2023-12-23T00:00:00.000Z",282,10,"Kevon Looney",0,17,24,13,18,26.7
"4722",453,7,1,9,5,1,12,7,0,0,32,1,1,15,10,1,2,1037991,"2023-12-23T00:00:00.000Z",56677858,10,"Brandin Podziemski",2,25,32,22,17,41.5
"4723",454,2,0,3,7,2,18,11,3,3,30,0,1,27,3,0,1,1037991,"2023-12-23T00:00:00.000Z",115,10,"Stephen Curry",0,30,32,29,5,32.6
"4724",455,11,0,3,2,0,4,1,0,0,26,0,1,2,3,3,1,1037991,"2023-12-23T00:00:00.000Z",367,10,"Chris Paul",3,5,16,13,14,30.1
"4725",456,3,0,4,0,0,7,6,4,1,17,1,2,13,5,1,2,1037991,"2023-12-23T00:00:00.000Z",56677799,10,"Trayce Jackson-Davis",1,18,21,16,8,24.5
"4726",457,1,1,1,2,1,6,4,2,2,17,0,3,11,1,1,2,1037991,"2023-12-23T00:00:00.000Z",17553992,10,"Moses Moody",2,12,13,12,2,17.7
"4727",458,1,0,3,2,0,7,3,2,2,19,2,2,8,5,1,1,1037991,"2023-12-23T00:00:00.000Z",407,10,"Dario Saric",1,13,14,9,6,17.5
"4728",459,1,0,0,1,0,1,0,0,0,4,0,0,0,0,0,1,1037991,"2023-12-23T00:00:00.000Z",251,10,"Cory Joseph",0,0,1,1,1,0.5
"4729",460,0,0,0,0,0,0,0,0,0,4,0,1,0,0,1,0,1037991,"2023-12-23T00:00:00.000Z",17896070,10,"Usman Garuba",1,0,0,0,0,3
"4730",461,0,0,1,0,0,0,0,2,2,4,1,0,2,2,0,0,1037991,"2023-12-23T00:00:00.000Z",57875092,10,"Gui Santos",0,4,4,2,2,4.4
"4731",462,0,0,0,2,0,2,0,4,3,4,0,0,3,0,0,0,1037991,"2023-12-23T00:00:00.000Z",398,10,"Jerome Robinson",0,3,3,3,0,3
"4732",463,0,0,0,0,0,0,0,0,0,0,0,0,0,0,0,0,1037991,"2023-12-23T00:00:00.000Z",185,10,"Draymond Green",0,0,0,0,0,0
"4733",464,0,0,0,0,0,0,0,0,0,0,0,0,0,0,0,0,1037991,"2023-12-23T00:00:00.000Z",2189,10,"Gary Payton II",0,0,0,0,0,0
"4734",465,0,0,0,0,0,0,0,0,0,0,0,0,0,0,0,0,1037991,"2023-12-23T00:00:00.000Z",45658838,10,"Lester Quinones",0,0,0,0,0,0
"4735",466,0,0,0,0,0,0,0,0,0,0,0,0,0,0,0,0,1037991,"2023-12-23T00:00:00.000Z",475,10,"Andrew Wiggins",0,0,0,0,0,0
"4736",467,0,1,2,0,0,3,2,2,2,24,0,1,6,2,1,1,1037991,"2023-12-23T00:00:00.000Z",56677850,25,"Toumani Camara",2,8,8,6,2,13.4
"4737",468,3,0,1,4,1,12,5,8,6,32,1,3,17,2,0,2,1037991,"2023-12-23T00:00:00.000Z",182,25,"Jerami Grant",0,19,22,20,5,21.9
"4738",469,2,0,5,0,0,12,6,3,1,29,1,2,13,6,3,1,1037991,"2023-12-23T00:00:00.000Z",22,25,"Deandre Ayton",3,19,21,15,8,31.2
"4739",470,2,0,2,13,7,17,7,4,4,34,0,0,25,2,1,1,1037991,"2023-12-23T00:00:00.000Z",419,25,"Anfernee Simons",1,27,29,27,4,32.4
"4740",471,12,1,4,4,1,14,8,0,0,37,2,2,17,6,3,2,1037991,"2023-12-23T00:00:00.000Z",65,25,"Malcolm Brogdon",4,23,35,29,18,52.2
"4741",472,2,0,1,4,2,9,4,4,2,23,0,4,12,1,3,2,1037991,"2023-12-23T00:00:00.000Z",56677747,25,"Scoot Henderson",3,13,15,14,3,23.2
"4742",473,2,0,1,5,1,6,2,0,0,16,1,0,5,2,1,0,1037991,"2023-12-23T00:00:00.000Z",666923,25,"Matisse Thybulle",1,7,9,7,4,13.4
"4743",474,0,0,1,2,0,2,0,0,0,9,0,3,0,1,0,0,1037991,"2023-12-23T00:00:00.000Z",56783340,25,"Duop Reath",0,1,1,0,1,1.2
"4744",475,1,0,0,0,0,2,0,2,1,5,0,0,1,0,0,1,1037991,"2023-12-23T00:00:00.000Z",3547289,25,"Skylar Mays",0,1,2,2,1,1.5
"4745",476,8,1,2,6,1,19,8,4,1,28,4,3,18,6,0,2,1038126,"2024-01-12T00:00:00.000Z",38017682,9,"Jaden Ivey",1,24,32,26,14,38.2
"4746",477,8,1,4,2,0,6,2,1,1,29,0,1,5,4,1,1,1038126,"2024-01-12T00:00:00.000Z",3547241,9,"Killian Hayes",2,9,17,13,12,26.8
"4747",478,1,2,0,4,1,4,1,0,0,16,0,3,3,0,0,0,1038126,"2024-01-12T00:00:00.000Z",17896071,9,"Isaiah Livers",2,3,4,4,1,10.5
"4748",479,1,2,0,9,5,14,7,0,0,30,0,3,19,0,0,2,1038126,"2024-01-12T00:00:00.000Z",77,9,"Alec Burks",2,19,20,20,1,24.5
"4749",480,0,0,1,1,0,1,0,0,0,10,0,0,0,1,0,1,1038122,"2024-01-11T00:00:00.000Z",114,7,"Seth Curry",0,1,1,0,1,0.2
"4750",481,0,0,0,0,0,0,0,0,0,0,0,0,0,0,0,0,1038122,"2024-01-11T00:00:00.000Z",217,7,"Richaun Holmes",0,0,0,0,0,0
"4751",482,0,0,0,0,0,0,0,0,0,0,0,0,0,0,0,0,1038122,"2024-01-11T00:00:00.000Z",17554004,7,"AJ Lawson",0,0,0,0,0,0
"4752",483,0,0,0,0,0,0,0,0,0,0,0,0,0,0,0,0,1038122,"2024-01-11T00:00:00.000Z",24489167,7,"Brandon Williams",0,0,0,0,0,0
"4753",484,0,0,0,0,0,0,0,0,0,0,0,0,0,0,0,0,1038122,"2024-01-11T00:00:00.000Z",17896028,7,"Greg Brown III",0,0,0,0,0,0
"4754",485,0,0,0,0,0,0,0,0,0,0,0,0,0,0,0,0,1038122,"2024-01-11T00:00:00.000Z",132,7,"Luka Doncic",0,0,0,0,0,0
"4755",486,0,0,0,0,0,0,0,0,0,0,0,0,0,0,0,0,1038122,"2024-01-11T00:00:00.000Z",151,7,"Dante Exum",0,0,0,0,0,0
"4756",487,0,0,6,1,0,3,2,0,0,18,2,2,4,8,0,1,1038126,"2024-01-12T00:00:00.000Z",56677826,9,"Ausar Thompson",0,12,12,4,8,12.6
"4757",488,7,0,0,1,0,2,0,0,0,11,1,2,0,1,1,1,1038126,"2024-01-12T00:00:00.000Z",56677792,9,"Marcus Sasser",1,1,8,7,8,13.7
"4758",489,1,0,3,0,0,6,4,4,3,12,1,2,11,4,1,0,1038126,"2024-01-12T00:00:00.000Z",24,9,"Marvin Bagley III",1,15,16,12,5,20.3
"4759",490,0,0,0,0,0,0,0,0,0,0,0,0,0,0,0,0,1038126,"2024-01-12T00:00:00.000Z",197,9,"Joe Harris",0,0,0,0,0,0
"4760",491,0,0,0,0,0,0,0,0,0,0,0,0,0,0,0,0,1038126,"2024-01-12T00:00:00.000Z",44477024,9,"Stanley Umude",0,0,0,0,0,0
"4761",492,0,0,0,0,0,0,0,0,0,0,0,0,0,0,0,0,1038126,"2024-01-12T00:00:00.000Z",3547240,9,"James Wiseman",0,0,0,0,0,0
"4762",493,0,0,0,0,0,0,0,0,0,0,0,0,0,0,0,0,1038126,"2024-01-12T00:00:00.000Z",54,9,"Bojan Bogdanovic",0,0,0,0,0,0
"4763",494,0,0,0,0,0,0,0,0,0,0,0,0,0,0,0,0,1038126,"2024-01-12T00:00:00.000Z",56677729,9,"Malcolm Cazalon",0,0,0,0,0,0
"4764",495,0,0,0,0,0,0,0,0,0,0,0,0,0,0,0,0,1038126,"2024-01-12T00:00:00.000Z",17896075,9,"Cade Cunningham",0,0,0,0,0,0
"4765",496,0,0,0,0,0,0,0,0,0,0,0,0,0,0,0,0,1038126,"2024-01-12T00:00:00.000Z",330,9,"Monte Morris",0,0,0,0,0,0
"4766",497,0,0,0,0,0,0,0,0,0,0,0,0,0,0,0,0,1038126,"2024-01-12T00:00:00.000Z",42097199,9,"Jared Rhoden",0,0,0,0,0,0
"4767",498,1,0,5,0,0,2,1,0,0,20,2,1,2,7,0,1,1038126,"2024-01-12T00:00:00.000Z",3547301,11,"Jae'Sean Tate",0,9,10,3,8,10.9
"4768",499,1,2,6,3,1,15,7,4,4,41,5,0,19,11,1,1,1038126,"2024-01-12T00:00:00.000Z",38017684,11,"Jabari Smith Jr.",3,30,31,20,12,41.7
"4769",500,1,0,6,1,0,19,12,7,5,37,0,3,29,6,1,4,1038126,"2024-01-12T00:00:00.000Z",17896062,11,"Alperen Sengun",1,35,36,30,7,36.7
"4770",501,4,0,2,6,2,7,3,9,8,21,1,2,16,3,0,0,1037729,"2023-11-12T00:00:00.000Z",77,9,"Alec Burks",0,19,23,20,7,25.6
"4771",502,0,0,0,0,0,0,0,0,0,0,0,0,0,0,0,0,1037729,"2023-11-12T00:00:00.000Z",38017694,9,"Jalen Duren",0,0,0,0,0,0
"4772",503,0,0,0,1,0,2,0,0,0,6,1,0,0,1,0,0,1037731,"2023-11-12T00:00:00.000Z",114,7,"Seth Curry",0,1,1,0,1,1.2
"4773",504,0,0,1,0,0,1,1,0,0,4,0,1,2,1,0,0,1037731,"2023-11-12T00:00:00.000Z",217,7,"Richaun Holmes",0,3,3,2,1,3.2
"4774",505,0,0,0,0,0,0,0,0,0,0,0,0,0,0,0,0,1037733,"2023-11-12T00:00:00.000Z",3547095,24,"Udoka Azubuike",0,0,0,0,0,0
"4775",506,0,0,0,0,0,0,0,0,0,0,0,0,0,0,0,0,1037733,"2023-11-12T00:00:00.000Z",666451,24,"Bol Bol",0,0,0,0,0,0
"4776",507,0,0,0,0,0,0,0,0,0,0,0,0,0,0,0,0,1037733,"2023-11-12T00:00:00.000Z",3547298,24,"Saben Lee",0,0,0,0,0,0
"4777",508,1,1,0,0,0,2,0,0,0,7,0,2,0,0,0,0,1037730,"2023-11-12T00:00:00.000Z",38017721,8,"Peyton Watson",1,0,1,1,1,4.5
"4778",509,0,0,2,1,0,4,1,0,0,11,2,0,2,4,0,0,1037730,"2023-11-12T00:00:00.000Z",3547268,8,"Zeke Nnaji",0,6,6,2,4,6.8
"4779",510,0,0,0,0,0,0,0,0,0,0,0,0,0,0,0,0,1037730,"2023-11-12T00:00:00.000Z",250,8,"DeAndre Jordan",0,0,0,0,0,0
"4780",511,0,0,0,0,0,0,0,0,0,0,0,0,0,0,0,0,1037730,"2023-11-12T00:00:00.000Z",17896007,8,"Braxton Key",0,0,0,0,0,0
"4781",512,0,0,0,0,0,0,0,0,0,0,0,0,0,0,0,0,1037730,"2023-11-12T00:00:00.000Z",56677582,8,"Jalen Pickett",0,0,0,0,0,0
"4782",513,0,0,0,0,0,0,0,0,0,0,0,0,0,0,0,0,1037730,"2023-11-12T00:00:00.000Z",666489,8,"Vlatko Cancar",0,0,0,0,0,0
"4783",514,0,0,0,0,0,0,0,0,0,0,0,0,0,0,0,0,1037730,"2023-11-12T00:00:00.000Z",17896103,8,"Jay Huff",0,0,0,0,0,0
"4784",515,0,0,0,0,0,0,0,0,0,0,0,0,0,0,0,0,1037730,"2023-11-12T00:00:00.000Z",335,8,"Jamal Murray",0,0,0,0,0,0
"4785",516,0,0,0,0,0,0,0,0,0,0,0,0,0,0,0,0,1037730,"2023-11-12T00:00:00.000Z",56677871,8,"Hunter Tyson",0,0,0,0,0,0
"4786",517,1,0,1,3,2,7,6,0,0,21,0,2,14,1,0,0,1037728,"2023-11-12T00:00:00.000Z",3547243,12,"Obi Toppin",0,15,16,15,2,16.7
"4787",518,0,3,3,9,4,17,7,4,4,29,2,4,22,5,1,3,1037728,"2023-11-12T00:00:00.000Z",452,12,"Myles Turner",4,27,27,22,5,37
"4788",519,3,2,2,1,0,5,3,4,3,31,2,1,9,4,0,0,1037728,"2023-11-12T00:00:00.000Z",69,12,"Bruce Brown",2,13,16,12,7,24.3
"4789",520,17,1,1,6,3,14,9,4,4,36,0,0,25,1,2,0,1037728,"2023-11-12T00:00:00.000Z",3547245,12,"Tyrese Haliburton",3,26,43,42,18,60.7
"4790",521,3,1,3,8,4,13,6,0,0,21,1,0,16,4,1,0,1037728,"2023-11-12T00:00:00.000Z",210,12,"Buddy Hield",2,20,23,19,7,31.3
"4791",522,3,0,3,5,2,6,3,0,0,26,1,3,8,4,1,0,1037728,"2023-11-12T00:00:00.000Z",3547250,12,"Aaron Nesmith",1,12,15,11,7,20.3
"4792",523,1,0,5,2,1,7,4,2,2,19,1,2,11,6,0,2,1037728,"2023-11-12T00:00:00.000Z",3547264,12,"Jalen Smith",0,17,18,12,7,17.7
"4793",524,1,0,0,2,0,4,2,0,0,14,0,0,4,0,0,3,1037728,"2023-11-12T00:00:00.000Z",38017507,12,"Andrew Nembhard",0,4,5,5,1,2.5
"4794",525,1,1,2,0,0,6,3,2,2,17,0,1,8,2,3,1,1037728,"2023-11-12T00:00:00.000Z",304,12,"T.J. McConnell",4,10,11,9,3,22.9
"4795",526,0,0,0,0,0,0,0,0,0,0,0,0,0,0,0,0,1037870,"2023-12-01T00:00:00.000Z",56677822,27,"Victor Wembanyama",0,0,0,0,0,0
"4796",527,0,0,0,6,1,9,3,2,1,22,0,0,8,0,0,1,1037866,"2023-12-01T00:00:00.000Z",196,22,"Gary Harris",0,8,8,8,0,7
"4797",528,0,0,0,0,0,0,0,0,0,0,0,0,0,0,0,0,1037867,"2023-12-01T00:00:00.000Z",2175,23,"Danuel House Jr.",0,0,0,0,0,0
"4798",529,11,3,4,3,1,25,8,13,13,36,0,2,30,4,1,1,1037871,"2023-12-01T00:00:00.000Z",140,24,"Kevin Durant",4,34,45,41,15,62.3
"4799",530,1,0,1,0,0,1,0,4,4,17,0,0,4,1,0,0,1037871,"2023-12-01T00:00:00.000Z",32,24,"Keita Bates-Diop",0,5,6,5,2,6.7
"4800",531,2,1,3,6,2,22,13,5,3,33,3,6,31,6,0,6,1037871,"2023-12-01T00:00:00.000Z",349,24,"Jusuf Nurkic",1,37,39,33,8,38.2
"4801",532,3,1,3,7,4,11,6,0,0,33,1,1,16,4,1,3,1037871,"2023-12-01T00:00:00.000Z",178,24,"Eric Gordon",2,20,23,19,7,28.3
"4802",533,3,0,9,4,1,9,5,2,2,37,0,2,13,9,1,0,1037871,"2023-12-01T00:00:00.000Z",8,24,"Grayson Allen",1,22,25,16,12,31.3
"4803",534,0,0,4,1,0,3,1,0,0,20,2,1,2,6,0,0,1037871,"2023-12-01T00:00:00.000Z",18678058,24,"Jordan Goodwin",0,8,8,2,6,9.2
"4804",535,0,0,2,0,0,1,1,0,0,19,0,0,2,2,0,0,1037871,"2023-12-01T00:00:00.000Z",666729,24,"Nassir Little",0,4,4,2,2,4.4
"4805",536,1,0,6,0,0,1,0,0,0,15,0,2,0,6,0,0,1037871,"2023-12-01T00:00:00.000Z",147,24,"Drew Eubanks",0,6,7,1,7,8.7
"4806",537,0,0,0,0,0,0,0,0,0,0,0,0,0,0,0,0,1037871,"2023-12-01T00:00:00.000Z",3547095,24,"Udoka Azubuike",0,0,0,0,0,0
"4807",538,0,0,0,0,0,0,0,0,0,0,0,0,0,0,0,0,1037871,"2023-12-01T00:00:00.000Z",666451,24,"Bol Bol",0,0,0,0,0,0
"4808",539,0,0,0,0,0,0,0,0,0,0,0,0,0,0,0,0,1037871,"2023-12-01T00:00:00.000Z",3547298,24,"Saben Lee",0,0,0,0,0,0
"4809",540,0,3,2,5,1,9,5,2,2,26,2,3,13,4,1,2,1037871,"2023-12-01T00:00:00.000Z",356,24,"Josh Okogie",4,17,17,13,4,27.8
"4810",541,1,0,1,1,0,2,0,0,0,4,0,0,0,1,0,0,1037871,"2023-12-01T00:00:00.000Z",314,24,"Chimezie Metu",0,1,2,1,2,2.7
"4811",542,0,0,0,0,0,0,0,0,0,0,0,0,0,0,0,0,1037871,"2023-12-01T00:00:00.000Z",470,24,"Yuta Watanabe",0,0,0,0,0,0
"4812",543,0,0,0,0,0,0,0,0,0,0,0,0,0,0,0,0,1037871,"2023-12-01T00:00:00.000Z",37,24,"Bradley Beal",0,0,0,0,0,0
"4813",544,0,0,0,0,0,0,0,0,0,0,0,0,0,0,0,0,1037871,"2023-12-01T00:00:00.000Z",57,24,"Devin Booker",0,0,0,0,0,0
"4814",545,0,0,0,0,0,0,0,0,0,0,0,0,0,0,0,0,1037871,"2023-12-01T00:00:00.000Z",272,24,"Damion Lee",0,0,0,0,0,0
"4815",546,5,0,1,5,3,8,6,0,0,26,1,2,15,2,1,0,1037871,"2023-12-01T00:00:00.000Z",215,8,"Justin Holiday",1,17,22,20,7,27.9
"4816",547,4,1,9,4,0,16,8,3,3,37,1,1,19,10,2,2,1037871,"2023-12-01T00:00:00.000Z",375,8,"Michael Porter Jr.",3,29,33,23,14,44
"4817",548,16,2,4,3,0,18,9,6,3,35,1,4,21,5,1,3,1037871,"2023-12-01T00:00:00.000Z",246,8,"Nikola Jokic",3,26,42,37,21,57
"4818",549,5,0,1,6,3,10,6,0,0,35,0,2,15,1,3,0,1037871,"2023-12-01T00:00:00.000Z",81,8,"Kentavious Caldwell-Pope",3,16,21,20,6,32.7
"4819",550,4,0,2,4,3,11,8,2,1,29,0,3,20,2,0,1,1037871,"2023-12-01T00:00:00.000Z",236,8,"Reggie Jackson",0,22,26,24,6,27.4
"4820",551,0,0,0,0,0,0,0,0,0,0,0,0,0,0,0,0,1037981,"2023-12-23T00:00:00.000Z",56677864,2,"Jordan Walsh",0,0,0,0,0,0
"4821",552,0,0,0,0,0,0,0,0,0,0,0,0,0,0,0,0,1037981,"2023-12-23T00:00:00.000Z",261,2,"Luke Kornet",0,0,0,0,0,0
"4822",553,0,0,0,0,0,0,0,0,0,0,0,0,0,0,0,0,1037981,"2023-12-23T00:00:00.000Z",338,2,"Svi Mykhailiuk",0,0,0,0,0,0
"4823",554,0,0,0,0,0,0,0,0,0,0,0,0,0,0,0,0,1037981,"2023-12-23T00:00:00.000Z",378,2,"Kristaps Porzingis",0,0,0,0,0,0
"4824",555,0,0,0,2,1,10,8,4,3,24,2,5,20,2,0,2,1037985,"2023-12-23T00:00:00.000Z",231,15,"Jaren Jackson Jr.",0,22,22,20,2,20.4
"4825",556,3,0,4,0,0,6,3,6,2,29,7,2,8,11,1,1,1037985,"2023-12-23T00:00:00.000Z",48,15,"Bismack Biyombo",1,19,22,11,14,27.7
"4826",557,6,0,6,14,5,25,13,6,6,36,0,0,37,6,1,2,1037985,"2023-12-23T00:00:00.000Z",3547287,15,"Desmond Bane",1,43,49,43,12,54.2
"4827",558,11,2,6,3,1,25,14,1,1,36,0,1,30,6,1,3,1037985,"2023-12-23T00:00:00.000Z",666786,15,"Ja Morant",3,36,47,41,17,59.7
"4828",559,3,1,4,4,1,7,2,2,1,27,0,0,6,4,0,1,1037985,"2023-12-23T00:00:00.000Z",17896067,15,"Santi Aldama",1,10,13,9,7,17.3
"4829",560,2,2,4,2,1,3,2,0,0,13,1,1,5,5,0,0,1037985,"2023-12-23T00:00:00.000Z",666703,15,"John Konchar",2,10,12,7,7,20
"4830",561,3,0,2,3,1,8,3,3,1,24,1,3,8,3,0,1,1037985,"2023-12-23T00:00:00.000Z",17896027,15,"Ziaire Williams",0,11,14,11,6,15.1
"4831",562,7,1,4,4,1,17,9,10,10,33,2,2,29,6,1,1,1037986,"2023-12-23T00:00:00.000Z",61,3,"Mikal Bridges",2,35,42,36,13,51.7
"4832",563,2,0,2,5,2,10,6,4,4,28,0,3,18,2,2,1,1037986,"2023-12-23T00:00:00.000Z",666679,3,"Cameron Johnson",2,20,22,20,4,28.4
"4833",564,2,2,5,0,0,8,4,4,3,30,2,2,11,7,2,2,1037986,"2023-12-23T00:00:00.000Z",666508,3,"Nicolas Claxton",4,18,20,13,9,32.4
"4834",565,3,0,2,3,1,16,7,5,5,28,0,3,20,2,1,2,1037986,"2023-12-23T00:00:00.000Z",17896048,3,"Cam Thomas",1,22,25,23,5,27.9
"4835",566,7,0,3,5,2,12,5,4,2,30,1,1,14,4,1,1,1037986,"2023-12-23T00:00:00.000Z",130,3,"Spencer Dinwiddie",1,18,25,21,11,31.3
"4836",567,5,2,2,2,0,12,6,9,7,36,1,2,19,3,0,0,1037984,"2023-12-23T00:00:00.000Z",227,19,"Brandon Ingram",2,22,27,24,8,36.1
"4837",568,4,1,6,2,1,16,11,10,5,34,2,1,28,8,2,3,1037984,"2023-12-23T00:00:00.000Z",666969,19,"Zion Williamson",3,36,40,32,12,49.6
"4838",569,5,1,9,2,0,11,5,0,0,26,2,6,10,11,2,6,1037984,"2023-12-23T00:00:00.000Z",455,19,"Jonas Valanciunas",3,21,26,15,16,33.7
"4839",570,1,0,0,4,2,8,2,0,0,18,3,1,6,3,0,0,1037984,"2023-12-23T00:00:00.000Z",17896024,19,"Herbert Jones",0,9,10,7,4,11.1
"4840",571,2,1,4,7,2,10,4,4,3,34,1,4,13,5,1,4,1037984,"2023-12-23T00:00:00.000Z",303,19,"CJ McCollum",2,18,20,15,7,24
"4841",572,0,0,5,7,3,11,4,3,3,34,1,2,14,6,2,1,1037984,"2023-12-23T00:00:00.000Z",18677986,19,"Trey Murphy III",2,20,20,14,6,26.2
"4842",573,2,0,1,0,0,2,2,3,2,12,1,1,6,2,0,0,1037984,"2023-12-23T00:00:00.000Z",3547293,19,"Naji Marshall",0,8,10,8,4,11.4
"4843",574,0,1,2,2,0,4,2,0,0,10,0,3,4,2,0,1,1037984,"2023-12-23T00:00:00.000Z",17896097,19,"Jose Alvarado",1,6,6,4,2,8.4
"4844",575,2,1,3,3,0,5,2,0,0,22,0,2,4,3,2,0,1037984,"2023-12-23T00:00:00.000Z",17896021,19,"Jeremiah Robinson-Earl",3,7,9,6,5,19.6
"4845",576,6,1,3,3,2,14,7,5,5,31,1,0,21,4,0,1,1038102,"2024-01-08T00:00:00.000Z",100,29,"Jordan Clarkson",1,25,31,27,10,36.8
"4846",577,4,0,6,9,4,13,7,1,1,23,0,0,19,6,0,2,1038102,"2024-01-08T00:00:00.000Z",56677834,29,"Keyonte George",0,25,29,23,10,30.2
"4847",578,0,0,1,1,0,2,1,0,0,15,0,1,2,1,0,0,1038102,"2024-01-08T00:00:00.000Z",38017620,29,"Ochai Agbaji",0,3,3,2,1,3.2
"4848",579,0,0,0,0,0,0,0,0,0,0,0,0,0,0,0,0,1038102,"2024-01-08T00:00:00.000Z",666650,29,"Talen Horton-Tucker",0,0,0,0,0,0
"4849",580,0,0,0,0,0,0,0,0,0,0,0,0,0,0,0,0,1038102,"2024-01-08T00:00:00.000Z",38017691,17,"TyTy Washington Jr.",0,0,0,0,0,0
"4850",581,0,0,0,0,0,0,0,0,0,0,0,0,0,0,0,0,1038102,"2024-01-08T00:00:00.000Z",112,17,"Jae Crowder",0,0,0,0,0,0
"4851",582,0,0,0,0,0,0,0,0,0,0,0,0,0,0,0,0,1038102,"2024-01-08T00:00:00.000Z",278,17,"Damian Lillard",0,0,0,0,0,0
"4852",583,0,0,0,0,0,0,0,0,0,0,0,0,0,0,0,0,1038102,"2024-01-08T00:00:00.000Z",368,17,"Cameron Payne",0,0,0,0,0,0
"4853",584,0,2,4,0,0,4,3,4,2,21,2,1,8,6,1,0,1038102,"2024-01-08T00:00:00.000Z",38017705,29,"Walker Kessler",3,14,14,8,6,24.2
"4854",585,3,0,4,2,2,6,4,4,3,17,2,4,13,6,0,2,1038102,"2024-01-08T00:00:00.000Z",358,29,"Kelly Olynyk",0,19,22,16,9,22.7
"4855",586,0,0,0,0,0,0,0,0,0,0,0,0,0,0,0,0,1038102,"2024-01-08T00:00:00.000Z",666881,29,"Luka Samanic",0,0,0,0,0,0
"4856",587,0,0,0,0,0,0,0,0,0,0,0,0,0,0,0,0,1038102,"2024-01-08T00:00:00.000Z",11891374,29,"Omer Yurtseven",0,0,0,0,0,0
"4857",588,0,0,0,0,0,0,0,0,0,0,0,0,0,0,0,0,1038102,"2024-01-08T00:00:00.000Z",17896023,29,"Josh Christopher",0,0,0,0,0,0
"4858",589,0,0,0,0,0,0,0,0,0,0,0,0,0,0,0,0,1038102,"2024-01-08T00:00:00.000Z",56677824,29,"Taylor Hendricks",0,0,0,0,0,0
"4859",590,0,0,0,0,0,0,0,0,0,0,0,0,0,0,0,0,1038102,"2024-01-08T00:00:00.000Z",38017630,29,"Johnny Juzang",0,0,0,0,0,0
"4860",591,0,0,0,0,0,0,0,0,0,0,0,0,0,0,0,0,1038102,"2024-01-08T00:00:00.000Z",19465584,29,"Micah Potter",0,0,0,0,0,0
"4861",592,0,0,0,0,0,0,0,0,0,0,0,0,0,0,0,0,1038102,"2024-01-08T00:00:00.000Z",56677842,29,"Brice Sensabaugh",0,0,0,0,0,0
"4862",593,7,0,3,10,3,12,4,3,3,30,0,6,14,3,1,1,1038101,"2024-01-08T00:00:00.000Z",397,16,"Duncan Robinson",1,17,24,21,10,30.1
"4863",594,0,0,3,2,1,2,1,0,0,16,0,0,3,3,0,0,1038101,"2024-01-08T00:00:00.000Z",3092,16,"Haywood Highsmith",0,6,6,3,3,6.6
"4864",595,0,0,0,0,0,0,0,0,0,0,0,0,0,0,0,0,1038101,"2024-01-08T00:00:00.000Z",74,16,"Thomas Bryant",0,0,0,0,0,0
"4865",596,0,0,0,0,0,0,0,0,0,0,0,0,0,0,0,0,1038101,"2024-01-08T00:00:00.000Z",38017734,16,"Jamal Cain",0,0,0,0,0,0
"4866",597,0,0,0,0,0,0,0,0,0,0,0,0,0,0,0,0,1038101,"2024-01-08T00:00:00.000Z",39398582,16,"Orlando Robinson",0,0,0,0,0,0
"4867",598,0,0,0,0,0,0,0,0,0,0,0,0,0,0,0,0,1038101,"2024-01-08T00:00:00.000Z",79,16,"Jimmy Butler",0,0,0,0,0,0
"4868",599,0,0,0,0,0,0,0,0,0,0,0,0,0,0,0,0,1038101,"2024-01-08T00:00:00.000Z",3547257,16,"R.J. Hampton",0,0,0,0,0,0
"4869",600,0,0,0,0,0,0,0,0,0,0,0,0,0,0,0,0,1038101,"2024-01-08T00:00:00.000Z",666747,16,"Caleb Martin",0,0,0,0,0,0
"4870",601,0,0,0,0,0,0,0,0,0,0,0,0,0,0,0,0,1037699,"2023-11-08T00:00:00.000Z",9051997,3,"Armoni Brooks",0,0,0,0,0,0
"4871",602,0,0,0,0,0,0,0,0,0,0,0,0,0,0,0,0,1037699,"2023-11-08T00:00:00.000Z",174,3,"Harry Giles III",0,0,0,0,0,0
"4872",603,1,0,3,1,0,2,1,2,2,9,2,1,4,5,1,0,1037706,"2023-11-08T00:00:00.000Z",38017716,21,"Ousmane Dieng",1,9,10,5,6,14.5
"4873",604,0,0,0,0,0,0,0,0,0,0,0,0,0,0,0,0,1037698,"2023-11-08T00:00:00.000Z",17896094,2,"Dalano Banton",0,0,0,0,0,0
"4874",605,0,0,0,0,0,0,0,0,0,0,0,0,0,0,0,0,1037698,"2023-11-08T00:00:00.000Z",666468,2,"Oshae Brissett",0,0,0,0,0,0
"4875",606,4,0,6,4,2,14,6,6,4,32,1,2,18,7,3,3,1037696,"2023-11-08T00:00:00.000Z",204,4,"Gordon Hayward",3,25,29,22,11,38.4
"4876",607,1,2,6,5,0,11,4,7,6,36,1,2,14,7,0,2,1037696,"2023-11-08T00:00:00.000Z",666950,4,"P.J. Washington",2,21,22,15,8,27.9
"4877",608,0,1,5,0,0,5,5,6,4,18,2,4,14,7,0,1,1037696,"2023-11-08T00:00:00.000Z",38017698,4,"Mark Williams",1,21,21,14,7,24.4
"4878",609,2,0,3,2,1,11,5,3,2,30,2,2,13,5,1,2,1037696,"2023-11-08T00:00:00.000Z",56677823,4,"Brandon Miller",1,18,20,15,7,23
"4879",610,7,0,1,9,3,22,13,7,5,36,3,3,34,4,1,6,1037696,"2023-11-08T00:00:00.000Z",3547239,4,"LaMelo Ball",1,38,45,41,11,46.3
"4880",611,1,0,6,0,0,3,2,4,3,16,0,2,7,6,0,0,1037696,"2023-11-08T00:00:00.000Z",3547282,4,"Nick Richards",0,13,14,8,7,15.7
"4881",612,1,0,3,0,0,0,0,2,2,15,0,2,2,3,0,2,1037696,"2023-11-08T00:00:00.000Z",38017708,4,"Bryce McGowens",0,5,6,3,4,5.1
"4882",613,0,0,1,2,1,7,4,0,0,18,0,2,9,1,1,1,1037696,"2023-11-08T00:00:00.000Z",3547253,4,"Theo Maledon",1,10,10,9,1,12.2
"4883",614,1,1,3,2,0,3,0,0,0,21,2,3,0,5,0,0,1037696,"2023-11-08T00:00:00.000Z",18678001,4,"JT Thor",1,5,6,1,6,10.5
"4884",615,0,0,1,0,0,0,0,0,0,10,0,0,0,1,1,2,1037696,"2023-11-08T00:00:00.000Z",422,4,"Ish Smith",1,1,1,0,1,2.2
"4885",616,0,0,1,1,1,2,2,0,0,4,0,0,5,1,1,1,1037696,"2023-11-08T00:00:00.000Z",56677846,4,"Nick Smith Jr.",1,6,6,5,1,8.2
"4886",617,0,1,0,0,0,1,0,0,0,4,0,0,0,0,0,0,1037696,"2023-11-08T00:00:00.000Z",56677866,4,"Leaky Black",1,0,0,0,0,3
"4887",618,0,0,0,0,0,0,0,0,0,0,0,0,0,0,0,0,1037696,"2023-11-08T00:00:00.000Z",56677848,4,"Amari Bailey",0,0,0,0,0,0
"4888",619,0,0,0,0,0,0,0,0,0,0,0,0,0,0,0,0,1037696,"2023-11-08T00:00:00.000Z",17896037,4,"James Bouknight",0,0,0,0,0,0
"4889",620,0,0,0,0,0,0,0,0,0,0,0,0,0,0,0,0,1037696,"2023-11-08T00:00:00.000Z",62,4,"Miles Bridges",0,0,0,0,0,0
"4890",621,0,0,0,0,0,0,0,0,0,0,0,0,0,0,0,0,1037696,"2023-11-08T00:00:00.000Z",666748,4,"Cody Martin",0,0,0,0,0,0
"4891",622,0,0,0,0,0,0,0,0,0,0,0,0,0,0,0,0,1037696,"2023-11-08T00:00:00.000Z",347,4,"Frank Ntilikina",0,0,0,0,0,0
"4892",623,0,0,0,0,0,0,0,0,0,0,0,0,0,0,0,0,1037696,"2023-11-08T00:00:00.000Z",403,4,"Terry Rozier",0,0,0,0,0,0
"4893",624,4,0,6,11,4,24,13,3,3,31,3,1,33,9,0,2,1037696,"2023-11-08T00:00:00.000Z",265,30,"Kyle Kuzma",0,42,46,37,13,47.8
"4894",625,0,1,4,6,3,8,5,0,0,19,0,0,13,4,1,0,1037698,"2023-11-08T00:00:00.000Z",17896060,2,"Sam Hauser",2,17,17,13,4,23.8
"4895",626,0,0,0,0,0,0,0,0,0,0,0,0,0,0,0,0,1037863,"2023-11-30T00:00:00.000Z",44,21,"Davis Bertans",0,0,0,0,0,0
"4896",627,0,0,0,0,0,0,0,0,0,0,0,0,0,0,0,0,1037863,"2023-11-30T00:00:00.000Z",4197029,21,"Vasilije Micic",0,0,0,0,0,0
"4897",628,0,0,0,0,0,0,0,0,0,0,0,0,0,0,0,0,1037863,"2023-11-30T00:00:00.000Z",38017716,21,"Ousmane Dieng",0,0,0,0,0,0
"4898",629,0,0,0,0,0,0,0,0,0,0,0,0,0,0,0,0,1037863,"2023-11-30T00:00:00.000Z",56677853,21,"Keyontae Johnson",0,0,0,0,0,0
"4899",630,0,0,0,0,0,0,0,0,0,0,0,0,0,0,0,0,1037863,"2023-11-30T00:00:00.000Z",24572055,21,"Olivier Sarr",0,0,0,0,0,0
"4900",631,2,0,1,5,2,7,2,0,0,32,0,5,6,1,0,1,1037863,"2023-11-30T00:00:00.000Z",383,14,"Taurean Prince",0,7,9,8,3,9.2
"4901",632,6,1,10,8,4,12,7,4,3,35,2,1,21,12,1,5,1037863,"2023-11-30T00:00:00.000Z",237,14,"LeBron James",2,33,39,27,18,45.4
"4902",633,0,1,6,1,0,4,1,0,0,14,1,3,2,7,0,2,1037862,"2023-11-30T00:00:00.000Z",11891374,29,"Omer Yurtseven",1,9,9,2,7,11.4
"4903",634,3,0,3,6,3,10,5,0,0,36,3,1,13,6,4,1,1037862,"2023-11-30T00:00:00.000Z",38017620,29,"Ochai Agbaji",4,19,22,16,9,35.7
"4904",635,4,0,3,6,1,19,4,3,3,33,1,2,12,4,0,2,1037862,"2023-11-30T00:00:00.000Z",56677834,29,"Keyonte George",0,16,20,16,8,20.8
"4905",636,2,3,5,2,0,6,3,2,1,27,0,1,7,5,1,1,1037862,"2023-11-30T00:00:00.000Z",38017705,29,"Walker Kessler",4,12,14,9,7,27
"4906",637,1,0,1,3,1,7,3,0,0,19,0,1,7,1,0,0,1037862,"2023-11-30T00:00:00.000Z",666650,29,"Talen Horton-Tucker",0,8,9,8,2,9.7
"4907",638,0,0,3,1,0,4,1,0,0,12,1,0,2,4,0,2,1037862,"2023-11-30T00:00:00.000Z",666881,29,"Luka Samanic",0,6,6,2,4,4.8
"4908",639,3,0,3,2,2,5,3,0,0,14,1,3,8,4,0,2,1037862,"2023-11-30T00:00:00.000Z",358,29,"Kelly Olynyk",0,12,15,11,7,15.3
"4909",640,0,0,0,0,0,0,0,0,0,0,0,0,0,0,0,0,1037862,"2023-11-30T00:00:00.000Z",38017630,29,"Johnny Juzang",0,0,0,0,0,0
"4910",641,0,0,0,0,0,0,0,0,0,0,0,0,0,0,0,0,1037862,"2023-11-30T00:00:00.000Z",19465584,29,"Micah Potter",0,0,0,0,0,0
"4911",642,4,0,4,10,4,14,8,5,5,27,0,1,25,4,0,2,1037864,"2023-11-30T00:00:00.000Z",3547246,27,"Devin Vassell",0,29,33,29,8,33.8
"4912",643,3,0,2,2,0,7,2,2,1,20,0,0,5,2,2,0,1037862,"2023-11-30T00:00:00.000Z",320,18,"Shake Milton",2,7,10,8,5,17.9
"4913",644,0,0,1,4,1,5,1,0,0,10,0,0,3,1,0,0,1037862,"2023-11-30T00:00:00.000Z",17895968,18,"Daishen Nix",0,4,4,3,1,4.2
"4914",645,0,0,0,0,0,0,0,0,0,0,0,0,0,0,0,0,1037862,"2023-11-30T00:00:00.000Z",17896056,18,"Luka Garza",0,0,0,0,0,0
"4915",646,0,0,0,0,0,0,0,0,0,0,0,0,0,0,0,0,1037862,"2023-11-30T00:00:00.000Z",38017715,18,"Josh Minott",0,0,0,0,0,0
"4916",647,0,0,0,0,0,0,0,0,0,0,0,0,0,0,0,0,1037862,"2023-11-30T00:00:00.000Z",38017700,18,"Wendell Moore Jr.",0,0,0,0,0,0
"4917",648,0,0,0,0,0,0,0,0,0,0,0,0,0,0,0,0,1037862,"2023-11-30T00:00:00.000Z",56677851,18,"Jaylen Clark",0,0,0,0,0,0
"4918",649,0,0,0,0,0,0,0,0,0,0,0,0,0,0,0,0,1037862,"2023-11-30T00:00:00.000Z",3547238,18,"Anthony Edwards",0,0,0,0,0,0
"4919",650,0,0,0,0,0,0,0,0,0,0,0,0,0,0,0,0,1037862,"2023-11-30T00:00:00.000Z",3547259,18,"Jaden McDaniels",0,0,0,0,0,0
"4920",651,2,0,6,5,2,7,3,2,1,36,1,3,9,7,0,2,1037956,"2023-12-20T00:00:00.000Z",38017739,29,"Simone Fontecchio",0,16,18,11,9,18.4
"4921",652,0,1,5,4,2,8,5,4,4,22,0,1,16,5,1,2,1037956,"2023-12-20T00:00:00.000Z",101,29,"John Collins",2,21,21,16,5,26
"4922",653,1,1,2,1,1,1,1,0,0,16,1,1,3,3,0,0,1037956,"2023-12-20T00:00:00.000Z",38017620,29,"Ochai Agbaji",1,6,7,4,4,11.1
"4923",654,1,0,2,2,2,3,3,0,0,16,0,4,8,2,0,4,1037956,"2023-12-20T00:00:00.000Z",139,29,"Kris Dunn",0,10,11,9,3,7.9
"4924",655,6,2,1,1,0,3,2,2,1,20,1,0,5,2,1,3,1037956,"2023-12-20T00:00:00.000Z",358,29,"Kelly Olynyk",3,7,13,11,8,22.4
"4925",656,0,0,0,0,0,0,0,0,0,0,0,0,0,0,0,0,1037956,"2023-12-20T00:00:00.000Z",56677824,29,"Taylor Hendricks",0,0,0,0,0,0
"4926",657,0,0,0,0,0,0,0,0,0,0,0,0,0,0,0,0,1037956,"2023-12-20T00:00:00.000Z",666881,29,"Luka Samanic",0,0,0,0,0,0
"4927",658,0,0,0,0,0,0,0,0,0,0,0,0,0,0,0,0,1037956,"2023-12-20T00:00:00.000Z",11891374,29,"Omer Yurtseven",0,0,0,0,0,0
"4928",659,0,0,0,0,0,0,0,0,0,0,0,0,0,0,0,0,1037956,"2023-12-20T00:00:00.000Z",17896023,29,"Josh Christopher",0,0,0,0,0,0
"4929",660,0,0,0,0,0,0,0,0,0,0,0,0,0,0,0,0,1037956,"2023-12-20T00:00:00.000Z",100,29,"Jordan Clarkson",0,0,0,0,0,0
"4930",661,4,0,2,4,1,7,1,2,2,29,1,1,5,3,2,0,1037955,"2023-12-19T00:00:00.000Z",178,24,"Eric Gordon",2,8,12,9,7,20.6
"4931",662,2,1,3,2,0,7,1,0,0,20,3,2,2,6,0,1,1037955,"2023-12-19T00:00:00.000Z",18678058,24,"Jordan Goodwin",1,8,10,4,8,14.2
"4932",663,0,0,0,0,0,0,0,0,0,0,0,0,0,0,0,0,1037956,"2023-12-20T00:00:00.000Z",56677834,29,"Keyonte George",0,0,0,0,0,0
"4933",664,0,0,0,0,0,0,0,0,0,0,0,0,0,0,0,0,1037956,"2023-12-20T00:00:00.000Z",38017630,29,"Johnny Juzang",0,0,0,0,0,0
"4934",665,0,0,0,0,0,0,0,0,0,0,0,0,0,0,0,0,1037956,"2023-12-20T00:00:00.000Z",19465584,29,"Micah Potter",0,0,0,0,0,0
"4935",666,0,0,1,7,2,10,4,2,2,27,3,1,12,4,0,1,1037957,"2023-12-20T00:00:00.000Z",666950,4,"P.J. Washington",0,16,16,12,4,15.8
"4936",667,0,0,0,0,0,0,0,2,2,6,1,2,2,1,0,0,1037957,"2023-12-20T00:00:00.000Z",18678001,4,"JT Thor",0,3,3,2,1,3.2
"4937",668,0,0,0,0,0,0,0,0,0,0,0,0,0,0,0,0,1037957,"2023-12-20T00:00:00.000Z",56677848,4,"Amari Bailey",0,0,0,0,0,0
"4938",669,0,0,0,0,0,0,0,0,0,0,0,0,0,0,0,0,1037957,"2023-12-20T00:00:00.000Z",3547239,4,"LaMelo Ball",0,0,0,0,0,0
"4939",670,0,0,0,0,0,0,0,0,0,0,0,0,0,0,0,0,1037957,"2023-12-20T00:00:00.000Z",666748,4,"Cody Martin",0,0,0,0,0,0
"4940",671,0,0,0,0,0,0,0,0,0,0,0,0,0,0,0,0,1037957,"2023-12-20T00:00:00.000Z",347,4,"Frank Ntilikina",0,0,0,0,0,0
"4941",672,0,0,0,0,0,0,0,0,0,0,0,0,0,0,0,0,1037957,"2023-12-20T00:00:00.000Z",38017698,4,"Mark Williams",0,0,0,0,0,0
"4942",673,0,0,0,0,0,1,1,2,1,7,0,1,3,0,0,0,1037959,"2023-12-20T00:00:00.000Z",3547294,23,"Kenyon Martin Jr.",0,3,3,3,0,3
"4943",674,0,0,0,0,0,1,0,0,0,2,0,0,0,0,0,0,1037959,"2023-12-20T00:00:00.000Z",260,23,"Furkan Korkmaz",0,0,0,0,0,0
"4944",675,0,0,0,0,0,0,0,0,0,2,0,0,0,0,0,0,1037959,"2023-12-20T00:00:00.000Z",28,23,"Mo Bamba",0,0,0,0,0,0
"4945",676,0,0,0,0,0,0,0,0,0,0,0,0,0,0,0,0,1038103,"2024-01-08T00:00:00.000Z",272,24,"Damion Lee",0,0,0,0,0,0
"4946",677,0,0,0,0,0,0,0,0,0,0,0,0,0,0,0,0,1038103,"2024-01-08T00:00:00.000Z",666729,24,"Nassir Little",0,0,0,0,0,0
"4947",678,0,0,0,0,0,0,0,0,0,0,0,0,0,0,0,0,1038103,"2024-01-08T00:00:00.000Z",3547253,24,"Theo Maledon",0,0,0,0,0,0
"4948",679,2,0,4,10,2,12,3,0,0,34,3,2,8,7,0,0,1038105,"2024-01-09T00:00:00.000Z",38017724,22,"Caleb Houstan",0,15,17,10,9,19.4
"4949",680,3,1,2,4,1,22,8,4,1,35,0,4,18,2,3,4,1038105,"2024-01-09T00:00:00.000Z",38017683,22,"Paolo Banchero",4,20,23,21,5,32.9
"4950",681,1,2,2,0,0,3,1,0,0,17,4,4,2,6,1,1,1038105,"2024-01-09T00:00:00.000Z",666442,22,"Goga Bitadze",3,8,9,3,7,18.7
"4951",682,1,1,8,8,1,10,1,0,0,27,2,2,3,10,0,0,1038105,"2024-01-09T00:00:00.000Z",666818,22,"Chuma Okeke",1,13,14,4,11,19.5
"4952",683,2,0,4,8,4,14,8,1,0,27,1,2,20,5,3,2,1038105,"2024-01-09T00:00:00.000Z",17896073,22,"Jalen Suggs",3,25,27,22,7,36
"4953",684,2,0,2,0,0,7,2,0,0,13,1,0,4,3,0,0,1038105,"2024-01-09T00:00:00.000Z",165,22,"Markelle Fultz",0,7,9,6,5,10.6
"4954",685,0,0,0,1,0,4,1,0,0,7,1,2,2,1,0,0,1038105,"2024-01-09T00:00:00.000Z",3547251,22,"Cole Anthony",0,3,3,2,1,3.2
"4955",686,4,1,1,3,1,4,1,0,0,21,0,2,3,1,3,2,1038105,"2024-01-09T00:00:00.000Z",56677827,22,"Anthony Black",4,4,8,7,5,20.2
"4956",687,0,0,0,0,0,0,0,0,0,0,0,0,0,0,0,0,1038105,"2024-01-09T00:00:00.000Z",85,22,"Wendell Carter Jr.",0,0,0,0,0,0
"4957",688,0,0,0,0,0,0,0,0,0,0,0,0,0,0,0,0,1038105,"2024-01-09T00:00:00.000Z",226,22,"Joe Ingles",0,0,0,0,0,0
"4958",689,2,0,0,2,1,3,1,0,0,15,1,0,3,1,0,0,1038104,"2024-01-09T00:00:00.000Z",17896071,9,"Isaiah Livers",0,4,6,5,3,7.2
"4959",690,2,0,4,7,4,14,10,3,2,33,1,1,26,5,3,3,1038104,"2024-01-09T00:00:00.000Z",54,9,"Bojan Bogdanovic",3,31,33,28,7,41
"4960",691,3,0,7,0,0,14,8,0,0,24,3,4,16,10,0,3,1038104,"2024-01-09T00:00:00.000Z",38017694,9,"Jalen Duren",0,26,29,19,13,29.5
"4961",692,6,0,0,9,2,17,7,8,6,33,5,4,22,5,2,4,1038104,"2024-01-09T00:00:00.000Z",38017682,9,"Jaden Ivey",2,27,33,28,11,39
"4962",693,7,0,3,1,0,4,1,2,2,31,1,2,4,4,1,6,1038104,"2024-01-09T00:00:00.000Z",3547241,9,"Killian Hayes",1,8,15,11,11,16.3
"4963",694,1,0,4,1,0,3,0,0,0,14,2,4,0,6,0,1,1038104,"2024-01-09T00:00:00.000Z",666925,26,"Juan Toscano-Anderson",0,6,7,1,7,7.7
"4964",695,0,0,0,0,0,0,0,0,0,0,0,0,0,0,0,0,1038105,"2024-01-09T00:00:00.000Z",666885,22,"Admiral Schofield",0,0,0,0,0,0
"4965",696,0,0,2,0,0,2,0,0,0,13,0,3,0,2,3,0,1038104,"2024-01-09T00:00:00.000Z",56677826,9,"Ausar Thompson",3,2,2,0,2,11.4
"4966",697,0,1,2,6,4,12,9,2,1,29,2,3,23,4,1,1,1038106,"2024-01-09T00:00:00.000Z",18,20,"OG Anunoby",2,27,27,23,4,32.8
"4967",698,8,1,7,4,2,17,7,4,4,32,0,1,20,7,0,2,1038106,"2024-01-09T00:00:00.000Z",387,20,"Julius Randle",1,27,35,28,15,41.4
"4968",699,3,1,9,0,0,1,1,4,3,28,5,3,5,14,3,2,1038106,"2024-01-09T00:00:00.000Z",201,20,"Isaiah Hartenstein",4,19,22,8,17,36.3
"4969",700,7,0,2,7,1,11,3,6,5,26,1,0,12,3,0,0,1038106,"2024-01-09T00:00:00.000Z",73,20,"Jalen Brunson",0,15,22,19,10,26.1
"4970",701,0,0,0,0,0,0,0,0,0,0,0,0,0,0,0,0,1037700,"2023-11-08T00:00:00.000Z",56677817,27,"Sidy Cissoko",0,0,0,0,0,0
"4971",702,3,0,1,4,2,5,3,0,0,19,0,0,8,1,0,0,1037700,"2023-11-08T00:00:00.000Z",17895858,20,"Quentin Grimes",0,9,12,11,4,13.7
"4972",703,0,0,5,2,1,3,1,0,0,24,0,0,3,5,1,0,1037700,"2023-11-08T00:00:00.000Z",202,20,"Josh Hart",1,8,8,3,5,12
"4973",704,5,0,0,9,3,17,8,0,0,28,0,1,19,0,1,0,1037700,"2023-11-08T00:00:00.000Z",3547269,20,"Immanuel Quickley",1,19,24,24,5,29.5
"4974",705,0,0,0,0,0,9,6,1,1,15,3,4,13,3,2,0,1037700,"2023-11-08T00:00:00.000Z",201,20,"Isaiah Hartenstein",2,16,16,13,3,22.6
"4975",706,2,0,3,3,1,6,1,0,0,20,1,1,3,4,1,0,1037700,"2023-11-08T00:00:00.000Z",131,20,"Donte DiVincenzo",1,7,9,5,6,13.8
"4976",707,0,0,0,0,0,0,0,0,0,2,0,0,0,0,0,0,1037700,"2023-11-08T00:00:00.000Z",17896033,20,"Miles McBride",0,0,0,0,0,0
"4977",708,0,0,1,1,0,1,0,0,0,2,0,0,0,1,0,1,1037700,"2023-11-08T00:00:00.000Z",666675,20,"DaQuan Jeffries",0,1,1,0,1,0.2
"4978",709,0,0,1,0,0,0,0,0,0,1,0,0,0,1,0,0,1037700,"2023-11-08T00:00:00.000Z",17896063,20,"Jericho Sims",0,1,1,0,1,1.2
"4979",710,0,0,0,0,0,0,0,0,0,1,0,0,0,0,0,0,1037700,"2023-11-08T00:00:00.000Z",19,20,"Ryan Arcidiacono",0,0,0,0,0,0
"4980",711,0,0,0,0,0,0,0,0,0,1,0,0,0,0,0,0,1037700,"2023-11-08T00:00:00.000Z",666971,20,"Dylan Windler",0,0,0,0,0,0
"4981",712,0,0,0,0,0,0,0,0,0,0,0,0,0,0,0,0,1037700,"2023-11-08T00:00:00.000Z",160,20,"Evan Fournier",0,0,0,0,0,0
"4982",713,0,0,0,0,0,0,0,0,0,0,0,0,0,0,0,0,1037700,"2023-11-08T00:00:00.000Z",666474,20,"Charles Brown",0,0,0,0,0,0
"4983",714,0,0,0,0,0,0,0,0,0,0,0,0,0,0,0,0,1037700,"2023-11-08T00:00:00.000Z",56677795,20,"Jacob Toppin",0,0,0,0,0,0
"4984",715,0,0,0,0,0,0,0,0,0,0,0,0,0,0,0,0,1037700,"2023-11-08T00:00:00.000Z",17896089,20,"Duane Washington Jr.",0,0,0,0,0,0
"4985",716,5,0,6,4,2,12,7,0,0,29,0,5,16,6,0,0,1037700,"2023-11-08T00:00:00.000Z",38017699,27,"Jeremy Sochan",0,22,27,21,11,30.7
"4986",717,2,1,5,4,0,14,4,6,6,30,4,2,14,9,0,3,1037700,"2023-11-08T00:00:00.000Z",56677822,27,"Victor Wembanyama",1,23,25,16,11,27.8
"4987",718,3,3,5,2,1,6,4,2,2,25,2,4,11,7,0,2,1037700,"2023-11-08T00:00:00.000Z",102,27,"Zach Collins",3,18,21,14,10,30.9
"4988",719,1,0,0,2,2,9,6,0,0,24,0,2,14,0,0,1,1037700,"2023-11-08T00:00:00.000Z",38017692,27,"Malaki Branham",0,14,15,15,1,14.5
"4989",720,8,0,7,4,1,9,4,2,0,33,0,4,9,7,0,3,1037700,"2023-11-08T00:00:00.000Z",666682,27,"Keldon Johnson",0,16,24,17,15,26.4
"4990",721,1,0,2,8,3,9,4,0,0,22,1,3,11,3,0,3,1037700,"2023-11-08T00:00:00.000Z",305,27,"Doug McDermott",0,14,15,12,4,13.1
"4991",722,1,0,1,0,0,3,2,0,0,3,1,0,4,2,0,0,1037700,"2023-11-08T00:00:00.000Z",38017693,27,"Blake Wesley",0,6,7,5,3,7.9
"4992",723,5,2,2,2,1,3,2,2,1,25,0,2,6,2,1,2,1037705,"2023-11-08T00:00:00.000Z",12,18,"Kyle Anderson",3,8,13,11,7,22.9
"4993",724,0,0,0,1,0,1,0,0,0,3,1,1,0,1,0,0,1037700,"2023-11-08T00:00:00.000Z",17896059,27,"Sandro Mamukelashvili",0,1,1,0,1,1.2
"4994",725,3,0,0,5,2,7,4,0,0,26,0,2,10,0,0,0,1037705,"2023-11-08T00:00:00.000Z",3547259,18,"Jaden McDaniels",0,10,13,13,3,14.5
"4995",726,0,0,0,0,0,0,0,0,0,0,0,0,0,0,0,0,1037836,"2023-11-26T00:00:00.000Z",177,8,"Aaron Gordon",0,0,0,0,0,0
"4996",727,0,0,0,0,0,0,0,0,0,0,0,0,0,0,0,0,1037836,"2023-11-26T00:00:00.000Z",335,8,"Jamal Murray",0,0,0,0,0,0
"4997",728,2,0,1,2,0,7,3,5,4,31,0,1,10,1,0,0,1037836,"2023-11-26T00:00:00.000Z",666682,27,"Keldon Johnson",0,11,13,12,3,14.2
"4998",729,2,4,7,5,2,17,7,7,6,25,4,4,22,11,6,3,1037836,"2023-11-26T00:00:00.000Z",56677822,27,"Victor Wembanyama",10,33,35,24,13,65.2
"4999",730,3,0,2,4,1,9,4,0,0,21,2,4,9,4,1,4,1037836,"2023-11-26T00:00:00.000Z",102,27,"Zach Collins",1,13,16,12,7,17.3
"5000",731,4,0,6,5,1,18,8,4,3,39,0,1,20,6,0,0,1037834,"2023-11-26T00:00:00.000Z",268,5,"Zach LaVine",0,26,30,24,10,33.2
"5001",732,4,1,4,12,5,16,7,4,4,38,1,3,23,5,0,1,1037834,"2023-11-26T00:00:00.000Z",666956,5,"Coby White",1,28,32,27,9,37
"5002",733,0,0,0,0,0,0,0,0,0,0,0,0,0,0,0,0,1037836,"2023-11-26T00:00:00.000Z",56677817,27,"Sidy Cissoko",0,0,0,0,0,0
"5003",734,0,0,0,0,0,0,0,0,0,0,0,0,0,0,0,0,1037836,"2023-11-26T00:00:00.000Z",56677870,27,"Sir'Jabari Rice",0,0,0,0,0,0
"5004",735,0,0,0,0,0,0,0,0,0,0,0,0,0,0,0,0,1037836,"2023-11-26T00:00:00.000Z",38017693,27,"Blake Wesley",0,0,0,0,0,0
"5005",736,4,0,4,3,2,7,4,0,0,29,3,3,10,7,3,0,1037839,"2023-11-27T00:00:00.000Z",33,23,"Nicolas Batum",3,17,21,14,11,33.4
"5006",737,0,0,5,4,0,12,3,2,2,23,0,1,8,5,0,1,1037839,"2023-11-27T00:00:00.000Z",200,23,"Tobias Harris",0,13,13,8,5,13
"5007",738,11,1,7,3,2,15,9,12,10,31,4,2,30,11,1,3,1037839,"2023-11-27T00:00:00.000Z",145,23,"Joel Embiid",2,41,52,41,22,62.7
"5008",739,3,1,1,6,1,10,3,2,2,24,0,1,9,1,1,2,1037838,"2023-11-27T00:00:00.000Z",210,12,"Buddy Hield",2,10,13,12,4,18.7
"5009",740,2,1,2,4,1,9,3,2,2,19,2,0,9,4,0,1,1037838,"2023-11-27T00:00:00.000Z",3547243,12,"Obi Toppin",1,13,15,11,6,18.8
"5010",741,0,2,7,3,0,11,5,1,1,27,1,4,11,8,2,1,1037838,"2023-11-27T00:00:00.000Z",452,12,"Myles Turner",4,19,19,11,8,31.6
"5011",742,3,0,3,5,1,10,5,0,0,33,0,4,11,3,2,2,1037838,"2023-11-27T00:00:00.000Z",69,12,"Bruce Brown",2,14,17,14,6,23.1
"5012",743,9,0,2,6,3,17,11,9,8,36,0,1,33,2,0,3,1037838,"2023-11-27T00:00:00.000Z",3547245,12,"Tyrese Haliburton",0,35,44,42,11,45.9
"5013",744,1,1,4,0,0,2,1,0,0,10,1,3,2,5,0,1,1037838,"2023-11-27T00:00:00.000Z",17896035,12,"Isaiah Jackson",1,7,8,3,6,11.5
"5014",745,2,1,4,2,0,14,8,0,0,28,0,4,16,4,2,1,1037837,"2023-11-27T00:00:00.000Z",56677826,9,"Ausar Thompson",3,20,22,18,6,31.8
"5015",746,0,0,6,7,1,11,3,0,0,29,2,2,7,8,1,0,1037837,"2023-11-27T00:00:00.000Z",3547267,9,"Isaiah Stewart",1,15,15,7,8,19.6
"5016",747,3,5,7,0,0,8,5,5,2,33,7,5,12,14,1,6,1037837,"2023-11-27T00:00:00.000Z",38017694,9,"Jalen Duren",6,26,29,15,17,45.3
"5017",748,7,1,5,3,2,12,6,2,1,33,2,3,15,7,1,3,1037837,"2023-11-27T00:00:00.000Z",38017682,9,"Jaden Ivey",2,22,29,22,14,36.9
"5018",749,7,0,4,7,2,22,10,4,4,32,1,2,26,5,1,1,1037837,"2023-11-27T00:00:00.000Z",17896075,9,"Cade Cunningham",1,31,38,33,12,44.5
"5019",750,3,0,1,8,2,11,3,0,0,23,0,1,8,1,1,2,1037837,"2023-11-27T00:00:00.000Z",17896071,9,"Isaiah Livers",1,9,12,11,4,14.7
"5020",751,1,1,10,1,1,12,9,3,3,33,4,5,22,14,1,2,1037952,"2023-12-19T00:00:00.000Z",455,19,"Jonas Valanciunas",2,36,37,23,15,44.3
"5021",752,2,0,1,5,1,10,3,0,0,30,0,3,7,1,0,1,1037952,"2023-12-19T00:00:00.000Z",17896024,19,"Herbert Jones",0,8,10,9,3,10.2
"5022",753,6,1,3,9,6,11,6,0,0,41,0,2,18,3,1,1,1037952,"2023-12-19T00:00:00.000Z",303,19,"CJ McCollum",2,21,27,24,9,35.6
"5023",754,0,0,3,1,0,6,2,3,3,21,0,2,7,3,0,1,1037952,"2023-12-19T00:00:00.000Z",18677986,19,"Trey Murphy III",0,10,10,7,3,9.6
"5024",755,1,0,1,4,1,7,1,0,0,17,1,0,3,2,0,1,1037952,"2023-12-19T00:00:00.000Z",3547293,19,"Naji Marshall",0,5,6,4,3,5.9
"5025",756,0,0,1,2,0,4,1,0,0,9,1,1,2,2,0,0,1037952,"2023-12-19T00:00:00.000Z",17896097,19,"Jose Alvarado",0,4,4,2,2,4.4
"5026",757,1,1,2,0,0,3,1,2,2,13,4,1,4,6,0,1,1037952,"2023-12-19T00:00:00.000Z",491,19,"Cody Zeller",1,10,11,5,7,14.7
"5027",758,2,0,1,2,1,2,1,0,0,14,0,1,3,1,0,0,1037952,"2023-12-19T00:00:00.000Z",38017677,19,"Dyson Daniels",0,4,6,5,3,7.2
"5028",759,0,0,0,0,0,0,0,0,0,0,0,0,0,0,0,0,1037952,"2023-12-19T00:00:00.000Z",56677837,19,"Jordan Hawkins",0,0,0,0,0,0
"5029",760,0,0,2,0,0,1,1,0,0,8,0,1,2,2,0,0,1037951,"2023-12-18T00:00:00.000Z",666626,14,"Jaxson Hayes",0,4,4,2,2,4.4
"5030",761,0,0,0,0,0,0,0,0,0,0,0,0,0,0,0,0,1037951,"2023-12-18T00:00:00.000Z",38017697,14,"Max Christie",0,0,0,0,0,0
"5031",762,0,0,0,0,0,0,0,0,0,0,0,0,0,0,0,0,1037951,"2023-12-18T00:00:00.000Z",56677836,14,"Maxwell Lewis",0,0,0,0,0,0
"5032",763,0,0,0,0,0,0,0,0,0,0,0,0,0,0,0,0,1037951,"2023-12-18T00:00:00.000Z",59421201,20,"Jaylen Martin",0,0,0,0,0,0
"5033",764,0,0,0,0,0,0,0,0,0,0,0,0,0,0,0,0,1037951,"2023-12-18T00:00:00.000Z",399,20,"Mitchell Robinson",0,0,0,0,0,0
"5034",765,0,0,0,0,0,0,0,0,0,0,0,0,0,0,0,0,1037951,"2023-12-18T00:00:00.000Z",56677795,20,"Jacob Toppin",0,0,0,0,0,0
"5035",766,0,0,1,1,1,4,3,1,1,5,0,0,8,1,0,0,1037950,"2023-12-18T00:00:00.000Z",18677954,30,"Jared Butler",0,9,9,8,1,9.2
"5036",767,0,0,2,1,0,3,1,0,0,5,0,1,2,2,0,0,1037950,"2023-12-18T00:00:00.000Z",17896106,30,"Eugene Omoruyi",0,4,4,2,2,4.4
"5037",768,0,0,0,0,0,0,0,0,0,0,0,0,0,0,0,0,1037950,"2023-12-18T00:00:00.000Z",38017704,30,"Patrick Baldwin Jr.",0,0,0,0,0,0
"5038",770,0,0,0,0,0,0,0,0,0,0,0,0,0,0,0,0,1037950,"2023-12-18T00:00:00.000Z",38017687,30,"Johnny Davis",0,0,0,0,0,0
"5039",771,0,0,0,0,0,0,0,0,0,0,0,0,0,0,0,0,1037950,"2023-12-18T00:00:00.000Z",167,30,"Danilo Gallinari",0,0,0,0,0,0
"5040",772,0,0,0,0,0,0,0,0,0,0,0,0,0,0,0,0,1037950,"2023-12-18T00:00:00.000Z",38017712,30,"Ryan Rollins",0,0,0,0,0,0
"5041",773,0,0,0,0,0,0,0,0,0,0,0,0,0,0,0,0,1037950,"2023-12-18T00:00:00.000Z",414,30,"Landry Shamet",0,0,0,0,0,0
"5042",774,0,0,0,0,0,0,0,0,0,0,0,0,0,0,0,0,1037950,"2023-12-18T00:00:00.000Z",487,30,"Delon Wright",0,0,0,0,0,0
"5043",775,0,0,0,0,0,0,0,0,0,0,0,0,0,0,0,0,1037952,"2023-12-19T00:00:00.000Z",17896021,19,"Jeremiah Robinson-Earl",0,0,0,0,0,0
"5044",776,1,1,5,7,1,11,2,3,2,16,2,2,7,7,1,4,1038095,"2024-01-07T00:00:00.000Z",17896067,15,"Santi Aldama",2,14,15,8,8,18.9
"5045",777,0,0,1,1,0,1,0,0,0,3,0,0,0,1,0,0,1038095,"2024-01-07T00:00:00.000Z",666703,15,"John Konchar",0,1,1,0,1,1.2
"5046",778,0,0,0,0,0,0,0,0,0,0,0,0,0,0,0,0,1038095,"2024-01-07T00:00:00.000Z",38017729,15,"David Roddy",0,0,0,0,0,0
"5047",779,0,0,0,0,0,0,0,0,0,0,0,0,0,0,0,0,1038093,"2024-01-07T00:00:00.000Z",17896056,18,"Luka Garza",0,0,0,0,0,0
"5048",780,0,0,0,0,0,0,0,0,0,0,0,0,0,0,0,0,1038093,"2024-01-07T00:00:00.000Z",17895968,18,"Daishen Nix",0,0,0,0,0,0
"5049",781,0,0,0,0,0,0,0,0,0,0,0,0,0,0,0,0,1038095,"2024-01-07T00:00:00.000Z",401,15,"Derrick Rose",0,0,0,0,0,0
"5050",782,0,0,0,0,0,0,0,0,0,0,0,0,0,0,0,0,1038095,"2024-01-07T00:00:00.000Z",3,15,"Steven Adams",0,0,0,0,0,0
"5051",783,0,0,0,0,0,0,0,0,0,0,0,0,0,0,0,0,1038095,"2024-01-07T00:00:00.000Z",666505,15,"Brandon Clarke",0,0,0,0,0,0
"5052",784,0,0,0,0,0,0,0,0,0,0,0,0,0,0,0,0,1038095,"2024-01-07T00:00:00.000Z",48248287,15,"Jacob Gilyard",0,0,0,0,0,0
"5053",785,0,0,0,0,0,0,0,0,0,0,0,0,0,0,0,0,1038095,"2024-01-07T00:00:00.000Z",56677830,15,"GG Jackson",0,0,0,0,0,0
"5054",786,0,0,0,0,0,0,0,0,0,0,0,0,0,0,0,0,1038095,"2024-01-07T00:00:00.000Z",38017728,15,"Jake LaRavia",0,0,0,0,0,0
"5055",787,1,0,2,2,0,6,1,2,1,17,0,0,3,2,0,1,1038096,"2024-01-07T00:00:00.000Z",475,10,"Andrew Wiggins",0,5,6,4,3,5.9
"5056",788,4,1,3,5,1,12,5,2,2,25,1,0,13,4,1,1,1038096,"2024-01-07T00:00:00.000Z",17553979,10,"Jonathan Kuminga",2,17,21,17,8,28.8
"5057",789,2,3,8,0,0,9,8,0,0,27,3,0,16,11,0,0,1038096,"2024-01-07T00:00:00.000Z",56677799,10,"Trayce Jackson-Davis",3,27,29,18,13,41.2
"5058",790,3,0,0,7,5,15,10,0,0,28,0,0,25,0,0,2,1038096,"2024-01-07T00:00:00.000Z",443,10,"Klay Thompson",0,25,28,28,3,27.5
"5059",791,6,0,1,9,0,14,2,5,5,30,0,3,9,1,0,2,1038096,"2024-01-07T00:00:00.000Z",115,10,"Stephen Curry",0,10,16,15,7,17.2
"5060",792,4,0,6,8,1,11,2,0,0,29,2,1,5,8,0,0,1038096,"2024-01-07T00:00:00.000Z",56677858,10,"Brandin Podziemski",0,13,17,9,12,20.6
"5061",793,1,0,3,6,4,9,7,3,3,22,0,1,21,3,1,1,1038096,"2024-01-07T00:00:00.000Z",17553992,10,"Moses Moody",1,24,25,22,4,28.1
"5062",794,2,0,0,0,0,6,4,2,2,17,7,2,10,7,0,1,1038096,"2024-01-07T00:00:00.000Z",282,10,"Kevon Looney",0,17,19,12,9,20.4
"5063",795,2,0,0,1,0,2,0,0,0,14,0,1,0,0,0,1,1038096,"2024-01-07T00:00:00.000Z",251,10,"Cory Joseph",0,0,2,2,2,2
"5064",796,0,0,0,0,0,0,0,0,0,0,0,0,0,0,0,0,1038095,"2024-01-07T00:00:00.000Z",3547095,24,"Udoka Azubuike",0,0,0,0,0,0
"5065",797,0,0,0,0,0,0,0,0,0,0,0,0,0,0,0,0,1038095,"2024-01-07T00:00:00.000Z",666451,24,"Bol Bol",0,0,0,0,0,0
"5066",798,0,0,0,0,0,0,0,0,0,0,0,0,0,0,0,0,1038095,"2024-01-07T00:00:00.000Z",178,24,"Eric Gordon",0,0,0,0,0,0
"5067",799,0,0,0,0,0,0,0,0,0,0,0,0,0,0,0,0,1038095,"2024-01-07T00:00:00.000Z",272,24,"Damion Lee",0,0,0,0,0,0
"5068",800,0,0,0,0,0,0,0,0,0,0,0,0,0,0,0,0,1038095,"2024-01-07T00:00:00.000Z",666729,24,"Nassir Little",0,0,0,0,0,0
"5069",801,3,0,3,1,0,3,0,0,0,20,3,2,0,6,0,0,1037693,"2023-11-06T00:00:00.000Z",3547276,2,"Payton Pritchard",0,6,9,3,9,11.7
"5070",802,0,0,0,0,0,0,0,0,0,0,0,0,0,0,0,0,1037691,"2023-11-06T00:00:00.000Z",19465584,29,"Micah Potter",0,0,0,0,0,0
"5071",803,0,0,0,0,0,0,0,0,0,0,0,0,0,0,0,0,1037691,"2023-11-06T00:00:00.000Z",56677842,29,"Brice Sensabaugh",0,0,0,0,0,0
"5072",804,0,0,0,0,0,0,0,0,0,0,0,0,0,0,0,0,1037693,"2023-11-06T00:00:00.000Z",38017700,18,"Wendell Moore Jr.",0,0,0,0,0,0
"5073",805,2,0,5,8,2,22,12,8,6,43,0,2,32,5,5,6,1037693,"2023-11-06T00:00:00.000Z",434,2,"Jayson Tatum",5,37,39,34,7,50
"5074",806,4,1,6,0,0,7,4,1,1,25,0,2,9,6,0,1,1037689,"2023-11-06T00:00:00.000Z",117,14,"Anthony Davis",1,15,19,13,10,24.2
"5075",807,9,0,7,8,3,14,9,3,2,40,3,1,23,10,1,4,1037689,"2023-11-06T00:00:00.000Z",17553995,14,"Austin Reaves",1,33,42,32,19,47.5
"5076",808,6,1,4,3,1,10,6,0,0,29,0,2,13,4,0,3,1037689,"2023-11-06T00:00:00.000Z",405,14,"D'Angelo Russell",1,17,23,19,10,26.8
"5077",809,0,0,0,0,0,0,0,0,0,0,0,0,0,0,0,0,1037689,"2023-11-06T00:00:00.000Z",56677738,14,"Colin Castleton",0,0,0,0,0,0
"5078",810,4,0,3,4,1,5,1,0,0,36,2,4,3,5,1,2,1037693,"2023-11-06T00:00:00.000Z",219,2,"Al Horford",1,8,12,7,9,16
"5079",811,0,0,0,0,0,0,0,0,0,0,0,0,0,0,0,0,1037694,"2023-11-06T00:00:00.000Z",666564,1,"Bruno Fernando",0,0,0,0,0,0
"5080",812,0,0,0,0,0,0,0,0,0,0,0,0,0,0,0,0,1037694,"2023-11-06T00:00:00.000Z",3547297,1,"Trent Forrest",0,0,0,0,0,0
"5081",813,0,0,0,0,0,0,0,0,0,0,0,0,0,0,0,0,1037694,"2023-11-06T00:00:00.000Z",38017689,1,"AJ Griffin",0,0,0,0,0,0
"5082",814,0,0,0,0,0,0,0,0,0,0,0,0,0,0,0,0,1037694,"2023-11-06T00:00:00.000Z",56677806,1,"Mouhamed Gueye",0,0,0,0,0,0
"5083",815,2,0,1,3,1,6,2,0,0,15,0,3,5,1,1,1,1037692,"2023-11-06T00:00:00.000Z",324,26,"Malik Monk",1,6,8,7,3,11.2
"5084",816,1,0,2,0,0,6,4,2,2,13,3,1,10,5,0,0,1037692,"2023-11-06T00:00:00.000Z",56677845,26,"Colby Jones",0,15,16,11,6,17.5
"5085",817,0,0,0,0,0,5,4,2,2,10,3,4,10,3,0,2,1037692,"2023-11-06T00:00:00.000Z",306,26,"JaVale McGee",0,13,13,10,3,11.6
"5086",818,1,0,1,1,1,3,2,0,0,9,0,0,5,1,0,0,1037692,"2023-11-06T00:00:00.000Z",17895990,26,"Jordan Ford",0,6,7,6,2,7.7
"5087",819,2,0,1,2,1,4,1,2,1,12,0,1,4,1,1,0,1037692,"2023-11-06T00:00:00.000Z",17896044,26,"Kessler Edwards",1,5,7,6,3,11.2
"5088",820,1,1,2,1,0,1,0,0,0,8,1,0,0,3,0,0,1037692,"2023-11-06T00:00:00.000Z",273,26,"Alex Len",1,3,4,1,4,8.1
"5089",821,1,0,1,6,4,7,5,4,1,14,1,1,15,2,1,0,1037692,"2023-11-06T00:00:00.000Z",38017714,26,"Keon Ellis",1,17,18,16,3,21.9
"5090",822,0,0,0,0,0,0,0,0,0,0,0,0,0,0,0,0,1037693,"2023-11-06T00:00:00.000Z",17553967,2,"Neemias Queta",0,0,0,0,0,0
"5091",823,0,0,0,0,0,0,0,0,0,0,0,0,0,0,0,0,1037693,"2023-11-06T00:00:00.000Z",56677864,2,"Jordan Walsh",0,0,0,0,0,0
"5092",824,0,0,0,0,0,0,0,0,0,0,0,0,0,0,0,0,1037693,"2023-11-06T00:00:00.000Z",473,2,"Derrick White",0,0,0,0,0,0
"5093",825,5,1,6,4,0,15,6,2,1,34,6,2,13,12,3,0,1037694,"2023-11-06T00:00:00.000Z",17896040,1,"Jalen Johnson",4,25,30,18,17,46.9
"5094",826,5,0,6,3,1,9,6,3,3,26,0,3,16,6,0,3,1037837,"2023-11-27T00:00:00.000Z",3547242,30,"Deni Avdija",0,22,27,21,11,27.7
"5095",827,8,0,12,7,2,23,10,11,10,35,0,0,32,12,0,1,1037837,"2023-11-27T00:00:00.000Z",265,30,"Kyle Kuzma",0,44,52,40,20,57.4
"5096",828,0,0,0,0,0,0,0,0,0,0,0,0,0,0,0,0,1037839,"2023-11-27T00:00:00.000Z",360,23,"Kelly Oubre Jr.",0,0,0,0,0,0
"5097",829,0,0,0,0,0,0,0,0,0,0,0,0,0,0,0,0,1037839,"2023-11-27T00:00:00.000Z",17554001,23,"Javonte Smart",0,0,0,0,0,0
"5098",830,0,0,0,0,0,0,0,0,0,0,0,0,0,0,0,0,1037839,"2023-11-27T00:00:00.000Z",56677788,23,"Terquavion Smith",0,0,0,0,0,0
"5099",831,0,0,0,0,0,0,0,0,0,0,0,0,0,0,0,0,1037839,"2023-11-27T00:00:00.000Z",17896025,23,"Jaden Springer",0,0,0,0,0,0
"5100",832,1,0,5,1,0,7,4,0,0,19,0,4,8,5,1,0,1037837,"2023-11-27T00:00:00.000Z",17896045,30,"Corey Kispert",1,13,14,9,6,18.5
"5101",833,0,1,4,2,0,6,2,1,1,28,0,1,5,4,2,2,1037837,"2023-11-27T00:00:00.000Z",56677844,30,"Bilal Coulibaly",3,9,9,5,4,16.8
"5102",834,2,0,2,6,3,8,5,3,3,19,0,2,16,2,0,1,1037837,"2023-11-27T00:00:00.000Z",167,30,"Danilo Gallinari",0,18,20,18,4,20.4
"5103",835,3,1,2,3,2,7,4,2,2,22,0,2,12,2,2,1,1037837,"2023-11-27T00:00:00.000Z",414,30,"Landry Shamet",3,14,17,15,5,26.9
"5104",836,0,0,0,0,0,2,1,0,0,7,0,0,2,0,0,1,1037837,"2023-11-27T00:00:00.000Z",38017687,30,"Johnny Davis",0,2,2,2,0,1
"5105",837,0,0,1,1,0,1,0,0,0,2,0,1,0,1,0,0,1037837,"2023-11-27T00:00:00.000Z",18677954,30,"Jared Butler",0,1,1,0,1,1.2
"5106",838,0,0,0,0,0,0,0,0,0,2,0,0,0,0,0,0,1037837,"2023-11-27T00:00:00.000Z",3547302,30,"Anthony Gill",0,0,0,0,0,0
"5107",839,0,0,0,0,0,0,0,0,0,0,0,0,0,0,0,0,1037837,"2023-11-27T00:00:00.000Z",337,30,"Mike Muscala",0,0,0,0,0,0
"5108",840,0,0,0,0,0,0,0,0,0,0,0,0,0,0,0,0,1037838,"2023-11-27T00:00:00.000Z",666476,25,"Moses Brown",0,0,0,0,0,0
"5109",841,0,0,0,0,0,0,0,0,0,0,0,0,0,0,0,0,1037838,"2023-11-27T00:00:00.000Z",17896120,25,"Ish Wainright",0,0,0,0,0,0
"5110",842,0,0,0,0,0,0,0,0,0,0,0,0,0,0,0,0,1037838,"2023-11-27T00:00:00.000Z",476,25,"Robert Williams III",0,0,0,0,0,0
"5111",843,1,0,4,6,3,8,4,0,0,29,0,3,11,4,0,1,1037839,"2023-11-27T00:00:00.000Z",383,14,"Taurean Prince",0,15,16,12,5,16.3
"5112",844,5,1,0,1,1,12,8,2,1,30,0,0,18,0,1,1,1037839,"2023-11-27T00:00:00.000Z",237,14,"LeBron James",2,18,23,23,5,30.5
"5113",845,2,1,8,0,0,14,7,5,3,32,3,4,17,11,1,2,1037839,"2023-11-27T00:00:00.000Z",117,14,"Anthony Davis",2,28,30,19,13,37.2
"5114",846,1,1,7,5,0,9,3,0,0,22,0,1,6,7,0,3,1037839,"2023-11-27T00:00:00.000Z",486,14,"Christian Wood",1,13,14,7,8,15.9
"5115",847,0,0,0,0,0,0,0,0,0,0,0,0,0,0,0,0,1037839,"2023-11-27T00:00:00.000Z",56677738,14,"Colin Castleton",0,0,0,0,0,0
"5116",848,0,0,0,0,0,0,0,0,0,0,0,0,0,0,0,0,1037839,"2023-11-27T00:00:00.000Z",666609,14,"Rui Hachimura",0,0,0,0,0,0
"5117",849,0,0,0,0,0,0,0,0,0,0,0,0,0,0,0,0,1037839,"2023-11-27T00:00:00.000Z",666860,14,"Cameron Reddish",0,0,0,0,0,0
"5118",850,0,0,3,2,0,10,4,5,3,22,1,3,11,4,0,2,1037838,"2023-11-27T00:00:00.000Z",38017686,12,"Bennedict Mathurin",0,15,15,11,4,13.8
"5119",851,0,0,0,1,0,1,0,0,0,4,0,0,0,0,0,0,1037950,"2023-12-18T00:00:00.000Z",17896030,26,"Chris Duarte",0,0,0,0,0,0
"5120",852,1,0,1,2,1,2,1,0,0,4,0,0,3,1,0,1,1037950,"2023-12-18T00:00:00.000Z",17896044,26,"Kessler Edwards",0,4,5,4,2,4.7
"5121",853,1,0,1,0,0,2,1,0,0,4,0,0,2,1,0,0,1037950,"2023-12-18T00:00:00.000Z",17553994,26,"Davion Mitchell",0,3,4,3,2,4.7
"5122",854,0,0,0,0,0,3,1,0,0,4,1,1,2,1,0,0,1037950,"2023-12-18T00:00:00.000Z",56677845,26,"Colby Jones",0,3,3,2,1,3.2
"5123",855,0,0,0,0,0,0,0,0,0,0,0,0,0,0,0,0,1037950,"2023-12-18T00:00:00.000Z",306,26,"JaVale McGee",0,0,0,0,0,0
"5124",856,0,0,0,0,0,12,7,4,3,23,1,2,17,1,0,2,1037944,"2023-12-18T00:00:00.000Z",24,9,"Marvin Bagley III",0,18,18,17,1,16.2
"5125",857,4,0,6,2,0,13,6,5,3,29,2,6,15,8,0,2,1037944,"2023-12-18T00:00:00.000Z",38017682,9,"Jaden Ivey",0,23,27,19,12,28.6
"5126",858,0,0,0,0,0,0,0,0,0,0,0,0,0,0,0,0,1037950,"2023-12-18T00:00:00.000Z",17895990,26,"Jordan Ford",0,0,0,0,0,0
"5127",859,0,0,0,0,0,0,0,0,0,0,0,0,0,0,0,0,1037950,"2023-12-18T00:00:00.000Z",273,26,"Alex Len",0,0,0,0,0,0
"5128",860,0,0,0,0,0,0,0,0,0,0,0,0,0,0,0,0,1037950,"2023-12-18T00:00:00.000Z",56677862,26,"Jalen Slawson",0,0,0,0,0,0
"5129",861,3,0,5,3,1,8,3,4,2,23,0,5,9,5,1,2,1037950,"2023-12-18T00:00:00.000Z",3547242,30,"Deni Avdija",1,14,17,12,8,20.5
"5130",862,1,1,8,7,3,16,8,8,8,29,0,1,27,8,0,3,1037950,"2023-12-18T00:00:00.000Z",265,30,"Kyle Kuzma",1,35,36,28,9,38.1
"5131",863,1,3,3,0,0,5,3,2,2,25,2,4,8,5,0,0,1037950,"2023-12-18T00:00:00.000Z",666577,30,"Daniel Gafford",3,13,14,9,6,24.5
"5132",864,2,0,0,13,8,18,10,0,0,29,0,4,28,0,0,1,1037950,"2023-12-18T00:00:00.000Z",666848,30,"Jordan Poole",0,28,30,30,2,30
"5133",865,9,0,1,2,2,10,7,0,0,28,0,0,16,1,1,0,1037950,"2023-12-18T00:00:00.000Z",249,30,"Tyus Jones",1,17,26,25,10,33.7
"5134",866,2,1,3,2,0,7,3,7,5,33,1,1,11,4,0,0,1037950,"2023-12-18T00:00:00.000Z",56677844,30,"Bilal Coulibaly",1,15,17,13,6,21.8
"5135",867,3,0,3,5,2,6,2,2,1,20,0,1,7,3,0,2,1037950,"2023-12-18T00:00:00.000Z",17896045,30,"Corey Kispert",0,10,13,10,6,13.1
"5136",868,2,1,5,1,1,3,2,6,6,23,1,3,11,6,1,2,1037950,"2023-12-18T00:00:00.000Z",337,30,"Mike Muscala",2,17,19,13,8,25.2
"5137",869,3,0,3,2,0,5,2,0,0,20,1,1,4,4,0,1,1037950,"2023-12-18T00:00:00.000Z",3547302,30,"Anthony Gill",0,8,11,7,7,12.3
"5138",870,0,1,2,4,3,9,4,0,0,20,1,2,11,3,0,4,1037949,"2023-12-18T00:00:00.000Z",101,29,"John Collins",1,14,14,11,3,13.6
"5139",871,1,0,2,1,0,1,0,0,0,7,0,1,0,2,0,1,1037949,"2023-12-18T00:00:00.000Z",56677824,29,"Taylor Hendricks",0,2,3,1,3,2.9
"5140",872,0,0,1,1,1,2,2,0,0,2,0,1,5,1,0,0,1037949,"2023-12-18T00:00:00.000Z",666881,29,"Luka Samanic",0,6,6,5,1,6.2
"5141",873,0,0,0,0,0,0,0,0,0,0,0,0,0,0,0,0,1037949,"2023-12-18T00:00:00.000Z",56677834,29,"Keyonte George",0,0,0,0,0,0
"5142",874,0,0,0,0,0,0,0,0,0,0,0,0,0,0,0,0,1037949,"2023-12-18T00:00:00.000Z",17896023,29,"Josh Christopher",0,0,0,0,0,0
"5143",875,0,0,0,0,0,0,0,0,0,0,0,0,0,0,0,0,1037949,"2023-12-18T00:00:00.000Z",100,29,"Jordan Clarkson",0,0,0,0,0,0
"5144",876,0,0,0,0,0,0,0,0,0,0,0,0,0,0,0,0,1038084,"2024-01-05T00:00:00.000Z",56677828,28,"Gradey Dick",0,0,0,0,0,0
"5145",877,0,0,0,0,0,0,0,0,0,0,0,0,0,0,0,0,1038084,"2024-01-05T00:00:00.000Z",56677805,28,"Javon Freeman-Liberty",0,0,0,0,0,0
"5146",878,0,0,0,0,0,0,0,0,0,0,0,0,0,0,0,0,1038084,"2024-01-05T00:00:00.000Z",38017710,28,"Christian Koloko",0,0,0,0,0,0
"5147",879,0,0,0,0,0,0,0,0,0,0,0,0,0,0,0,0,1038084,"2024-01-05T00:00:00.000Z",56677869,28,"Markquis Nowell",0,0,0,0,0,0
"5148",880,0,0,0,0,0,0,0,0,0,0,0,0,0,0,0,0,1038084,"2024-01-05T00:00:00.000Z",376,28,"Otto Porter Jr.",0,0,0,0,0,0
"5149",881,10,1,2,1,0,8,3,4,4,29,0,6,10,2,2,1,1038090,"2024-01-07T00:00:00.000Z",421,3,"Dennis Smith Jr.",3,12,22,20,12,35.4
"5150",882,2,1,3,0,0,7,4,4,3,17,3,3,11,6,0,0,1038090,"2024-01-07T00:00:00.000Z",17896038,3,"Day'Ron Sharpe",1,17,19,13,8,24.2
"5151",883,0,0,1,2,0,3,0,0,0,6,0,2,0,1,0,0,1038090,"2024-01-07T00:00:00.000Z",464,3,"Lonnie Walker IV",0,1,1,0,1,1.2
"5152",884,0,0,0,0,0,0,0,0,0,1,0,0,0,0,0,1,1038090,"2024-01-07T00:00:00.000Z",17896058,3,"Trendon Watford",0,0,0,0,0,-1
"5153",885,0,0,0,0,0,0,0,0,0,0,0,0,0,0,0,0,1038090,"2024-01-07T00:00:00.000Z",174,3,"Harry Giles III",0,0,0,0,0,0
"5154",886,0,0,0,0,0,0,0,0,0,0,0,0,0,0,0,0,1038090,"2024-01-07T00:00:00.000Z",56677843,3,"Noah Clowney",0,0,0,0,0,0
"5155",887,0,0,0,0,0,0,0,0,0,0,0,0,0,0,0,0,1038090,"2024-01-07T00:00:00.000Z",17896041,3,"Keon Johnson",0,0,0,0,0,0
"5156",888,0,0,0,0,0,0,0,0,0,0,0,0,0,0,0,0,1038090,"2024-01-07T00:00:00.000Z",417,3,"Ben Simmons",0,0,0,0,0,0
"5157",889,0,0,0,0,0,0,0,0,0,0,0,0,0,0,0,0,1038083,"2024-01-05T00:00:00.000Z",3,15,"Steven Adams",0,0,0,0,0,0
"5158",890,0,0,0,0,0,0,0,0,0,0,0,0,0,0,0,0,1038083,"2024-01-05T00:00:00.000Z",666505,15,"Brandon Clarke",0,0,0,0,0,0
"5159",891,0,0,0,0,0,0,0,0,0,0,0,0,0,0,0,0,1038083,"2024-01-05T00:00:00.000Z",48248287,15,"Jacob Gilyard",0,0,0,0,0,0
"5160",892,0,0,0,0,0,0,0,0,0,0,0,0,0,0,0,0,1038083,"2024-01-05T00:00:00.000Z",56677830,15,"GG Jackson",0,0,0,0,0,0
"5161",893,2,0,1,8,5,12,5,2,1,34,3,3,16,4,0,1,1038084,"2024-01-05T00:00:00.000Z",30,26,"Harrison Barnes",0,20,22,18,6,22.8
"5162",894,1,0,9,4,4,11,6,4,2,35,3,1,18,12,1,3,1038084,"2024-01-05T00:00:00.000Z",38017688,26,"Keegan Murray",1,30,31,19,13,33.9
"5163",895,0,0,0,0,0,0,0,0,0,0,0,0,0,0,0,0,1038083,"2024-01-05T00:00:00.000Z",38017728,15,"Jake LaRavia",0,0,0,0,0,0
"5164",896,0,0,0,0,0,0,0,0,0,0,0,0,0,0,0,0,1038083,"2024-01-05T00:00:00.000Z",38017731,15,"Vince Williams Jr.",0,0,0,0,0,0
"5165",897,11,0,11,0,0,16,11,3,2,39,4,6,24,15,0,6,1038084,"2024-01-05T00:00:00.000Z",406,26,"Domantas Sabonis",0,39,50,35,26,52.5
"5166",898,1,0,0,3,2,6,4,0,0,16,0,2,10,0,0,1,1038084,"2024-01-05T00:00:00.000Z",17896030,26,"Chris Duarte",0,10,11,11,1,10.5
"5167",899,4,1,1,3,1,20,10,3,3,37,1,4,24,2,2,2,1038084,"2024-01-05T00:00:00.000Z",161,26,"De'Aaron Fox",3,26,30,28,6,39.4
"5168",900,0,0,0,0,0,0,0,2,0,2,0,0,0,0,1,0,1038081,"2024-01-05T00:00:00.000Z",3547298,24,"Saben Lee",1,0,0,0,0,3
"5169",901,0,0,0,0,0,3,0,0,0,4,1,0,0,1,0,0,1037696,"2023-11-08T00:00:00.000Z",3547302,30,"Anthony Gill",0,1,1,0,1,1.2
"5170",902,0,0,1,0,0,0,0,0,0,10,0,0,0,1,1,2,1037696,"2023-11-08T00:00:00.000Z",422,4,"Ish Smith",1,1,1,0,1,2.2
"5171",903,0,0,1,1,1,2,2,0,0,4,0,0,5,1,1,1,1037696,"2023-11-08T00:00:00.000Z",56677846,4,"Nick Smith Jr.",1,6,6,5,1,8.2
"5172",904,0,1,0,0,0,1,0,0,0,4,0,0,0,0,0,0,1037696,"2023-11-08T00:00:00.000Z",56677866,4,"Leaky Black",1,0,0,0,0,3
"5173",905,0,0,0,0,0,0,0,0,0,0,0,0,0,0,0,0,1037696,"2023-11-08T00:00:00.000Z",56677848,4,"Amari Bailey",0,0,0,0,0,0
"5174",906,0,0,0,0,0,0,0,0,0,0,0,0,0,0,0,0,1037696,"2023-11-08T00:00:00.000Z",17896037,4,"James Bouknight",0,0,0,0,0,0
"5175",907,0,0,0,0,0,0,0,0,0,0,0,0,0,0,0,0,1037696,"2023-11-08T00:00:00.000Z",62,4,"Miles Bridges",0,0,0,0,0,0
"5176",908,0,0,0,0,0,0,0,0,0,0,0,0,0,0,0,0,1037696,"2023-11-08T00:00:00.000Z",666748,4,"Cody Martin",0,0,0,0,0,0
"5177",909,0,0,0,0,0,0,0,0,0,0,0,0,0,0,0,0,1037696,"2023-11-08T00:00:00.000Z",347,4,"Frank Ntilikina",0,0,0,0,0,0
"5178",910,0,0,0,0,0,0,0,0,0,0,0,0,0,0,0,0,1037696,"2023-11-08T00:00:00.000Z",403,4,"Terry Rozier",0,0,0,0,0,0
"5179",911,4,0,6,11,4,24,13,3,3,31,3,1,33,9,0,2,1037696,"2023-11-08T00:00:00.000Z",265,30,"Kyle Kuzma",0,42,46,37,13,47.8
"5180",912,0,1,4,6,3,8,5,0,0,19,0,0,13,4,1,0,1037698,"2023-11-08T00:00:00.000Z",17896060,2,"Sam Hauser",2,17,17,13,4,23.8
"5181",913,3,2,5,6,1,6,1,0,0,26,0,1,3,5,0,1,1037698,"2023-11-08T00:00:00.000Z",219,2,"Al Horford",2,8,11,6,8,18.5
"5182",914,4,0,0,2,0,4,0,0,0,16,2,0,0,2,0,1,1037698,"2023-11-08T00:00:00.000Z",3547276,2,"Payton Pritchard",0,2,6,4,6,7.4
"5183",915,0,0,0,0,0,0,0,0,0,3,0,0,0,0,0,0,1037698,"2023-11-08T00:00:00.000Z",261,2,"Luke Kornet",0,0,0,0,0,0
"5184",916,0,0,0,0,0,0,0,0,0,0,0,0,0,0,0,0,1037698,"2023-11-08T00:00:00.000Z",338,2,"Svi Mykhailiuk",0,0,0,0,0,0
"5185",917,0,0,0,0,0,0,0,0,0,0,0,0,0,0,0,0,1037698,"2023-11-08T00:00:00.000Z",3547279,2,"Lamar Stevens",0,0,0,0,0,0
"5186",918,0,0,0,0,0,0,0,0,0,0,0,0,0,0,0,0,1037698,"2023-11-08T00:00:00.000Z",38017707,2,"JD Davison",0,0,0,0,0,0
"5187",919,0,0,0,0,0,0,0,0,0,0,0,0,0,0,0,0,1037698,"2023-11-08T00:00:00.000Z",3547295,2,"Nathan Knight",0,0,0,0,0,0
"5188",920,0,0,0,0,0,0,0,0,0,0,0,0,0,0,0,0,1037698,"2023-11-08T00:00:00.000Z",17553967,2,"Neemias Queta",0,0,0,0,0,0
"5189",921,0,0,0,0,0,0,0,0,0,0,0,0,0,0,0,0,1037698,"2023-11-08T00:00:00.000Z",56677864,2,"Jordan Walsh",0,0,0,0,0,0
"5190",922,3,0,1,3,2,5,4,8,8,26,2,1,18,3,4,1,1037696,"2023-11-08T00:00:00.000Z",487,30,"Delon Wright",4,21,24,21,6,37.1
"5191",923,2,1,1,6,3,9,6,1,0,17,0,3,15,1,1,0,1037696,"2023-11-08T00:00:00.000Z",414,30,"Landry Shamet",2,16,18,17,3,25.2
"5192",924,0,0,0,0,0,0,0,0,0,0,0,0,0,0,0,0,1037696,"2023-11-08T00:00:00.000Z",38017704,30,"Patrick Baldwin Jr.",0,0,0,0,0,0
"5193",925,0,0,0,0,0,0,0,0,0,0,0,0,0,0,0,0,1037696,"2023-11-08T00:00:00.000Z",18677954,30,"Jared Butler",0,0,0,0,0,0
"5194",926,0,0,0,0,0,0,0,0,0,0,0,0,0,0,0,0,1037873,"2023-12-02T00:00:00.000Z",666767,18,"Jordan McLaughlin",0,0,0,0,0,0
"5195",927,0,0,0,0,0,0,0,0,0,0,0,0,0,0,0,0,1037873,"2023-12-02T00:00:00.000Z",56677782,18,"Leonard Miller",0,0,0,0,0,0
"5196",928,0,0,0,0,0,0,0,0,0,0,0,0,0,0,0,0,1037874,"2023-12-02T00:00:00.000Z",158,3,"Dorian Finney-Smith",0,0,0,0,0,0
"5197",929,4,0,2,5,2,18,8,4,4,36,1,5,22,3,1,1,1037873,"2023-12-02T00:00:00.000Z",62,4,"Miles Bridges",1,25,29,26,7,33.6
"5198",930,0,0,4,0,0,6,4,4,3,29,2,6,11,6,0,1,1037873,"2023-12-02T00:00:00.000Z",38017698,4,"Mark Williams",0,17,17,11,6,17.2
"5199",931,3,2,4,4,2,13,5,2,2,36,1,3,14,5,0,2,1037873,"2023-12-02T00:00:00.000Z",56677823,4,"Brandon Miller",2,19,22,17,8,28.5
"5200",932,7,0,5,7,3,20,8,5,4,36,1,4,23,6,2,1,1037873,"2023-12-02T00:00:00.000Z",403,4,"Terry Rozier",2,29,36,30,13,45.7
"5201",933,5,1,4,7,4,14,7,0,0,31,3,1,18,7,0,1,1037873,"2023-12-02T00:00:00.000Z",666950,4,"P.J. Washington",1,25,30,23,12,35.9
"5202",934,1,1,2,0,0,3,1,2,2,9,1,1,4,3,1,0,1037873,"2023-12-02T00:00:00.000Z",3547282,4,"Nick Richards",2,7,8,5,4,15.1
"5203",935,5,0,3,0,0,3,3,0,0,16,1,0,6,4,0,0,1037873,"2023-12-02T00:00:00.000Z",422,4,"Ish Smith",0,10,15,11,9,18.3
"5204",936,1,0,1,0,0,4,1,0,0,16,0,1,2,1,0,0,1037873,"2023-12-02T00:00:00.000Z",38017708,4,"Bryce McGowens",0,3,4,3,2,4.7
"5205",937,0,0,0,0,0,0,0,0,0,0,0,0,0,0,0,0,1037873,"2023-12-02T00:00:00.000Z",56677866,4,"Leaky Black",0,0,0,0,0,0
"5206",938,0,0,0,0,0,0,0,0,0,0,0,0,0,0,0,0,1037873,"2023-12-02T00:00:00.000Z",17896037,4,"James Bouknight",0,0,0,0,0,0
"5207",939,0,0,0,0,0,0,0,0,0,0,0,0,0,0,0,0,1037873,"2023-12-02T00:00:00.000Z",3547253,4,"Theo Maledon",0,0,0,0,0,0
"5208",940,3,0,6,1,1,11,6,1,0,33,0,2,13,6,2,2,1037875,"2023-12-02T00:00:00.000Z",3547241,9,"Killian Hayes",2,19,22,16,9,28.7
"5209",941,5,0,6,5,1,9,4,2,2,30,1,0,11,7,2,3,1037875,"2023-12-02T00:00:00.000Z",3547267,9,"Isaiah Stewart",2,18,23,16,12,29.9
"5210",942,1,2,7,0,0,8,8,6,1,30,4,3,17,11,1,2,1037875,"2023-12-02T00:00:00.000Z",38017694,9,"Jalen Duren",3,28,29,18,12,38.7
"5211",943,1,0,2,3,0,7,2,4,3,29,0,3,7,2,0,1,1037875,"2023-12-02T00:00:00.000Z",38017682,9,"Jaden Ivey",0,9,10,8,3,9.9
"5212",944,11,0,8,6,3,20,8,4,4,37,0,3,23,8,3,1,1037875,"2023-12-02T00:00:00.000Z",17896075,9,"Cade Cunningham",3,31,42,34,19,57.1
"5213",945,1,0,2,2,0,5,2,0,0,16,0,1,4,2,0,2,1037875,"2023-12-02T00:00:00.000Z",56677792,9,"Marcus Sasser",0,6,7,5,3,5.9
"5214",946,2,0,1,9,3,15,7,6,5,28,1,1,22,2,1,1,1037875,"2023-12-02T00:00:00.000Z",54,9,"Bojan Bogdanovic",1,24,26,24,4,29.4
"5215",947,0,0,4,2,0,6,2,0,0,16,3,5,4,7,0,2,1037875,"2023-12-02T00:00:00.000Z",56677826,9,"Ausar Thompson",0,11,11,4,7,10.4
"5216",948,0,0,0,1,0,1,0,0,0,14,0,1,0,0,0,2,1037875,"2023-12-02T00:00:00.000Z",17896071,9,"Isaiah Livers",0,0,0,0,0,-2
"5217",949,0,0,2,0,0,1,0,0,0,7,1,1,0,3,1,0,1037875,"2023-12-02T00:00:00.000Z",24,9,"Marvin Bagley III",1,3,3,0,3,6.6
"5218",950,0,0,0,0,0,0,0,0,0,0,0,0,0,0,0,0,1037875,"2023-12-02T00:00:00.000Z",77,9,"Alec Burks",0,0,0,0,0,0
"5219",951,0,0,1,1,1,3,3,0,0,4,0,0,7,1,0,0,1038003,"2023-12-26T00:00:00.000Z",56677782,18,"Leonard Miller",0,8,8,7,1,8.2
"5220",952,0,0,0,0,0,0,0,0,0,0,0,0,0,0,0,0,1038003,"2023-12-26T00:00:00.000Z",56677851,18,"Jaylen Clark",0,0,0,0,0,0
"5221",953,0,0,0,0,0,0,0,0,0,0,0,0,0,0,0,0,1038003,"2023-12-26T00:00:00.000Z",17896056,18,"Luka Garza",0,0,0,0,0,0
"5222",954,0,0,0,0,0,0,0,0,0,0,0,0,0,0,0,0,1038003,"2023-12-26T00:00:00.000Z",17895968,18,"Daishen Nix",0,0,0,0,0,0
"5223",955,7,0,1,1,0,7,3,1,0,27,3,1,6,4,2,0,1038004,"2023-12-26T00:00:00.000Z",3547274,27,"Tre Jones",2,10,17,13,11,27.3
"5224",956,3,0,2,1,0,2,0,4,1,13,0,0,1,2,0,0,1038004,"2023-12-26T00:00:00.000Z",359,27,"Cedi Osman",0,3,6,4,5,7.9
"5225",957,0,0,0,0,0,0,0,0,0,0,0,0,0,0,0,0,1038005,"2023-12-26T00:00:00.000Z",47957121,25,"Justin Minaya",0,0,0,0,0,0
"5226",958,0,0,0,0,0,0,0,0,0,0,0,0,0,0,0,0,1038005,"2023-12-26T00:00:00.000Z",56677829,25,"Rayan Rupert",0,0,0,0,0,0
"5227",959,0,0,0,2,0,2,0,0,0,11,0,0,0,0,0,0,1038004,"2023-12-26T00:00:00.000Z",305,27,"Doug McDermott",0,0,0,0,0,0
"5228",960,0,0,0,0,0,0,0,0,0,0,0,0,0,0,0,0,1038004,"2023-12-26T00:00:00.000Z",19465584,29,"Micah Potter",0,0,0,0,0,0
"5229",961,0,0,2,1,0,3,1,2,2,23,0,0,4,2,0,0,1038006,"2023-12-26T00:00:00.000Z",666511,13,"Amir Coffey",0,6,6,4,2,6.4
"5230",962,4,0,2,11,5,25,10,0,0,37,2,4,25,4,0,3,1038006,"2023-12-26T00:00:00.000Z",172,13,"Paul George",0,29,33,29,8,32.8
"5231",963,4,1,9,0,0,11,7,8,4,31,5,3,18,14,1,2,1038006,"2023-12-26T00:00:00.000Z",493,13,"Ivica Zubac",2,32,36,22,18,44.8
"5232",964,0,0,0,1,0,4,1,2,2,21,1,2,4,1,0,1,1038006,"2023-12-26T00:00:00.000Z",666743,13,"Terance Mann",0,5,5,4,1,4.2
"5233",965,8,1,6,12,6,16,8,8,7,40,0,2,29,6,2,4,1038006,"2023-12-26T00:00:00.000Z",192,13,"James Harden",3,35,43,37,14,53.2
"5234",966,6,1,10,2,2,8,5,3,2,28,1,2,14,11,2,2,1038006,"2023-12-26T00:00:00.000Z",472,13,"Russell Westbrook",3,25,31,20,17,43.2
"5235",967,0,0,3,5,1,7,2,2,2,28,0,1,7,3,0,0,1038006,"2023-12-26T00:00:00.000Z",380,13,"Norman Powell",0,10,10,7,3,10.6
"5236",968,0,0,2,0,0,7,5,0,0,15,2,0,10,4,0,1,1038006,"2023-12-26T00:00:00.000Z",439,13,"Daniel Theis",0,14,14,10,4,13.8
"5237",969,2,0,0,2,0,4,1,0,0,17,0,0,2,0,2,0,1038006,"2023-12-26T00:00:00.000Z",56677849,13,"Kobe Brown",2,2,4,4,2,11
"5238",970,0,0,0,0,0,0,0,0,0,0,0,0,0,0,0,0,1038006,"2023-12-26T00:00:00.000Z",17896022,13,"Brandon Boston Jr.",0,0,0,0,0,0
"5239",971,2,0,3,1,0,6,4,3,2,22,0,3,10,3,0,0,1038006,"2023-12-26T00:00:00.000Z",38017708,4,"Bryce McGowens",0,13,15,12,5,16.6
"5240",972,7,0,4,8,1,23,8,3,1,39,0,2,18,4,1,4,1038006,"2023-12-26T00:00:00.000Z",403,4,"Terry Rozier",1,22,29,25,11,32.3
"5241",973,2,1,2,2,1,8,3,0,0,25,0,2,7,2,4,0,1038006,"2023-12-26T00:00:00.000Z",666748,4,"Cody Martin",5,9,11,9,4,27.4
"5242",974,1,0,0,4,1,5,2,0,0,12,0,3,5,0,0,0,1038006,"2023-12-26T00:00:00.000Z",56677846,4,"Nick Smith Jr.",0,5,6,6,1,6.5
"5243",975,0,0,0,0,0,0,0,0,0,0,0,0,0,0,0,0,1038006,"2023-12-26T00:00:00.000Z",17896037,4,"James Bouknight",0,0,0,0,0,0
"5244",976,2,0,1,2,0,2,0,0,0,13,0,1,0,1,0,1,1037614,"2023-10-27T00:00:00.000Z",87,5,"Jevon Carter",0,1,3,2,3,3.2
"5245",977,0,1,7,5,1,11,4,4,4,34,5,4,13,12,0,0,1037617,"2023-10-27T00:00:00.000Z",101,29,"John Collins",1,25,25,13,12,30.4
"5246",978,0,0,0,0,0,0,0,0,0,0,0,0,0,0,0,0,1037614,"2023-10-27T00:00:00.000Z",56677869,28,"Markquis Nowell",0,0,0,0,0,0
"5247",979,8,2,6,0,0,8,5,0,0,33,4,3,10,10,2,2,1037616,"2023-10-27T00:00:00.000Z",417,3,"Ben Simmons",4,20,28,18,18,44
"5248",980,3,0,8,7,3,9,4,0,0,34,2,4,11,10,1,3,1037616,"2023-10-27T00:00:00.000Z",351,3,"Royce O'Neale",1,21,24,14,13,27.5
"5249",981,0,0,0,0,0,0,0,0,0,0,0,0,0,0,0,0,1037616,"2023-10-27T00:00:00.000Z",9051997,3,"Armoni Brooks",0,0,0,0,0,0
"5250",982,0,0,0,0,0,0,0,0,0,0,0,0,0,0,0,0,1037616,"2023-10-27T00:00:00.000Z",56677843,3,"Noah Clowney",0,0,0,0,0,0
"5251",983,0,0,0,0,0,0,0,0,0,0,0,0,0,0,0,0,1037616,"2023-10-27T00:00:00.000Z",174,3,"Harry Giles III",0,0,0,0,0,0
"5252",984,0,0,2,2,1,6,3,0,0,21,2,0,7,4,0,0,1037617,"2023-10-27T00:00:00.000Z",38017705,29,"Walker Kessler",0,11,11,7,4,11.8
"5253",985,6,0,3,5,3,13,4,3,2,34,1,0,13,4,1,2,1037617,"2023-10-27T00:00:00.000Z",100,29,"Jordan Clarkson",1,17,23,19,10,27.8
"5254",986,8,1,3,5,2,10,3,2,2,27,0,1,10,3,3,2,1037617,"2023-10-27T00:00:00.000Z",666650,29,"Talen Horton-Tucker",4,13,21,18,11,35.6
"5255",987,0,0,1,2,0,12,5,4,3,20,0,3,13,1,0,0,1037617,"2023-10-27T00:00:00.000Z",413,29,"Collin Sexton",0,14,14,13,1,14.2
"5256",988,2,1,1,2,0,3,1,0,0,12,0,3,2,1,1,0,1037617,"2023-10-27T00:00:00.000Z",38017620,29,"Ochai Agbaji",2,3,5,4,3,12.2
"5257",989,3,1,1,2,2,6,5,3,3,27,3,3,15,4,1,3,1037617,"2023-10-27T00:00:00.000Z",358,29,"Kelly Olynyk",2,19,22,18,7,27.3
"5258",990,4,1,10,2,2,26,15,2,2,36,1,2,34,11,5,5,1037613,"2023-10-27T00:00:00.000Z",175,21,"Shai Gilgeous-Alexander",6,45,49,38,15,66.2
"5259",991,2,0,1,2,0,2,0,0,0,11,0,3,0,1,0,0,1037613,"2023-10-27T00:00:00.000Z",38017716,21,"Ousmane Dieng",0,1,3,2,3,4.2
"5260",992,1,0,3,9,3,17,9,15,15,38,1,1,36,4,0,2,1037617,"2023-10-27T00:00:00.000Z",172,13,"Paul George",0,40,41,37,5,40.3
"5261",993,4,1,8,1,0,4,2,0,0,37,1,4,4,9,1,5,1037617,"2023-10-27T00:00:00.000Z",472,13,"Russell Westbrook",2,13,17,8,13,21.8
"5262",994,1,0,2,5,2,10,5,0,0,22,0,2,12,2,1,3,1037617,"2023-10-27T00:00:00.000Z",17896031,13,"Nah'Shon Hyland",1,14,15,13,3,15.9
"5263",995,1,0,3,4,2,10,7,4,4,25,0,2,20,3,1,1,1037617,"2023-10-27T00:00:00.000Z",380,13,"Norman Powell",1,23,24,21,4,27.1
"5264",996,0,0,3,0,0,1,1,2,1,12,1,2,3,4,0,1,1037617,"2023-10-27T00:00:00.000Z",371,13,"Mason Plumlee",0,7,7,3,4,6.8
"5265",997,3,3,2,3,2,4,3,0,0,30,0,4,8,2,1,0,1037617,"2023-10-27T00:00:00.000Z",33,13,"Nicolas Batum",4,10,13,11,5,26.9
"5266",998,0,0,0,0,0,0,0,0,0,0,0,0,0,0,0,0,1037617,"2023-10-27T00:00:00.000Z",56677849,13,"Kobe Brown",0,0,0,0,0,0
"5267",999,0,0,0,0,0,0,0,0,0,0,0,0,0,0,0,0,1037617,"2023-10-27T00:00:00.000Z",666511,13,"Amir Coffey",0,0,0,0,0,0
"5268",1000,0,0,0,0,0,0,0,0,0,0,0,0,0,0,0,0,1037617,"2023-10-27T00:00:00.000Z",38017725,13,"Moussa Diabate",0,0,0,0,0,0
"5269",1001,1,0,0,0,0,1,0,0,0,9,1,0,0,1,0,0,1037781,"2023-11-19T00:00:00.000Z",17896044,26,"Kessler Edwards",0,1,2,1,2,2.7
"5270",1002,0,0,0,0,0,0,0,0,0,0,0,0,0,0,0,0,1037782,"2023-11-19T00:00:00.000Z",38017728,15,"Jake LaRavia",0,0,0,0,0,0
"5271",1003,4,0,5,4,0,11,3,0,0,24,2,2,6,7,0,0,1037782,"2023-11-19T00:00:00.000Z",17896027,15,"Ziaire Williams",0,13,17,10,11,20.4
"5272",1004,0,0,2,2,0,2,0,0,0,20,0,0,0,2,0,0,1037782,"2023-11-19T00:00:00.000Z",38017729,15,"David Roddy",0,2,2,0,2,2.4
"5273",1005,0,2,0,3,2,4,2,0,0,17,0,2,6,0,0,0,1037782,"2023-11-19T00:00:00.000Z",38017731,15,"Vince Williams Jr.",2,6,6,6,0,12
"5274",1006,0,0,0,0,0,0,0,0,0,0,0,0,0,0,0,0,1037782,"2023-11-19T00:00:00.000Z",3,15,"Steven Adams",0,0,0,0,0,0
"5275",1007,0,0,0,0,0,0,0,0,0,0,0,0,0,0,0,0,1037781,"2023-11-19T00:00:00.000Z",290,26,"Trey Lyles",0,0,0,0,0,0
"5276",1008,1,1,1,1,1,1,1,0,0,34,2,4,3,3,1,1,1037783,"2023-11-19T00:00:00.000Z",38017620,29,"Ochai Agbaji",2,6,7,4,4,13.1
"5277",1009,0,2,10,10,2,27,15,9,6,50,7,3,38,17,2,1,1037783,"2023-11-19T00:00:00.000Z",297,29,"Lauri Markkanen",4,55,55,38,17,69.4
"5278",1010,0,0,0,0,0,0,0,0,0,0,0,0,0,0,0,0,1037782,"2023-11-19T00:00:00.000Z",666505,15,"Brandon Clarke",0,0,0,0,0,0
"5279",1011,0,0,0,0,0,0,0,0,0,0,0,0,0,0,0,0,1037782,"2023-11-19T00:00:00.000Z",254,15,"Luke Kennard",0,0,0,0,0,0
"5280",1012,0,0,0,0,0,0,0,0,0,0,0,0,0,0,0,0,1037782,"2023-11-19T00:00:00.000Z",666786,15,"Ja Morant",0,0,0,0,0,0
"5281",1013,0,0,0,0,0,0,0,0,0,0,0,0,0,0,0,0,1037782,"2023-11-19T00:00:00.000Z",401,15,"Derrick Rose",0,0,0,0,0,0
"5282",1014,0,0,0,0,0,0,0,0,0,0,0,0,0,0,0,0,1037782,"2023-11-19T00:00:00.000Z",420,15,"Marcus Smart",0,0,0,0,0,0
"5283",1015,0,0,0,0,0,0,0,0,0,0,0,0,0,0,0,0,1037782,"2023-11-19T00:00:00.000Z",3547285,15,"Xavier Tillman",0,0,0,0,0,0
"5284",1016,3,2,6,7,1,16,5,2,1,34,0,4,12,6,2,2,1037782,"2023-11-19T00:00:00.000Z",70,2,"Jaylen Brown",4,18,21,15,9,33.7
"5285",1017,5,1,7,1,1,13,7,6,5,35,2,4,20,9,1,8,1037782,"2023-11-19T00:00:00.000Z",434,2,"Jayson Tatum",2,29,34,25,14,36.3
"5286",1018,1,6,6,3,0,13,9,9,8,33,2,4,26,8,1,2,1037782,"2023-11-19T00:00:00.000Z",378,2,"Kristaps Porzingis",7,34,35,27,9,56.1
"5287",1019,4,0,4,3,1,7,2,2,2,37,2,1,7,6,0,2,1037782,"2023-11-19T00:00:00.000Z",214,2,"Jrue Holiday",0,13,17,11,10,18.2
"5288",1020,4,1,2,5,2,9,3,2,2,34,1,2,10,3,0,2,1037782,"2023-11-19T00:00:00.000Z",473,2,"Derrick White",1,13,17,14,7,20.6
"5289",1021,0,0,4,7,5,8,5,0,0,22,0,0,15,4,2,0,1037782,"2023-11-19T00:00:00.000Z",17896060,2,"Sam Hauser",2,19,19,15,4,25.8
"5290",1022,2,0,1,3,1,5,2,0,0,22,2,2,5,3,0,0,1037782,"2023-11-19T00:00:00.000Z",219,2,"Al Horford",0,8,10,7,5,11.6
"5291",1023,1,0,3,2,1,5,2,4,2,15,0,0,7,3,0,1,1037782,"2023-11-19T00:00:00.000Z",3547276,2,"Payton Pritchard",0,10,11,8,4,11.1
"5292",1024,0,0,2,0,0,1,0,0,0,5,0,1,0,2,0,0,1037782,"2023-11-19T00:00:00.000Z",17553967,2,"Neemias Queta",0,2,2,0,2,2.4
"5293",1025,0,0,1,0,0,0,0,0,0,3,0,1,0,1,0,0,1037782,"2023-11-19T00:00:00.000Z",3547279,2,"Lamar Stevens",0,1,1,0,1,1.2
"5294",1026,5,0,0,2,1,4,2,0,0,18,0,2,5,0,0,1,1037892,"2023-12-11T00:00:00.000Z",368,17,"Cameron Payne",0,5,10,10,5,11.5
"5295",1027,3,0,5,5,4,6,4,0,0,13,0,1,12,5,0,0,1037892,"2023-12-11T00:00:00.000Z",38017733,17,"A.J. Green",0,17,20,15,8,22.5
"5296",1028,0,0,0,0,0,0,0,0,0,0,0,0,0,0,0,0,1037892,"2023-12-11T00:00:00.000Z",2148,17,"Thanasis Antetokounmpo",0,0,0,0,0,0
"5297",1029,0,0,0,0,0,0,0,0,0,0,0,0,0,0,0,0,1037892,"2023-12-11T00:00:00.000Z",56677852,17,"Andre Jackson Jr.",0,0,0,0,0,0
"5298",1030,0,0,0,0,0,0,0,0,0,0,0,0,0,0,0,0,1037892,"2023-12-11T00:00:00.000Z",284,17,"Robin Lopez",0,0,0,0,0,0
"5299",1031,0,0,0,0,0,0,0,0,0,0,0,0,0,0,0,0,1037886,"2023-12-11T00:00:00.000Z",666885,22,"Admiral Schofield",0,0,0,0,0,0
"5300",1032,0,0,0,0,0,0,0,0,0,0,0,0,0,0,0,0,1037886,"2023-12-11T00:00:00.000Z",85,22,"Wendell Carter Jr.",0,0,0,0,0,0
"5301",1033,0,0,0,0,0,0,0,0,0,0,0,0,0,0,0,0,1037886,"2023-12-11T00:00:00.000Z",165,22,"Markelle Fultz",0,0,0,0,0,0
"5302",1034,0,1,1,0,0,2,1,2,1,20,1,2,3,2,0,0,1037888,"2023-12-11T00:00:00.000Z",38017721,8,"Peyton Watson",1,5,5,3,2,8.4
"5303",1035,0,0,0,0,0,0,0,0,0,0,0,0,0,0,0,0,1037888,"2023-12-11T00:00:00.000Z",56677871,8,"Hunter Tyson",0,0,0,0,0,0
"5304",1036,0,0,0,0,0,0,0,0,0,0,0,0,0,0,0,0,1037888,"2023-12-11T00:00:00.000Z",666489,8,"Vlatko Cancar",0,0,0,0,0,0
"5305",1037,0,0,0,0,0,0,0,0,0,0,0,0,0,0,0,0,1037888,"2023-12-11T00:00:00.000Z",38017727,8,"Collin Gillespie",0,0,0,0,0,0
"5306",1038,0,0,0,0,0,0,0,0,0,0,0,0,0,0,0,0,1037888,"2023-12-11T00:00:00.000Z",17896103,8,"Jay Huff",0,0,0,0,0,0
"5307",1039,0,0,0,0,0,0,0,0,0,0,0,0,0,0,0,0,1037888,"2023-12-11T00:00:00.000Z",17896007,8,"Braxton Key",0,0,0,0,0,0
"5308",1040,2,1,1,3,1,7,3,4,4,15,0,5,11,1,0,2,1037894,"2023-12-11T00:00:00.000Z",666650,29,"Talen Horton-Tucker",1,12,14,13,3,16.2
"5309",1041,0,1,3,0,0,2,1,0,0,10,2,3,2,5,0,3,1037894,"2023-12-11T00:00:00.000Z",11891374,29,"Omer Yurtseven",1,7,7,2,5,8
"5310",1042,2,1,2,4,1,6,3,1,1,26,0,2,8,2,1,0,1037894,"2023-12-11T00:00:00.000Z",56677824,29,"Taylor Hendricks",2,10,12,10,4,19.4
"5311",1043,2,0,2,4,1,13,7,6,5,26,2,1,20,4,2,0,1037894,"2023-12-11T00:00:00.000Z",413,29,"Collin Sexton",2,24,26,22,6,33.8
"5312",1044,1,0,7,4,1,10,6,1,1,17,0,3,14,7,0,2,1037894,"2023-12-11T00:00:00.000Z",666881,29,"Luka Samanic",0,21,22,15,8,21.9
"5313",1045,0,0,0,0,0,0,0,0,0,0,0,0,0,0,0,0,1037894,"2023-12-11T00:00:00.000Z",38017705,29,"Walker Kessler",0,0,0,0,0,0
"5314",1046,0,0,0,0,0,0,0,0,0,0,0,0,0,0,0,0,1037894,"2023-12-11T00:00:00.000Z",17896023,29,"Josh Christopher",0,0,0,0,0,0
"5315",1047,0,0,0,0,0,0,0,0,0,0,0,0,0,0,0,0,1037894,"2023-12-11T00:00:00.000Z",101,29,"John Collins",0,0,0,0,0,0
"5316",1048,0,0,0,0,0,0,0,0,0,0,0,0,0,0,0,0,1037894,"2023-12-11T00:00:00.000Z",38017630,29,"Johnny Juzang",0,0,0,0,0,0
"5317",1049,5,0,6,8,3,19,11,9,9,39,0,2,34,6,3,1,1037896,"2023-12-11T00:00:00.000Z",274,13,"Kawhi Leonard",3,40,45,39,11,56.7
"5318",1050,8,1,5,8,2,17,7,4,4,41,3,4,20,8,1,1,1037896,"2023-12-11T00:00:00.000Z",172,13,"Paul George",2,28,36,28,16,46.6
"5319",1051,0,0,0,0,0,0,0,0,0,7,0,0,0,0,0,0,1038045,"2024-01-01T00:00:00.000Z",19465326,11,"Jock Landale",0,0,0,0,0,0
"5320",1052,1,0,1,1,0,2,0,0,0,6,0,1,0,1,0,0,1038045,"2024-01-01T00:00:00.000Z",296,11,"Boban Marjanovic",0,1,2,1,2,2.7
"5321",1053,0,0,0,0,0,0,0,0,0,0,0,0,0,0,0,0,1038045,"2024-01-01T00:00:00.000Z",3547281,11,"Nate Hinton",0,0,0,0,0,0
"5322",1054,0,0,0,0,0,0,0,0,0,0,0,0,0,0,0,0,1038045,"2024-01-01T00:00:00.000Z",357,11,"Victor Oladipo",0,0,0,0,0,0
"5323",1055,0,0,0,0,0,0,0,0,0,0,0,0,0,0,0,0,1038045,"2024-01-01T00:00:00.000Z",56677809,11,"Jermaine Samuels Jr.",0,0,0,0,0,0
"5324",1056,0,0,0,0,0,0,0,0,0,0,0,0,0,0,0,0,1038045,"2024-01-01T00:00:00.000Z",47738533,11,"Jeenathan Williams",0,0,0,0,0,0
"5325",1057,1,1,4,4,2,6,3,0,0,19,0,2,8,4,1,0,1038047,"2024-01-01T00:00:00.000Z",38017721,8,"Peyton Watson",2,12,13,9,5,20.3
"5326",1058,0,0,0,0,0,0,0,0,0,0,0,0,0,0,0,0,1038047,"2024-01-01T00:00:00.000Z",666489,8,"Vlatko Cancar",0,0,0,0,0,0
"5327",1059,0,0,0,0,0,0,0,0,0,0,0,0,0,0,0,0,1038047,"2024-01-01T00:00:00.000Z",38017727,8,"Collin Gillespie",0,0,0,0,0,0
"5328",1060,0,0,0,0,0,0,0,0,0,0,0,0,0,0,0,0,1038047,"2024-01-01T00:00:00.000Z",17896103,8,"Jay Huff",0,0,0,0,0,0
"5329",1061,0,0,0,0,0,0,0,0,0,0,0,0,0,0,0,0,1038045,"2024-01-01T00:00:00.000Z",42097199,9,"Jared Rhoden",0,0,0,0,0,0
"5330",1062,0,0,0,0,0,0,0,0,0,0,0,0,0,0,0,0,1038045,"2024-01-01T00:00:00.000Z",3547267,9,"Isaiah Stewart",0,0,0,0,0,0
"5331",1063,0,0,0,0,0,0,0,0,0,0,0,0,0,0,0,0,1038045,"2024-01-01T00:00:00.000Z",44477024,9,"Stanley Umude",0,0,0,0,0,0
"5332",1064,0,0,0,0,0,0,0,0,0,0,0,0,0,0,0,0,1038047,"2024-01-01T00:00:00.000Z",56677871,8,"Hunter Tyson",0,0,0,0,0,0
"5333",1065,3,0,2,3,2,8,4,0,0,23,0,4,10,2,0,0,1038047,"2024-01-01T00:00:00.000Z",38017708,4,"Bryce McGowens",0,12,15,13,5,16.9
"5334",1066,5,0,9,5,3,14,10,5,3,36,0,1,26,9,1,2,1038047,"2024-01-01T00:00:00.000Z",62,4,"Miles Bridges",1,35,40,31,14,45.3
"5335",1067,1,1,6,0,0,12,7,2,1,30,2,2,15,8,1,0,1038047,"2024-01-01T00:00:00.000Z",3547282,4,"Nick Richards",2,23,24,16,9,32.1
"5336",1068,4,1,2,5,2,7,4,2,2,28,0,1,12,2,2,1,1038048,"2024-01-01T00:00:00.000Z",8,24,"Grayson Allen",3,14,18,16,6,28.4
"5337",1069,1,0,3,4,2,8,4,4,4,26,2,3,14,5,1,2,1038048,"2024-01-01T00:00:00.000Z",314,24,"Chimezie Metu",1,19,20,15,6,22.5
"5338",1070,5,2,6,2,1,8,6,6,5,25,1,3,18,7,1,2,1038048,"2024-01-01T00:00:00.000Z",349,24,"Jusuf Nurkic",3,25,30,23,12,40.9
"5339",1071,1,1,4,3,1,16,8,4,4,34,0,2,21,4,1,4,1038048,"2024-01-01T00:00:00.000Z",37,24,"Bradley Beal",2,25,26,22,5,29.3
"5340",1072,6,0,5,4,1,16,4,2,1,31,3,2,10,8,1,2,1038048,"2024-01-01T00:00:00.000Z",57,24,"Devin Booker",1,18,24,16,14,29.6
"5341",1073,0,0,1,0,0,1,1,0,0,7,0,0,2,1,0,0,1038049,"2024-01-01T00:00:00.000Z",217,7,"Richaun Holmes",0,3,3,2,1,3.2
"5342",1074,2,1,6,8,3,16,10,1,1,29,0,0,24,6,2,1,1038049,"2024-01-01T00:00:00.000Z",38017739,29,"Simone Fontecchio",3,30,32,26,8,42.2
"5343",1075,1,1,2,8,4,12,6,1,1,25,2,0,17,4,1,1,1038049,"2024-01-01T00:00:00.000Z",297,29,"Lauri Markkanen",2,21,22,18,5,28.3
"5344",1076,0,0,1,2,1,3,2,0,0,9,0,0,5,1,0,0,1037660,"2023-11-02T00:00:00.000Z",666762,28,"Jalen McDaniels",0,6,6,5,1,6.2
"5345",1077,0,1,9,4,2,6,4,0,0,29,2,3,10,11,1,2,1037659,"2023-11-01T00:00:00.000Z",486,14,"Christian Wood",2,21,21,10,11,27.2
"5346",1078,0,0,0,0,0,0,0,0,0,0,0,0,0,0,0,0,1037657,"2023-11-01T00:00:00.000Z",38017630,29,"Johnny Juzang",0,0,0,0,0,0
"5347",1079,0,0,0,0,0,0,0,0,0,0,0,0,0,0,0,0,1037657,"2023-11-01T00:00:00.000Z",19465584,29,"Micah Potter",0,0,0,0,0,0
"5348",1080,0,2,3,5,2,5,2,2,2,19,1,2,8,4,0,1,1037657,"2023-11-01T00:00:00.000Z",17896027,15,"Ziaire Williams",2,12,12,8,4,17.8
"5349",1081,8,0,3,3,0,5,1,0,0,28,1,2,2,4,1,0,1037658,"2023-11-01T00:00:00.000Z",367,10,"Chris Paul",1,6,14,10,12,21.8
"5350",1082,2,0,6,5,3,9,6,0,0,20,0,1,15,6,0,3,1037658,"2023-11-01T00:00:00.000Z",407,10,"Dario Saric",0,21,23,17,8,22.2
"5351",1083,1,0,2,0,0,4,2,0,0,22,0,0,4,2,1,1,1037658,"2023-11-01T00:00:00.000Z",2189,10,"Gary Payton II",1,6,7,5,3,9.9
"5352",1084,1,0,1,2,1,9,4,3,3,17,0,2,12,1,1,1,1037658,"2023-11-01T00:00:00.000Z",17553979,10,"Jonathan Kuminga",1,13,14,13,2,16.7
"5353",1085,0,1,3,2,0,3,0,2,1,15,0,1,1,3,0,0,1037658,"2023-11-01T00:00:00.000Z",17553992,10,"Moses Moody",1,4,4,1,3,7.6
"5354",1086,0,0,0,0,0,0,0,0,0,0,0,0,0,0,0,0,1037658,"2023-11-01T00:00:00.000Z",251,10,"Cory Joseph",0,0,0,0,0,0
"5355",1087,0,0,0,0,0,0,0,0,0,0,0,0,0,0,0,0,1037658,"2023-11-01T00:00:00.000Z",56677858,10,"Brandin Podziemski",0,0,0,0,0,0
"5356",1088,0,0,0,0,0,0,0,0,0,0,0,0,0,0,0,0,1037658,"2023-11-01T00:00:00.000Z",17896070,10,"Usman Garuba",0,0,0,0,0,0
"5357",1089,0,0,0,0,0,0,0,0,0,0,0,0,0,0,0,0,1037658,"2023-11-01T00:00:00.000Z",45658838,10,"Lester Quinones",0,0,0,0,0,0
"5358",1090,0,0,0,0,0,0,0,0,0,0,0,0,0,0,0,0,1037658,"2023-11-01T00:00:00.000Z",398,10,"Jerome Robinson",0,0,0,0,0,0
"5359",1091,1,0,0,7,4,8,4,2,2,31,1,0,14,1,1,1,1037658,"2023-11-01T00:00:00.000Z",30,26,"Harrison Barnes",1,15,16,15,2,18.7
"5360",1092,0,0,0,0,0,0,0,0,0,0,0,0,0,0,0,0,1037659,"2023-11-01T00:00:00.000Z",457,14,"Jarred Vanderbilt",0,0,0,0,0,0
"5361",1093,0,0,0,0,0,0,0,0,0,0,0,0,0,0,0,0,1037659,"2023-11-01T00:00:00.000Z",1603383,14,"Gabe Vincent",0,0,0,0,0,0
"5362",1094,1,0,6,9,6,16,11,8,7,37,0,6,35,6,2,3,1037659,"2023-11-01T00:00:00.000Z",172,13,"Paul George",2,41,42,36,7,46.7
"5363",1095,5,0,5,11,5,28,15,6,3,41,1,2,38,6,2,2,1037659,"2023-11-01T00:00:00.000Z",274,13,"Kawhi Leonard",2,44,49,43,11,56.7
"5364",1096,0,0,7,0,0,8,3,2,1,29,2,5,7,9,0,1,1037659,"2023-11-01T00:00:00.000Z",493,13,"Ivica Zubac",0,16,16,7,9,16.8
"5365",1097,5,0,1,3,0,7,2,0,0,34,0,3,4,1,1,0,1037659,"2023-11-01T00:00:00.000Z",17896031,13,"Nah'Shon Hyland",1,5,10,9,6,15.7
"5366",1098,8,0,7,6,3,21,9,5,3,44,4,5,24,11,4,6,1037659,"2023-11-01T00:00:00.000Z",472,13,"Russell Westbrook",4,35,43,32,19,55.2
"5367",1099,2,0,4,7,0,15,4,2,2,39,2,2,10,6,2,0,1037658,"2023-11-01T00:00:00.000Z",38017688,26,"Keegan Murray",2,16,18,12,8,26.2
"5368",1100,7,0,8,1,0,16,8,12,7,37,3,2,23,11,0,2,1037658,"2023-11-01T00:00:00.000Z",406,26,"Domantas Sabonis",0,34,41,30,18,44.7
"5369",1101,0,0,2,0,0,2,1,4,3,10,2,0,5,4,1,1,1037835,"2023-11-26T00:00:00.000Z",58,28,"Chris Boucher",1,9,9,5,4,11.8
"5370",1102,0,0,0,1,0,1,0,0,0,5,1,0,0,1,0,0,1037835,"2023-11-26T00:00:00.000Z",376,28,"Otto Porter Jr.",0,1,1,0,1,1.2
"5371",1103,0,0,0,0,0,0,0,0,0,0,0,0,0,0,0,0,1037835,"2023-11-26T00:00:00.000Z",666762,28,"Jalen McDaniels",0,0,0,0,0,0
"5372",1104,0,0,0,0,0,0,0,0,0,0,0,0,0,0,0,0,1037835,"2023-11-26T00:00:00.000Z",436,28,"Garrett Temple",0,0,0,0,0,0
"5373",1105,0,0,0,0,0,0,0,0,0,0,0,0,0,0,0,0,1037835,"2023-11-26T00:00:00.000Z",489,28,"Thaddeus Young",0,0,0,0,0,0
"5374",1106,1,0,1,1,0,1,0,0,0,2,0,0,0,1,0,0,1037836,"2023-11-26T00:00:00.000Z",17896007,8,"Braxton Key",0,1,2,1,2,2.7
"5375",1107,0,0,0,0,0,0,0,0,0,2,0,0,0,0,0,0,1037836,"2023-11-26T00:00:00.000Z",38017727,8,"Collin Gillespie",0,0,0,0,0,0
"5376",1108,0,0,0,0,0,1,1,0,0,1,0,0,2,0,0,0,1037836,"2023-11-26T00:00:00.000Z",17896103,8,"Jay Huff",0,2,2,2,0,2
"5377",1109,5,1,10,9,4,16,8,0,0,37,1,4,20,11,0,2,1037835,"2023-11-26T00:00:00.000Z",666908,6,"Max Strus",1,31,36,25,16,41.7
"5378",1110,1,2,11,1,0,14,5,2,2,38,3,3,12,14,0,3,1037835,"2023-11-26T00:00:00.000Z",17896076,6,"Evan Mobley",2,26,27,13,15,33.3
"5379",1111,3,2,1,0,0,10,9,0,0,27,3,4,18,4,0,2,1037835,"2023-11-26T00:00:00.000Z",9,6,"Jarrett Allen",2,22,25,21,7,31.3
"5380",1112,4,0,4,5,0,17,4,3,2,34,1,0,10,5,1,0,1037835,"2023-11-26T00:00:00.000Z",322,6,"Donovan Mitchell",1,15,19,14,9,25
"5381",1113,8,0,2,6,3,16,10,1,1,41,0,2,24,2,0,5,1037835,"2023-11-26T00:00:00.000Z",666581,6,"Darius Garland",0,26,34,32,10,33.4
"5382",1114,1,0,3,4,1,10,3,0,0,22,0,1,7,3,0,0,1037835,"2023-11-26T00:00:00.000Z",277,6,"Caris LeVert",0,10,11,8,4,12.1
"5383",1115,0,0,0,0,0,0,0,0,0,0,0,0,0,0,0,0,1037835,"2023-11-26T00:00:00.000Z",248,6,"Damian Jones",0,0,0,0,0,0
"5384",1116,0,0,0,0,0,0,0,0,0,0,0,0,0,0,0,0,1037835,"2023-11-26T00:00:00.000Z",3547299,6,"Sam Merrill",0,0,0,0,0,0
"5385",1117,0,0,0,0,0,0,0,0,0,0,0,0,0,0,0,0,1037834,"2023-11-26T00:00:00.000Z",17896041,3,"Keon Johnson",0,0,0,0,0,0
"5386",1118,0,0,0,0,0,0,0,0,0,0,0,0,0,0,0,0,1037834,"2023-11-26T00:00:00.000Z",417,3,"Ben Simmons",0,0,0,0,0,0
"5387",1119,0,0,0,0,0,0,0,0,0,0,0,0,0,0,0,0,1037834,"2023-11-26T00:00:00.000Z",421,3,"Dennis Smith Jr.",0,0,0,0,0,0
"5388",1120,0,0,0,0,0,0,0,0,0,0,0,0,0,0,0,0,1037834,"2023-11-26T00:00:00.000Z",17896048,3,"Cam Thomas",0,0,0,0,0,0
"5389",1121,0,0,0,0,0,0,0,0,0,0,0,0,0,0,0,0,1037834,"2023-11-26T00:00:00.000Z",56677841,3,"Dariq Whitehead",0,0,0,0,0,0
"5390",1122,6,0,4,4,2,22,11,5,3,38,2,2,27,6,1,1,1037834,"2023-11-26T00:00:00.000Z",125,5,"DeMar DeRozan",1,33,39,33,12,45.2
"5391",1123,0,0,3,5,4,9,7,2,2,35,1,2,20,4,0,1,1037834,"2023-11-26T00:00:00.000Z",3547248,5,"Patrick Williams",0,24,24,20,4,23.8
"5392",1124,5,1,8,3,0,9,3,0,0,37,1,5,6,9,1,2,1037834,"2023-11-26T00:00:00.000Z",460,5,"Nikola Vucevic",2,15,20,11,14,28.3
"5393",1125,0,0,0,2,0,2,0,0,0,8,0,0,0,0,0,1,1037834,"2023-11-26T00:00:00.000Z",87,5,"Jevon Carter",0,0,0,0,0,-1
"5394",1126,0,0,0,0,0,0,0,0,0,0,0,0,0,0,0,0,1037961,"2023-12-20T00:00:00.000Z",489,28,"Thaddeus Young",0,0,0,0,0,0
"5395",1127,0,0,0,0,0,0,0,0,0,0,0,0,0,0,0,0,1037961,"2023-12-20T00:00:00.000Z",56677805,28,"Javon Freeman-Liberty",0,0,0,0,0,0
"5396",1128,6,3,5,10,2,11,2,0,0,28,1,2,6,6,1,2,1037960,"2023-12-20T00:00:00.000Z",351,3,"Royce O'Neale",4,12,18,12,12,32.2
"5397",1129,0,1,0,0,0,1,0,0,0,4,0,1,0,0,0,1,1037960,"2023-12-20T00:00:00.000Z",174,3,"Harry Giles III",1,0,0,0,0,2
"5398",1130,0,0,0,0,0,0,0,0,0,0,0,0,0,0,0,0,1037961,"2023-12-20T00:00:00.000Z",38017710,28,"Christian Koloko",0,0,0,0,0,0
"5399",1131,0,0,0,0,0,0,0,0,0,0,0,0,0,0,0,0,1037961,"2023-12-20T00:00:00.000Z",56677869,28,"Markquis Nowell",0,0,0,0,0,0
"5400",1132,0,0,0,0,0,0,0,0,0,0,0,0,0,0,0,0,1037961,"2023-12-20T00:00:00.000Z",2309958,28,"Jontay Porter",0,0,0,0,0,0
"5401",1133,2,0,5,7,2,13,5,0,0,32,1,1,12,6,1,0,1037961,"2023-12-20T00:00:00.000Z",375,8,"Michael Porter Jr.",1,18,20,14,8,25.2
"5402",1134,0,0,0,0,0,0,0,0,0,0,0,0,0,0,0,0,1037961,"2023-12-20T00:00:00.000Z",38017727,8,"Collin Gillespie",0,0,0,0,0,0
"5403",1135,0,0,0,0,0,0,0,0,0,0,0,0,0,0,0,0,1037961,"2023-12-20T00:00:00.000Z",215,8,"Justin Holiday",0,0,0,0,0,0
"5404",1136,0,0,0,0,0,0,0,0,0,0,0,0,0,0,0,0,1037956,"2023-12-20T00:00:00.000Z",56677842,29,"Brice Sensabaugh",0,0,0,0,0,0
"5405",1137,7,0,7,10,2,26,10,3,3,34,2,0,25,9,1,1,1037957,"2023-12-20T00:00:00.000Z",403,4,"Terry Rozier",1,34,41,32,16,48.3
"5406",1138,2,0,3,8,1,21,4,6,6,33,2,0,15,5,2,2,1037960,"2023-12-20T00:00:00.000Z",61,3,"Mikal Bridges",2,20,22,17,7,28
"5407",1139,2,0,4,6,4,14,8,1,0,28,0,3,20,4,0,0,1037960,"2023-12-20T00:00:00.000Z",666679,3,"Cameron Johnson",0,24,26,22,6,27.8
"5408",1140,2,4,4,0,0,5,3,0,0,26,4,5,6,8,0,0,1037960,"2023-12-20T00:00:00.000Z",666508,3,"Nicolas Claxton",4,14,16,8,10,30.6
"5409",1141,5,0,1,7,4,18,8,1,0,32,1,2,20,2,0,1,1037960,"2023-12-20T00:00:00.000Z",17896048,3,"Cam Thomas",0,22,27,25,7,28.9
"5410",1142,2,0,2,8,2,11,3,2,2,30,0,0,10,2,1,2,1037960,"2023-12-20T00:00:00.000Z",130,3,"Spencer Dinwiddie",1,12,14,12,4,16.4
"5411",1143,0,0,0,0,0,0,0,0,0,0,0,0,0,0,0,0,1037957,"2023-12-20T00:00:00.000Z",56677861,12,"Ben Sheppard",0,0,0,0,0,0
"5412",1144,3,0,11,3,2,5,2,4,4,31,2,2,10,13,1,2,1037960,"2023-12-20T00:00:00.000Z",202,20,"Josh Hart",1,23,26,13,16,31.1
"5413",1145,2,1,0,6,4,12,7,4,1,24,0,0,19,0,1,1,1037960,"2023-12-20T00:00:00.000Z",3547269,20,"Immanuel Quickley",2,19,21,21,2,27
"5414",1146,0,1,1,4,1,7,2,0,0,18,0,1,5,1,1,0,1037960,"2023-12-20T00:00:00.000Z",17895858,20,"Quentin Grimes",2,6,6,5,1,12.2
"5415",1147,0,2,2,0,0,2,1,0,0,13,0,3,2,2,0,0,1037960,"2023-12-20T00:00:00.000Z",173,20,"Taj Gibson",2,4,4,2,2,10.4
"5416",1148,0,0,0,0,0,3,2,0,0,3,0,1,4,0,0,0,1037960,"2023-12-20T00:00:00.000Z",666675,20,"DaQuan Jeffries",0,4,4,4,0,4
"5417",1149,0,0,0,1,0,1,0,0,0,3,0,0,0,0,0,0,1037960,"2023-12-20T00:00:00.000Z",17896033,20,"Miles McBride",0,0,0,0,0,0
"5418",1150,0,0,0,0,0,0,0,0,0,0,0,0,0,0,0,0,1037960,"2023-12-20T00:00:00.000Z",666474,20,"Charles Brown",0,0,0,0,0,0
"5419",1151,4,0,1,5,1,13,8,5,5,34,0,1,22,1,0,2,1038118,"2024-01-10T00:00:00.000Z",409,28,"Dennis Schroder",0,23,27,26,5,27.2
"5420",1152,1,1,2,0,0,4,4,0,0,15,2,4,8,4,2,1,1038116,"2024-01-10T00:00:00.000Z",38017705,29,"Walker Kessler",3,12,13,9,5,22.3
"5421",1153,1,1,1,5,2,9,4,2,2,28,0,2,12,1,4,1,1038116,"2024-01-10T00:00:00.000Z",81,8,"Kentavious Caldwell-Pope",5,13,14,13,2,28.7
"5422",1154,6,2,1,5,1,15,6,4,4,31,0,3,17,1,1,4,1038116,"2024-01-10T00:00:00.000Z",335,8,"Jamal Murray",3,18,24,23,7,32.2
"5423",1155,1,0,3,2,1,4,2,0,0,17,0,1,5,3,1,1,1038116,"2024-01-10T00:00:00.000Z",38017709,8,"Christian Braun",1,8,9,6,4,12.1
"5424",1156,2,0,2,4,2,9,5,0,0,24,1,1,12,3,0,0,1038118,"2024-01-10T00:00:00.000Z",3089,28,"Gary Trent Jr.",0,15,17,14,5,18.6
"5425",1157,1,0,2,1,1,2,1,0,0,9,0,2,3,2,0,0,1038118,"2024-01-10T00:00:00.000Z",436,28,"Garrett Temple",0,5,6,4,3,6.9
"5426",1158,0,0,0,0,0,0,0,0,0,0,0,0,0,0,0,0,1038118,"2024-01-10T00:00:00.000Z",376,28,"Otto Porter Jr.",0,0,0,0,0,0
"5427",1159,0,0,0,0,0,0,0,0,0,0,0,0,0,0,0,0,1038118,"2024-01-10T00:00:00.000Z",416,28,"Pascal Siakam",0,0,0,0,0,0
"5428",1160,0,0,0,0,0,0,0,0,0,0,0,0,0,0,0,0,1038118,"2024-01-10T00:00:00.000Z",56677828,28,"Gradey Dick",0,0,0,0,0,0
"5429",1161,0,0,0,0,0,0,0,0,0,0,0,0,0,0,0,0,1038118,"2024-01-10T00:00:00.000Z",56677805,28,"Javon Freeman-Liberty",0,0,0,0,0,0
"5430",1162,0,0,0,0,0,0,0,0,0,0,0,0,0,0,0,0,1038118,"2024-01-10T00:00:00.000Z",38017710,28,"Christian Koloko",0,0,0,0,0,0
"5431",1163,0,0,0,0,0,0,0,0,0,0,0,0,0,0,0,0,1038118,"2024-01-10T00:00:00.000Z",56677869,28,"Markquis Nowell",0,0,0,0,0,0
"5432",1164,0,0,0,0,0,0,0,0,0,0,0,0,0,0,0,0,1038118,"2024-01-10T00:00:00.000Z",373,28,"Jakob Poeltl",0,0,0,0,0,0
"5433",1165,1,1,2,0,0,11,9,1,1,22,3,1,19,5,1,1,1038117,"2024-01-10T00:00:00.000Z",56677799,10,"Trayce Jackson-Davis",2,24,25,20,6,31.5
"5434",1166,3,0,2,2,0,3,1,2,2,14,1,2,4,3,1,2,1038117,"2024-01-10T00:00:00.000Z",407,10,"Dario Saric",1,7,10,7,6,13.1
"5435",1167,2,0,1,2,0,3,1,0,0,17,2,2,2,3,0,2,1038117,"2024-01-10T00:00:00.000Z",251,10,"Cory Joseph",0,5,7,4,5,6.6
"5436",1168,0,1,1,5,2,12,4,2,2,35,3,4,12,4,0,1,1038119,"2024-01-11T00:00:00.000Z",3547247,6,"Isaac Okoro",1,16,16,12,4,18.8
"5437",1169,2,0,1,1,0,1,0,4,4,27,0,5,4,1,2,0,1038119,"2024-01-11T00:00:00.000Z",666940,6,"Dean Wade",2,5,7,6,3,14.2
"5438",1170,4,4,9,0,0,5,3,6,6,38,3,5,12,12,2,1,1038119,"2024-01-11T00:00:00.000Z",9,6,"Jarrett Allen",6,24,28,16,16,49.4
"5439",1171,0,0,0,2,0,2,0,0,0,7,0,0,0,0,0,0,1038119,"2024-01-11T00:00:00.000Z",666908,6,"Max Strus",0,0,0,0,0,0
"5440",1172,6,0,10,12,4,30,15,13,11,40,2,1,45,12,4,7,1038119,"2024-01-11T00:00:00.000Z",322,6,"Donovan Mitchell",4,57,63,51,18,73.4
"5441",1173,1,1,3,9,3,14,5,12,8,35,0,2,21,3,1,1,1038119,"2024-01-11T00:00:00.000Z",277,6,"Caris LeVert",2,24,25,22,4,31.1
"5442",1174,1,0,7,11,2,12,2,0,0,32,2,1,6,9,1,0,1038119,"2024-01-11T00:00:00.000Z",3547299,6,"Sam Merrill",1,15,16,7,10,21.3
"5443",1175,2,0,3,4,2,6,3,2,2,16,1,3,10,4,0,0,1038119,"2024-01-11T00:00:00.000Z",344,6,"Georges Niang",0,14,16,12,6,17.8
"5444",1176,0,0,0,0,0,0,0,0,0,0,0,0,0,0,0,0,3277426,"2023-11-14T00:00:00.000Z",17896071,9,"Isaiah Livers",0,0,0,0,0,0
"5445",1177,0,0,0,0,0,0,0,0,0,0,0,0,0,0,0,0,3277426,"2023-11-14T00:00:00.000Z",54,9,"Bojan Bogdanovic",0,0,0,0,0,0
"5446",1178,0,0,0,0,0,0,0,0,0,0,0,0,0,0,0,0,3277426,"2023-11-14T00:00:00.000Z",56677729,9,"Malcolm Cazalon",0,0,0,0,0,0
"5447",1179,0,0,0,0,0,0,0,0,0,0,0,0,0,0,0,0,3277426,"2023-11-14T00:00:00.000Z",330,9,"Monte Morris",0,0,0,0,0,0
"5448",1180,2,0,4,7,3,11,7,4,3,29,1,1,20,5,3,1,3277428,"2023-11-14T00:00:00.000Z",666679,3,"Cameron Johnson",3,25,27,22,7,37
"5449",1181,0,0,2,4,1,5,2,0,0,24,2,1,5,4,1,0,3277428,"2023-11-14T00:00:00.000Z",158,3,"Dorian Finney-Smith",1,9,9,5,4,12.8
"5450",1182,0,2,4,0,0,5,3,2,2,21,2,4,8,6,1,1,3277428,"2023-11-14T00:00:00.000Z",666508,3,"Nicolas Claxton",3,14,14,8,6,23.2
"5451",1183,4,0,4,5,3,17,9,1,0,32,1,2,21,5,4,6,3277428,"2023-11-14T00:00:00.000Z",61,3,"Mikal Bridges",4,26,30,25,9,39
"5452",1184,9,0,4,10,5,18,10,6,4,37,1,3,29,5,0,1,3277428,"2023-11-14T00:00:00.000Z",130,3,"Spencer Dinwiddie",0,34,43,38,14,47.5
"5453",1185,0,1,2,3,1,6,2,2,1,24,1,2,6,3,1,0,3277429,"2023-11-14T00:00:00.000Z",666541,21,"Luguentz Dort",2,9,9,6,3,15.6
"5454",1186,3,0,2,3,1,9,5,0,0,23,0,3,11,2,0,3,3277429,"2023-11-14T00:00:00.000Z",38017703,21,"Jalen Williams",0,13,16,14,5,14.9
"5455",1187,3,1,7,5,1,10,3,2,2,30,0,2,9,7,2,2,3277429,"2023-11-14T00:00:00.000Z",38017685,21,"Chet Holmgren",3,16,19,12,10,28.9
"5456",1188,7,2,6,2,0,11,7,5,4,25,1,0,18,7,0,3,3277429,"2023-11-14T00:00:00.000Z",17896065,21,"Josh Giddey",2,25,32,25,14,39.9
"5457",1189,5,0,5,4,1,16,10,7,7,28,1,2,28,6,7,2,3277429,"2023-11-14T00:00:00.000Z",175,21,"Shai Gilgeous-Alexander",7,34,39,33,11,61.7
"5458",1190,1,0,2,3,2,5,3,0,0,14,0,1,8,2,2,0,3277429,"2023-11-14T00:00:00.000Z",3547272,21,"Isaiah Joe",2,10,11,9,3,17.9
"5459",1191,3,2,4,1,1,5,4,0,0,21,1,1,9,5,2,1,3277429,"2023-11-14T00:00:00.000Z",56677833,21,"Cason Wallace",4,14,17,12,8,30.5
"5460",1192,4,0,1,3,2,4,2,4,2,19,0,1,8,1,1,2,3277429,"2023-11-14T00:00:00.000Z",4197029,21,"Vasilije Micic",1,9,13,12,5,16.2
"5461",1193,2,0,2,3,1,4,2,0,0,8,0,0,5,2,1,1,3277429,"2023-11-14T00:00:00.000Z",17896036,21,"Tre Mann",1,7,9,7,4,12.4
"5462",1194,1,0,1,1,0,1,0,0,0,5,0,0,0,1,0,0,3277429,"2023-11-14T00:00:00.000Z",3547271,21,"Aleksej Pokusevski",0,1,2,1,2,2.7
"5463",1195,0,0,0,0,0,0,0,0,0,0,0,0,0,0,0,0,3277429,"2023-11-14T00:00:00.000Z",44,21,"Davis Bertans",0,0,0,0,0,0
"5464",1196,0,0,0,3,1,3,1,2,2,8,0,2,5,0,0,0,3277426,"2023-11-14T00:00:00.000Z",38017689,1,"AJ Griffin",0,5,5,5,0,5
"5465",1197,2,1,6,0,0,4,4,0,0,21,3,5,8,9,0,2,3277426,"2023-11-14T00:00:00.000Z",3547244,1,"Onyeka Okongwu",1,17,19,10,11,22.8
"5466",1198,0,0,1,1,1,1,1,0,0,2,0,0,3,1,0,0,3277426,"2023-11-14T00:00:00.000Z",666754,1,"Garrison Mathews",0,4,4,3,1,4.2
"5467",1199,0,0,0,0,0,0,0,0,0,0,0,0,0,0,0,0,3277426,"2023-11-14T00:00:00.000Z",301,1,"Wesley Matthews",0,0,0,0,0,0
"5468",1200,0,0,0,0,0,0,0,0,0,0,0,0,0,0,0,0,3277426,"2023-11-14T00:00:00.000Z",319,1,"Patty Mills",0,0,0,0,0,0
"5469",1201,0,0,0,0,0,0,0,0,0,0,0,0,0,0,0,0,7049322,"2023-12-06T00:00:00.000Z",666476,25,"Moses Brown",0,0,0,0,0,0
"5470",1202,0,0,0,0,0,0,0,0,0,0,0,0,0,0,0,0,7049322,"2023-12-06T00:00:00.000Z",3547289,25,"Skylar Mays",0,0,0,0,0,0
"5471",1203,0,0,0,0,0,0,0,0,0,0,0,0,0,0,0,0,7049322,"2023-12-06T00:00:00.000Z",56677829,25,"Rayan Rupert",0,0,0,0,0,0
"5472",1204,0,0,0,0,0,0,0,0,0,0,0,0,0,0,0,0,7049322,"2023-12-06T00:00:00.000Z",22,25,"Deandre Ayton",0,0,0,0,0,0
"5473",1205,0,0,0,0,0,0,0,0,0,0,0,0,0,0,0,0,7049322,"2023-12-06T00:00:00.000Z",182,25,"Jerami Grant",0,0,0,0,0,0
"5474",1206,0,0,0,0,0,0,0,0,0,0,0,0,0,0,0,0,7049322,"2023-12-06T00:00:00.000Z",47957121,25,"Justin Minaya",0,0,0,0,0,0
"5475",1207,3,0,1,3,1,4,1,0,0,34,0,1,3,1,1,0,7049323,"2023-12-06T00:00:00.000Z",81,8,"Kentavious Caldwell-Pope",1,4,7,6,4,11.7
"5476",1208,6,1,0,7,2,18,10,1,1,29,0,4,23,0,1,1,7049323,"2023-12-06T00:00:00.000Z",335,8,"Jamal Murray",2,23,29,29,6,37
"5477",1209,4,0,6,5,4,13,7,2,2,30,1,2,20,7,2,4,7981414,"2023-12-07T00:00:00.000Z",315,17,"Khris Middleton",2,27,31,24,11,36.4
"5478",1210,2,2,9,1,0,19,13,13,11,41,1,3,37,10,0,1,7981414,"2023-12-07T00:00:00.000Z",15,17,"Giannis Antetokounmpo",2,47,49,39,12,57
"5479",1211,2,4,4,10,3,17,7,3,1,37,2,5,18,6,0,1,7981414,"2023-12-07T00:00:00.000Z",283,17,"Brook Lopez",4,24,26,20,8,39.2
"5480",1212,1,0,2,4,1,9,3,0,0,36,1,2,7,3,0,0,7981414,"2023-12-07T00:00:00.000Z",38,17,"Malik Beasley",0,10,11,8,4,12.1
"5481",1213,7,1,7,9,4,20,7,6,6,42,0,2,24,7,1,3,7981414,"2023-12-07T00:00:00.000Z",278,17,"Damian Lillard",2,31,38,31,14,45.9
"5482",1214,1,1,2,1,0,5,2,0,0,18,4,2,4,6,0,1,7981414,"2023-12-07T00:00:00.000Z",377,17,"Bobby Portis",1,10,11,5,7,14.7
"5483",1215,0,0,0,0,0,0,0,0,0,0,0,0,0,0,0,0,7049322,"2023-12-06T00:00:00.000Z",17896120,25,"Ish Wainright",0,0,0,0,0,0
"5484",1216,0,1,3,0,0,3,2,4,1,15,3,0,5,6,0,0,7981414,"2023-12-07T00:00:00.000Z",38017676,17,"MarJon Beauchamp",1,11,11,5,6,15.2
"5485",1217,0,0,0,0,0,1,0,0,0,4,0,0,0,0,0,0,7981414,"2023-12-07T00:00:00.000Z",38017733,17,"A.J. Green",0,0,0,0,0,0
"5486",1218,2,0,1,3,0,9,2,0,0,16,0,0,4,1,0,2,7981414,"2023-12-07T00:00:00.000Z",368,17,"Cameron Payne",0,5,7,6,3,6.2
"5487",1219,0,0,0,0,0,0,0,0,0,1,0,1,0,0,0,0,7981414,"2023-12-07T00:00:00.000Z",56677852,17,"Andre Jackson Jr.",0,0,0,0,0,0
"5488",1220,0,0,0,0,0,0,0,0,0,0,0,0,0,0,0,0,7981414,"2023-12-07T00:00:00.000Z",2148,17,"Thanasis Antetokounmpo",0,0,0,0,0,0
"5489",1221,0,0,0,0,0,0,0,0,0,0,0,0,0,0,0,0,7981414,"2023-12-07T00:00:00.000Z",56677854,17,"Chris Livingston",0,0,0,0,0,0
"5490",1222,0,0,0,0,0,0,0,0,0,0,0,0,0,0,0,0,7981414,"2023-12-07T00:00:00.000Z",284,17,"Robin Lopez",0,0,0,0,0,0
"5491",1223,0,0,0,0,0,0,0,0,0,0,0,0,0,0,0,0,7981414,"2023-12-07T00:00:00.000Z",38017691,17,"TyTy Washington Jr.",0,0,0,0,0,0
"5492",1224,0,0,0,0,0,0,0,0,0,0,0,0,0,0,0,0,7981414,"2023-12-07T00:00:00.000Z",666960,17,"Lindell Wigginton",0,0,0,0,0,0
"5493",1225,0,0,0,0,0,0,0,0,0,0,0,0,0,0,0,0,7981414,"2023-12-07T00:00:00.000Z",666453,17,"Marques Bolden",0,0,0,0,0,0
"5494",1226,0,0,5,4,0,11,4,2,1,25,1,1,9,6,0,3,1038020,"2023-12-28T00:00:00.000Z",666950,4,"P.J. Washington",0,15,15,9,6,13.2
"5495",1227,4,0,3,0,0,4,3,0,0,14,0,1,6,3,1,1,1038020,"2023-12-28T00:00:00.000Z",422,4,"Ish Smith",1,9,13,10,7,17.6
"5496",1228,4,1,3,2,2,4,2,0,0,18,0,1,6,3,0,2,1038020,"2023-12-28T00:00:00.000Z",56677846,4,"Nick Smith Jr.",1,9,13,10,7,16.6
"5497",1230,1,0,2,1,1,3,2,0,0,6,0,0,5,2,0,0,1038020,"2023-12-28T00:00:00.000Z",17896037,4,"James Bouknight",0,7,8,6,3,8.9
"5498",1231,1,0,0,1,1,1,1,0,0,6,0,0,3,0,0,0,1038020,"2023-12-28T00:00:00.000Z",18678001,4,"JT Thor",0,3,4,4,1,4.5
"5499",1232,0,0,0,0,0,0,0,0,0,0,0,0,0,0,0,0,1038020,"2023-12-28T00:00:00.000Z",56677848,4,"Amari Bailey",0,0,0,0,0,0
"5500",1233,0,1,1,1,0,1,0,2,2,14,0,0,2,1,2,1,1038019,"2023-12-28T00:00:00.000Z",38017649,27,"Julian Champagnie",3,3,3,2,1,11.2
"5501",1234,6,1,11,5,3,18,9,4,0,34,2,2,21,13,1,1,1038022,"2023-12-29T00:00:00.000Z",3547242,30,"Deni Avdija",2,34,40,27,19,50.6
"5502",1235,2,1,7,10,4,22,11,0,0,31,1,1,26,8,0,2,1038022,"2023-12-29T00:00:00.000Z",265,30,"Kyle Kuzma",1,34,36,28,10,39.6
"5503",1236,0,0,0,0,0,0,0,0,0,0,0,0,0,0,0,0,1038020,"2023-12-28T00:00:00.000Z",3547239,4,"LaMelo Ball",0,0,0,0,0,0
"5504",1237,0,0,0,0,0,0,0,0,0,0,0,0,0,0,0,0,1038020,"2023-12-28T00:00:00.000Z",56677866,4,"Leaky Black",0,0,0,0,0,0
"5505",1238,0,0,0,0,0,0,0,0,0,0,0,0,0,0,0,0,1038020,"2023-12-28T00:00:00.000Z",204,4,"Gordon Hayward",0,0,0,0,0,0
"5506",1239,0,0,0,0,0,0,0,0,0,0,0,0,0,0,0,0,1038020,"2023-12-28T00:00:00.000Z",347,4,"Frank Ntilikina",0,0,0,0,0,0
"5507",1240,0,0,0,0,0,0,0,0,0,0,0,0,0,0,0,0,1038020,"2023-12-28T00:00:00.000Z",38017698,4,"Mark Williams",0,0,0,0,0,0
"5508",1241,0,0,4,0,0,4,1,2,2,17,1,4,4,5,1,1,1038022,"2023-12-29T00:00:00.000Z",666577,30,"Daniel Gafford",1,9,9,4,5,12
"5509",1242,5,0,0,4,1,6,2,0,0,25,0,4,5,0,0,1,1038022,"2023-12-29T00:00:00.000Z",666848,30,"Jordan Poole",0,5,10,10,5,11.5
"5510",1243,6,0,3,0,0,9,6,0,0,31,1,0,12,4,0,0,1038022,"2023-12-29T00:00:00.000Z",249,30,"Tyus Jones",0,16,22,18,10,25.8
"5511",1244,2,0,4,0,0,3,2,0,0,19,2,3,4,6,0,1,1038022,"2023-12-29T00:00:00.000Z",56677844,30,"Bilal Coulibaly",0,10,12,6,8,13.2
"5512",1245,0,0,0,0,0,0,0,0,0,0,0,0,0,0,0,0,1038022,"2023-12-29T00:00:00.000Z",38017704,30,"Patrick Baldwin Jr.",0,0,0,0,0,0
"5513",1246,0,0,0,0,0,0,0,0,0,0,0,0,0,0,0,0,1038022,"2023-12-29T00:00:00.000Z",18677954,30,"Jared Butler",0,0,0,0,0,0
"5514",1247,0,0,0,0,0,0,0,0,0,0,0,0,0,0,0,0,1038022,"2023-12-29T00:00:00.000Z",38017687,30,"Johnny Davis",0,0,0,0,0,0
"5515",1248,6,0,9,6,5,16,11,5,4,41,1,4,31,10,0,7,1038024,"2023-12-29T00:00:00.000Z",70,2,"Jaylen Brown",0,41,47,37,16,45
"5516",1249,1,1,9,7,3,7,3,0,0,34,0,2,9,9,0,0,1038024,"2023-12-29T00:00:00.000Z",17896060,2,"Sam Hauser",1,18,19,10,10,24.3
"5517",1250,3,3,3,0,0,11,9,2,2,33,5,3,20,8,0,1,1038024,"2023-12-29T00:00:00.000Z",261,2,"Luke Kornet",3,28,31,23,11,42.1
"5518",1251,4,0,5,6,3,15,9,0,0,26,0,0,21,5,0,2,1037635,"2023-10-30T00:00:00.000Z",265,30,"Kyle Kuzma",0,26,30,25,9,31
"5519",1252,0,0,0,0,0,0,0,0,0,0,0,0,0,0,0,0,1037635,"2023-10-30T00:00:00.000Z",666577,30,"Daniel Gafford",0,0,0,0,0,0
"5520",1253,0,0,0,0,0,0,0,0,0,0,0,0,0,0,0,0,1037635,"2023-10-30T00:00:00.000Z",414,30,"Landry Shamet",0,0,0,0,0,0
"5521",1254,2,1,6,13,8,24,13,4,2,31,0,3,36,6,3,0,1037635,"2023-10-30T00:00:00.000Z",70,2,"Jaylen Brown",4,42,44,38,8,58.2
"5522",1255,3,0,6,9,4,21,14,1,1,28,0,2,33,6,0,2,1037635,"2023-10-30T00:00:00.000Z",434,2,"Jayson Tatum",0,39,42,36,9,42.7
"5523",1256,3,1,6,2,1,9,7,0,0,24,0,2,15,6,0,2,1037635,"2023-10-30T00:00:00.000Z",378,2,"Kristaps Porzingis",1,21,24,18,9,27.7
"5524",1257,8,1,0,2,1,3,2,0,0,24,1,1,5,1,2,2,1037635,"2023-10-30T00:00:00.000Z",473,2,"Derrick White",3,6,14,13,9,25.2
"5525",1258,3,2,4,3,1,7,4,2,2,27,1,1,11,5,1,1,1037635,"2023-10-30T00:00:00.000Z",214,2,"Jrue Holiday",3,16,19,14,8,29.5
"5526",1259,6,0,6,6,0,8,0,0,0,25,1,3,0,7,1,4,1037635,"2023-10-30T00:00:00.000Z",3547276,2,"Payton Pritchard",1,7,13,6,13,16.4
"5527",1260,1,0,1,3,0,9,4,0,0,15,4,1,8,5,2,0,1037635,"2023-10-30T00:00:00.000Z",219,2,"Al Horford",2,13,14,9,6,21.5
"5528",1261,1,1,5,9,2,10,3,0,0,25,3,3,8,8,0,1,1037635,"2023-10-30T00:00:00.000Z",17896060,2,"Sam Hauser",1,16,17,9,9,21.1
"5529",1262,1,0,1,2,0,4,0,0,0,10,1,2,0,2,1,0,1037635,"2023-10-30T00:00:00.000Z",666468,2,"Oshae Brissett",1,2,3,1,3,6.9
"5530",1263,1,0,0,1,0,3,1,0,0,10,2,1,2,2,0,1,1037635,"2023-10-30T00:00:00.000Z",17896094,2,"Dalano Banton",0,4,5,3,3,4.9
"5531",1264,1,0,1,0,0,0,0,0,0,11,0,1,0,1,0,2,1037635,"2023-10-30T00:00:00.000Z",261,2,"Luke Kornet",0,1,2,1,2,0.7
"5532",1265,0,0,0,1,1,2,2,0,0,5,2,1,5,2,0,3,1037635,"2023-10-30T00:00:00.000Z",3547279,2,"Lamar Stevens",0,7,7,5,2,4.4
"5533",1266,1,0,0,2,1,2,1,0,0,5,0,0,3,0,1,0,1037635,"2023-10-30T00:00:00.000Z",338,2,"Svi Mykhailiuk",1,3,4,4,1,7.5
"5534",1267,0,0,0,0,0,0,0,0,0,0,0,0,0,0,0,0,1037635,"2023-10-30T00:00:00.000Z",56677864,2,"Jordan Walsh",0,0,0,0,0,0
"5535",1268,0,0,0,0,0,0,0,0,0,0,0,0,0,0,0,0,1037635,"2023-10-30T00:00:00.000Z",38017707,2,"JD Davison",0,0,0,0,0,0
"5536",1269,0,0,0,0,0,0,0,0,0,0,0,0,0,0,0,0,1037635,"2023-10-30T00:00:00.000Z",3547295,2,"Nathan Knight",0,0,0,0,0,0
"5537",1270,0,0,0,0,0,0,0,0,0,0,0,0,0,0,0,0,1037635,"2023-10-30T00:00:00.000Z",17553967,2,"Neemias Queta",0,0,0,0,0,0
"5538",1271,1,2,2,0,0,1,1,2,2,13,0,2,4,2,1,1,1037633,"2023-10-30T00:00:00.000Z",3547282,4,"Nick Richards",3,6,7,5,3,15.9
"5539",1272,3,0,2,4,1,6,3,0,0,19,0,1,7,2,0,1,1037633,"2023-10-30T00:00:00.000Z",18678001,4,"JT Thor",0,9,12,10,5,12.9
"5540",1273,2,1,5,5,2,16,7,6,6,36,4,3,22,9,0,0,1037633,"2023-10-30T00:00:00.000Z",56677823,4,"Brandon Miller",1,31,33,24,11,38.8
"5541",1274,0,0,0,0,0,0,0,0,0,0,0,0,0,0,0,0,1037633,"2023-10-30T00:00:00.000Z",56677846,4,"Nick Smith Jr.",0,0,0,0,0,0
"5542",1275,0,0,0,0,0,0,0,0,0,0,0,0,0,0,0,0,1037633,"2023-10-30T00:00:00.000Z",17896037,4,"James Bouknight",0,0,0,0,0,0
"5543",1276,2,0,2,4,2,5,2,0,0,17,0,1,6,2,1,1,1037788,"2023-11-20T00:00:00.000Z",368,17,"Cameron Payne",1,8,10,8,4,13.4
"5544",1277,2,0,5,3,0,6,1,0,0,21,0,1,2,5,0,0,1037789,"2023-11-20T00:00:00.000Z",666747,16,"Caleb Martin",0,7,9,4,7,11
"5545",1278,0,0,0,0,0,0,0,0,0,1,0,2,0,0,0,0,1037788,"2023-11-20T00:00:00.000Z",284,17,"Robin Lopez",0,0,0,0,0,0
"5546",1279,0,0,0,0,0,0,0,0,0,1,0,0,0,0,0,0,1037788,"2023-11-20T00:00:00.000Z",2148,17,"Thanasis Antetokounmpo",0,0,0,0,0,0
"5547",1280,0,0,0,0,0,0,0,0,0,1,1,0,0,1,0,0,1037788,"2023-11-20T00:00:00.000Z",56677852,17,"Andre Jackson Jr.",0,1,1,0,1,1.2
"5548",1281,0,0,0,0,0,0,0,0,0,0,0,0,0,0,0,0,1037788,"2023-11-20T00:00:00.000Z",38017676,17,"MarJon Beauchamp",0,0,0,0,0,0
"5549",1282,1,0,3,3,2,9,7,1,1,22,1,4,17,4,0,0,1037792,"2023-11-20T00:00:00.000Z",359,27,"Cedi Osman",0,21,22,18,5,23.3
"5550",1283,2,0,2,3,1,3,1,0,0,14,0,1,3,2,0,0,1037792,"2023-11-20T00:00:00.000Z",305,27,"Doug McDermott",0,5,7,5,4,8.4
"5551",1284,0,0,0,0,0,0,0,0,0,0,0,0,0,0,0,0,1037792,"2023-11-20T00:00:00.000Z",56677870,27,"Sir'Jabari Rice",0,0,0,0,0,0
"5552",1285,0,0,0,0,0,0,0,0,0,0,0,0,0,0,0,0,1037792,"2023-11-20T00:00:00.000Z",56677865,27,"Charles Bediako",0,0,0,0,0,0
"5553",1286,0,0,0,0,0,0,0,0,0,0,0,0,0,0,0,0,1037792,"2023-11-20T00:00:00.000Z",3547246,27,"Devin Vassell",0,0,0,0,0,0
"5554",1287,0,0,0,0,0,0,0,0,0,0,0,0,0,0,0,0,1037792,"2023-11-20T00:00:00.000Z",38017693,27,"Blake Wesley",0,0,0,0,0,0
"5555",1288,3,0,2,6,2,17,8,3,3,28,2,0,21,4,1,0,1037792,"2023-11-20T00:00:00.000Z",274,13,"Kawhi Leonard",1,25,28,24,7,33.3
"5556",1289,0,0,4,6,3,9,4,6,5,30,0,0,16,4,1,0,1037791,"2023-11-20T00:00:00.000Z",30,26,"Harrison Barnes",1,20,20,16,4,23.8
"5557",1290,0,1,1,2,1,4,1,2,2,16,2,2,5,3,1,0,1037791,"2023-11-20T00:00:00.000Z",38017688,26,"Keegan Murray",2,8,8,5,3,14.6
"5558",1291,8,0,5,0,0,8,4,3,2,31,5,4,10,10,0,5,1037791,"2023-11-20T00:00:00.000Z",406,26,"Domantas Sabonis",0,20,28,18,18,29
"5559",1292,3,0,0,8,2,10,4,0,0,23,0,1,10,0,0,0,1037791,"2023-11-20T00:00:00.000Z",221,26,"Kevin Huerter",0,10,13,13,3,14.5
"5560",1293,0,0,2,12,2,18,5,4,2,29,0,1,14,2,1,2,1037791,"2023-11-20T00:00:00.000Z",161,26,"De'Aaron Fox",1,16,16,14,2,17.4
"5561",1294,5,0,0,6,2,11,3,0,0,24,0,2,8,0,0,1,1037791,"2023-11-20T00:00:00.000Z",324,26,"Malik Monk",0,8,13,13,5,14.5
"5562",1295,0,0,2,2,0,2,0,0,0,8,0,1,0,2,0,0,1037791,"2023-11-20T00:00:00.000Z",17896030,26,"Chris Duarte",0,2,2,0,2,2.4
"5563",1296,8,0,0,2,0,2,0,2,2,19,0,1,2,0,0,1,1037791,"2023-11-20T00:00:00.000Z",17553994,26,"Davion Mitchell",0,2,10,10,8,13
"5564",1297,0,0,0,0,0,0,0,0,0,0,0,0,0,0,0,0,1037791,"2023-11-20T00:00:00.000Z",340,19,"Larry Nance Jr.",0,0,0,0,0,0
"5565",1298,0,0,0,0,0,0,0,0,0,0,0,0,0,0,0,0,1037791,"2023-11-20T00:00:00.000Z",38017663,19,"E.J. Liddell",0,0,0,0,0,0
"5566",1299,0,0,0,0,0,0,0,0,0,0,0,0,0,0,0,0,1037791,"2023-11-20T00:00:00.000Z",303,19,"CJ McCollum",0,0,0,0,0,0
"5567",1300,0,0,0,0,0,0,0,0,0,0,0,0,0,0,0,0,1037791,"2023-11-20T00:00:00.000Z",18677986,19,"Trey Murphy III",0,0,0,0,0,0
"5568",1301,0,0,0,0,0,0,0,0,0,0,0,0,0,0,0,0,1037915,"2023-12-14T00:00:00.000Z",297,29,"Lauri Markkanen",0,0,0,0,0,0
"5569",1302,0,0,0,0,0,0,0,0,0,0,0,0,0,0,0,0,1037915,"2023-12-14T00:00:00.000Z",56677842,29,"Brice Sensabaugh",0,0,0,0,0,0
"5570",1303,3,0,2,5,2,9,4,2,2,29,0,4,12,2,0,2,1037917,"2023-12-14T00:00:00.000Z",367,10,"Chris Paul",0,14,17,15,5,16.9
"5571",1304,1,0,6,4,1,5,2,0,0,17,0,2,5,6,0,1,1037917,"2023-12-14T00:00:00.000Z",407,10,"Dario Saric",0,11,12,6,7,12.7
"5572",1305,0,1,1,4,0,9,4,2,1,22,2,5,9,3,0,0,1037917,"2023-12-14T00:00:00.000Z",475,10,"Andrew Wiggins",1,12,12,9,3,15.6
"5573",1306,1,0,3,1,0,6,4,4,3,16,2,1,11,5,1,2,1037917,"2023-12-14T00:00:00.000Z",17553992,10,"Moses Moody",1,16,17,12,6,19.5
"5574",1307,0,0,0,0,0,1,1,1,1,2,0,0,3,0,0,0,1037913,"2023-12-14T00:00:00.000Z",38017715,18,"Josh Minott",0,3,3,3,0,3
"5575",1308,0,0,0,0,0,1,1,0,0,2,0,0,2,0,0,0,1037913,"2023-12-14T00:00:00.000Z",320,18,"Shake Milton",0,2,2,2,0,2
"5576",1309,0,0,0,0,0,0,0,0,0,0,0,0,0,0,0,0,1037913,"2023-12-14T00:00:00.000Z",56677851,18,"Jaylen Clark",0,0,0,0,0,0
"5577",1310,2,0,5,4,1,13,9,2,2,36,0,3,21,5,1,1,1037917,"2023-12-14T00:00:00.000Z",380,13,"Norman Powell",1,26,28,23,7,32
"5578",1311,2,1,4,2,1,7,4,0,0,19,0,0,9,4,0,2,1037917,"2023-12-14T00:00:00.000Z",472,13,"Russell Westbrook",1,13,15,11,6,17.8
"5579",1312,1,1,1,1,0,2,0,4,4,16,0,2,4,1,1,0,1037917,"2023-12-14T00:00:00.000Z",439,13,"Daniel Theis",2,5,6,5,2,12.7
"5580",1313,0,0,0,0,0,0,0,0,0,0,0,0,0,0,0,0,1037917,"2023-12-14T00:00:00.000Z",17896031,13,"Nah'Shon Hyland",0,0,0,0,0,0
"5581",1314,0,0,0,0,0,0,0,0,0,0,0,0,0,0,0,0,1037917,"2023-12-14T00:00:00.000Z",24417679,13,"Xavier Moon",0,0,0,0,0,0
"5582",1315,0,0,0,0,0,0,0,0,0,0,0,0,0,0,0,0,1037917,"2023-12-14T00:00:00.000Z",450,13,"PJ Tucker",0,0,0,0,0,0
"5583",1316,0,0,0,0,0,0,0,0,0,0,0,0,0,0,0,0,1037917,"2023-12-14T00:00:00.000Z",38017725,13,"Moussa Diabate",0,0,0,0,0,0
"5584",1317,0,0,0,0,0,3,1,0,0,5,3,0,2,3,0,0,1037917,"2023-12-14T00:00:00.000Z",56677799,10,"Trayce Jackson-Davis",0,5,5,2,3,5.6
"5585",1318,0,0,0,0,0,0,0,0,0,0,0,0,0,0,0,0,1037916,"2023-12-14T00:00:00.000Z",17895990,26,"Jordan Ford",0,0,0,0,0,0
"5586",1319,0,0,0,0,0,0,0,0,0,0,0,0,0,0,0,0,1037917,"2023-12-14T00:00:00.000Z",172,13,"Paul George",0,0,0,0,0,0
"5587",1320,0,0,0,0,0,0,0,0,0,0,0,0,0,0,0,0,1037916,"2023-12-14T00:00:00.000Z",56677845,26,"Colby Jones",0,0,0,0,0,0
"5588",1321,0,0,0,0,0,0,0,0,0,0,0,0,0,0,0,0,1037916,"2023-12-14T00:00:00.000Z",17553994,26,"Davion Mitchell",0,0,0,0,0,0
"5589",1322,0,0,0,0,0,0,0,0,0,0,0,0,0,0,0,0,1037916,"2023-12-14T00:00:00.000Z",273,26,"Alex Len",0,0,0,0,0,0
"5590",1323,0,1,3,6,3,11,6,0,0,13,2,1,15,5,1,0,1037915,"2023-12-14T00:00:00.000Z",56783340,25,"Duop Reath",2,20,20,15,5,27
"5591",1324,5,0,0,0,0,0,0,0,0,17,1,0,0,1,1,0,1037915,"2023-12-14T00:00:00.000Z",3547289,25,"Skylar Mays",1,1,6,5,6,11.7
"5592",1325,3,1,2,5,2,7,2,0,0,17,3,0,6,5,2,0,1037915,"2023-12-14T00:00:00.000Z",56677791,25,"Kris Murray",3,11,14,9,8,25.5
"5593",1326,0,0,0,0,0,0,0,0,0,0,0,0,0,0,0,0,1038087,"2024-01-06T00:00:00.000Z",313,23,"De'Anthony Melton",0,0,0,0,0,0
"5594",1327,2,0,6,6,1,9,3,0,0,33,1,1,7,7,1,4,1038087,"2024-01-06T00:00:00.000Z",38017739,29,"Simone Fontecchio",1,14,16,9,9,17.4
"5595",1328,1,1,9,9,5,19,12,5,4,35,4,2,33,13,0,1,1038087,"2024-01-06T00:00:00.000Z",297,29,"Lauri Markkanen",1,46,47,34,14,52.1
"5596",1329,2,1,4,0,0,10,9,2,1,28,1,1,19,5,0,1,1038087,"2024-01-06T00:00:00.000Z",101,29,"John Collins",1,24,26,21,7,30
"5597",1330,10,0,2,3,1,14,9,4,3,27,1,3,22,3,0,5,1038087,"2024-01-06T00:00:00.000Z",413,29,"Collin Sexton",0,25,35,32,13,35.6
"5598",1331,1,2,5,1,0,1,0,0,0,23,0,3,0,5,1,1,1038087,"2024-01-06T00:00:00.000Z",139,29,"Kris Dunn",3,5,6,1,6,15.5
"5599",1332,0,0,3,0,0,4,4,2,2,19,1,2,10,4,1,0,1038087,"2024-01-06T00:00:00.000Z",38017705,29,"Walker Kessler",1,14,14,10,4,17.8
"5600",1333,6,0,5,6,0,14,5,9,8,31,0,0,18,5,1,5,1038087,"2024-01-06T00:00:00.000Z",100,29,"Jordan Clarkson",1,23,29,24,11,31
"5601",1334,3,0,2,2,0,4,2,2,2,16,0,2,6,2,0,2,1038087,"2024-01-06T00:00:00.000Z",56677834,29,"Keyonte George",0,8,11,9,5,10.9
"5602",1335,1,0,2,2,0,2,0,0,0,13,1,1,0,3,0,1,1038087,"2024-01-06T00:00:00.000Z",38017620,29,"Ochai Agbaji",0,3,4,1,4,4.1
"5603",1336,4,0,1,1,1,3,2,0,0,15,0,3,5,1,0,3,1038087,"2024-01-06T00:00:00.000Z",358,29,"Kelly Olynyk",0,6,10,9,5,9.2
"5604",1337,0,0,0,0,0,0,0,0,0,0,0,0,0,0,0,0,1038087,"2024-01-06T00:00:00.000Z",666650,29,"Talen Horton-Tucker",0,0,0,0,0,0
"5605",1338,0,0,0,0,0,0,0,0,0,0,0,0,0,0,0,0,1038087,"2024-01-06T00:00:00.000Z",666881,29,"Luka Samanic",0,0,0,0,0,0
"5606",1339,0,0,0,0,0,0,0,0,0,0,0,0,0,0,0,0,1038087,"2024-01-06T00:00:00.000Z",11891374,29,"Omer Yurtseven",0,0,0,0,0,0
"5607",1340,0,0,0,0,0,0,0,0,0,0,0,0,0,0,0,0,1038087,"2024-01-06T00:00:00.000Z",17896023,29,"Josh Christopher",0,0,0,0,0,0
"5608",1341,0,0,0,0,0,0,0,0,0,0,0,0,0,0,0,0,1038087,"2024-01-06T00:00:00.000Z",56677824,29,"Taylor Hendricks",0,0,0,0,0,0
"5609",1342,0,0,0,0,0,0,0,0,0,0,0,0,0,0,0,0,1038087,"2024-01-06T00:00:00.000Z",38017630,29,"Johnny Juzang",0,0,0,0,0,0
"5610",1343,0,0,0,0,0,0,0,0,0,0,0,0,0,0,0,0,1038089,"2024-01-07T00:00:00.000Z",666676,6,"Ty Jerome",0,0,0,0,0,0
"5611",1344,0,0,0,0,0,0,0,0,0,0,0,0,0,0,0,0,1038089,"2024-01-07T00:00:00.000Z",17896076,6,"Evan Mobley",0,0,0,0,0,0
"5612",1345,0,0,0,0,0,0,0,0,0,0,0,0,0,0,0,0,1038089,"2024-01-07T00:00:00.000Z",38017662,6,"Isaiah Mobley",0,0,0,0,0,0
"5613",1346,1,0,2,2,0,2,0,2,2,16,0,0,2,2,1,1,1038089,"2024-01-07T00:00:00.000Z",38017649,27,"Julian Champagnie",1,4,5,3,3,7.9
"5614",1347,4,0,4,5,2,9,4,1,1,28,1,2,11,5,0,1,1038089,"2024-01-07T00:00:00.000Z",38017699,27,"Jeremy Sochan",0,16,20,15,9,22
"5615",1348,3,5,9,5,2,13,6,11,10,25,0,3,24,9,1,3,1038089,"2024-01-07T00:00:00.000Z",56677822,27,"Victor Wembanyama",6,33,36,27,12,54.3
"5616",1349,2,0,3,9,4,19,9,0,0,35,0,2,22,3,3,0,1038089,"2024-01-07T00:00:00.000Z",3547246,27,"Devin Vassell",3,25,27,24,5,37.6
"5617",1350,5,0,2,2,2,8,7,2,2,34,0,1,18,2,2,2,1038089,"2024-01-07T00:00:00.000Z",3547274,27,"Tre Jones",2,20,25,23,7,31.9
"5618",1351,0,0,0,0,0,0,0,0,0,0,0,0,0,0,0,0,1037703,"2023-11-08T00:00:00.000Z",38017736,16,"Cole Swider",0,0,0,0,0,0
"5619",1352,0,0,0,0,0,0,0,0,0,0,0,0,0,0,0,0,1037705,"2023-11-08T00:00:00.000Z",666767,18,"Jordan McLaughlin",0,0,0,0,0,0
"5620",1353,0,0,0,0,0,0,0,0,0,0,0,0,0,0,0,0,1037705,"2023-11-08T00:00:00.000Z",56677782,18,"Leonard Miller",0,0,0,0,0,0
"5621",1354,0,0,0,0,0,0,0,0,0,0,0,0,0,0,0,0,1037705,"2023-11-08T00:00:00.000Z",38017700,18,"Wendell Moore Jr.",0,0,0,0,0,0
"5622",1355,1,0,1,0,0,2,1,0,0,7,2,2,2,3,0,1,1037707,"2023-11-08T00:00:00.000Z",217,7,"Richaun Holmes",0,5,6,3,4,6.1
"5623",1356,0,0,0,0,0,0,0,0,0,0,0,0,0,0,0,0,1037707,"2023-11-08T00:00:00.000Z",329,7,"Markieff Morris",0,0,0,0,0,0
"5624",1357,0,0,0,0,0,0,0,0,0,0,0,0,0,0,0,0,1037707,"2023-11-08T00:00:00.000Z",56677859,7,"Olivier-Maxence Prosper",0,0,0,0,0,0
"5625",1358,0,0,0,0,0,0,0,0,0,0,0,0,0,0,0,0,1037707,"2023-11-08T00:00:00.000Z",17896028,7,"Greg Brown III",0,0,0,0,0,0
"5626",1359,0,0,0,0,0,0,0,0,0,0,0,0,0,0,0,0,1037707,"2023-11-08T00:00:00.000Z",56677873,7,"Dexter Dennis",0,0,0,0,0,0
"5627",1360,0,0,0,0,0,0,0,0,0,0,0,0,0,0,0,0,1037707,"2023-11-08T00:00:00.000Z",17554004,7,"AJ Lawson",0,0,0,0,0,0
"5628",1361,0,0,0,0,0,0,0,0,0,0,0,0,0,0,0,0,1037707,"2023-11-08T00:00:00.000Z",56677840,7,"Dereck Lively II",0,0,0,0,0,0
"5629",1362,2,0,4,8,3,17,9,6,5,36,1,4,26,5,0,2,1037707,"2023-11-08T00:00:00.000Z",18,28,"OG Anunoby",0,31,33,28,7,33
"5630",1363,5,0,8,5,0,25,15,4,1,37,4,2,31,12,0,3,1037707,"2023-11-08T00:00:00.000Z",416,28,"Pascal Siakam",0,43,48,36,17,49.9
"5631",1364,3,0,3,0,0,5,2,1,0,21,3,4,4,6,2,1,1037707,"2023-11-08T00:00:00.000Z",373,28,"Jakob Poeltl",2,10,13,7,9,20.7
"5632",1365,6,0,3,6,1,25,11,1,1,32,0,1,24,3,0,2,1037705,"2023-11-08T00:00:00.000Z",227,19,"Brandon Ingram",0,27,33,30,9,34.6
"5633",1366,1,0,6,2,1,7,3,4,4,28,3,2,11,9,0,2,1037705,"2023-11-08T00:00:00.000Z",17896021,19,"Jeremiah Robinson-Earl",0,20,21,12,10,21.3
"5634",1367,0,0,5,2,0,9,4,0,0,22,1,1,8,6,0,0,1037705,"2023-11-08T00:00:00.000Z",455,19,"Jonas Valanciunas",0,14,14,8,6,15.2
"5635",1368,5,0,2,3,1,10,3,0,0,31,1,2,7,3,4,3,1037705,"2023-11-08T00:00:00.000Z",38017677,19,"Dyson Daniels",4,10,15,12,8,27.1
"5636",1369,1,0,1,5,2,11,4,4,4,30,0,5,14,1,0,2,1037705,"2023-11-08T00:00:00.000Z",56677837,19,"Jordan Hawkins",0,15,16,15,2,14.7
"5637",1370,2,1,7,3,2,14,10,5,2,25,1,0,24,8,2,0,1037702,"2023-11-08T00:00:00.000Z",666609,14,"Rui Hachimura",3,32,34,26,10,45.6
"5638",1371,0,0,0,0,0,0,0,0,0,0,0,0,0,0,0,0,1037707,"2023-11-08T00:00:00.000Z",489,28,"Thaddeus Young",0,0,0,0,0,0
"5639",1372,0,0,0,0,0,0,0,0,0,0,0,0,0,0,0,0,1037707,"2023-11-08T00:00:00.000Z",3547249,28,"Precious Achiuwa",0,0,0,0,0,0
"5640",1373,0,0,0,0,0,0,0,0,0,0,0,0,0,0,0,0,1037707,"2023-11-08T00:00:00.000Z",56677805,28,"Javon Freeman-Liberty",0,0,0,0,0,0
"5641",1374,0,0,0,0,0,0,0,0,0,0,0,0,0,0,0,0,1037707,"2023-11-08T00:00:00.000Z",38017717,28,"Ron Harper Jr.",0,0,0,0,0,0
"5642",1375,0,0,0,0,0,0,0,0,0,0,0,0,0,0,0,0,1037707,"2023-11-08T00:00:00.000Z",38017710,28,"Christian Koloko",0,0,0,0,0,0
"5643",1376,2,0,6,5,2,6,2,0,0,25,1,1,6,7,0,0,1037879,"2023-12-02T00:00:00.000Z",3547272,21,"Isaiah Joe",0,13,15,8,9,17.4
"5644",1377,1,0,1,3,3,3,3,6,6,11,0,3,15,1,1,0,1037879,"2023-12-02T00:00:00.000Z",44,21,"Davis Bertans",1,16,17,16,2,20.7
"5645",1378,0,1,2,2,0,5,1,0,0,12,1,3,2,3,0,0,1037881,"2023-12-02T00:00:00.000Z",666881,29,"Luka Samanic",1,5,5,2,3,8.6
"5646",1379,0,0,0,0,0,0,0,0,0,0,0,0,0,0,0,0,1037881,"2023-12-02T00:00:00.000Z",38017630,29,"Johnny Juzang",0,0,0,0,0,0
"5647",1380,0,0,0,0,0,0,0,0,0,0,0,0,0,0,0,0,1037881,"2023-12-02T00:00:00.000Z",19465584,29,"Micah Potter",0,0,0,0,0,0
"5648",1381,1,0,0,1,0,2,0,2,2,14,1,2,2,1,0,0,1037879,"2023-12-02T00:00:00.000Z",56677859,7,"Olivier-Maxence Prosper",0,3,4,3,2,4.7
"5649",1382,0,0,0,0,0,0,0,0,0,0,0,0,0,0,0,0,1037879,"2023-12-02T00:00:00.000Z",151,7,"Dante Exum",0,0,0,0,0,0
"5650",1383,0,0,0,0,0,0,0,0,0,0,0,0,0,0,0,0,1037879,"2023-12-02T00:00:00.000Z",3547258,7,"Josh Green",0,0,0,0,0,0
"5651",1384,0,0,0,0,0,0,0,0,0,0,0,0,0,0,0,0,1037879,"2023-12-02T00:00:00.000Z",191,7,"Tim Hardaway Jr.",0,0,0,0,0,0
"5652",1385,5,1,4,8,1,12,3,0,0,35,1,2,7,5,0,2,1037881,"2023-12-02T00:00:00.000Z",38017739,29,"Simone Fontecchio",1,12,17,12,10,21.5
"5653",1386,3,3,7,4,1,14,6,6,5,35,2,2,18,9,1,2,1037881,"2023-12-02T00:00:00.000Z",101,29,"John Collins",4,27,30,21,12,43.3
"5654",1387,4,1,11,1,0,8,4,1,1,27,4,3,9,15,1,1,1037881,"2023-12-02T00:00:00.000Z",11891374,29,"Omer Yurtseven",2,24,28,13,19,38
"5655",1388,0,0,2,0,0,4,3,0,0,26,0,2,6,2,0,2,1037881,"2023-12-02T00:00:00.000Z",38017620,29,"Ochai Agbaji",0,8,8,6,2,6.4
"5656",1389,6,0,4,8,1,17,7,8,5,36,2,2,20,6,0,4,1037881,"2023-12-02T00:00:00.000Z",56677834,29,"Keyonte George",0,26,32,26,12,32.2
"5657",1390,0,2,4,0,0,6,6,0,0,25,4,1,12,8,0,2,1037881,"2023-12-02T00:00:00.000Z",38017705,29,"Walker Kessler",2,20,20,12,8,25.6
"5658",1391,0,2,1,4,1,7,2,0,0,18,1,1,5,2,0,0,1037881,"2023-12-02T00:00:00.000Z",56677824,29,"Taylor Hendricks",2,7,7,5,2,13.4
"5659",1392,0,0,0,0,0,0,0,0,0,0,0,0,0,0,0,0,1037879,"2023-12-02T00:00:00.000Z",228,7,"Kyrie Irving",0,0,0,0,0,0
"5660",1393,0,0,0,0,0,0,0,0,0,0,0,0,0,0,0,0,1037879,"2023-12-02T00:00:00.000Z",257,7,"Maxi Kleber",0,0,0,0,0,0
"5661",1394,3,0,4,6,1,13,4,2,1,32,1,4,10,5,0,2,1037879,"2023-12-02T00:00:00.000Z",666541,21,"Luguentz Dort",0,15,18,13,8,18.5
"5662",1395,4,0,2,5,3,8,5,2,1,21,0,3,14,2,3,1,1037881,"2023-12-02T00:00:00.000Z",666650,29,"Talen Horton-Tucker",3,16,20,18,6,30.4
"5663",1396,0,0,0,0,0,0,0,0,0,0,0,0,0,0,0,0,1037881,"2023-12-02T00:00:00.000Z",139,29,"Kris Dunn",0,0,0,0,0,0
"5664",1397,0,0,0,0,0,0,0,0,0,0,0,0,0,0,0,0,1037881,"2023-12-02T00:00:00.000Z",297,29,"Lauri Markkanen",0,0,0,0,0,0
"5665",1398,0,0,0,0,0,0,0,0,0,0,0,0,0,0,0,0,1037881,"2023-12-02T00:00:00.000Z",358,29,"Kelly Olynyk",0,0,0,0,0,0
"5666",1399,0,1,1,3,0,8,4,0,0,30,2,4,8,3,4,0,1037881,"2023-12-02T00:00:00.000Z",56677850,25,"Toumani Camara",5,11,11,8,3,26.6
"5667",1400,0,1,3,5,0,9,1,7,7,26,0,2,9,3,0,3,1037881,"2023-12-02T00:00:00.000Z",182,25,"Jerami Grant",1,12,12,9,3,12.6
"5668",1401,0,0,0,0,0,0,0,0,0,0,0,0,0,0,0,0,1037996,"2023-12-25T00:00:00.000Z",74,16,"Thomas Bryant",0,0,0,0,0,0
"5669",1402,0,0,0,0,0,0,0,0,0,0,0,0,0,0,0,0,1037996,"2023-12-25T00:00:00.000Z",38017696,16,"Nikola Jovic",0,0,0,0,0,0
"5670",1403,0,0,1,3,0,4,0,0,0,11,0,1,0,1,0,0,1037996,"2023-12-25T00:00:00.000Z",328,23,"Marcus Morris",0,1,1,0,1,1.2
"5671",1404,2,0,5,3,3,8,7,2,1,25,1,2,18,6,2,1,1037996,"2023-12-25T00:00:00.000Z",28,23,"Mo Bamba",2,24,26,20,8,33.2
"5672",1405,0,0,3,3,1,4,2,4,4,13,0,2,9,3,0,2,1037996,"2023-12-25T00:00:00.000Z",45,23,"Patrick Beverley",0,12,12,9,3,10.6
"5673",1406,0,0,0,2,0,3,0,2,1,6,0,0,1,0,1,1,1037996,"2023-12-25T00:00:00.000Z",2175,23,"Danuel House Jr.",1,1,1,1,0,3
"5674",1407,1,0,0,0,0,1,1,0,0,6,0,0,2,0,1,0,1037996,"2023-12-25T00:00:00.000Z",3547294,23,"Kenyon Martin Jr.",1,2,3,3,1,6.5
"5675",1408,0,0,0,0,0,0,0,0,0,1,0,0,0,0,0,0,1037996,"2023-12-25T00:00:00.000Z",17896025,23,"Jaden Springer",0,0,0,0,0,0
"5676",1409,0,0,0,0,0,0,0,0,0,0,0,0,0,0,0,0,1037996,"2023-12-25T00:00:00.000Z",108,23,"Robert Covington",0,0,0,0,0,0
"5677",1410,0,0,0,0,0,0,0,0,0,0,0,0,0,0,0,0,1037996,"2023-12-25T00:00:00.000Z",260,23,"Furkan Korkmaz",0,0,0,0,0,0
"5678",1411,0,0,0,0,0,0,0,0,0,0,0,0,0,0,0,0,1037996,"2023-12-25T00:00:00.000Z",38017732,23,"Kenneth Lofton Jr.",0,0,0,0,0,0
"5679",1412,0,0,0,0,0,0,0,0,0,0,0,0,0,0,0,0,1037996,"2023-12-25T00:00:00.000Z",33,23,"Nicolas Batum",0,0,0,0,0,0
"5680",1413,0,0,0,0,0,0,0,0,0,0,0,0,0,0,0,0,1037996,"2023-12-25T00:00:00.000Z",56913527,23,"Ricky Council IV",0,0,0,0,0,0
"5681",1414,0,0,0,0,0,0,0,0,0,0,0,0,0,0,0,0,1037996,"2023-12-25T00:00:00.000Z",145,23,"Joel Embiid",0,0,0,0,0,0
"5682",1415,0,0,0,0,0,0,0,0,0,0,0,0,0,0,0,0,1037996,"2023-12-25T00:00:00.000Z",56677788,23,"Terquavion Smith",0,0,0,0,0,0
"5683",1416,2,0,1,7,2,12,6,0,0,37,0,3,14,1,0,0,1037997,"2023-12-25T00:00:00.000Z",178,24,"Eric Gordon",0,15,17,16,3,18.2
"5684",1417,7,1,7,3,1,11,4,7,7,43,1,2,16,8,0,6,1037997,"2023-12-25T00:00:00.000Z",140,24,"Kevin Durant",1,24,31,23,15,33.1
"5685",1418,0,0,5,0,0,3,1,0,0,17,2,3,2,7,1,1,1037997,"2023-12-25T00:00:00.000Z",147,24,"Drew Eubanks",1,9,9,2,7,12.4
"5686",1419,4,0,3,17,8,22,12,0,0,39,1,4,32,4,1,2,1037997,"2023-12-25T00:00:00.000Z",8,24,"Grayson Allen",1,36,40,36,8,43.8
"5687",1420,10,1,3,4,1,14,6,10,7,40,0,5,20,3,1,3,1037997,"2023-12-25T00:00:00.000Z",57,24,"Devin Booker",2,23,33,30,13,41.6
"5688",1421,2,0,1,3,0,5,0,2,1,12,1,2,1,2,1,0,1037997,"2023-12-25T00:00:00.000Z",356,24,"Josh Okogie",1,3,5,3,4,9.4
"5689",1422,2,0,13,6,2,18,9,4,3,34,6,1,23,19,1,3,1037997,"2023-12-25T00:00:00.000Z",314,24,"Chimezie Metu",1,42,44,25,21,48.8
"5690",1423,0,0,0,0,0,0,0,0,0,3,0,1,0,0,0,0,1037997,"2023-12-25T00:00:00.000Z",666729,24,"Nassir Little",0,0,0,0,0,0
"5691",1424,1,0,0,1,0,3,0,2,2,11,3,0,2,3,0,0,1037997,"2023-12-25T00:00:00.000Z",18678058,24,"Jordan Goodwin",0,5,6,3,4,7.1
"5692",1425,0,0,0,0,0,2,2,0,0,4,0,0,4,0,0,0,1037997,"2023-12-25T00:00:00.000Z",3547095,24,"Udoka Azubuike",0,4,4,4,0,4
"5693",1426,1,1,6,4,2,10,6,2,1,36,1,3,15,7,0,4,1037609,"2023-10-27T00:00:00.000Z",3547267,9,"Isaiah Stewart",1,22,23,16,8,23.9
"5694",1427,6,1,9,1,0,9,2,2,2,30,3,5,6,12,0,3,1037609,"2023-10-27T00:00:00.000Z",56677826,9,"Ausar Thompson",1,18,24,12,18,29.4
"5695",1428,3,2,11,0,0,8,7,0,0,35,6,3,14,17,2,5,1037609,"2023-10-27T00:00:00.000Z",38017694,9,"Jalen Duren",4,31,34,17,20,45.9
"5696",1429,0,0,0,1,0,1,0,0,0,6,0,1,0,0,1,0,1037630,"2023-10-29T00:00:00.000Z",56677791,25,"Kris Murray",1,0,0,0,0,3
"5697",1430,1,0,0,1,0,2,0,0,0,5,0,0,0,0,0,1,1037630,"2023-10-29T00:00:00.000Z",3547289,25,"Skylar Mays",0,0,1,1,1,0.5
"5698",1431,0,0,0,1,0,1,0,0,0,5,0,0,0,0,0,0,1037630,"2023-10-29T00:00:00.000Z",56677829,25,"Rayan Rupert",0,0,0,0,0,0
"5699",1432,0,0,0,0,0,0,0,0,0,0,0,0,0,0,0,0,1037630,"2023-10-29T00:00:00.000Z",666476,25,"Moses Brown",0,0,0,0,0,0
"5700",1433,1,0,0,0,0,0,0,2,2,6,0,0,2,0,0,1,1037629,"2023-10-29T00:00:00.000Z",284,17,"Robin Lopez",0,2,3,3,1,2.5
"5701",1434,0,0,0,1,1,2,1,0,0,3,0,0,3,0,0,1,1037629,"2023-10-29T00:00:00.000Z",38017691,17,"TyTy Washington Jr.",0,3,3,3,0,2
"5702",1435,0,0,0,0,0,0,0,0,0,0,0,0,0,0,0,0,1037629,"2023-10-29T00:00:00.000Z",666453,17,"Marques Bolden",0,0,0,0,0,0
"5703",1436,0,0,0,0,0,0,0,0,0,0,0,0,0,0,0,0,1037629,"2023-10-29T00:00:00.000Z",315,17,"Khris Middleton",0,0,0,0,0,0
"5704",1437,0,0,0,0,0,0,0,0,0,0,0,0,0,0,0,0,1037629,"2023-10-29T00:00:00.000Z",666960,17,"Lindell Wigginton",0,0,0,0,0,0
"5705",1438,1,0,2,4,2,10,6,1,1,24,1,3,15,3,4,2,1037629,"2023-10-29T00:00:00.000Z",666656,1,"De'Andre Hunter",4,18,19,16,4,30.1
"5706",1439,1,0,0,2,2,3,2,0,0,9,1,0,6,1,1,1,1037629,"2023-10-29T00:00:00.000Z",38017689,1,"AJ Griffin",1,7,8,7,2,10.7
"5707",1440,1,0,0,0,0,0,0,0,0,5,0,1,0,0,0,0,1037629,"2023-10-29T00:00:00.000Z",3547297,1,"Trent Forrest",0,0,1,1,1,1.5
"5708",1441,0,0,0,1,0,1,0,0,0,5,0,1,0,0,0,2,1037629,"2023-10-29T00:00:00.000Z",666564,1,"Bruno Fernando",0,0,0,0,0,-2
"5709",1442,0,0,0,1,0,1,0,0,0,3,0,1,0,0,1,0,1037629,"2023-10-29T00:00:00.000Z",56677806,1,"Mouhamed Gueye",1,0,0,0,0,3
"5710",1443,0,0,0,0,0,0,0,0,0,0,0,0,0,0,0,0,1037629,"2023-10-29T00:00:00.000Z",666754,1,"Garrison Mathews",0,0,0,0,0,0
"5711",1444,0,0,0,0,0,0,0,0,0,0,0,0,0,0,0,0,1037629,"2023-10-29T00:00:00.000Z",319,1,"Patty Mills",0,0,0,0,0,0
"5712",1445,0,0,0,0,0,0,0,0,0,0,0,0,0,0,0,0,1037629,"2023-10-29T00:00:00.000Z",56677855,1,"Seth Lundy",0,0,0,0,0,0
"5713",1446,0,0,0,0,0,0,0,0,0,0,0,0,0,0,0,0,1037629,"2023-10-29T00:00:00.000Z",301,1,"Wesley Matthews",0,0,0,0,0,0
"5714",1447,5,0,4,6,2,16,7,2,2,26,1,2,18,5,1,2,1037630,"2023-10-29T00:00:00.000Z",65,25,"Malcolm Brogdon",1,23,28,23,10,32.5
"5715",1448,2,2,5,0,0,3,2,2,2,26,2,2,6,7,2,1,1037630,"2023-10-29T00:00:00.000Z",476,25,"Robert Williams III",4,13,15,8,9,28.4
"5716",1449,2,2,0,5,1,16,5,2,1,28,3,3,12,3,0,0,1037630,"2023-10-29T00:00:00.000Z",56677850,25,"Toumani Camara",2,15,17,14,5,24.6
"5717",1450,2,1,2,4,0,9,3,2,2,39,0,1,8,2,0,0,1037632,"2023-10-29T00:00:00.000Z",30,26,"Harrison Barnes",1,10,12,10,4,16.4
"5718",1451,1,0,3,7,4,7,4,0,0,16,0,0,12,3,0,0,1037784,"2023-11-19T00:00:00.000Z",27924547,21,"Lindy Waters III",0,15,16,13,4,17.1
"5719",1452,1,0,0,0,0,1,0,0,0,6,0,0,0,0,0,2,1037784,"2023-11-19T00:00:00.000Z",4197029,21,"Vasilije Micic",0,0,1,1,1,-0.5
"5720",1453,0,0,1,3,2,5,2,0,0,10,1,4,6,2,0,0,1037784,"2023-11-19T00:00:00.000Z",24572055,21,"Olivier Sarr",0,8,8,6,2,8.4
"5721",1454,4,0,1,1,1,3,2,0,0,9,2,1,5,3,0,0,1037784,"2023-11-19T00:00:00.000Z",3547271,21,"Aleksej Pokusevski",0,8,12,9,7,14.6
"5722",1455,0,0,0,0,0,0,0,0,0,0,0,0,0,0,0,0,1037784,"2023-11-19T00:00:00.000Z",38017716,21,"Ousmane Dieng",0,0,0,0,0,0
"5723",1456,0,0,0,0,0,0,0,0,0,0,0,0,0,0,0,0,1037784,"2023-11-19T00:00:00.000Z",56677853,21,"Keyontae Johnson",0,0,0,0,0,0
"5724",1457,0,0,0,0,0,0,0,0,0,0,0,0,0,0,0,0,1037784,"2023-11-19T00:00:00.000Z",38017703,21,"Jalen Williams",0,0,0,0,0,0
"5725",1458,10,2,8,9,4,27,14,7,7,46,0,2,39,8,2,7,1037783,"2023-11-19T00:00:00.000Z",140,24,"Kevin Durant",4,47,57,49,18,68.6
"5726",1459,2,2,8,0,0,11,7,4,4,35,4,5,18,12,1,2,1037783,"2023-11-19T00:00:00.000Z",349,24,"Jusuf Nurkic",3,30,32,20,14,42.4
"5727",1460,3,1,4,6,3,8,5,2,1,43,0,4,14,4,1,2,1037783,"2023-11-19T00:00:00.000Z",8,24,"Grayson Allen",2,18,21,17,7,27.3
"5728",1461,3,0,3,5,1,9,3,0,0,39,0,2,7,3,3,1,1037785,"2023-11-19T00:00:00.000Z",666860,14,"Cameron Reddish",3,10,13,10,6,23.1
"5729",1462,8,0,5,5,2,19,14,9,7,40,1,0,37,6,3,2,1037785,"2023-11-19T00:00:00.000Z",237,14,"LeBron James",3,43,51,45,14,63.2
"5730",1463,3,1,6,0,0,15,11,7,5,33,4,6,27,10,2,4,1037785,"2023-11-19T00:00:00.000Z",117,14,"Anthony Davis",3,37,40,30,13,48.5
"5731",1464,2,0,1,4,0,11,1,1,0,24,3,0,2,4,0,2,1037785,"2023-11-19T00:00:00.000Z",383,14,"Taurean Prince",0,6,8,4,6,7.8
"5732",1465,2,0,5,5,1,8,1,2,1,24,0,1,4,5,3,3,1037785,"2023-11-19T00:00:00.000Z",405,14,"D'Angelo Russell",3,9,11,6,7,19
"5733",1466,2,0,3,4,0,10,4,4,3,32,1,0,11,4,2,2,1037785,"2023-11-19T00:00:00.000Z",666609,14,"Rui Hachimura",2,15,17,13,6,22.8
"5734",1467,6,0,6,3,2,7,5,6,5,25,0,0,17,6,0,2,1037785,"2023-11-19T00:00:00.000Z",17553995,14,"Austin Reaves",0,23,29,23,12,31.2
"5735",1468,0,0,2,3,0,4,0,0,0,18,0,3,0,2,0,1,1037785,"2023-11-19T00:00:00.000Z",486,14,"Christian Wood",0,2,2,0,2,1.4
"5736",1469,4,1,2,2,1,15,6,8,7,39,3,3,20,5,1,2,1037786,"2023-11-20T00:00:00.000Z",204,4,"Gordon Hayward",2,25,29,24,9,36
"5737",1470,5,0,15,7,2,13,3,6,6,45,0,1,14,15,1,1,1037786,"2023-11-20T00:00:00.000Z",62,4,"Miles Bridges",1,29,34,19,20,41.5
"5738",1471,2,3,8,0,0,14,8,2,2,33,8,4,18,16,1,1,1037786,"2023-11-20T00:00:00.000Z",38017698,4,"Mark Williams",4,34,36,20,18,51.2
"5739",1472,4,1,3,4,1,12,4,0,0,40,4,2,9,7,2,2,1037786,"2023-11-20T00:00:00.000Z",56677823,4,"Brandon Miller",3,16,20,13,11,30.4
"5740",1473,8,1,7,11,5,27,15,1,1,41,2,5,36,9,2,5,1037786,"2023-11-20T00:00:00.000Z",3547239,4,"LaMelo Ball",3,45,53,44,17,62.8
"5741",1474,2,0,2,6,1,6,1,0,0,14,0,1,3,2,0,1,1037786,"2023-11-20T00:00:00.000Z",38017708,4,"Bryce McGowens",0,5,7,5,4,7.4
"5742",1475,0,0,0,0,0,0,0,0,0,0,0,0,0,0,0,0,1037786,"2023-11-20T00:00:00.000Z",17896037,4,"James Bouknight",0,0,0,0,0,0
"5743",1476,2,4,13,3,2,19,9,16,15,29,0,2,35,13,2,4,1037919,"2023-12-15T00:00:00.000Z",145,23,"Joel Embiid",6,48,50,37,15,67.6
"5744",1477,1,1,1,3,0,6,1,2,2,23,2,4,4,3,1,0,1037919,"2023-12-15T00:00:00.000Z",313,23,"De'Anthony Melton",2,7,8,5,4,15.1
"5745",1478,4,0,1,6,1,16,7,5,4,27,0,1,19,1,2,1,1037919,"2023-12-15T00:00:00.000Z",3547254,23,"Tyrese Maxey",2,20,24,23,5,31.2
"5746",1479,0,0,0,0,0,1,0,2,1,12,0,0,1,0,3,0,1037919,"2023-12-15T00:00:00.000Z",45,23,"Patrick Beverley",3,1,1,1,0,10
"5747",1480,0,0,2,1,0,2,0,0,0,13,1,0,0,3,1,1,1037919,"2023-12-15T00:00:00.000Z",108,23,"Robert Covington",1,3,3,0,3,5.6
"5748",1481,2,0,1,3,1,5,1,0,0,12,3,2,3,4,0,0,1037919,"2023-12-15T00:00:00.000Z",2175,23,"Danuel House Jr.",0,7,9,5,6,10.8
"5749",1482,0,1,3,1,1,2,1,0,0,9,1,2,3,4,0,0,1037919,"2023-12-15T00:00:00.000Z",28,23,"Mo Bamba",1,7,7,3,4,10.8
"5750",1483,4,1,3,4,1,10,4,0,0,34,0,2,9,3,1,1,1037918,"2023-12-15T00:00:00.000Z",204,4,"Gordon Hayward",2,12,16,13,7,23.6
"5751",1484,2,0,8,8,2,24,10,6,5,39,2,5,27,10,1,3,1037918,"2023-12-15T00:00:00.000Z",62,4,"Miles Bridges",1,37,39,29,12,42
"5752",1485,1,1,5,0,0,7,7,2,2,30,1,5,16,6,0,0,1037918,"2023-12-15T00:00:00.000Z",3547282,4,"Nick Richards",1,22,23,17,7,27.7
"5753",1486,3,0,4,5,2,16,7,2,0,35,0,3,16,4,1,0,1037918,"2023-12-15T00:00:00.000Z",56677823,4,"Brandon Miller",1,20,23,19,7,28.3
"5754",1487,6,0,4,11,4,25,11,4,4,39,0,0,30,4,3,2,1037918,"2023-12-15T00:00:00.000Z",403,4,"Terry Rozier",3,34,40,36,10,50.8
"5755",1488,2,0,0,0,0,2,0,0,0,15,1,0,0,1,0,0,1037918,"2023-12-15T00:00:00.000Z",422,4,"Ish Smith",0,1,3,2,3,4.2
"5756",1489,0,2,1,1,0,2,0,0,0,14,1,1,0,2,0,0,1037918,"2023-12-15T00:00:00.000Z",18678001,4,"JT Thor",2,2,2,0,2,8.4
"5757",1491,0,0,1,2,0,5,2,5,3,21,1,2,7,2,1,0,1037918,"2023-12-15T00:00:00.000Z",38017708,4,"Bryce McGowens",1,9,9,7,2,12.4
"5758",1492,0,0,0,0,0,0,0,0,0,0,0,0,0,0,0,0,1037918,"2023-12-15T00:00:00.000Z",56677866,4,"Leaky Black",0,0,0,0,0,0
"5759",1493,0,0,0,0,0,0,0,0,0,0,0,0,0,0,0,0,1037918,"2023-12-15T00:00:00.000Z",17896037,4,"James Bouknight",0,0,0,0,0,0
"5760",1494,0,0,0,0,0,0,0,0,0,0,0,0,0,0,0,0,1037918,"2023-12-15T00:00:00.000Z",56677846,4,"Nick Smith Jr.",0,0,0,0,0,0
"5761",1495,0,1,4,3,2,9,6,3,3,30,1,2,17,5,2,4,1037920,"2023-12-15T00:00:00.000Z",56677844,30,"Bilal Coulibaly",3,22,22,17,5,28
"5762",1496,1,1,1,7,3,14,9,3,2,28,0,2,23,1,1,1,1037920,"2023-12-15T00:00:00.000Z",17896045,30,"Corey Kispert",2,24,25,24,2,30.7
"5763",1497,1,0,4,1,0,2,1,2,2,10,1,0,4,5,0,0,1037920,"2023-12-15T00:00:00.000Z",167,30,"Danilo Gallinari",0,9,10,5,6,11.5
"5764",1498,2,1,0,1,0,1,0,0,0,19,0,1,0,0,0,0,1037920,"2023-12-15T00:00:00.000Z",337,30,"Mike Muscala",1,0,2,2,2,6
"5765",1499,0,0,0,0,0,0,0,0,0,3,0,0,0,0,0,0,1037920,"2023-12-15T00:00:00.000Z",3547302,30,"Anthony Gill",0,0,0,0,0,0
"5766",1500,0,0,0,0,0,0,0,0,0,0,0,0,0,0,0,0,1037920,"2023-12-15T00:00:00.000Z",414,30,"Landry Shamet",0,0,0,0,0,0
"5767",1501,1,0,5,3,2,4,2,0,0,22,0,0,6,5,1,0,1038074,"2024-01-05T00:00:00.000Z",666940,6,"Dean Wade",1,11,12,7,6,16.5
"5768",1502,1,0,2,0,0,1,1,0,0,5,0,0,2,2,2,0,1038075,"2024-01-05T00:00:00.000Z",28,23,"Mo Bamba",2,4,5,3,3,11.9
"5769",1503,0,0,0,0,0,0,0,0,0,0,0,0,0,0,0,0,1038074,"2024-01-05T00:00:00.000Z",56677847,6,"Emoni Bates",0,0,0,0,0,0
"5770",1504,0,0,0,0,0,0,0,0,0,0,0,0,0,0,0,0,1038074,"2024-01-05T00:00:00.000Z",666581,6,"Darius Garland",0,0,0,0,0,0
"5771",1505,0,0,0,0,0,0,0,0,0,0,0,0,0,0,0,0,1038074,"2024-01-05T00:00:00.000Z",17896076,6,"Evan Mobley",0,0,0,0,0,0
"5772",1506,0,0,0,0,0,0,0,0,0,0,0,0,0,0,0,0,1038074,"2024-01-05T00:00:00.000Z",38017662,6,"Isaiah Mobley",0,0,0,0,0,0
"5773",1507,0,0,0,0,0,0,0,0,0,0,0,0,0,0,0,0,1038074,"2024-01-05T00:00:00.000Z",404,6,"Ricky Rubio",0,0,0,0,0,0
"5774",1508,4,1,5,1,0,8,5,4,3,26,0,4,13,5,2,3,1038074,"2024-01-05T00:00:00.000Z",3547242,30,"Deni Avdija",3,18,22,17,9,31
"5775",1509,1,1,3,1,0,2,0,0,0,21,1,2,0,4,0,2,1038075,"2024-01-05T00:00:00.000Z",33,23,"Nicolas Batum",1,4,5,1,5,7.3
"5776",1510,4,0,3,2,1,6,2,1,0,24,0,2,5,3,0,0,1038075,"2024-01-05T00:00:00.000Z",200,23,"Tobias Harris",0,8,12,9,7,14.6
"5777",1511,3,3,7,1,1,23,10,12,9,36,3,3,30,10,1,6,1038075,"2024-01-05T00:00:00.000Z",145,23,"Joel Embiid",4,40,43,33,13,52.5
"5778",1512,1,3,5,6,3,12,6,0,0,31,2,2,15,7,0,3,1038075,"2024-01-05T00:00:00.000Z",360,23,"Kelly Oubre Jr.",3,22,23,16,8,30.9
"5779",1513,9,1,3,7,1,20,9,10,8,37,1,1,27,4,2,1,1038075,"2024-01-05T00:00:00.000Z",3547254,23,"Tyrese Maxey",3,31,40,36,13,53.3
"5780",1514,0,0,0,0,0,0,0,0,0,0,0,0,0,0,0,0,1038073,"2024-01-05T00:00:00.000Z",56677841,3,"Dariq Whitehead",0,0,0,0,0,0
"5781",1515,0,0,0,0,0,0,0,0,0,0,0,0,0,0,0,0,1038073,"2024-01-05T00:00:00.000Z",56677722,3,"Jalen Wilson",0,0,0,0,0,0
"5782",1516,3,0,2,5,2,8,5,0,0,28,2,4,12,4,3,1,1038073,"2024-01-05T00:00:00.000Z",666541,21,"Luguentz Dort",3,16,19,15,7,29.3
"5783",1517,5,1,5,4,2,11,8,3,2,36,0,3,20,5,0,3,1038073,"2024-01-05T00:00:00.000Z",38017703,21,"Jalen Williams",1,25,30,25,10,33.5
"5784",1518,3,1,3,4,0,15,8,2,1,35,3,3,17,6,1,1,1038073,"2024-01-05T00:00:00.000Z",38017685,21,"Chet Holmgren",2,23,26,20,9,33.7
"5785",1519,5,1,8,1,0,9,5,4,3,24,0,3,13,8,1,2,1038073,"2024-01-05T00:00:00.000Z",17896065,21,"Josh Giddey",2,21,26,18,13,34.1
"5786",1520,6,0,8,5,2,19,11,15,10,36,1,5,34,9,0,2,1038073,"2024-01-05T00:00:00.000Z",175,21,"Shai Gilgeous-Alexander",0,43,49,40,15,51.8
"5787",1521,1,1,1,3,1,5,1,0,0,20,0,1,3,1,0,1,1038073,"2024-01-05T00:00:00.000Z",3547272,21,"Isaiah Joe",1,4,5,4,2,7.7
"5788",1522,0,0,0,1,0,1,0,0,0,1,0,0,0,0,0,0,1038073,"2024-01-05T00:00:00.000Z",44,21,"Davis Bertans",0,0,0,0,0,0
"5789",1523,3,1,0,1,0,4,3,0,0,12,0,0,6,0,1,0,1038073,"2024-01-05T00:00:00.000Z",4197029,21,"Vasilije Micic",2,6,9,9,3,16.5
"5790",1524,0,0,0,0,0,0,0,0,0,0,0,0,0,0,0,0,1038073,"2024-01-05T00:00:00.000Z",17896036,21,"Tre Mann",0,0,0,0,0,0
"5791",1525,0,0,0,0,0,0,0,0,0,0,0,0,0,0,0,0,1038073,"2024-01-05T00:00:00.000Z",3547271,21,"Aleksej Pokusevski",0,0,0,0,0,0
"5792",1526,0,0,0,0,0,0,0,0,0,0,0,0,0,0,0,0,1037697,"2023-11-08T00:00:00.000Z",439,12,"Daniel Theis",0,0,0,0,0,0
"5793",1527,1,0,1,3,0,8,4,2,2,26,1,4,10,2,0,1,1037704,"2023-11-08T00:00:00.000Z",38017676,17,"MarJon Beauchamp",0,12,13,11,3,12.9
"5794",1528,2,0,3,4,1,14,7,3,3,23,2,1,18,5,0,2,1037704,"2023-11-08T00:00:00.000Z",377,17,"Bobby Portis",0,23,25,20,7,25
"5795",1529,2,0,2,0,0,0,0,2,1,13,0,2,1,2,1,2,1037706,"2023-11-08T00:00:00.000Z",444,6,"Tristan Thompson",1,3,5,3,4,7.4
"5796",1530,0,0,0,0,0,0,0,0,0,0,0,0,0,0,0,0,1037706,"2023-11-08T00:00:00.000Z",3547247,6,"Isaac Okoro",0,0,0,0,0,0
"5797",1531,0,0,0,0,0,0,0,0,0,0,0,0,0,0,0,0,1037706,"2023-11-08T00:00:00.000Z",56677872,6,"Craig Porter",0,0,0,0,0,0
"5798",1532,0,0,3,0,0,5,4,2,1,11,3,3,9,6,0,1,1037702,"2023-11-08T00:00:00.000Z",188,11,"Jeff Green",0,15,15,9,6,15.2
"5799",1533,3,0,2,2,1,6,3,0,0,23,0,3,7,2,0,0,1037702,"2023-11-08T00:00:00.000Z",213,11,"Aaron Holiday",0,9,12,10,5,13.9
"5800",1534,1,1,0,6,2,10,6,0,0,27,1,3,14,1,0,0,1037702,"2023-11-08T00:00:00.000Z",3547301,11,"Jae'Sean Tate",1,15,16,15,2,19.7
"5801",1535,0,1,2,1,0,3,1,0,0,12,1,0,2,3,0,1,1037702,"2023-11-08T00:00:00.000Z",19465326,11,"Jock Landale",1,5,5,2,3,7.6
"5802",1536,1,0,0,1,0,4,2,2,1,8,0,0,5,0,1,0,1037702,"2023-11-08T00:00:00.000Z",47738533,11,"Jeenathan Williams",1,5,6,6,1,9.5
"5803",1537,0,0,5,0,0,4,3,1,0,6,2,1,6,7,0,0,1037702,"2023-11-08T00:00:00.000Z",296,11,"Boban Marjanovic",0,13,13,6,7,14.4
"5804",1538,0,0,0,0,0,0,0,0,0,0,0,0,0,0,0,0,1037702,"2023-11-08T00:00:00.000Z",3547281,11,"Nate Hinton",0,0,0,0,0,0
"5805",1539,0,0,0,0,0,0,0,0,0,0,0,0,0,0,0,0,1037702,"2023-11-08T00:00:00.000Z",357,11,"Victor Oladipo",0,0,0,0,0,0
"5806",1540,0,0,0,0,0,0,0,0,0,0,0,0,0,0,0,0,1037702,"2023-11-08T00:00:00.000Z",56677809,11,"Jermaine Samuels Jr.",0,0,0,0,0,0
"5807",1541,0,0,0,0,0,0,0,0,0,0,0,0,0,0,0,0,1037702,"2023-11-08T00:00:00.000Z",56677825,11,"Amen Thompson",0,0,0,0,0,0
"5808",1542,2,0,0,0,0,3,1,0,0,14,2,5,2,2,0,0,1037702,"2023-11-08T00:00:00.000Z",56677738,14,"Colin Castleton",0,4,6,4,4,7.4
"5809",1543,0,0,0,0,0,0,0,0,0,0,0,0,0,0,0,0,1037702,"2023-11-08T00:00:00.000Z",117,14,"Anthony Davis",0,0,0,0,0,0
"5810",1544,0,0,0,0,0,0,0,0,0,0,0,0,0,0,0,0,1037699,"2023-11-08T00:00:00.000Z",666679,3,"Cameron Johnson",0,0,0,0,0,0
"5811",1545,0,0,0,0,0,0,0,0,0,0,0,0,0,0,0,0,1037699,"2023-11-08T00:00:00.000Z",17896041,3,"Keon Johnson",0,0,0,0,0,0
"5812",1546,0,0,0,0,0,0,0,0,0,0,0,0,0,0,0,0,1037699,"2023-11-08T00:00:00.000Z",417,3,"Ben Simmons",0,0,0,0,0,0
"5813",1547,3,1,3,1,0,3,1,1,1,21,3,3,3,6,1,0,1037699,"2023-11-08T00:00:00.000Z",450,13,"PJ Tucker",2,9,12,6,9,20.7
"5814",1548,0,0,1,2,0,6,2,0,0,6,1,0,4,2,0,1,1037699,"2023-11-08T00:00:00.000Z",17896031,13,"Nah'Shon Hyland",0,6,6,4,2,5.4
"5815",1549,1,0,4,2,0,2,0,0,0,19,0,1,0,4,0,2,1037699,"2023-11-08T00:00:00.000Z",666743,13,"Terance Mann",0,4,5,1,5,4.3
"5816",1550,1,2,1,5,2,8,4,0,0,23,0,2,10,1,3,1,1037699,"2023-11-08T00:00:00.000Z",380,13,"Norman Powell",5,11,12,11,2,26.7
"5817",1551,0,0,0,1,1,1,1,0,0,3,0,0,3,0,0,0,7045523,"2023-12-05T00:00:00.000Z",17896033,20,"Miles McBride",0,3,3,3,0,3
"5818",1552,0,0,0,0,0,0,0,0,0,0,0,0,0,0,0,0,7045524,"2023-12-05T00:00:00.000Z",666451,24,"Bol Bol",0,0,0,0,0,0
"5819",1553,0,0,0,0,0,0,0,0,0,0,0,0,0,0,0,0,7045524,"2023-12-05T00:00:00.000Z",3547298,24,"Saben Lee",0,0,0,0,0,0
"5820",1554,0,0,0,0,0,0,0,0,0,0,0,0,0,0,0,0,7045524,"2023-12-05T00:00:00.000Z",314,24,"Chimezie Metu",0,0,0,0,0,0
"5821",1555,0,0,0,0,0,0,0,0,0,0,0,0,0,0,0,0,7045524,"2023-12-05T00:00:00.000Z",470,24,"Yuta Watanabe",0,0,0,0,0,0
"5822",1556,0,0,0,0,0,0,0,0,0,0,0,0,0,0,0,0,7045524,"2023-12-05T00:00:00.000Z",37,24,"Bradley Beal",0,0,0,0,0,0
"5823",1557,0,0,0,0,0,0,0,0,0,0,0,0,0,0,0,0,7045524,"2023-12-05T00:00:00.000Z",272,24,"Damion Lee",0,0,0,0,0,0
"5824",1558,1,0,2,4,1,8,3,0,0,21,0,1,7,2,0,0,7045524,"2023-12-05T00:00:00.000Z",666609,14,"Rui Hachimura",0,9,10,8,3,10.9
"5825",1559,0,0,1,0,0,2,0,0,0,9,1,2,0,2,1,0,7045524,"2023-12-05T00:00:00.000Z",666626,14,"Jaxson Hayes",1,2,2,0,2,5.4
"5826",1560,0,0,0,0,0,0,0,0,0,0,0,0,0,0,0,0,7045524,"2023-12-05T00:00:00.000Z",56677835,14,"Jalen Hood-Schifino",0,0,0,0,0,0
"5827",1561,0,0,0,0,0,0,0,0,0,0,0,0,0,0,0,0,7045524,"2023-12-05T00:00:00.000Z",56677836,14,"Maxwell Lewis",0,0,0,0,0,0
"5828",1562,0,0,0,0,0,0,0,0,0,0,0,0,0,0,0,0,7045524,"2023-12-05T00:00:00.000Z",486,14,"Christian Wood",0,0,0,0,0,0
"5829",1563,0,0,0,0,0,0,0,0,0,0,0,0,0,0,0,0,7045524,"2023-12-05T00:00:00.000Z",56677738,14,"Colin Castleton",0,0,0,0,0,0
"5830",1564,0,0,0,0,0,0,0,0,0,0,0,0,0,0,0,0,7045524,"2023-12-05T00:00:00.000Z",56677867,14,"Alex Fudge",0,0,0,0,0,0
"5831",1565,0,0,0,0,0,0,0,0,0,0,0,0,0,0,0,0,7045524,"2023-12-05T00:00:00.000Z",56677868,14,"D'Moi Hodge",0,0,0,0,0,0
"5832",1566,0,0,0,0,0,0,0,0,0,0,0,0,0,0,0,0,7045524,"2023-12-05T00:00:00.000Z",1603383,14,"Gabe Vincent",0,0,0,0,0,0
"5833",1567,4,1,4,4,1,8,3,0,0,35,0,1,7,4,2,1,7045524,"2023-12-05T00:00:00.000Z",178,24,"Eric Gordon",3,11,15,11,8,25.8
"5834",1568,4,1,7,7,4,17,12,4,3,39,0,5,31,7,0,5,7045524,"2023-12-05T00:00:00.000Z",140,24,"Kevin Durant",1,38,42,35,11,43.4
"5835",1569,4,0,8,0,0,3,1,4,1,29,0,4,3,8,1,2,7045524,"2023-12-05T00:00:00.000Z",349,24,"Jusuf Nurkic",1,11,15,7,12,19.6
"5836",1570,2,1,2,8,4,14,6,5,5,39,0,2,21,2,2,0,7045524,"2023-12-05T00:00:00.000Z",8,24,"Grayson Allen",3,23,25,23,4,35.4
"5837",1571,6,1,9,1,1,16,6,8,8,37,2,5,21,11,1,7,7045524,"2023-12-05T00:00:00.000Z",57,24,"Devin Booker",2,32,38,27,17,42.2
"5838",1572,1,0,0,0,0,3,3,0,0,17,2,2,6,2,1,3,7045524,"2023-12-05T00:00:00.000Z",147,24,"Drew Eubanks",1,8,9,7,3,9.9
"5839",1573,0,0,1,1,0,1,0,0,0,9,0,0,0,1,1,0,7045524,"2023-12-05T00:00:00.000Z",356,24,"Josh Okogie",1,1,1,0,1,4.2
"5840",1574,2,0,1,1,1,4,2,0,0,14,1,1,5,2,0,1,7045524,"2023-12-05T00:00:00.000Z",666729,24,"Nassir Little",0,7,9,7,4,9.4
"5841",1575,0,0,1,2,0,2,0,2,1,12,0,0,1,1,2,0,1037878,"2023-12-02T00:00:00.000Z",301,1,"Wesley Matthews",2,2,2,1,1,8.2
"5842",1577,0,0,0,0,0,0,0,0,0,0,0,0,0,0,0,0,1038024,"2023-12-29T00:00:00.000Z",378,2,"Kristaps Porzingis",0,0,0,0,0,0
"5843",1578,0,0,0,0,0,0,0,0,0,0,0,0,0,0,0,0,1038024,"2023-12-29T00:00:00.000Z",56677864,2,"Jordan Walsh",0,0,0,0,0,0
"5844",1579,2,0,2,4,2,8,5,0,0,37,0,1,12,2,2,1,1038024,"2023-12-29T00:00:00.000Z",18,28,"OG Anunoby",2,14,16,14,4,22.4
"5845",1580,5,0,5,5,2,18,10,8,5,41,0,1,27,5,2,1,1038024,"2023-12-29T00:00:00.000Z",416,28,"Pascal Siakam",2,32,37,32,10,45.5
"5846",1581,3,2,6,0,0,8,5,2,2,22,4,3,12,10,0,0,1038024,"2023-12-29T00:00:00.000Z",373,28,"Jakob Poeltl",2,22,25,15,13,34.5
"5847",1582,1,0,4,4,1,10,2,2,1,29,0,0,6,4,2,0,1038024,"2023-12-29T00:00:00.000Z",3089,28,"Gary Trent Jr.",2,10,11,7,5,18.3
"5848",1583,5,3,7,15,7,24,10,4,3,38,3,2,30,10,1,2,1038024,"2023-12-29T00:00:00.000Z",17896055,28,"Scottie Barnes",4,40,45,35,15,59.5
"5849",1584,9,1,0,5,2,12,6,2,1,35,2,2,15,2,0,0,1038024,"2023-12-29T00:00:00.000Z",409,28,"Dennis Schroder",1,17,26,24,11,33.9
"5850",1585,0,0,3,3,1,3,1,0,0,7,0,1,3,3,0,0,1038024,"2023-12-29T00:00:00.000Z",58,28,"Chris Boucher",0,6,6,3,3,6.6
"5851",1586,2,0,0,1,0,1,0,0,0,8,0,0,0,0,0,0,1038024,"2023-12-29T00:00:00.000Z",376,28,"Otto Porter Jr.",0,0,2,2,2,3
"5852",1587,2,0,0,7,2,10,5,2,1,15,0,4,13,0,1,0,1038024,"2023-12-29T00:00:00.000Z",666762,28,"Jalen McDaniels",1,13,15,15,2,19
"5853",1588,0,0,2,0,0,1,0,0,0,2,0,0,0,2,0,0,1038024,"2023-12-29T00:00:00.000Z",3547249,28,"Precious Achiuwa",0,2,2,0,2,2.4
"5854",1589,0,0,0,0,0,0,0,0,0,6,0,1,0,0,2,0,1038024,"2023-12-29T00:00:00.000Z",3547275,28,"Malachi Flynn",2,0,0,0,0,6
"5855",1590,0,0,0,0,0,0,0,0,0,0,0,0,0,0,0,0,1038024,"2023-12-29T00:00:00.000Z",56677828,28,"Gradey Dick",0,0,0,0,0,0
"5856",1591,0,0,0,0,0,0,0,0,0,0,0,0,0,0,0,0,1038024,"2023-12-29T00:00:00.000Z",489,28,"Thaddeus Young",0,0,0,0,0,0
"5857",1592,0,0,0,0,0,0,0,0,0,0,0,0,0,0,0,0,1038024,"2023-12-29T00:00:00.000Z",56677805,28,"Javon Freeman-Liberty",0,0,0,0,0,0
"5858",1593,0,0,0,0,0,0,0,0,0,0,0,0,0,0,0,0,1038024,"2023-12-29T00:00:00.000Z",38017710,28,"Christian Koloko",0,0,0,0,0,0
"5859",1594,0,0,0,0,0,0,0,0,0,0,0,0,0,0,0,0,1038024,"2023-12-29T00:00:00.000Z",56677869,28,"Markquis Nowell",0,0,0,0,0,0
"5860",1595,0,0,0,0,0,0,0,0,0,0,0,0,0,0,0,0,1038024,"2023-12-29T00:00:00.000Z",2309958,28,"Jontay Porter",0,0,0,0,0,0
"5861",1596,0,0,0,0,0,0,0,0,0,0,0,0,0,0,0,0,1038024,"2023-12-29T00:00:00.000Z",436,28,"Garrett Temple",0,0,0,0,0,0
"5862",1597,1,1,9,7,3,7,3,0,0,34,0,2,9,9,0,0,1038024,"2023-12-29T00:00:00.000Z",17896060,2,"Sam Hauser",1,18,19,10,10,24.3
"5863",1598,3,3,3,0,0,11,9,2,2,33,5,3,20,8,0,1,1038024,"2023-12-29T00:00:00.000Z",261,2,"Luke Kornet",3,28,31,23,11,42.1
"5864",1599,7,2,4,10,2,19,5,9,9,36,1,2,21,5,3,3,1038024,"2023-12-29T00:00:00.000Z",473,2,"Derrick White",5,26,33,28,12,49.5
"5865",1600,3,0,2,5,3,15,5,4,2,32,0,1,15,2,0,1,1038024,"2023-12-29T00:00:00.000Z",214,2,"Jrue Holiday",0,17,20,18,5,20.9
"5866",1601,0,0,0,0,0,0,0,0,0,0,0,0,0,0,0,0,1037642,"2023-10-30T00:00:00.000Z",19465584,29,"Micah Potter",0,0,0,0,0,0
"5867",1602,1,1,0,2,0,4,1,2,2,26,0,3,4,0,0,0,1037643,"2023-10-30T00:00:00.000Z",383,14,"Taurean Prince",1,4,5,5,1,8.5
"5868",1603,4,1,3,6,2,17,7,4,3,33,0,0,19,3,3,5,1037643,"2023-10-30T00:00:00.000Z",237,14,"LeBron James",4,22,26,23,7,35.6
"5869",1604,5,3,17,1,0,18,12,3,2,38,2,3,26,19,1,1,1037643,"2023-10-30T00:00:00.000Z",117,14,"Anthony Davis",4,45,50,31,24,67.3
"5870",1605,3,1,3,4,1,12,5,0,0,31,0,0,11,3,0,3,1037643,"2023-10-30T00:00:00.000Z",17553995,14,"Austin Reaves",1,14,17,14,6,19.1
"5871",1606,8,1,2,6,3,14,10,5,5,36,0,4,28,2,1,3,1037643,"2023-10-30T00:00:00.000Z",405,14,"D'Angelo Russell",2,30,38,36,10,45.4
"5872",1607,1,2,1,0,0,1,1,2,2,19,1,2,4,2,0,2,1037644,"2023-10-31T00:00:00.000Z",444,6,"Tristan Thompson",2,6,7,5,3,11.9
"5873",1608,0,0,0,0,0,0,0,0,0,0,0,0,0,0,0,0,1037644,"2023-10-31T00:00:00.000Z",9,6,"Jarrett Allen",0,0,0,0,0,0
"5874",1609,0,0,0,0,0,0,0,0,0,0,0,0,0,0,0,0,1037644,"2023-10-31T00:00:00.000Z",666581,6,"Darius Garland",0,0,0,0,0,0
"5875",1610,0,0,0,0,0,0,0,0,0,0,0,0,0,0,0,0,1037644,"2023-10-31T00:00:00.000Z",666676,6,"Ty Jerome",0,0,0,0,0,0
"5876",1611,0,0,0,0,0,0,0,0,0,0,0,0,0,0,0,0,1037644,"2023-10-31T00:00:00.000Z",277,6,"Caris LeVert",0,0,0,0,0,0
"5877",1612,0,0,0,0,0,0,0,0,0,0,0,0,0,0,0,0,1037644,"2023-10-31T00:00:00.000Z",404,6,"Ricky Rubio",0,0,0,0,0,0
"5878",1613,0,0,2,5,3,13,5,4,3,25,1,2,16,3,0,1,1037644,"2023-10-31T00:00:00.000Z",666423,20,"RJ Barrett",0,19,19,16,3,18.6
"5879",1614,2,0,7,5,2,14,5,10,7,31,3,1,19,10,1,1,1037644,"2023-10-31T00:00:00.000Z",387,20,"Julius Randle",1,29,31,21,12,36
"5880",1615,2,2,1,4,1,10,3,5,4,30,1,1,11,2,0,2,1037645,"2023-10-31T00:00:00.000Z",356,24,"Josh Okogie",2,13,15,13,4,20.4
"5881",1616,7,0,2,3,1,19,12,2,1,37,0,0,26,2,2,5,1037645,"2023-10-31T00:00:00.000Z",140,24,"Kevin Durant",2,28,35,33,9,39.9
"5882",1617,4,2,12,5,2,10,4,2,2,30,0,4,12,12,1,0,1037645,"2023-10-31T00:00:00.000Z",349,24,"Jusuf Nurkic",3,24,28,16,16,41.4
"5883",1618,3,1,6,7,5,9,5,4,4,37,1,2,19,7,0,2,1037645,"2023-10-31T00:00:00.000Z",8,24,"Grayson Allen",1,26,29,22,10,32.9
"5884",1619,6,0,2,9,4,14,8,0,0,36,0,1,20,2,0,4,1037645,"2023-10-31T00:00:00.000Z",178,24,"Eric Gordon",0,22,28,26,8,27.4
"5885",1620,4,2,8,0,0,3,1,2,1,17,1,1,3,9,1,2,1037645,"2023-10-31T00:00:00.000Z",147,24,"Drew Eubanks",3,12,16,7,13,26.8
"5886",1621,0,0,2,2,0,7,3,0,0,15,2,3,6,4,1,1,1037645,"2023-10-31T00:00:00.000Z",18678058,24,"Jordan Goodwin",1,10,10,6,4,12.8
"5887",1622,1,0,2,2,2,3,2,0,0,18,0,5,6,2,2,1,1037645,"2023-10-31T00:00:00.000Z",666729,24,"Nassir Little",2,8,9,7,3,14.9
"5888",1623,0,0,0,0,0,0,0,0,0,0,0,0,0,0,0,0,1037645,"2023-10-31T00:00:00.000Z",3547095,24,"Udoka Azubuike",0,0,0,0,0,0
"5889",1624,0,0,0,0,0,0,0,0,0,0,0,0,0,0,0,0,1037645,"2023-10-31T00:00:00.000Z",32,24,"Keita Bates-Diop",0,0,0,0,0,0
"5890",1625,0,0,0,0,0,0,0,0,0,0,0,0,0,0,0,0,1037645,"2023-10-31T00:00:00.000Z",666451,24,"Bol Bol",0,0,0,0,0,0
"5891",1626,1,0,0,2,0,2,0,0,0,16,0,0,0,0,0,0,1037833,"2023-11-26T00:00:00.000Z",48248287,15,"Jacob Gilyard",0,0,1,1,1,1.5
"5892",1627,2,0,2,5,2,9,4,1,1,28,2,2,11,4,0,1,1037833,"2023-11-26T00:00:00.000Z",38017729,15,"David Roddy",0,15,17,13,6,17.8
"5893",1628,3,0,4,1,0,4,2,0,0,14,1,1,4,5,0,0,1037833,"2023-11-26T00:00:00.000Z",666809,15,"Jaylen Nowell",0,9,12,7,8,14.5
"5894",1629,0,1,1,0,0,2,1,0,0,2,0,0,2,1,0,0,1037833,"2023-11-26T00:00:00.000Z",199,15,"Shaquille Harrison",1,3,3,2,1,6.2
"5895",1630,0,0,0,0,0,1,1,0,0,2,0,0,2,0,0,0,1037833,"2023-11-26T00:00:00.000Z",38017732,15,"Kenneth Lofton Jr.",0,2,2,2,0,2
"5896",1631,0,0,0,0,0,0,0,0,0,2,0,0,0,0,0,0,1037833,"2023-11-26T00:00:00.000Z",666703,15,"John Konchar",0,0,0,0,0,0
"5897",1632,1,1,2,2,0,11,3,4,3,31,0,3,9,2,0,0,1037831,"2023-11-26T00:00:00.000Z",666423,20,"RJ Barrett",1,11,12,10,3,15.9
"5898",1633,2,0,2,4,1,21,10,8,7,36,3,2,28,5,0,2,1037831,"2023-11-26T00:00:00.000Z",387,20,"Julius Randle",0,33,35,30,7,35
"5899",1634,1,1,6,0,0,2,1,4,1,34,5,2,3,11,1,1,1037831,"2023-11-26T00:00:00.000Z",399,20,"Mitchell Robinson",2,14,15,4,12,22.7
"5900",1635,8,1,6,10,5,25,15,2,0,38,0,5,35,6,3,3,1037831,"2023-11-26T00:00:00.000Z",73,20,"Jalen Brunson",4,41,49,43,14,63.2
"5901",1636,2,0,2,3,1,5,1,0,0,20,1,2,3,3,0,1,1037831,"2023-11-26T00:00:00.000Z",17895858,20,"Quentin Grimes",0,6,8,5,5,8.6
"5902",1637,0,0,1,3,2,6,2,0,0,14,0,1,6,1,2,0,1037831,"2023-11-26T00:00:00.000Z",131,20,"Donte DiVincenzo",2,7,7,6,1,13.2
"5903",1638,0,0,0,0,0,0,0,0,0,0,0,0,0,0,0,0,1037831,"2023-11-26T00:00:00.000Z",19,20,"Ryan Arcidiacono",0,0,0,0,0,0
"5904",1639,2,0,3,2,0,3,1,2,2,24,0,0,4,3,0,0,1037831,"2023-11-26T00:00:00.000Z",202,20,"Josh Hart",0,7,9,6,5,10.6
"5905",1640,1,1,2,6,3,11,4,8,7,29,0,1,18,2,1,0,1037831,"2023-11-26T00:00:00.000Z",3547269,20,"Immanuel Quickley",2,20,21,19,3,27.9
"5906",1641,1,1,1,0,0,3,2,4,3,14,4,3,7,5,0,0,1037831,"2023-11-26T00:00:00.000Z",201,20,"Isaiah Hartenstein",1,12,13,8,6,17.5
"5907",1642,0,0,0,0,0,0,0,0,0,0,0,0,0,0,0,0,1037831,"2023-11-26T00:00:00.000Z",160,20,"Evan Fournier",0,0,0,0,0,0
"5908",1643,3,0,6,7,2,19,9,2,1,36,1,4,21,7,1,2,1037830,"2023-11-26T00:00:00.000Z",70,2,"Jaylen Brown",1,28,31,24,10,34.9
"5909",1644,4,0,8,13,5,25,11,10,7,39,1,2,34,9,2,6,1037830,"2023-11-26T00:00:00.000Z",434,2,"Jayson Tatum",2,43,47,38,13,50.8
"5910",1645,0,0,0,0,0,0,0,0,0,0,0,0,0,0,0,0,1037831,"2023-11-26T00:00:00.000Z",666675,20,"DaQuan Jeffries",0,0,0,0,0,0
"5911",1646,0,0,0,0,0,0,0,0,0,0,0,0,0,0,0,0,1037831,"2023-11-26T00:00:00.000Z",17896033,20,"Miles McBride",0,0,0,0,0,0
"5912",1647,0,0,0,0,0,0,0,0,0,0,0,0,0,0,0,0,1037831,"2023-11-26T00:00:00.000Z",17896063,20,"Jericho Sims",0,0,0,0,0,0
"5913",1648,0,0,0,0,0,0,0,0,0,0,0,0,0,0,0,0,1037831,"2023-11-26T00:00:00.000Z",666474,20,"Charles Brown",0,0,0,0,0,0
"5914",1649,0,0,0,0,0,0,0,0,0,0,0,0,0,0,0,0,1037831,"2023-11-26T00:00:00.000Z",56677795,20,"Jacob Toppin",0,0,0,0,0,0
"5915",1650,0,0,0,0,0,0,0,0,0,0,0,0,0,0,0,0,1037831,"2023-11-26T00:00:00.000Z",17896089,20,"Duane Washington Jr.",0,0,0,0,0,0
"5916",1651,2,0,2,8,2,11,3,2,2,30,0,0,10,2,1,2,1037960,"2023-12-20T00:00:00.000Z",130,3,"Spencer Dinwiddie",1,12,14,12,4,16.4
"5917",1652,0,0,0,0,0,0,0,0,0,0,0,0,0,0,0,0,1037957,"2023-12-20T00:00:00.000Z",56677861,12,"Ben Sheppard",0,0,0,0,0,0
"5918",1653,3,0,11,3,2,5,2,4,4,31,2,2,10,13,1,2,1037960,"2023-12-20T00:00:00.000Z",202,20,"Josh Hart",1,23,26,13,16,31.1
"5919",1654,2,1,0,6,4,12,7,4,1,24,0,0,19,0,1,1,1037960,"2023-12-20T00:00:00.000Z",3547269,20,"Immanuel Quickley",2,19,21,21,2,27
"5920",1655,0,1,1,4,1,7,2,0,0,18,0,1,5,1,1,0,1037960,"2023-12-20T00:00:00.000Z",17895858,20,"Quentin Grimes",2,6,6,5,1,12.2
"5921",1656,0,2,2,0,0,2,1,0,0,13,0,3,2,2,0,0,1037960,"2023-12-20T00:00:00.000Z",173,20,"Taj Gibson",2,4,4,2,2,10.4
"5922",1657,0,0,0,0,0,3,2,0,0,3,0,1,4,0,0,0,1037960,"2023-12-20T00:00:00.000Z",666675,20,"DaQuan Jeffries",0,4,4,4,0,4
"5923",1658,0,0,0,1,0,1,0,0,0,3,0,0,0,0,0,0,1037960,"2023-12-20T00:00:00.000Z",17896033,20,"Miles McBride",0,0,0,0,0,0
"5924",1659,0,0,0,0,0,0,0,0,0,0,0,0,0,0,0,0,1037960,"2023-12-20T00:00:00.000Z",666474,20,"Charles Brown",0,0,0,0,0,0
"5925",1660,0,0,0,0,0,0,0,0,0,0,0,0,0,0,0,0,1037960,"2023-12-20T00:00:00.000Z",59421201,20,"Jaylen Martin",0,0,0,0,0,0
"5926",1661,0,0,0,0,0,0,0,0,0,0,0,0,0,0,0,0,1037960,"2023-12-20T00:00:00.000Z",399,20,"Mitchell Robinson",0,0,0,0,0,0
"5927",1662,0,0,0,0,0,0,0,0,0,0,0,0,0,0,0,0,1037960,"2023-12-20T00:00:00.000Z",17896063,20,"Jericho Sims",0,0,0,0,0,0
"5928",1663,0,0,0,0,0,0,0,0,0,0,0,0,0,0,0,0,1037960,"2023-12-20T00:00:00.000Z",56677795,20,"Jacob Toppin",0,0,0,0,0,0
"5929",1664,5,1,9,5,1,21,13,4,3,33,1,0,30,10,0,3,1037961,"2023-12-20T00:00:00.000Z",17896055,28,"Scottie Barnes",1,40,45,35,15,49.5
"5930",1665,1,0,4,5,1,16,7,5,3,35,1,2,18,5,0,1,1037961,"2023-12-20T00:00:00.000Z",416,28,"Pascal Siakam",0,23,24,19,6,24.5
"5931",1666,3,2,3,0,0,5,2,0,0,19,2,2,4,5,0,1,1037961,"2023-12-20T00:00:00.000Z",373,28,"Jakob Poeltl",2,9,12,7,8,19.5
"5932",1667,3,0,1,4,1,9,4,0,0,40,0,2,9,1,0,1,1037961,"2023-12-20T00:00:00.000Z",18,28,"OG Anunoby",0,10,13,12,4,13.7
"5933",1668,7,0,2,2,1,8,3,0,0,31,0,2,7,2,1,2,1037961,"2023-12-20T00:00:00.000Z",409,28,"Dennis Schroder",1,9,16,14,9,20.9
"5934",1669,1,1,1,2,1,10,6,1,0,25,4,2,13,5,1,1,1037961,"2023-12-20T00:00:00.000Z",3547249,28,"Precious Achiuwa",2,18,19,14,6,25.5
"5935",1670,2,0,3,3,2,8,2,0,0,16,0,1,6,3,1,1,1037961,"2023-12-20T00:00:00.000Z",3547275,28,"Malachi Flynn",1,9,11,8,5,14.6
"5936",1671,0,1,5,1,1,3,2,0,0,12,2,1,5,7,0,1,1037961,"2023-12-20T00:00:00.000Z",58,28,"Chris Boucher",1,12,12,5,7,15.4
"5937",1672,0,0,0,0,0,0,0,0,0,0,0,0,0,0,0,0,1037961,"2023-12-20T00:00:00.000Z",56677828,28,"Gradey Dick",0,0,0,0,0,0
"5938",1673,0,0,0,0,0,0,0,0,0,0,0,0,0,0,0,0,1037961,"2023-12-20T00:00:00.000Z",666762,28,"Jalen McDaniels",0,0,0,0,0,0
"5939",1674,0,1,4,1,0,8,5,0,0,30,1,2,10,5,2,2,1037956,"2023-12-20T00:00:00.000Z",38017705,29,"Walker Kessler",3,15,15,10,5,23
"5940",1675,2,1,3,6,3,17,7,4,3,34,0,5,20,3,0,2,1037956,"2023-12-20T00:00:00.000Z",413,29,"Collin Sexton",1,23,25,22,5,27.6
"5941",1676,8,0,6,7,0,12,4,3,1,39,0,5,9,6,4,4,1037615,"2023-10-27T00:00:00.000Z",102,27,"Zach Collins",4,15,23,17,14,36.2
"5942",1677,2,0,3,7,3,13,7,11,8,40,0,0,25,3,0,1,1037615,"2023-10-27T00:00:00.000Z",3547246,27,"Devin Vassell",0,28,30,27,5,30.6
"5943",1678,0,0,0,0,0,0,0,0,0,0,0,0,0,0,0,0,1037610,"2023-10-27T00:00:00.000Z",38017727,8,"Collin Gillespie",0,0,0,0,0,0
"5944",1679,0,0,0,0,0,0,0,0,0,0,0,0,0,0,0,0,1037610,"2023-10-27T00:00:00.000Z",17896103,8,"Jay Huff",0,0,0,0,0,0
"5945",1680,4,0,4,1,0,9,5,4,4,26,1,3,14,5,2,2,1037615,"2023-10-27T00:00:00.000Z",38017699,27,"Jeremy Sochan",2,19,23,18,9,30
"5946",1681,2,1,1,6,4,9,5,0,0,21,0,3,14,1,0,2,1037616,"2023-10-27T00:00:00.000Z",464,3,"Lonnie Walker IV",1,15,17,16,3,19.2
"5947",1682,0,0,2,0,0,2,1,0,0,3,2,1,2,4,1,2,1037616,"2023-10-27T00:00:00.000Z",17896038,3,"Day'Ron Sharpe",1,6,6,2,4,7.8
"5948",1683,1,0,1,0,0,3,0,0,0,8,0,4,0,1,0,1,1037616,"2023-10-27T00:00:00.000Z",421,3,"Dennis Smith Jr.",0,1,2,1,2,1.7
"5949",1684,0,0,0,0,0,0,0,0,0,0,0,0,0,0,0,0,1037616,"2023-10-27T00:00:00.000Z",17896058,3,"Trendon Watford",0,0,0,0,0,0
"5950",1685,0,0,0,0,0,0,0,0,0,0,0,0,0,0,0,0,1037616,"2023-10-27T00:00:00.000Z",56677722,3,"Jalen Wilson",0,0,0,0,0,0
"5951",1686,0,0,0,0,0,0,0,0,0,0,0,0,0,0,0,0,1037616,"2023-10-27T00:00:00.000Z",666508,3,"Nicolas Claxton",0,0,0,0,0,0
"5952",1687,0,0,0,0,0,0,0,0,0,0,0,0,0,0,0,0,1037616,"2023-10-27T00:00:00.000Z",666679,3,"Cameron Johnson",0,0,0,0,0,0
"5953",1688,0,0,0,0,0,0,0,0,0,0,0,0,0,0,0,0,1037616,"2023-10-27T00:00:00.000Z",56677841,3,"Dariq Whitehead",0,0,0,0,0,0
"5954",1689,3,0,1,2,0,7,2,0,0,18,0,6,4,1,1,3,1037617,"2023-10-27T00:00:00.000Z",139,29,"Kris Dunn",1,5,8,7,4,9.7
"5955",1690,2,0,2,3,2,5,3,0,0,12,1,2,8,3,0,1,1037617,"2023-10-27T00:00:00.000Z",56677834,29,"Keyonte George",0,11,13,10,5,13.6
"5956",1691,0,0,0,0,0,0,0,0,0,0,0,0,0,0,0,0,1037617,"2023-10-27T00:00:00.000Z",38017739,29,"Simone Fontecchio",0,0,0,0,0,0
"5957",1692,0,0,0,0,0,0,0,0,0,0,0,0,0,0,0,0,1037617,"2023-10-27T00:00:00.000Z",56677824,29,"Taylor Hendricks",0,0,0,0,0,0
"5958",1693,0,0,0,0,0,0,0,0,0,0,0,0,0,0,0,0,1037617,"2023-10-27T00:00:00.000Z",666881,29,"Luka Samanic",0,0,0,0,0,0
"5959",1694,0,0,0,0,0,0,0,0,0,0,0,0,0,0,0,0,1037617,"2023-10-27T00:00:00.000Z",56677842,29,"Brice Sensabaugh",0,0,0,0,0,0
"5960",1695,0,0,0,0,0,0,0,0,0,0,0,0,0,0,0,0,1037611,"2023-10-27T00:00:00.000Z",17896063,20,"Jericho Sims",0,0,0,0,0,0
"5961",1696,0,0,0,0,0,0,0,0,0,0,0,0,0,0,0,0,1037611,"2023-10-27T00:00:00.000Z",666971,20,"Dylan Windler",0,0,0,0,0,0
"5962",1697,0,0,0,0,0,0,0,0,0,0,0,0,0,0,0,0,1037617,"2023-10-27T00:00:00.000Z",11891374,29,"Omer Yurtseven",0,0,0,0,0,0
"5963",1698,0,0,0,0,0,0,0,0,0,0,0,0,0,0,0,0,1037617,"2023-10-27T00:00:00.000Z",17896023,29,"Josh Christopher",0,0,0,0,0,0
"5964",1699,0,0,0,0,0,0,0,0,0,0,0,0,0,0,0,0,1037617,"2023-10-27T00:00:00.000Z",38017630,29,"Johnny Juzang",0,0,0,0,0,0
"5965",1700,4,0,4,6,2,20,10,0,0,38,1,2,22,5,0,2,1037615,"2023-10-27T00:00:00.000Z",17895966,11,"Jalen Green",0,27,31,26,9,32
"5966",1701,6,0,4,0,0,16,10,7,5,35,1,3,25,5,0,2,1037807,"2023-11-22T00:00:00.000Z",666969,19,"Zion Williamson",0,30,36,31,11,38
"5967",1702,2,0,8,0,0,9,6,4,3,28,3,5,15,11,0,1,1037807,"2023-11-22T00:00:00.000Z",455,19,"Jonas Valanciunas",0,26,28,17,13,30.2
"5968",1703,3,1,5,4,0,6,1,6,5,39,0,4,7,5,3,2,1037807,"2023-11-22T00:00:00.000Z",17896024,19,"Herbert Jones",4,12,15,10,8,27.5
"5969",1704,0,0,4,5,0,9,2,4,4,29,3,2,8,7,1,0,1037807,"2023-11-22T00:00:00.000Z",38017677,19,"Dyson Daniels",1,15,15,8,7,19.4
"5970",1705,3,0,1,8,2,9,3,5,5,21,1,3,13,2,0,0,1037807,"2023-11-22T00:00:00.000Z",56677837,19,"Jordan Hawkins",0,15,18,16,5,19.9
"5971",1706,4,1,4,2,2,5,4,3,2,20,2,0,12,6,1,1,1037807,"2023-11-22T00:00:00.000Z",3547293,19,"Naji Marshall",2,18,22,16,10,30.2
"5972",1707,2,0,1,6,2,9,4,4,0,19,0,2,10,1,3,1,1037807,"2023-11-22T00:00:00.000Z",17896097,19,"Jose Alvarado",3,11,13,12,3,22.2
"5973",1708,0,0,0,0,0,0,0,0,0,0,0,0,0,0,0,0,1037807,"2023-11-22T00:00:00.000Z",3547260,19,"Kira Lewis Jr.",0,0,0,0,0,0
"5974",1709,0,1,4,4,2,9,5,3,2,27,0,0,14,4,2,2,3277499,"2023-11-24T00:00:00.000Z",38017729,15,"David Roddy",3,18,18,14,4,25.8
"5975",1710,1,0,2,1,1,9,8,0,0,21,0,0,17,2,1,1,3277499,"2023-11-24T00:00:00.000Z",401,15,"Derrick Rose",1,19,20,18,3,22.9
"5976",1711,1,0,5,2,1,2,1,0,0,14,0,4,3,5,0,0,3277499,"2023-11-24T00:00:00.000Z",38017731,15,"Vince Williams Jr.",0,8,9,4,6,10.5
"5977",1712,0,0,0,0,0,1,1,0,0,2,0,1,2,0,0,0,3277499,"2023-11-24T00:00:00.000Z",38017732,15,"Kenneth Lofton Jr.",0,2,2,2,0,2
"5978",1713,1,0,0,1,0,1,0,0,0,2,0,1,0,0,0,0,3277499,"2023-11-24T00:00:00.000Z",17896027,15,"Ziaire Williams",0,0,1,1,1,1.5
"5979",1714,0,0,0,0,0,0,0,0,0,2,0,0,0,0,0,0,3277499,"2023-11-24T00:00:00.000Z",666809,15,"Jaylen Nowell",0,0,0,0,0,0
"5980",1715,0,0,0,0,0,0,0,0,0,0,0,0,0,0,0,0,3277499,"2023-11-24T00:00:00.000Z",3,15,"Steven Adams",0,0,0,0,0,0
"5981",1716,0,0,0,0,0,0,0,0,0,0,0,0,0,0,0,0,3277499,"2023-11-24T00:00:00.000Z",666505,15,"Brandon Clarke",0,0,0,0,0,0
"5982",1717,0,0,0,0,0,0,0,0,0,0,0,0,0,0,0,0,3277499,"2023-11-24T00:00:00.000Z",254,15,"Luke Kennard",0,0,0,0,0,0
"5983",1718,0,0,0,0,0,0,0,0,0,0,0,0,0,0,0,0,3277499,"2023-11-24T00:00:00.000Z",38017728,15,"Jake LaRavia",0,0,0,0,0,0
"5984",1719,0,0,0,0,0,0,0,0,0,0,0,0,0,0,0,0,3277499,"2023-11-24T00:00:00.000Z",666786,15,"Ja Morant",0,0,0,0,0,0
"5985",1720,0,0,0,0,0,0,0,0,0,0,0,0,0,0,0,0,3277499,"2023-11-24T00:00:00.000Z",420,15,"Marcus Smart",0,0,0,0,0,0
"5986",1721,0,0,0,0,0,0,0,0,0,0,0,0,0,0,0,0,3277499,"2023-11-24T00:00:00.000Z",3547285,15,"Xavier Tillman",0,0,0,0,0,0
"5987",1722,2,0,1,11,4,15,6,4,4,34,0,0,20,1,0,2,3277499,"2023-11-24T00:00:00.000Z",178,24,"Eric Gordon",0,21,23,22,3,22.2
"5988",1723,1,2,3,1,0,5,2,2,2,24,1,0,6,4,1,0,3277499,"2023-11-24T00:00:00.000Z",32,24,"Keita Bates-Diop",3,10,11,7,5,21.3
"5989",1724,6,2,9,2,0,4,2,4,2,33,1,2,6,10,2,2,3277499,"2023-11-24T00:00:00.000Z",349,24,"Jusuf Nurkic",4,16,22,12,16,37
"5990",1725,3,1,2,4,2,9,5,3,2,37,0,2,14,2,0,1,3277499,"2023-11-24T00:00:00.000Z",8,24,"Grayson Allen",1,16,19,17,5,22.9
"5991",1726,0,0,0,0,0,0,0,0,0,0,0,0,0,0,0,0,1037952,"2023-12-19T00:00:00.000Z",401,15,"Derrick Rose",0,0,0,0,0,0
"5992",1727,0,0,7,5,1,10,5,1,0,33,2,3,11,9,2,0,1037955,"2023-12-19T00:00:00.000Z",8,24,"Grayson Allen",2,20,20,11,9,27.8
"5993",1728,7,0,3,5,1,25,11,4,3,38,0,3,26,3,0,1,1037955,"2023-12-19T00:00:00.000Z",57,24,"Devin Booker",0,29,36,33,10,39.1
"5994",1729,0,0,0,0,0,0,0,0,0,0,0,0,0,0,0,0,1037955,"2023-12-19T00:00:00.000Z",32,24,"Keita Bates-Diop",0,0,0,0,0,0
"5995",1730,0,0,0,0,0,0,0,0,0,0,0,0,0,0,0,0,1037955,"2023-12-19T00:00:00.000Z",666451,24,"Bol Bol",0,0,0,0,0,0
"5996",1731,8,0,8,2,0,11,4,2,1,33,3,3,9,11,0,0,1037953,"2023-12-19T00:00:00.000Z",38017699,27,"Jeremy Sochan",0,20,28,17,19,34.2
"5997",1732,1,0,10,1,0,13,9,12,10,35,2,2,28,12,0,5,1037953,"2023-12-19T00:00:00.000Z",666682,27,"Keldon Johnson",0,40,41,29,13,38.9
"5998",1733,2,2,6,7,4,16,9,0,0,29,2,3,22,8,1,4,1037953,"2023-12-19T00:00:00.000Z",102,27,"Zach Collins",3,30,32,24,10,39.6
"5999",1734,2,0,3,5,2,17,7,1,1,33,0,0,17,3,0,2,1037953,"2023-12-19T00:00:00.000Z",3547246,27,"Devin Vassell",0,20,22,19,5,21.6
"6000",1735,0,0,0,3,0,6,3,0,0,6,0,0,6,0,0,1,1037957,"2023-12-20T00:00:00.000Z",56677846,4,"Nick Smith Jr.",0,6,6,6,0,5
"6001",1736,0,0,0,0,0,0,0,0,0,4,0,0,0,0,0,0,1037957,"2023-12-20T00:00:00.000Z",56677866,4,"Leaky Black",0,0,0,0,0,0
"6002",1737,2,0,5,3,1,3,1,0,0,30,2,4,3,7,0,0,1037956,"2023-12-20T00:00:00.000Z",666940,6,"Dean Wade",0,10,12,5,9,14.4
"6003",1738,3,0,5,0,0,13,8,2,1,29,3,1,17,8,2,2,1037956,"2023-12-20T00:00:00.000Z",9,6,"Jarrett Allen",2,25,28,20,11,35.1
"6004",1739,4,0,3,12,6,15,6,0,0,33,1,3,18,4,0,5,1037956,"2023-12-20T00:00:00.000Z",666908,6,"Max Strus",0,22,26,22,8,23.8
"6005",1740,6,3,4,2,0,7,2,2,2,25,3,0,6,7,0,0,1037956,"2023-12-20T00:00:00.000Z",56677872,6,"Craig Porter",3,13,19,12,13,32.4
"6006",1741,0,0,0,0,0,0,0,0,0,0,0,0,0,0,0,0,1037956,"2023-12-20T00:00:00.000Z",56677847,6,"Emoni Bates",0,0,0,0,0,0
"6007",1742,0,0,0,0,0,0,0,0,0,0,0,0,0,0,0,0,1037956,"2023-12-20T00:00:00.000Z",248,6,"Damian Jones",0,0,0,0,0,0
"6008",1743,0,0,0,0,0,0,0,0,0,0,0,0,0,0,0,0,1037957,"2023-12-20T00:00:00.000Z",56677778,12,"Oscar Tshiebwe",0,0,0,0,0,0
"6009",1744,0,0,0,0,0,0,0,0,0,0,0,0,0,0,0,0,1037957,"2023-12-20T00:00:00.000Z",56677832,12,"Jarace Walker",0,0,0,0,0,0
"6010",1745,0,0,0,0,0,0,0,0,0,0,0,0,0,0,0,0,1037957,"2023-12-20T00:00:00.000Z",56677794,12,"Isaiah Wong",0,0,0,0,0,0
"6011",1746,3,0,1,1,1,5,3,6,4,24,0,0,11,1,0,2,1037957,"2023-12-20T00:00:00.000Z",204,4,"Gordon Hayward",0,12,15,14,4,14.7
"6012",1747,3,0,3,2,0,17,8,4,3,37,1,2,19,4,3,0,1037957,"2023-12-20T00:00:00.000Z",62,4,"Miles Bridges",3,23,26,22,7,37.3
"6013",1748,0,0,2,0,0,4,2,0,0,19,6,3,4,8,0,0,1037957,"2023-12-20T00:00:00.000Z",3547282,4,"Nick Richards",0,12,12,4,8,13.6
"6014",1749,3,0,4,4,2,17,9,2,1,33,2,4,21,6,1,1,1037957,"2023-12-20T00:00:00.000Z",56677823,4,"Brandon Miller",1,27,30,24,9,34.7
"6015",1750,5,1,6,4,0,14,5,6,5,32,0,1,15,6,2,0,1037958,"2023-12-20T00:00:00.000Z",17896026,22,"Franz Wagner",3,21,26,20,11,38.7
"6016",1751,0,0,0,0,0,0,0,0,0,1,0,0,0,0,0,0,1037593,"2023-10-24T00:00:00.000Z",56677836,14,"Maxwell Lewis",0,0,0,0,0,0
"6017",1752,3,1,6,11,3,18,6,0,0,36,1,3,15,7,0,3,1037594,"2023-10-24T00:00:00.000Z",443,10,"Klay Thompson",1,22,25,18,10,27.9
"6018",1753,0,1,0,3,0,12,4,3,2,27,1,3,10,1,0,0,1037594,"2023-10-24T00:00:00.000Z",475,10,"Andrew Wiggins",1,11,11,10,1,14.2
"6019",1754,1,0,6,0,0,6,3,1,1,28,5,2,7,11,0,2,1037594,"2023-10-24T00:00:00.000Z",282,10,"Kevon Looney",0,18,19,8,12,19.7
"6020",1755,9,0,5,6,0,15,4,7,6,34,1,0,14,6,2,1,1037594,"2023-10-24T00:00:00.000Z",367,10,"Chris Paul",2,20,29,23,15,39.7
"6021",1756,1,0,4,14,4,20,8,7,7,31,1,5,27,5,1,2,1037594,"2023-10-24T00:00:00.000Z",115,10,"Stephen Curry",1,32,33,28,6,35.5
"6022",1757,1,0,0,0,0,0,0,0,0,4,1,0,0,1,0,0,1037594,"2023-10-24T00:00:00.000Z",251,10,"Cory Joseph",0,1,2,1,2,2.7
"6023",1758,4,0,4,2,1,11,4,7,5,31,4,2,14,8,2,2,1037593,"2023-10-24T00:00:00.000Z",17553995,14,"Austin Reaves",2,22,26,18,12,33.6
"6024",1759,7,0,4,5,2,12,4,2,1,36,0,3,11,4,1,3,1037593,"2023-10-24T00:00:00.000Z",405,14,"D'Angelo Russell",1,15,22,18,11,26.3
"6025",1760,2,0,0,4,0,8,3,0,0,22,1,3,6,1,1,2,1037593,"2023-10-24T00:00:00.000Z",1603383,14,"Gabe Vincent",1,7,9,8,3,11.2
"6026",1761,0,0,3,1,0,4,3,2,1,16,1,1,7,4,0,1,1037593,"2023-10-24T00:00:00.000Z",486,14,"Christian Wood",0,11,11,7,4,10.8
"6027",1762,0,0,0,0,0,0,0,0,0,0,0,0,0,0,0,0,1037594,"2023-10-24T00:00:00.000Z",56677799,10,"Trayce Jackson-Davis",0,0,0,0,0,0
"6028",1763,0,0,0,0,0,0,0,0,0,0,0,0,0,0,0,0,1037593,"2023-10-24T00:00:00.000Z",56677738,14,"Colin Castleton",0,0,0,0,0,0
"6029",1764,0,0,0,0,0,0,0,0,0,0,0,0,0,0,0,0,1037593,"2023-10-24T00:00:00.000Z",56677867,14,"Alex Fudge",0,0,0,0,0,0
"6030",1765,0,0,0,0,0,0,0,0,0,0,0,0,0,0,0,0,1037593,"2023-10-24T00:00:00.000Z",56677868,14,"D'Moi Hodge",0,0,0,0,0,0
"6031",1766,0,0,0,0,0,0,0,0,0,0,0,0,0,0,0,0,1037593,"2023-10-24T00:00:00.000Z",56677835,14,"Jalen Hood-Schifino",0,0,0,0,0,0
"6032",1767,0,0,0,0,0,0,0,0,0,0,0,0,0,0,0,0,1037593,"2023-10-24T00:00:00.000Z",457,14,"Jarred Vanderbilt",0,0,0,0,0,0
"6033",1768,0,0,0,0,0,0,0,0,0,0,0,0,0,0,0,0,1037594,"2023-10-24T00:00:00.000Z",3547095,24,"Udoka Azubuike",0,0,0,0,0,0
"6034",1769,0,0,0,0,0,0,0,0,0,0,0,0,0,0,0,0,1037594,"2023-10-24T00:00:00.000Z",32,24,"Keita Bates-Diop",0,0,0,0,0,0
"6035",1770,0,0,0,0,0,0,0,0,0,0,0,0,0,0,0,0,1037594,"2023-10-24T00:00:00.000Z",666451,24,"Bol Bol",0,0,0,0,0,0
"6036",1771,0,0,0,0,0,0,0,0,0,0,0,0,0,0,0,0,1037594,"2023-10-24T00:00:00.000Z",3547298,24,"Saben Lee",0,0,0,0,0,0
"6037",1772,1,1,3,0,0,8,4,6,4,20,3,5,12,6,2,2,1037594,"2023-10-24T00:00:00.000Z",17553979,10,"Jonathan Kuminga",3,18,19,13,7,27.7
"6038",1773,2,0,2,2,0,5,0,2,1,22,0,1,1,2,3,0,1037594,"2023-10-24T00:00:00.000Z",2189,10,"Gary Payton II",3,3,5,3,4,15.4
"6039",1774,0,1,2,4,2,6,4,2,1,18,1,1,11,3,3,1,1037594,"2023-10-24T00:00:00.000Z",17553992,10,"Moses Moody",4,14,14,11,3,25.6
"6040",1775,1,2,3,3,1,11,3,0,0,20,4,3,7,7,0,0,1037594,"2023-10-24T00:00:00.000Z",407,10,"Dario Saric",2,14,15,8,8,22.9
"6041",1776,0,0,0,0,0,1,0,0,0,4,0,2,0,0,0,2,3277452,"2023-11-17T00:00:00.000Z",3547268,8,"Zeke Nnaji",0,0,0,0,0,-2
"6042",1777,0,0,0,0,0,0,0,0,0,0,0,0,0,0,0,0,3277448,"2023-11-17T00:00:00.000Z",666676,6,"Ty Jerome",0,0,0,0,0,0
"6043",1778,0,0,0,0,0,0,0,0,0,0,0,0,0,0,0,0,3277448,"2023-11-17T00:00:00.000Z",322,6,"Donovan Mitchell",0,0,0,0,0,0
"6044",1779,0,0,0,0,0,0,0,0,0,0,0,0,0,0,0,0,3277448,"2023-11-17T00:00:00.000Z",38017662,6,"Isaiah Mobley",0,0,0,0,0,0
"6045",1780,0,0,0,0,0,0,0,0,0,0,0,0,0,0,0,0,3277446,"2023-11-17T00:00:00.000Z",17896089,20,"Duane Washington Jr.",0,0,0,0,0,0
"6046",1781,0,0,0,0,0,0,0,0,0,0,0,0,0,0,0,0,3277446,"2023-11-17T00:00:00.000Z",666971,20,"Dylan Windler",0,0,0,0,0,0
"6047",1782,0,0,0,0,0,0,0,0,0,0,0,0,0,0,0,0,3277448,"2023-11-17T00:00:00.000Z",3547247,6,"Isaac Okoro",0,0,0,0,0,0
"6048",1783,0,0,0,0,0,0,0,0,0,0,0,0,0,0,0,0,3277448,"2023-11-17T00:00:00.000Z",404,6,"Ricky Rubio",0,0,0,0,0,0
"6049",1784,2,0,5,1,0,8,4,3,1,17,5,4,9,10,0,5,3277448,"2023-11-17T00:00:00.000Z",56677826,9,"Ausar Thompson",0,19,21,11,12,19
"6050",1785,0,1,7,4,1,10,5,0,0,31,4,3,11,11,1,0,3277448,"2023-11-17T00:00:00.000Z",259,9,"Kevin Knox",2,22,22,11,11,30.2
"6051",1786,2,3,6,4,1,11,4,2,2,31,4,0,11,10,1,1,3277448,"2023-11-17T00:00:00.000Z",3547267,9,"Isaiah Stewart",4,21,23,13,12,37
"6052",1787,8,0,4,7,2,21,9,0,0,34,1,4,20,5,0,4,3277448,"2023-11-17T00:00:00.000Z",17896075,9,"Cade Cunningham",0,25,33,28,13,34
"6053",1788,2,1,0,2,0,6,2,0,0,22,0,0,4,0,1,0,3277448,"2023-11-17T00:00:00.000Z",3547241,9,"Killian Hayes",2,4,6,6,2,13
"6054",1789,1,0,1,9,2,14,4,0,0,24,2,3,10,3,1,0,3277448,"2023-11-17T00:00:00.000Z",77,9,"Alec Burks",1,13,14,11,4,18.1
"6055",1790,0,0,0,0,0,0,0,0,0,0,0,0,0,0,0,0,3277449,"2023-11-17T00:00:00.000Z",436,28,"Garrett Temple",0,0,0,0,0,0
"6056",1791,0,0,0,0,0,0,0,0,0,0,0,0,0,0,0,0,3277449,"2023-11-17T00:00:00.000Z",56677805,28,"Javon Freeman-Liberty",0,0,0,0,0,0
"6057",1792,0,0,0,0,0,0,0,0,0,0,0,0,0,0,0,0,3277449,"2023-11-17T00:00:00.000Z",38017717,28,"Ron Harper Jr.",0,0,0,0,0,0
"6058",1793,0,0,0,0,0,0,0,0,0,0,0,0,0,0,0,0,3277449,"2023-11-17T00:00:00.000Z",38017710,28,"Christian Koloko",0,0,0,0,0,0
"6059",1794,0,0,0,0,0,0,0,0,0,0,0,0,0,0,0,0,3277449,"2023-11-17T00:00:00.000Z",56677869,28,"Markquis Nowell",0,0,0,0,0,0
"6060",1795,0,0,0,0,0,0,0,0,0,0,0,0,0,0,0,0,3277449,"2023-11-17T00:00:00.000Z",376,28,"Otto Porter Jr.",0,0,0,0,0,0
"6061",1796,0,0,0,0,0,0,0,0,0,0,0,0,0,0,0,0,3277449,"2023-11-17T00:00:00.000Z",338,2,"Svi Mykhailiuk",0,0,0,0,0,0
"6062",1797,1,0,0,0,0,2,2,0,0,8,0,1,4,0,0,1,3277450,"2023-11-17T00:00:00.000Z",306,26,"JaVale McGee",0,4,5,5,1,4.5
"6063",1798,0,0,3,3,2,4,2,0,0,15,0,2,6,3,2,2,3277450,"2023-11-17T00:00:00.000Z",17896030,26,"Chris Duarte",2,9,9,6,3,13.6
"6064",1799,0,0,0,0,0,0,0,0,0,0,0,0,0,0,0,0,3277450,"2023-11-17T00:00:00.000Z",17895990,26,"Jordan Ford",0,0,0,0,0,0
"6065",1800,0,0,0,0,0,0,0,0,0,0,0,0,0,0,0,0,3277450,"2023-11-17T00:00:00.000Z",56677845,26,"Colby Jones",0,0,0,0,0,0
"6066",1801,2,0,9,1,0,8,2,6,5,24,1,4,9,10,0,2,1037906,"2023-12-13T00:00:00.000Z",17896062,11,"Alperen Sengun",0,19,21,11,12,22
"6067",1802,0,0,0,0,0,0,0,0,0,0,0,0,0,0,0,0,1037904,"2023-12-13T00:00:00.000Z",56677866,4,"Leaky Black",0,0,0,0,0,0
"6068",1803,4,0,4,5,0,12,2,4,4,24,0,3,8,4,0,3,1037906,"2023-12-13T00:00:00.000Z",17895966,11,"Jalen Green",0,12,16,12,8,15.8
"6069",1804,9,0,5,3,0,8,2,9,7,39,0,4,11,5,3,3,1037906,"2023-12-13T00:00:00.000Z",458,11,"Fred VanVleet",3,16,25,20,14,36.5
"6070",1805,0,0,0,4,2,4,2,0,0,7,0,0,6,0,0,0,1037906,"2023-12-13T00:00:00.000Z",75,11,"Reggie Bullock",0,6,6,6,0,6
"6071",1806,1,2,6,5,3,9,5,0,0,30,2,0,13,8,1,0,1037905,"2023-12-13T00:00:00.000Z",3547244,1,"Onyeka Okongwu",3,21,22,14,9,33.1
"6072",1807,0,0,0,0,0,0,0,0,0,0,0,0,0,0,0,0,1037905,"2023-12-13T00:00:00.000Z",56677838,1,"Kobe Bufkin",0,0,0,0,0,0
"6073",1808,0,0,0,0,0,0,0,0,0,0,0,0,0,0,0,0,1037905,"2023-12-13T00:00:00.000Z",38017689,1,"AJ Griffin",0,0,0,0,0,0
"6074",1809,0,0,0,0,0,0,0,0,0,0,0,0,0,0,0,0,1037905,"2023-12-13T00:00:00.000Z",56677806,1,"Mouhamed Gueye",0,0,0,0,0,0
"6075",1810,0,0,0,0,0,0,0,0,0,0,0,0,0,0,0,0,1037902,"2023-12-13T00:00:00.000Z",330,9,"Monte Morris",0,0,0,0,0,0
"6076",1811,0,0,3,0,0,3,1,3,3,13,1,2,5,4,0,3,1037902,"2023-12-13T00:00:00.000Z",3547270,23,"Paul Reed",0,9,9,5,4,6.8
"6077",1812,2,0,0,1,1,2,1,4,2,7,0,1,5,0,0,0,1037902,"2023-12-13T00:00:00.000Z",17896025,23,"Jaden Springer",0,5,7,7,2,8
"6078",1813,1,0,0,1,0,3,0,0,0,7,0,0,0,0,0,0,1037902,"2023-12-13T00:00:00.000Z",2175,23,"Danuel House Jr.",0,0,1,1,1,1.5
"6079",1814,0,0,0,1,0,1,0,0,0,5,0,0,0,0,0,0,1037902,"2023-12-13T00:00:00.000Z",260,23,"Furkan Korkmaz",0,0,0,0,0,0
"6080",1815,1,0,1,0,0,1,1,0,0,4,1,0,2,2,1,0,1037902,"2023-12-13T00:00:00.000Z",3547294,23,"Kenyon Martin Jr.",1,4,5,3,3,8.9
"6081",1816,0,0,0,0,0,0,0,0,0,0,0,0,0,0,0,0,1037902,"2023-12-13T00:00:00.000Z",56913527,23,"Ricky Council IV",0,0,0,0,0,0
"6082",1817,0,0,0,0,0,0,0,0,0,0,0,0,0,0,0,0,1037905,"2023-12-13T00:00:00.000Z",666656,1,"De'Andre Hunter",0,0,0,0,0,0
"6083",1818,0,0,0,0,0,0,0,0,0,0,0,0,0,0,0,0,1037905,"2023-12-13T00:00:00.000Z",17896040,1,"Jalen Johnson",0,0,0,0,0,0
"6084",1819,0,0,0,0,0,0,0,0,0,0,0,0,0,0,0,0,1037905,"2023-12-13T00:00:00.000Z",56677875,1,"Miles Norris",0,0,0,0,0,0
"6085",1820,0,0,0,0,0,0,0,0,0,0,0,0,0,0,0,0,1037902,"2023-12-13T00:00:00.000Z",17554001,23,"Javonte Smart",0,0,0,0,0,0
"6086",1821,0,0,0,0,0,0,0,0,0,0,0,0,0,0,0,0,1037902,"2023-12-13T00:00:00.000Z",56677788,23,"Terquavion Smith",0,0,0,0,0,0
"6087",1822,2,1,0,3,2,6,2,0,0,14,0,2,6,0,0,1,1037906,"2023-12-13T00:00:00.000Z",213,11,"Aaron Holiday",1,6,8,8,2,11
"6088",1823,3,0,4,4,1,9,4,3,1,23,3,1,10,7,1,0,1037906,"2023-12-13T00:00:00.000Z",3547301,11,"Jae'Sean Tate",1,17,20,13,10,25.9
"6089",1824,0,0,1,0,0,2,1,0,0,11,2,2,2,3,0,0,1037906,"2023-12-13T00:00:00.000Z",19465326,11,"Jock Landale",0,5,5,2,3,5.6
"6090",1825,1,1,8,4,3,16,10,4,2,27,6,2,25,14,1,3,1037906,"2023-12-13T00:00:00.000Z",38017695,11,"Tari Eason",2,39,40,26,15,46.3
"6091",1826,1,0,1,1,0,2,1,4,3,6,0,1,5,1,0,0,1038071,"2024-01-05T00:00:00.000Z",17896094,2,"Dalano Banton",0,6,7,6,2,7.7
"6092",1827,2,0,2,1,0,4,2,2,2,14,0,0,6,2,1,2,1038072,"2024-01-05T00:00:00.000Z",3547297,1,"Trent Forrest",1,8,10,8,4,12.4
"6093",1828,1,1,2,0,0,1,1,2,1,21,4,1,3,6,0,0,1038072,"2024-01-05T00:00:00.000Z",3547244,1,"Onyeka Okongwu",1,9,10,4,7,14.7
"6094",1829,2,0,2,3,2,3,2,0,0,20,1,1,6,3,0,1,1038072,"2024-01-05T00:00:00.000Z",666754,1,"Garrison Mathews",0,9,11,8,5,11.6
"6095",1830,0,0,0,2,1,2,1,0,0,7,0,0,3,0,0,0,1038072,"2024-01-05T00:00:00.000Z",56677855,1,"Seth Lundy",0,3,3,3,0,3
"6096",1831,0,0,0,3,1,3,1,0,0,7,0,0,3,0,0,2,1038072,"2024-01-05T00:00:00.000Z",38017689,1,"AJ Griffin",0,3,3,3,0,1
"6097",1832,0,1,2,0,0,2,2,2,2,7,0,1,6,2,0,0,1038072,"2024-01-05T00:00:00.000Z",666564,1,"Bruno Fernando",1,8,8,6,2,11.4
"6098",1833,0,0,0,0,0,0,0,0,0,0,0,0,0,0,0,0,1038072,"2024-01-05T00:00:00.000Z",301,1,"Wesley Matthews",0,0,0,0,0,0
"6099",1834,0,0,0,0,0,0,0,0,0,0,0,0,0,0,0,0,1038072,"2024-01-05T00:00:00.000Z",319,1,"Patty Mills",0,0,0,0,0,0
"6100",1835,0,0,0,0,0,0,0,0,0,0,0,0,0,0,0,0,1038072,"2024-01-05T00:00:00.000Z",56677838,1,"Kobe Bufkin",0,0,0,0,0,0
"6101",1836,0,0,0,0,0,0,0,0,0,0,0,0,0,0,0,0,1038072,"2024-01-05T00:00:00.000Z",56677806,1,"Mouhamed Gueye",0,0,0,0,0,0
"6102",1837,0,0,0,0,0,0,0,0,0,0,0,0,0,0,0,0,1038072,"2024-01-05T00:00:00.000Z",666656,1,"De'Andre Hunter",0,0,0,0,0,0
"6103",1838,0,0,0,0,0,0,0,0,0,0,0,0,0,0,0,0,1038072,"2024-01-05T00:00:00.000Z",4197387,1,"Vit Krejci",0,0,0,0,0,0
"6104",1839,2,0,2,2,0,5,2,2,2,17,1,3,6,3,2,0,1038071,"2024-01-05T00:00:00.000Z",666468,2,"Oshae Brissett",2,9,11,8,5,18.6
"6105",1840,1,0,4,7,3,10,5,0,0,23,1,1,13,5,1,0,1038071,"2024-01-05T00:00:00.000Z",17896060,2,"Sam Hauser",1,18,19,14,6,23.5
"6106",1841,4,0,1,7,1,10,3,0,0,23,1,3,7,2,1,3,1038071,"2024-01-05T00:00:00.000Z",3547276,2,"Payton Pritchard",1,9,13,11,6,15.4
"6107",1842,0,1,3,0,0,3,1,0,0,11,4,1,2,7,1,1,1038071,"2024-01-05T00:00:00.000Z",261,2,"Luke Kornet",2,9,9,2,7,15.4
"6108",1843,0,0,3,6,1,7,1,0,0,15,0,2,3,3,0,0,1038071,"2024-01-05T00:00:00.000Z",338,2,"Svi Mykhailiuk",0,6,6,3,3,6.6
"6109",1844,0,1,4,1,0,4,2,0,0,12,1,1,4,5,1,1,1038071,"2024-01-05T00:00:00.000Z",3547279,2,"Lamar Stevens",2,9,9,4,5,15
"6110",1845,0,0,0,0,0,1,0,0,0,4,0,2,0,0,0,0,1038071,"2024-01-05T00:00:00.000Z",17553967,2,"Neemias Queta",0,0,0,0,0,0
"6111",1846,0,0,0,0,0,0,0,0,0,0,0,0,0,0,0,0,1038071,"2024-01-05T00:00:00.000Z",38017707,2,"JD Davison",0,0,0,0,0,0
"6112",1847,0,0,0,0,0,0,0,0,0,0,0,0,0,0,0,0,1038071,"2024-01-05T00:00:00.000Z",219,2,"Al Horford",0,0,0,0,0,0
"6113",1849,0,0,0,0,0,0,0,0,0,0,0,0,0,0,0,0,1038071,"2024-01-05T00:00:00.000Z",56677864,2,"Jordan Walsh",0,0,0,0,0,0
"6114",1850,3,0,3,5,2,7,2,2,1,25,1,2,7,4,1,2,1038071,"2024-01-05T00:00:00.000Z",38017739,29,"Simone Fontecchio",1,11,14,10,7,17.3
"6115",1851,1,3,11,0,0,15,8,16,14,36,0,5,30,11,1,4,1037703,"2023-11-08T00:00:00.000Z",4,16,"Bam Adebayo",4,41,42,31,12,52.7
"6116",1852,2,0,2,0,0,0,0,2,1,13,0,2,1,2,1,2,1037706,"2023-11-08T00:00:00.000Z",444,6,"Tristan Thompson",1,3,5,3,4,7.4
"6117",1853,0,0,0,0,0,0,0,0,0,0,0,0,0,0,0,0,1037706,"2023-11-08T00:00:00.000Z",3547247,6,"Isaac Okoro",0,0,0,0,0,0
"6118",1854,0,0,0,0,0,0,0,0,0,0,0,0,0,0,0,0,1037706,"2023-11-08T00:00:00.000Z",56677872,6,"Craig Porter",0,0,0,0,0,0
"6119",1855,0,0,3,0,0,5,4,2,1,11,3,3,9,6,0,1,1037702,"2023-11-08T00:00:00.000Z",188,11,"Jeff Green",0,15,15,9,6,15.2
"6120",1856,3,0,2,2,1,6,3,0,0,23,0,3,7,2,0,0,1037702,"2023-11-08T00:00:00.000Z",213,11,"Aaron Holiday",0,9,12,10,5,13.9
"6121",1857,1,1,0,6,2,10,6,0,0,27,1,3,14,1,0,0,1037702,"2023-11-08T00:00:00.000Z",3547301,11,"Jae'Sean Tate",1,15,16,15,2,19.7
"6122",1858,0,1,2,1,0,3,1,0,0,12,1,0,2,3,0,1,1037702,"2023-11-08T00:00:00.000Z",19465326,11,"Jock Landale",1,5,5,2,3,7.6
"6123",1859,1,0,0,1,0,4,2,2,1,8,0,0,5,0,1,0,1037702,"2023-11-08T00:00:00.000Z",47738533,11,"Jeenathan Williams",1,5,6,6,1,9.5
"6124",1860,0,0,5,0,0,4,3,1,0,6,2,1,6,7,0,0,1037702,"2023-11-08T00:00:00.000Z",296,11,"Boban Marjanovic",0,13,13,6,7,14.4
"6125",1861,0,0,0,0,0,0,0,0,0,0,0,0,0,0,0,0,1037702,"2023-11-08T00:00:00.000Z",3547281,11,"Nate Hinton",0,0,0,0,0,0
"6126",1862,0,0,0,0,0,0,0,0,0,0,0,0,0,0,0,0,1037702,"2023-11-08T00:00:00.000Z",357,11,"Victor Oladipo",0,0,0,0,0,0
"6127",1863,0,0,0,0,0,0,0,0,0,0,0,0,0,0,0,0,1037702,"2023-11-08T00:00:00.000Z",56677809,11,"Jermaine Samuels Jr.",0,0,0,0,0,0
"6128",1864,0,0,0,0,0,0,0,0,0,0,0,0,0,0,0,0,1037702,"2023-11-08T00:00:00.000Z",56677825,11,"Amen Thompson",0,0,0,0,0,0
"6129",1865,2,0,0,0,0,3,1,0,0,14,2,5,2,2,0,0,1037702,"2023-11-08T00:00:00.000Z",56677738,14,"Colin Castleton",0,4,6,4,4,7.4
"6130",1866,0,0,0,0,0,0,0,0,0,0,0,0,0,0,0,0,1037702,"2023-11-08T00:00:00.000Z",117,14,"Anthony Davis",0,0,0,0,0,0
"6131",1867,0,0,0,0,0,0,0,0,0,0,0,0,0,0,0,0,1037699,"2023-11-08T00:00:00.000Z",666679,3,"Cameron Johnson",0,0,0,0,0,0
"6132",1868,0,0,0,0,0,0,0,0,0,0,0,0,0,0,0,0,1037699,"2023-11-08T00:00:00.000Z",17896041,3,"Keon Johnson",0,0,0,0,0,0
"6133",1869,0,0,0,0,0,0,0,0,0,0,0,0,0,0,0,0,1037699,"2023-11-08T00:00:00.000Z",417,3,"Ben Simmons",0,0,0,0,0,0
"6134",1870,3,1,3,1,0,3,1,1,1,21,3,3,3,6,1,0,1037699,"2023-11-08T00:00:00.000Z",450,13,"PJ Tucker",2,9,12,6,9,20.7
"6135",1871,0,0,1,2,0,6,2,0,0,6,1,0,4,2,0,1,1037699,"2023-11-08T00:00:00.000Z",17896031,13,"Nah'Shon Hyland",0,6,6,4,2,5.4
"6136",1872,1,0,4,2,0,2,0,0,0,19,0,1,0,4,0,2,1037699,"2023-11-08T00:00:00.000Z",666743,13,"Terance Mann",0,4,5,1,5,4.3
"6137",1873,1,2,1,5,2,8,4,0,0,23,0,2,10,1,3,1,1037699,"2023-11-08T00:00:00.000Z",380,13,"Norman Powell",5,11,12,11,2,26.7
"6138",1874,0,0,0,0,0,0,0,0,0,0,0,0,0,0,0,0,1037699,"2023-11-08T00:00:00.000Z",17896022,13,"Brandon Boston Jr.",0,0,0,0,0,0
"6139",1875,0,0,0,0,0,0,0,0,0,0,0,0,0,0,0,0,1037699,"2023-11-08T00:00:00.000Z",56677856,13,"Jordan Miller",0,0,0,0,0,0
"6140",1876,0,0,0,0,0,0,0,0,0,0,0,0,0,0,0,0,7045522,"2023-12-04T00:00:00.000Z",56677845,26,"Colby Jones",0,0,0,0,0,0
"6141",1877,0,0,0,0,0,0,0,0,0,0,0,0,0,0,0,0,7045522,"2023-12-04T00:00:00.000Z",17553994,26,"Davion Mitchell",0,0,0,0,0,0
"6142",1878,0,0,0,0,0,0,0,0,0,0,0,0,0,0,0,0,7045521,"2023-12-04T00:00:00.000Z",56677864,2,"Jordan Walsh",0,0,0,0,0,0
"6143",1879,0,0,0,1,0,3,0,0,0,6,2,2,0,2,0,0,7045522,"2023-12-04T00:00:00.000Z",4197162,26,"Aleksandar Vezenkov",0,2,2,0,2,2.4
"6144",1880,0,0,0,0,0,0,0,0,0,0,0,0,0,0,0,0,7045522,"2023-12-04T00:00:00.000Z",56677862,26,"Jalen Slawson",0,0,0,0,0,0
"6145",1881,0,0,0,0,0,0,0,0,0,0,0,0,0,0,0,0,7045522,"2023-12-04T00:00:00.000Z",17896030,26,"Chris Duarte",0,0,0,0,0,0
"6146",1882,0,0,0,0,0,0,0,0,0,0,0,0,0,0,0,0,7045522,"2023-12-04T00:00:00.000Z",273,26,"Alex Len",0,0,0,0,0,0
"6147",1883,6,0,6,6,3,20,10,9,7,40,2,2,30,8,1,2,7045522,"2023-12-04T00:00:00.000Z",227,19,"Brandon Ingram",1,38,44,36,14,49.6
"6148",1884,6,0,5,2,0,8,5,0,0,28,1,3,10,6,3,4,7045522,"2023-12-04T00:00:00.000Z",666969,19,"Zion Williamson",3,16,22,16,12,31.2
"6149",1885,0,0,7,0,0,11,7,4,4,29,4,6,18,11,0,1,7045522,"2023-12-04T00:00:00.000Z",455,19,"Jonas Valanciunas",0,29,29,18,11,30.2
"6150",1886,5,2,2,5,3,13,8,4,4,35,3,5,23,5,0,1,7045522,"2023-12-04T00:00:00.000Z",17896024,19,"Herbert Jones",2,28,33,28,10,41.5
"6151",1887,7,2,2,5,3,14,7,0,0,36,0,2,17,2,2,2,7045522,"2023-12-04T00:00:00.000Z",303,19,"CJ McCollum",4,19,26,24,9,39.9
"6152",1888,2,0,2,2,0,3,1,2,2,13,2,1,4,4,1,1,7045522,"2023-12-04T00:00:00.000Z",3547293,19,"Naji Marshall",1,8,10,6,6,13.8
"6153",1889,2,2,3,3,2,4,3,2,1,18,0,1,9,3,2,1,7045522,"2023-12-04T00:00:00.000Z",17896097,19,"Jose Alvarado",4,12,14,11,5,26.6
"6154",1890,1,1,2,8,3,13,6,2,1,30,0,1,16,2,0,0,7045522,"2023-12-04T00:00:00.000Z",18677986,19,"Trey Murphy III",1,18,19,17,3,22.9
"6155",1891,0,0,0,0,0,0,0,0,0,5,0,0,0,0,1,0,7045522,"2023-12-04T00:00:00.000Z",491,19,"Cody Zeller",1,0,0,0,0,3
"6156",1892,0,0,0,0,0,1,0,0,0,6,1,1,0,1,2,0,7045522,"2023-12-04T00:00:00.000Z",38017677,19,"Dyson Daniels",2,1,1,0,1,7.2
"6157",1893,0,0,0,0,0,0,0,0,0,0,0,0,0,0,0,0,7045522,"2023-12-04T00:00:00.000Z",56677837,19,"Jordan Hawkins",0,0,0,0,0,0
"6158",1894,0,0,0,0,0,0,0,0,0,0,0,0,0,0,0,0,7045522,"2023-12-04T00:00:00.000Z",3547260,19,"Kira Lewis Jr.",0,0,0,0,0,0
"6159",1895,0,0,0,0,0,0,0,0,0,0,0,0,0,0,0,0,7045522,"2023-12-04T00:00:00.000Z",17896021,19,"Jeremiah Robinson-Earl",0,0,0,0,0,0
"6160",1896,0,0,0,0,0,0,0,0,0,0,0,0,0,0,0,0,7045522,"2023-12-04T00:00:00.000Z",38017663,19,"E.J. Liddell",0,0,0,0,0,0
"6161",1897,0,0,0,0,0,0,0,0,0,0,0,0,0,0,0,0,7045522,"2023-12-04T00:00:00.000Z",340,19,"Larry Nance Jr.",0,0,0,0,0,0
"6162",1898,0,0,0,0,0,0,0,0,0,0,0,0,0,0,0,0,7045522,"2023-12-04T00:00:00.000Z",17896017,19,"Matt Ryan",0,0,0,0,0,0
"6163",1899,0,0,0,0,0,0,0,0,0,0,0,0,0,0,0,0,7045522,"2023-12-04T00:00:00.000Z",38017726,19,"Dereon Seabron",0,0,0,0,0,0
"6164",1900,7,0,2,3,2,12,6,0,0,26,2,1,14,4,1,2,7045523,"2023-12-05T00:00:00.000Z",315,17,"Khris Middleton",1,18,25,21,11,30.3
"6165",1901,0,0,0,0,0,0,0,0,0,0,0,0,0,0,0,0,1038023,"2023-12-29T00:00:00.000Z",56677806,1,"Mouhamed Gueye",0,0,0,0,0,0
"6166",1902,0,0,2,0,0,2,1,0,0,8,0,1,2,2,1,1,1038030,"2023-12-29T00:00:00.000Z",48,15,"Bismack Biyombo",1,4,4,2,2,6.4
"6167",1903,5,0,7,5,2,11,7,2,2,37,0,3,18,7,2,2,1038030,"2023-12-29T00:00:00.000Z",3547287,15,"Desmond Bane",2,25,30,23,12,37.9
"6168",1904,10,0,6,7,0,19,7,6,5,37,0,4,19,6,0,3,1038030,"2023-12-29T00:00:00.000Z",666786,15,"Ja Morant",0,25,35,29,16,38.2
"6169",1905,1,0,4,3,2,7,5,0,0,22,1,1,12,5,1,0,1038030,"2023-12-29T00:00:00.000Z",17896067,15,"Santi Aldama",1,17,18,13,6,22.5
"6170",1906,1,0,2,1,0,3,1,3,2,22,0,1,4,2,0,1,1038030,"2023-12-29T00:00:00.000Z",38017729,15,"David Roddy",0,6,7,5,3,6.9
"6171",1907,0,0,0,0,0,0,0,0,0,0,0,0,0,0,0,0,1038030,"2023-12-29T00:00:00.000Z",48248287,15,"Jacob Gilyard",0,0,0,0,0,0
"6172",1908,0,0,0,0,0,0,0,0,0,0,0,0,0,0,0,0,1038030,"2023-12-29T00:00:00.000Z",666703,15,"John Konchar",0,0,0,0,0,0
"6173",1909,2,2,6,2,0,13,5,0,0,27,5,3,10,11,3,2,1038026,"2023-12-29T00:00:00.000Z",38017695,11,"Tari Eason",5,21,23,12,13,39.2
"6174",1910,1,0,2,0,0,1,0,2,1,9,1,1,1,3,0,0,1038026,"2023-12-29T00:00:00.000Z",56677825,11,"Amen Thompson",0,4,5,2,4,6.1
"6175",1911,0,0,0,0,0,0,0,0,0,0,0,0,0,0,0,0,1038026,"2023-12-29T00:00:00.000Z",75,11,"Reggie Bullock",0,0,0,0,0,0
"6176",1912,0,0,0,0,0,0,0,0,0,0,0,0,0,0,0,0,1038026,"2023-12-29T00:00:00.000Z",56677809,11,"Jermaine Samuels Jr.",0,0,0,0,0,0
"6177",1913,0,0,0,0,0,0,0,0,0,0,0,0,0,0,0,0,1038026,"2023-12-29T00:00:00.000Z",38017684,11,"Jabari Smith Jr.",0,0,0,0,0,0
"6178",1914,0,0,0,0,0,0,0,0,0,0,0,0,0,0,0,0,1038026,"2023-12-29T00:00:00.000Z",47738533,11,"Jeenathan Williams",0,0,0,0,0,0
"6179",1915,1,0,1,4,3,7,4,2,2,24,0,1,13,1,0,3,1038026,"2023-12-29T00:00:00.000Z",360,23,"Kelly Oubre Jr.",0,14,15,14,2,12.7
"6180",1916,7,3,3,6,2,18,10,0,0,35,1,3,22,4,4,3,1038026,"2023-12-29T00:00:00.000Z",200,23,"Tobias Harris",7,26,33,29,11,55.3
"6181",1917,4,0,0,0,0,5,3,2,1,24,2,3,7,2,1,0,1038026,"2023-12-29T00:00:00.000Z",3547270,23,"Paul Reed",1,9,13,11,6,18.4
"6182",1918,2,0,3,7,2,12,5,4,3,36,0,1,15,3,1,2,1038026,"2023-12-29T00:00:00.000Z",313,23,"De'Anthony Melton",1,18,20,17,5,22.6
"6183",1919,0,0,0,0,0,0,0,0,0,0,0,0,0,0,0,0,1038029,"2023-12-29T00:00:00.000Z",17895854,27,"Charles Bassey",0,0,0,0,0,0
"6184",1920,0,0,0,0,0,0,0,0,0,0,0,0,0,0,0,0,1038029,"2023-12-29T00:00:00.000Z",56677817,27,"Sidy Cissoko",0,0,0,0,0,0
"6185",1921,0,0,0,0,0,0,0,0,0,0,0,0,0,0,0,0,1038029,"2023-12-29T00:00:00.000Z",17896049,27,"David Duke Jr.",0,0,0,0,0,0
"6186",1922,0,0,0,0,0,0,0,0,0,0,0,0,0,0,0,0,1038029,"2023-12-29T00:00:00.000Z",180,27,"Devonte' Graham",0,0,0,0,0,0
"6187",1923,0,0,0,0,0,0,0,0,0,0,0,0,0,0,0,0,1038029,"2023-12-29T00:00:00.000Z",56677822,27,"Victor Wembanyama",0,0,0,0,0,0
"6188",1924,4,0,13,4,2,12,9,5,4,37,0,2,24,13,0,2,1038037,"2023-12-31T00:00:00.000Z",17896040,1,"Jalen Johnson",0,37,41,28,17,43.6
"6189",1925,2,1,11,6,2,9,5,8,5,31,1,5,17,12,1,3,1038037,"2023-12-31T00:00:00.000Z",3547242,30,"Deni Avdija",2,29,31,19,14,37.4
"6190",1926,0,1,0,1,1,4,2,1,1,26,0,2,6,0,1,1,1037655,"2023-11-01T00:00:00.000Z",81,8,"Kentavious Caldwell-Pope",2,6,6,6,0,11
"6191",1927,6,1,4,4,1,16,5,5,3,32,2,3,14,6,1,3,1037655,"2023-11-01T00:00:00.000Z",335,8,"Jamal Murray",2,20,26,20,12,33.2
"6192",1928,5,1,0,1,0,4,1,0,0,19,0,0,2,0,2,1,1037655,"2023-11-01T00:00:00.000Z",236,8,"Reggie Jackson",3,2,7,7,5,17.5
"6193",1929,2,1,6,1,0,8,4,0,0,20,3,3,8,9,0,1,1037655,"2023-11-01T00:00:00.000Z",38017709,8,"Christian Braun",1,17,19,10,11,23.8
"6194",1930,4,1,4,5,1,7,2,4,3,37,0,5,8,4,3,0,1037659,"2023-11-01T00:00:00.000Z",666860,14,"Cameron Reddish",4,12,16,12,8,30.8
"6195",1931,7,2,12,8,4,19,13,10,5,42,0,3,35,12,1,4,1037659,"2023-11-01T00:00:00.000Z",237,14,"LeBron James",3,47,54,42,19,64.9
"6196",1932,6,0,2,6,4,10,8,3,3,22,1,1,23,3,0,2,1037657,"2023-11-01T00:00:00.000Z",413,29,"Collin Sexton",0,26,32,29,9,33.6
"6197",1933,1,0,2,0,0,2,1,2,1,7,1,3,3,3,0,1,1037657,"2023-11-01T00:00:00.000Z",11891374,29,"Omer Yurtseven",0,6,7,4,4,7.1
"6198",1934,0,0,0,0,0,0,0,0,0,0,0,0,0,0,0,0,1037657,"2023-11-01T00:00:00.000Z",17896023,29,"Josh Christopher",0,0,0,0,0,0
"6199",1935,3,4,6,0,0,18,10,9,7,48,4,3,27,10,2,0,1037659,"2023-11-01T00:00:00.000Z",117,14,"Anthony Davis",6,37,40,30,13,61.5
"6200",1936,7,0,5,3,0,13,5,5,5,38,2,4,15,7,3,5,1037659,"2023-11-01T00:00:00.000Z",17553995,14,"Austin Reaves",3,22,29,22,14,37.9
"6201",1937,6,0,2,7,3,19,10,4,4,36,0,2,27,2,0,3,1037659,"2023-11-01T00:00:00.000Z",405,14,"D'Angelo Russell",0,29,35,33,8,35.4
"6202",1938,0,0,3,5,1,7,1,2,2,22,0,3,5,3,0,0,1037659,"2023-11-01T00:00:00.000Z",38017697,14,"Max Christie",0,8,8,5,3,8.6
"6203",1939,0,1,9,4,2,6,4,0,0,29,2,3,10,11,1,2,1037659,"2023-11-01T00:00:00.000Z",486,14,"Christian Wood",2,21,21,10,11,27.2
"6204",1940,0,0,0,0,0,0,0,0,0,0,0,0,0,0,0,0,1037657,"2023-11-01T00:00:00.000Z",38017630,29,"Johnny Juzang",0,0,0,0,0,0
"6205",1941,0,0,0,0,0,0,0,0,0,0,0,0,0,0,0,0,1037657,"2023-11-01T00:00:00.000Z",19465584,29,"Micah Potter",0,0,0,0,0,0
"6206",1942,0,2,3,5,2,5,2,2,2,19,1,2,8,4,0,1,1037657,"2023-11-01T00:00:00.000Z",17896027,15,"Ziaire Williams",2,12,12,8,4,17.8
"6207",1943,0,0,3,6,6,12,9,7,5,30,2,4,29,5,0,1,3277353,"2023-11-03T00:00:00.000Z",666541,21,"Luguentz Dort",0,34,34,29,5,34
"6208",1944,8,0,2,0,0,12,8,5,2,35,1,6,18,3,1,6,3277353,"2023-11-03T00:00:00.000Z",38017703,21,"Jalen Williams",1,21,29,26,11,30.6
"6209",1945,5,1,5,2,2,9,7,8,8,32,3,4,24,8,1,2,3277353,"2023-11-03T00:00:00.000Z",38017685,21,"Chet Holmgren",2,32,37,29,13,45.1
"6210",1946,4,0,5,3,0,15,8,2,2,31,0,2,18,5,0,6,3277353,"2023-11-03T00:00:00.000Z",17896065,21,"Josh Giddey",0,23,27,22,9,24
"6211",1947,1,0,1,2,1,10,6,0,0,36,1,1,13,2,0,1,3277353,"2023-11-03T00:00:00.000Z",56677833,21,"Cason Wallace",0,15,16,14,3,15.9
"6212",1948,1,0,1,3,1,3,1,0,0,6,0,0,3,1,0,1,3277353,"2023-11-03T00:00:00.000Z",38017716,21,"Ousmane Dieng",0,4,5,4,2,4.7
"6213",1949,0,0,0,0,0,0,0,0,0,0,0,0,0,0,0,0,3277353,"2023-11-03T00:00:00.000Z",44,21,"Davis Bertans",0,0,0,0,0,0
"6214",1950,0,0,0,0,0,0,0,0,0,0,0,0,0,0,0,0,3277349,"2023-11-03T00:00:00.000Z",56677778,12,"Oscar Tshiebwe",0,0,0,0,0,0
"6215",1951,0,0,0,0,0,0,0,0,0,0,0,0,0,0,0,0,3277531,"2023-11-28T00:00:00.000Z",666971,20,"Dylan Windler",0,0,0,0,0,0
"6216",1952,2,1,4,3,2,12,5,2,1,32,0,2,13,4,2,2,3277531,"2023-11-28T00:00:00.000Z",62,4,"Miles Bridges",3,17,19,15,6,27.8
"6217",1953,6,0,4,2,0,7,2,0,0,28,2,1,4,6,0,2,3277531,"2023-11-28T00:00:00.000Z",204,4,"Gordon Hayward",0,10,16,10,12,18.2
"6218",1954,0,0,6,0,0,9,5,2,2,25,6,2,12,12,1,0,3277531,"2023-11-28T00:00:00.000Z",38017698,4,"Mark Williams",1,24,24,12,12,29.4
"6219",1955,2,0,3,8,4,18,7,0,0,36,0,2,18,3,1,3,3277531,"2023-11-28T00:00:00.000Z",56677823,4,"Brandon Miller",1,21,23,20,5,24.6
"6220",1956,5,0,2,3,0,16,5,1,1,32,0,0,11,2,1,3,3277531,"2023-11-28T00:00:00.000Z",403,4,"Terry Rozier",1,13,18,16,7,20.9
"6221",1957,0,0,0,0,0,0,0,0,0,0,0,0,0,0,0,0,3277534,"2023-11-28T00:00:00.000Z",17895990,26,"Jordan Ford",0,0,0,0,0,0
"6222",1958,0,0,0,0,0,0,0,0,0,0,0,0,0,0,0,0,3277534,"2023-11-28T00:00:00.000Z",56677845,26,"Colby Jones",0,0,0,0,0,0
"6223",1959,5,0,6,7,4,14,8,2,1,33,3,5,21,9,0,1,3277534,"2023-11-28T00:00:00.000Z",221,26,"Kevin Huerter",0,30,35,26,14,38.3
"6224",1960,1,1,4,5,2,8,5,0,0,26,0,1,12,4,1,1,3277534,"2023-11-28T00:00:00.000Z",30,26,"Harrison Barnes",2,16,17,13,5,23.3
"6225",1961,10,0,6,1,0,7,2,6,5,37,2,3,9,8,1,1,3277534,"2023-11-28T00:00:00.000Z",406,26,"Domantas Sabonis",1,17,27,19,18,35.6
"6226",1962,0,0,0,1,0,4,2,2,1,14,0,2,5,0,2,0,3277534,"2023-11-28T00:00:00.000Z",17896030,26,"Chris Duarte",2,5,5,5,0,11
"6227",1963,7,0,9,8,2,20,9,17,9,40,1,4,29,10,2,2,3277534,"2023-11-28T00:00:00.000Z",161,26,"De'Aaron Fox",2,39,46,36,17,55.5
"6228",1964,1,1,4,0,0,0,0,0,0,7,1,1,0,5,0,0,3277527,"2023-11-28T00:00:00.000Z",38017719,5,"Dalen Terry",1,5,6,1,6,10.5
"6229",1965,0,0,0,0,0,0,0,0,0,0,0,0,0,0,0,0,3277527,"2023-11-28T00:00:00.000Z",27,5,"Lonzo Ball",0,0,0,0,0,0
"6230",1966,0,0,0,0,0,0,0,0,0,0,0,0,0,0,0,0,3277527,"2023-11-28T00:00:00.000Z",56677874,5,"Onuralp Bitim",0,0,0,0,0,0
"6231",1967,0,0,0,0,0,0,0,0,0,0,0,0,0,0,0,0,3277527,"2023-11-28T00:00:00.000Z",45969255,5,"Justin Lewis",0,0,0,0,0,0
"6232",1968,0,0,0,0,0,0,0,0,0,0,0,0,0,0,0,0,3277527,"2023-11-28T00:00:00.000Z",56677860,5,"Adama Sanogo",0,0,0,0,0,0
"6233",1969,2,0,1,1,0,2,1,3,3,11,1,2,5,2,1,0,3277533,"2023-11-28T00:00:00.000Z",3547301,11,"Jae'Sean Tate",1,7,9,7,4,13.4
"6234",1970,0,0,0,0,0,0,0,0,0,0,0,0,0,0,0,0,3277533,"2023-11-28T00:00:00.000Z",296,11,"Boban Marjanovic",0,0,0,0,0,0
"6235",1971,0,0,0,0,0,0,0,0,0,0,0,0,0,0,0,0,3277533,"2023-11-28T00:00:00.000Z",56677809,11,"Jermaine Samuels Jr.",0,0,0,0,0,0
"6236",1972,0,0,0,0,0,0,0,0,0,0,0,0,0,0,0,0,3277533,"2023-11-28T00:00:00.000Z",56677831,11,"Cam Whitmore",0,0,0,0,0,0
"6237",1973,0,0,0,0,0,0,0,0,0,0,0,0,0,0,0,0,3277533,"2023-11-28T00:00:00.000Z",357,11,"Victor Oladipo",0,0,0,0,0,0
"6238",1974,0,0,0,0,0,0,0,0,0,0,0,0,0,0,0,0,3277533,"2023-11-28T00:00:00.000Z",56677825,11,"Amen Thompson",0,0,0,0,0,0
"6239",1975,0,0,0,0,0,0,0,0,0,0,0,0,0,0,0,0,3277533,"2023-11-28T00:00:00.000Z",47738533,11,"Jeenathan Williams",0,0,0,0,0,0
"6240",1976,0,0,0,0,0,0,0,0,0,1,0,0,0,0,0,0,1037992,"2023-12-23T00:00:00.000Z",17896044,26,"Kessler Edwards",0,0,0,0,0,0
"6241",1977,0,0,1,1,0,1,0,0,0,8,0,1,0,1,1,0,1037992,"2023-12-23T00:00:00.000Z",4197162,26,"Aleksandar Vezenkov",1,1,1,0,1,4.2
"6242",1978,0,0,0,0,0,0,0,0,0,0,0,0,0,0,0,0,1037985,"2023-12-23T00:00:00.000Z",3547297,1,"Trent Forrest",0,0,0,0,0,0
"6243",1979,0,0,0,0,0,0,0,0,0,0,0,0,0,0,0,0,1037985,"2023-12-23T00:00:00.000Z",4197387,1,"Vit Krejci",0,0,0,0,0,0
"6244",1980,0,0,0,0,0,0,0,0,0,0,0,0,0,0,0,0,1037985,"2023-12-23T00:00:00.000Z",301,1,"Wesley Matthews",0,0,0,0,0,0
"6245",1981,0,0,0,0,0,0,0,0,0,0,0,0,0,0,0,0,1037985,"2023-12-23T00:00:00.000Z",319,1,"Patty Mills",0,0,0,0,0,0
"6246",1982,0,0,0,0,0,0,0,0,0,0,0,0,0,0,0,0,1037985,"2023-12-23T00:00:00.000Z",38017689,1,"AJ Griffin",0,0,0,0,0,0
"6247",1983,0,0,0,0,0,0,0,0,0,0,0,0,0,0,0,0,1037985,"2023-12-23T00:00:00.000Z",56677806,1,"Mouhamed Gueye",0,0,0,0,0,0
"6248",1984,0,0,0,0,0,0,0,0,0,0,0,0,0,0,0,0,1037985,"2023-12-23T00:00:00.000Z",666656,1,"De'Andre Hunter",0,0,0,0,0,0
"6249",1985,0,2,1,0,0,7,3,0,0,16,2,0,6,3,1,0,1037985,"2023-12-23T00:00:00.000Z",3547285,15,"Xavier Tillman",3,9,9,6,3,18.6
"6250",1986,0,0,0,0,0,0,0,0,0,0,0,0,0,0,0,0,1037985,"2023-12-23T00:00:00.000Z",48248287,15,"Jacob Gilyard",0,0,0,0,0,0
"6251",1987,0,0,1,0,0,0,0,0,0,2,0,0,0,1,0,0,1037992,"2023-12-23T00:00:00.000Z",56677845,26,"Colby Jones",0,1,1,0,1,1.2
"6252",1988,0,0,0,0,0,0,0,0,0,0,0,0,0,0,0,0,1037992,"2023-12-23T00:00:00.000Z",17553994,26,"Davion Mitchell",0,0,0,0,0,0
"6253",1989,0,0,0,0,0,0,0,0,0,0,0,0,0,0,0,0,1037992,"2023-12-23T00:00:00.000Z",56677862,26,"Jalen Slawson",0,0,0,0,0,0
"6254",1990,0,0,0,0,0,0,0,0,0,0,0,0,0,0,0,0,1037992,"2023-12-23T00:00:00.000Z",666925,26,"Juan Toscano-Anderson",0,0,0,0,0,0
"6255",1991,0,0,0,0,0,0,0,0,0,0,0,0,0,0,0,0,1037992,"2023-12-23T00:00:00.000Z",17895990,26,"Jordan Ford",0,0,0,0,0,0
"6256",1992,0,0,0,0,0,0,0,0,0,0,0,0,0,0,0,0,1037992,"2023-12-23T00:00:00.000Z",273,26,"Alex Len",0,0,0,0,0,0
"6257",1993,0,0,0,0,0,0,0,0,0,0,0,0,0,0,0,0,1037992,"2023-12-23T00:00:00.000Z",324,26,"Malik Monk",0,0,0,0,0,0
"6258",1994,1,1,5,9,3,16,8,2,1,41,0,4,20,5,4,0,1037992,"2023-12-23T00:00:00.000Z",3547259,18,"Jaden McDaniels",5,25,26,21,6,42.5
"6259",1995,5,1,4,0,0,9,4,2,2,29,1,4,10,5,0,2,1037992,"2023-12-23T00:00:00.000Z",12,18,"Kyle Anderson",1,15,20,15,10,24.5
"6260",1996,1,2,11,0,0,13,10,2,1,39,6,3,21,17,0,1,1037992,"2023-12-23T00:00:00.000Z",176,18,"Rudy Gobert",2,38,39,22,18,47.9
"6261",1997,10,1,5,12,3,27,13,5,5,39,0,1,34,5,1,5,1037992,"2023-12-23T00:00:00.000Z",3547238,18,"Anthony Edwards",2,39,49,44,15,56
"6262",1998,9,0,7,7,3,10,4,1,1,32,0,1,12,7,2,2,1037992,"2023-12-23T00:00:00.000Z",104,18,"Mike Conley",2,19,28,21,16,37.9
"6263",1999,0,0,0,2,0,4,1,0,0,23,0,2,2,0,0,0,1037992,"2023-12-23T00:00:00.000Z",666400,18,"Nickeil Alexander-Walker",0,2,2,2,0,2
"6264",2000,2,0,2,1,0,4,2,2,2,19,0,0,6,2,2,1,1037992,"2023-12-23T00:00:00.000Z",667378,18,"Naz Reid",2,8,10,8,4,16.4
"6265",2001,0,0,0,0,0,0,0,0,0,0,0,0,0,0,0,0,1037621,"2023-10-28T00:00:00.000Z",17896067,15,"Santi Aldama",0,0,0,0,0,0
"6266",2002,0,1,2,1,0,5,2,0,0,18,2,1,4,4,0,1,1037623,"2023-10-28T00:00:00.000Z",3547243,12,"Obi Toppin",1,8,8,4,4,10.8
"6267",2003,1,2,11,5,1,14,7,5,5,29,1,5,20,12,0,2,1037623,"2023-10-28T00:00:00.000Z",452,12,"Myles Turner",2,32,33,21,13,39.9
"6268",2004,2,0,4,1,0,8,3,0,0,32,0,3,6,4,1,0,1037623,"2023-10-28T00:00:00.000Z",69,12,"Bruce Brown",1,10,12,8,6,16.8
"6269",2005,13,0,7,7,4,16,7,3,3,32,1,2,21,8,0,1,1037623,"2023-10-28T00:00:00.000Z",3547245,12,"Tyrese Haliburton",0,29,42,34,21,49.1
"6270",2006,4,0,2,2,0,5,2,0,0,25,0,4,4,2,2,1,1037623,"2023-10-28T00:00:00.000Z",38017507,12,"Andrew Nembhard",2,6,10,8,6,17.4
"6271",2007,1,0,0,1,1,1,1,0,0,3,0,1,3,0,0,0,1037622,"2023-10-28T00:00:00.000Z",666971,20,"Dylan Windler",0,3,4,4,1,4.5
"6272",2008,0,0,0,0,0,0,0,0,0,0,0,0,0,0,0,0,1037622,"2023-10-28T00:00:00.000Z",19,20,"Ryan Arcidiacono",0,0,0,0,0,0
"6273",2009,0,0,0,0,0,0,0,0,0,0,0,0,0,0,0,0,1037622,"2023-10-28T00:00:00.000Z",160,20,"Evan Fournier",0,0,0,0,0,0
"6274",2010,0,0,0,0,0,0,0,0,0,0,0,0,0,0,0,0,1037622,"2023-10-28T00:00:00.000Z",666474,20,"Charles Brown",0,0,0,0,0,0
"6275",2011,0,0,0,0,0,0,0,0,0,0,0,0,0,0,0,0,1037622,"2023-10-28T00:00:00.000Z",56677795,20,"Jacob Toppin",0,0,0,0,0,0
"6276",2012,0,0,0,0,0,0,0,0,0,0,0,0,0,0,0,0,1037622,"2023-10-28T00:00:00.000Z",17896089,20,"Duane Washington Jr.",0,0,0,0,0,0
"6277",2013,2,0,0,2,2,4,2,1,1,13,0,1,7,0,1,3,1037624,"2023-10-28T00:00:00.000Z",3547275,28,"Malachi Flynn",1,7,9,9,2,10
"6278",2014,0,0,0,0,0,0,0,0,0,0,0,0,0,0,0,0,1037622,"2023-10-28T00:00:00.000Z",18677986,19,"Trey Murphy III",0,0,0,0,0,0
"6279",2015,0,0,0,0,0,0,0,0,0,0,0,0,0,0,0,0,1037622,"2023-10-28T00:00:00.000Z",38017726,19,"Dereon Seabron",0,0,0,0,0,0
"6280",2016,2,1,3,6,1,16,7,4,3,30,0,0,18,3,1,3,1037622,"2023-10-28T00:00:00.000Z",666423,20,"RJ Barrett",2,21,23,20,5,27.6
"6281",2017,4,0,12,5,0,15,4,2,2,34,0,4,10,12,0,8,1037622,"2023-10-28T00:00:00.000Z",387,20,"Julius Randle",0,22,26,14,16,22.4
"6282",2018,0,2,5,0,0,8,4,0,0,29,10,1,8,15,0,0,1037622,"2023-10-28T00:00:00.000Z",399,20,"Mitchell Robinson",2,23,23,8,15,32
"6283",2019,1,0,2,6,1,9,2,0,0,26,0,1,5,2,2,0,1037622,"2023-10-28T00:00:00.000Z",17895858,20,"Quentin Grimes",2,7,8,6,3,14.9
"6284",2020,0,0,3,2,0,6,1,3,3,12,1,2,5,4,1,1,1037624,"2023-10-28T00:00:00.000Z",58,28,"Chris Boucher",1,9,9,5,4,11.8
"6285",2021,0,0,0,0,0,0,0,0,0,0,0,0,0,0,0,0,1037624,"2023-10-28T00:00:00.000Z",56677805,28,"Javon Freeman-Liberty",0,0,0,0,0,0
"6286",2022,0,0,0,0,0,0,0,0,0,0,0,0,0,0,0,0,1037624,"2023-10-28T00:00:00.000Z",28,23,"Mo Bamba",0,0,0,0,0,0
"6287",2023,0,0,0,0,0,0,0,0,0,0,0,0,0,0,0,0,1037624,"2023-10-28T00:00:00.000Z",260,23,"Furkan Korkmaz",0,0,0,0,0,0
"6288",2024,0,0,0,0,0,0,0,0,0,0,0,0,0,0,0,0,1037624,"2023-10-28T00:00:00.000Z",17895941,23,"Filip Petrusev",0,0,0,0,0,0
"6289",2025,2,2,3,0,0,7,6,0,0,19,2,3,12,5,0,0,1037626,"2023-10-28T00:00:00.000Z",147,24,"Drew Eubanks",2,17,19,14,7,27
"6290",2026,1,0,11,0,0,9,7,2,1,34,5,4,15,16,1,2,1037799,"2023-11-22T00:00:00.000Z",666577,30,"Daniel Gafford",1,31,32,16,17,36.7
"6291",2027,2,0,4,11,4,21,8,4,4,33,2,1,24,6,2,3,1037799,"2023-11-22T00:00:00.000Z",666848,30,"Jordan Poole",2,30,32,26,8,37.2
"6292",2028,7,0,1,3,1,13,6,0,0,35,0,1,13,1,2,0,1037799,"2023-11-22T00:00:00.000Z",249,30,"Tyus Jones",2,14,21,20,8,30.7
"6293",2029,2,1,0,1,0,5,2,3,3,19,0,4,7,0,0,1,1037799,"2023-11-22T00:00:00.000Z",56677844,30,"Bilal Coulibaly",1,7,9,9,2,12
"6294",2030,1,0,3,4,1,7,2,1,1,18,1,1,6,4,0,1,1037799,"2023-11-22T00:00:00.000Z",17896045,30,"Corey Kispert",0,10,11,7,5,11.3
"6295",2031,1,0,5,2,0,5,0,2,1,14,0,0,1,5,0,0,1037799,"2023-11-22T00:00:00.000Z",167,30,"Danilo Gallinari",0,6,7,2,6,8.5
"6296",2032,0,0,0,0,0,0,0,0,0,6,0,0,0,0,0,0,1037799,"2023-11-22T00:00:00.000Z",38017687,30,"Johnny Davis",0,0,0,0,0,0
"6297",2033,0,0,0,0,0,0,0,0,0,0,0,0,0,0,0,0,1037799,"2023-11-22T00:00:00.000Z",38017704,30,"Patrick Baldwin Jr.",0,0,0,0,0,0
"6298",2034,0,0,0,0,0,0,0,0,0,0,0,0,0,0,0,0,1037799,"2023-11-22T00:00:00.000Z",18677954,30,"Jared Butler",0,0,0,0,0,0
"6299",2035,0,0,0,0,0,0,0,0,0,0,0,0,0,0,0,0,1037799,"2023-11-22T00:00:00.000Z",3547302,30,"Anthony Gill",0,0,0,0,0,0
"6300",2036,0,0,0,0,0,0,0,0,0,0,0,0,0,0,0,0,1037799,"2023-11-22T00:00:00.000Z",337,30,"Mike Muscala",0,0,0,0,0,0
"6301",2037,0,0,0,0,0,0,0,0,0,0,0,0,0,0,0,0,1037799,"2023-11-22T00:00:00.000Z",17896106,30,"Eugene Omoruyi",0,0,0,0,0,0
"6302",2038,3,1,3,4,2,6,2,0,0,25,0,0,6,3,0,2,1037803,"2023-11-22T00:00:00.000Z",666908,6,"Max Strus",1,9,12,9,6,15.1
"6303",2039,2,0,8,0,0,7,5,3,3,25,2,0,13,10,0,2,1037803,"2023-11-22T00:00:00.000Z",17896076,6,"Evan Mobley",0,23,25,15,12,26
"6304",2040,2,0,4,0,0,2,1,2,2,23,0,2,4,4,0,3,1037803,"2023-11-22T00:00:00.000Z",9,6,"Jarrett Allen",0,8,10,6,6,8.8
"6305",2041,5,2,2,5,2,12,6,3,2,35,0,1,16,2,1,4,1037803,"2023-11-22T00:00:00.000Z",56677872,6,"Craig Porter",3,18,23,21,7,30.9
"6306",2042,3,0,1,2,1,11,6,2,1,27,0,3,14,1,1,3,1037803,"2023-11-22T00:00:00.000Z",666581,6,"Darius Garland",1,15,18,17,4,19.7
"6307",2043,3,1,2,3,2,8,4,2,2,18,0,0,12,2,0,2,1037803,"2023-11-22T00:00:00.000Z",277,6,"Caris LeVert",1,14,17,15,5,19.9
"6308",2044,0,1,1,0,0,3,2,2,0,13,2,1,4,3,0,0,1037803,"2023-11-22T00:00:00.000Z",444,6,"Tristan Thompson",1,7,7,4,3,10.6
"6309",2045,1,0,2,5,3,9,4,0,0,20,1,5,11,3,0,0,1037803,"2023-11-22T00:00:00.000Z",344,6,"Georges Niang",0,14,15,12,4,16.1
"6310",2046,1,0,1,5,3,6,3,0,0,17,0,3,9,1,0,1,1037803,"2023-11-22T00:00:00.000Z",3547299,6,"Sam Merrill",0,10,11,10,2,10.7
"6311",2047,1,0,1,5,1,5,1,0,0,16,0,1,3,1,1,0,1037803,"2023-11-22T00:00:00.000Z",56677847,6,"Emoni Bates",1,4,5,4,2,8.7
"6312",2048,1,1,1,0,0,5,1,0,0,12,2,0,2,3,1,1,1037803,"2023-11-22T00:00:00.000Z",248,6,"Damian Jones",2,5,6,3,4,12.1
"6313",2049,1,0,1,3,1,6,2,3,2,18,1,3,7,2,0,0,1037799,"2023-11-22T00:00:00.000Z",414,30,"Landry Shamet",0,9,10,8,3,10.9
"6314",2050,0,0,0,0,0,0,0,0,0,0,0,0,0,0,0,0,1037799,"2023-11-22T00:00:00.000Z",38124126,30,"John Butler Jr.",0,0,0,0,0,0
"6315",2051,0,0,0,0,0,0,0,0,0,0,0,0,0,0,0,0,1037944,"2023-12-18T00:00:00.000Z",56677875,1,"Miles Norris",0,0,0,0,0,0
"6316",2052,4,2,4,3,0,8,5,1,0,31,0,5,10,4,1,2,1037943,"2023-12-18T00:00:00.000Z",89,5,"Alex Caruso",3,14,18,14,8,27.8
"6317",2053,0,1,5,0,0,3,2,2,1,14,3,0,5,8,1,0,1037943,"2023-12-18T00:00:00.000Z",137,5,"Andre Drummond",2,13,13,5,8,20.6
"6318",2054,1,0,2,0,0,1,1,0,0,10,1,2,2,3,0,0,1037943,"2023-12-18T00:00:00.000Z",38017719,5,"Dalen Terry",0,5,6,3,4,7.1
"6319",2055,0,0,0,0,0,0,0,0,0,0,0,0,0,0,0,0,1037943,"2023-12-18T00:00:00.000Z",110,5,"Torrey Craig",0,0,0,0,0,0
"6320",2056,0,0,0,0,0,0,0,0,0,0,0,0,0,0,0,0,1037943,"2023-12-18T00:00:00.000Z",56677857,5,"Julian Phillips",0,0,0,0,0,0
"6321",2057,0,0,0,0,0,0,0,0,0,0,0,0,0,0,0,0,1037943,"2023-12-18T00:00:00.000Z",17896116,5,"Terry Taylor",0,0,0,0,0,0
"6322",2058,0,0,0,0,0,0,0,0,0,0,0,0,0,0,0,0,1037943,"2023-12-18T00:00:00.000Z",27,5,"Lonzo Ball",0,0,0,0,0,0
"6323",2059,1,0,1,5,2,18,12,2,2,27,1,2,28,2,1,3,1037942,"2023-12-18T00:00:00.000Z",274,13,"Kawhi Leonard",1,30,31,29,3,31.9
"6324",2060,1,0,2,0,0,1,1,8,2,18,2,2,4,4,0,0,1037941,"2023-12-18T00:00:00.000Z",444,6,"Tristan Thompson",0,8,9,5,5,10.3
"6325",2061,3,3,12,0,0,10,7,5,4,26,4,2,18,16,0,0,1037942,"2023-12-18T00:00:00.000Z",493,13,"Ivica Zubac",3,34,37,21,19,50.7
"6326",2062,1,1,1,3,0,5,2,0,0,28,1,0,4,2,0,1,1037942,"2023-12-18T00:00:00.000Z",666743,13,"Terance Mann",1,6,7,5,3,9.9
"6327",2063,9,1,3,11,8,16,12,3,3,28,0,2,35,3,1,1,1037942,"2023-12-18T00:00:00.000Z",192,13,"James Harden",2,38,47,44,12,57.1
"6328",2064,2,0,3,1,0,1,0,0,0,18,0,2,0,3,0,0,1037942,"2023-12-18T00:00:00.000Z",666511,13,"Amir Coffey",0,3,5,2,5,6.6
"6329",2065,0,2,4,0,0,4,1,2,2,22,5,2,4,9,0,2,1037942,"2023-12-18T00:00:00.000Z",439,13,"Daniel Theis",2,13,13,4,9,18.8
"6330",2066,0,0,3,6,4,11,6,3,3,30,0,1,19,3,0,0,1037942,"2023-12-18T00:00:00.000Z",380,13,"Norman Powell",0,22,22,19,3,22.6
"6331",2067,0,0,0,0,0,0,0,0,0,0,0,0,0,0,0,0,1037941,"2023-12-18T00:00:00.000Z",666581,6,"Darius Garland",0,0,0,0,0,0
"6332",2068,0,0,0,0,0,0,0,0,0,0,0,0,0,0,0,0,1037941,"2023-12-18T00:00:00.000Z",666676,6,"Ty Jerome",0,0,0,0,0,0
"6333",2069,0,0,0,0,0,0,0,0,0,0,0,0,0,0,0,0,1037941,"2023-12-18T00:00:00.000Z",17896076,6,"Evan Mobley",0,0,0,0,0,0
"6334",2070,0,0,0,0,0,0,0,0,0,0,0,0,0,0,0,0,1037941,"2023-12-18T00:00:00.000Z",38017662,6,"Isaiah Mobley",0,0,0,0,0,0
"6335",2071,0,0,0,0,0,0,0,0,0,0,0,0,0,0,0,0,1037941,"2023-12-18T00:00:00.000Z",404,6,"Ricky Rubio",0,0,0,0,0,0
"6336",2072,2,0,2,7,3,12,6,2,1,38,1,3,16,3,0,0,1037941,"2023-12-18T00:00:00.000Z",66,11,"Dillon Brooks",0,19,21,18,5,22.6
"6337",2073,0,0,4,4,1,7,2,0,0,23,3,4,5,7,0,2,1037941,"2023-12-18T00:00:00.000Z",38017684,11,"Jabari Smith Jr.",0,12,12,5,7,11.4
"6338",2074,0,0,0,0,0,4,3,0,0,6,0,2,6,0,0,1,1037942,"2023-12-18T00:00:00.000Z",17896022,13,"Brandon Boston Jr.",0,6,6,6,0,5
"6339",2075,1,0,1,1,0,2,0,0,0,6,0,1,0,1,0,1,1037942,"2023-12-18T00:00:00.000Z",56677849,13,"Kobe Brown",0,1,2,1,2,1.7
"6340",2076,2,0,3,1,1,2,2,2,1,18,1,0,6,4,0,0,1038108,"2024-01-09T00:00:00.000Z",38017697,14,"Max Christie",0,10,12,8,6,13.8
"6341",2077,0,0,1,0,0,1,0,0,0,2,0,0,0,1,0,0,1038107,"2024-01-09T00:00:00.000Z",38017728,15,"Jake LaRavia",0,1,1,0,1,1.2
"6342",2078,0,0,0,1,0,2,0,0,0,2,0,0,0,0,0,0,1038107,"2024-01-09T00:00:00.000Z",56677830,15,"GG Jackson",0,0,0,0,0,0
"6343",2079,0,0,0,0,0,0,0,0,0,0,0,0,0,0,0,0,1038107,"2024-01-09T00:00:00.000Z",3,15,"Steven Adams",0,0,0,0,0,0
"6344",2080,0,0,0,0,0,0,0,0,0,0,0,0,0,0,0,0,1038107,"2024-01-09T00:00:00.000Z",666505,15,"Brandon Clarke",0,0,0,0,0,0
"6345",2081,0,0,0,0,0,0,0,0,0,0,0,0,0,0,0,0,1038107,"2024-01-09T00:00:00.000Z",48248287,15,"Jacob Gilyard",0,0,0,0,0,0
"6346",2082,0,0,0,0,0,0,0,0,0,0,0,0,0,0,0,0,1038107,"2024-01-09T00:00:00.000Z",231,15,"Jaren Jackson Jr.",0,0,0,0,0,0
"6347",2083,0,0,0,0,0,0,0,0,0,0,0,0,0,0,0,0,1038107,"2024-01-09T00:00:00.000Z",666786,15,"Ja Morant",0,0,0,0,0,0
"6348",2084,0,0,0,0,0,0,0,0,0,0,0,0,0,0,0,0,1038107,"2024-01-09T00:00:00.000Z",401,15,"Derrick Rose",0,0,0,0,0,0
"6349",2085,1,1,1,5,2,9,4,2,2,28,0,2,12,1,4,1,1038116,"2024-01-10T00:00:00.000Z",81,8,"Kentavious Caldwell-Pope",5,13,14,13,2,28.7
"6350",2086,6,2,1,5,1,15,6,4,4,31,0,3,17,1,1,4,1038116,"2024-01-10T00:00:00.000Z",335,8,"Jamal Murray",3,18,24,23,7,32.2
"6351",2087,1,0,3,2,1,4,2,0,0,17,0,1,5,3,1,1,1038116,"2024-01-10T00:00:00.000Z",38017709,8,"Christian Braun",1,8,9,6,4,12.1
"6352",2088,2,0,2,4,2,9,5,0,0,24,1,1,12,3,0,0,1038118,"2024-01-10T00:00:00.000Z",3089,28,"Gary Trent Jr.",0,15,17,14,5,18.6
"6353",2089,1,0,2,1,1,2,1,0,0,9,0,2,3,2,0,0,1038118,"2024-01-10T00:00:00.000Z",436,28,"Garrett Temple",0,5,6,4,3,6.9
"6354",2090,0,0,0,0,0,0,0,0,0,0,0,0,0,0,0,0,1038118,"2024-01-10T00:00:00.000Z",376,28,"Otto Porter Jr.",0,0,0,0,0,0
"6355",2091,0,0,0,0,0,0,0,0,0,0,0,0,0,0,0,0,1038118,"2024-01-10T00:00:00.000Z",416,28,"Pascal Siakam",0,0,0,0,0,0
"6356",2092,0,0,0,0,0,0,0,0,0,0,0,0,0,0,0,0,1038118,"2024-01-10T00:00:00.000Z",56677828,28,"Gradey Dick",0,0,0,0,0,0
"6357",2093,0,0,0,0,0,0,0,0,0,0,0,0,0,0,0,0,1038118,"2024-01-10T00:00:00.000Z",56677805,28,"Javon Freeman-Liberty",0,0,0,0,0,0
"6358",2094,0,0,0,0,0,0,0,0,0,0,0,0,0,0,0,0,1038118,"2024-01-10T00:00:00.000Z",38017710,28,"Christian Koloko",0,0,0,0,0,0
"6359",2095,0,0,0,0,0,0,0,0,0,0,0,0,0,0,0,0,1038118,"2024-01-10T00:00:00.000Z",56677869,28,"Markquis Nowell",0,0,0,0,0,0
"6360",2096,0,0,0,0,0,0,0,0,0,0,0,0,0,0,0,0,1038118,"2024-01-10T00:00:00.000Z",373,28,"Jakob Poeltl",0,0,0,0,0,0
"6361",2097,1,1,2,0,0,11,9,1,1,22,3,1,19,5,1,1,1038117,"2024-01-10T00:00:00.000Z",56677799,10,"Trayce Jackson-Davis",2,24,25,20,6,31.5
"6362",2098,3,0,2,2,0,3,1,2,2,14,1,2,4,3,1,2,1038117,"2024-01-10T00:00:00.000Z",407,10,"Dario Saric",1,7,10,7,6,13.1
"6363",2099,2,0,1,2,0,3,1,0,0,17,2,2,2,3,0,2,1038117,"2024-01-10T00:00:00.000Z",251,10,"Cory Joseph",0,5,7,4,5,6.6
"6364",2100,0,1,1,5,2,12,4,2,2,35,3,4,12,4,0,1,1038119,"2024-01-11T00:00:00.000Z",3547247,6,"Isaac Okoro",1,16,16,12,4,18.8
"6365",2101,3,1,4,1,0,5,4,2,2,23,0,3,10,4,0,0,3277451,"2023-11-17T00:00:00.000Z",462,22,"Moritz Wagner",1,14,17,13,7,22.3
"6366",2102,0,0,2,1,1,1,1,0,0,6,0,0,3,2,0,0,3277451,"2023-11-17T00:00:00.000Z",38017724,22,"Caleb Houstan",0,5,5,3,2,5.4
"6367",2103,0,0,1,4,2,5,3,0,0,15,0,2,8,1,0,1,3277453,"2023-11-17T00:00:00.000Z",38017739,29,"Simone Fontecchio",0,9,9,8,1,8.2
"6368",2104,0,0,0,0,0,0,0,0,0,1,0,0,0,0,0,0,3277453,"2023-11-17T00:00:00.000Z",139,29,"Kris Dunn",0,0,0,0,0,0
"6369",2105,0,0,0,0,0,0,0,0,0,0,0,0,0,0,0,0,3277453,"2023-11-17T00:00:00.000Z",56677824,29,"Taylor Hendricks",0,0,0,0,0,0
"6370",2106,0,0,0,0,0,0,0,0,0,0,0,0,0,0,0,0,3277448,"2023-11-17T00:00:00.000Z",54,9,"Bojan Bogdanovic",0,0,0,0,0,0
"6371",2107,0,0,0,0,0,0,0,0,0,0,0,0,0,0,0,0,3277448,"2023-11-17T00:00:00.000Z",56677729,9,"Malcolm Cazalon",0,0,0,0,0,0
"6372",2108,0,0,0,0,0,0,0,0,0,0,0,0,0,0,0,0,3277448,"2023-11-17T00:00:00.000Z",197,9,"Joe Harris",0,0,0,0,0,0
"6373",2109,0,0,0,0,0,0,0,0,0,0,0,0,0,0,0,0,3277448,"2023-11-17T00:00:00.000Z",330,9,"Monte Morris",0,0,0,0,0,0
"6374",2110,0,0,0,0,0,0,0,0,0,0,0,0,0,0,0,0,3277448,"2023-11-17T00:00:00.000Z",42097199,9,"Jared Rhoden",0,0,0,0,0,0
"6375",2111,0,1,4,6,1,8,3,5,3,36,2,3,10,6,2,1,3277454,"2023-11-17T00:00:00.000Z",56677850,25,"Toumani Camara",3,16,16,10,6,25.2
"6376",2112,3,0,4,9,4,20,8,4,4,40,0,0,24,4,1,1,3277454,"2023-11-17T00:00:00.000Z",182,25,"Jerami Grant",1,28,31,27,7,35.3
"6377",2113,2,0,5,0,0,14,8,2,1,38,7,4,17,12,2,4,3277454,"2023-11-17T00:00:00.000Z",22,25,"Deandre Ayton",2,29,31,19,14,36.4
"6378",2114,0,3,3,2,2,4,3,0,0,25,2,3,8,5,0,0,3277453,"2023-11-17T00:00:00.000Z",38017620,29,"Ochai Agbaji",3,13,13,8,5,23
"6379",2115,0,2,2,4,1,12,5,12,10,40,0,1,21,2,1,0,3277453,"2023-11-17T00:00:00.000Z",297,29,"Lauri Markkanen",3,23,23,21,2,32.4
"6380",2116,1,2,10,2,1,10,5,6,4,35,4,6,15,14,0,0,3277453,"2023-11-17T00:00:00.000Z",101,29,"John Collins",2,29,30,16,15,39.3
"6381",2117,5,0,2,10,5,26,14,4,4,36,1,0,37,3,1,0,3277453,"2023-11-17T00:00:00.000Z",100,29,"Jordan Clarkson",1,40,45,42,8,51.1
"6382",2118,6,0,3,6,3,11,5,3,2,29,0,2,15,3,1,3,3277453,"2023-11-17T00:00:00.000Z",56677834,29,"Keyonte George",1,18,24,21,9,27.6
"6383",2119,0,0,0,0,0,0,0,0,0,0,0,0,0,0,0,0,3277451,"2023-11-17T00:00:00.000Z",666818,22,"Chuma Okeke",0,0,0,0,0,0
"6384",2120,0,0,0,0,0,0,0,0,0,0,0,0,0,0,0,0,3277451,"2023-11-17T00:00:00.000Z",666885,22,"Admiral Schofield",0,0,0,0,0,0
"6385",2121,2,1,7,5,1,17,7,2,2,38,2,4,17,9,1,10,3277454,"2023-11-17T00:00:00.000Z",38017690,25,"Shaedon Sharpe",2,26,28,19,11,26.8
"6386",2122,8,0,2,7,3,14,6,0,0,25,3,3,15,5,2,0,3277454,"2023-11-17T00:00:00.000Z",3547289,25,"Skylar Mays",2,20,28,23,13,39
"6387",2123,1,0,3,2,1,3,2,0,0,24,1,1,5,4,2,2,3277454,"2023-11-17T00:00:00.000Z",666923,25,"Matisse Thybulle",2,9,10,6,5,15.3
"6388",2124,1,0,3,2,0,6,2,5,3,18,2,0,7,5,0,0,3277454,"2023-11-17T00:00:00.000Z",38017711,25,"Jabari Walker",0,12,13,8,6,14.5
"6389",2125,0,0,1,4,0,5,0,0,0,10,1,1,0,2,0,0,3277454,"2023-11-17T00:00:00.000Z",56783340,25,"Duop Reath",0,2,2,0,2,2.4
"6390",2126,1,0,7,5,0,14,6,6,5,31,0,2,17,7,3,0,1037901,"2023-12-12T00:00:00.000Z",38017688,26,"Keegan Murray",3,24,25,18,8,35.9
"6391",2127,3,0,5,2,0,11,5,8,5,26,5,3,15,10,2,2,1037901,"2023-12-12T00:00:00.000Z",406,26,"Domantas Sabonis",2,25,28,18,13,35.5
"6392",2128,3,0,4,4,1,8,1,0,0,16,0,1,3,4,1,0,1037901,"2023-12-12T00:00:00.000Z",221,26,"Kevin Huerter",1,7,10,6,7,15.3
"6393",2129,3,0,3,7,3,16,5,1,1,25,0,3,14,3,0,4,1037901,"2023-12-12T00:00:00.000Z",161,26,"De'Aaron Fox",0,17,20,17,6,18.1
"6394",2130,0,0,0,0,0,0,0,0,0,0,0,0,0,0,0,0,1037917,"2023-12-14T00:00:00.000Z",56677856,13,"Jordan Miller",0,0,0,0,0,0
"6395",2131,0,0,0,0,0,0,0,0,0,0,0,0,0,0,0,0,1037913,"2023-12-14T00:00:00.000Z",17896056,18,"Luka Garza",0,0,0,0,0,0
"6396",2132,0,0,0,0,0,0,0,0,0,0,0,0,0,0,0,0,1037913,"2023-12-14T00:00:00.000Z",56677782,18,"Leonard Miller",0,0,0,0,0,0
"6397",2133,0,0,0,0,0,0,0,0,0,0,0,0,0,0,0,0,1037913,"2023-12-14T00:00:00.000Z",17895968,18,"Daishen Nix",0,0,0,0,0,0
"6398",2134,2,0,2,4,0,5,1,0,0,20,1,1,2,3,1,0,1037917,"2023-12-14T00:00:00.000Z",666743,13,"Terance Mann",1,5,7,4,5,11.6
"6399",2135,1,2,1,0,0,7,2,0,0,22,3,3,4,4,1,2,1037915,"2023-12-14T00:00:00.000Z",11891374,29,"Omer Yurtseven",3,8,9,5,5,17.3
"6400",2136,0,0,4,5,2,9,4,0,0,25,3,1,10,7,1,2,1037915,"2023-12-14T00:00:00.000Z",56677824,29,"Taylor Hendricks",1,17,17,10,7,19.4
"6401",2137,5,0,1,2,0,8,3,0,0,26,1,2,6,2,0,0,1037915,"2023-12-14T00:00:00.000Z",139,29,"Kris Dunn",0,8,13,11,7,15.9
"6402",2138,0,0,0,0,0,0,0,0,0,3,0,0,0,0,0,0,1037915,"2023-12-14T00:00:00.000Z",19465584,29,"Micah Potter",0,0,0,0,0,0
"6403",2139,0,0,0,0,0,0,0,0,0,0,0,0,0,0,0,0,1037915,"2023-12-14T00:00:00.000Z",101,29,"John Collins",0,0,0,0,0,0
"6404",2140,0,0,0,0,0,0,0,0,0,0,0,0,0,0,0,0,1037915,"2023-12-14T00:00:00.000Z",666881,29,"Luka Samanic",0,0,0,0,0,0
"6405",2141,0,0,0,0,0,0,0,0,0,0,0,0,0,0,0,0,1037915,"2023-12-14T00:00:00.000Z",17896023,29,"Josh Christopher",0,0,0,0,0,0
"6406",2142,2,1,5,4,2,16,9,9,7,39,3,2,27,8,1,2,1037917,"2023-12-14T00:00:00.000Z",274,13,"Kawhi Leonard",2,35,37,29,10,43.6
"6407",2143,2,2,5,0,0,10,5,0,0,30,3,5,10,8,0,3,1037917,"2023-12-14T00:00:00.000Z",493,13,"Ivica Zubac",2,18,20,12,10,25.6
"6408",2144,1,0,3,11,4,15,6,3,2,30,1,2,18,4,0,1,1037917,"2023-12-14T00:00:00.000Z",666511,13,"Amir Coffey",0,22,23,19,5,23.3
"6409",2145,0,0,0,0,0,0,0,0,0,0,0,0,0,0,0,0,1037915,"2023-12-14T00:00:00.000Z",100,29,"Jordan Clarkson",0,0,0,0,0,0
"6410",2146,0,0,0,0,0,0,0,0,0,0,0,0,0,0,0,0,1037915,"2023-12-14T00:00:00.000Z",56677834,29,"Keyonte George",0,0,0,0,0,0
"6411",2147,0,0,0,0,0,0,0,0,0,0,0,0,0,0,0,0,1037915,"2023-12-14T00:00:00.000Z",38017630,29,"Johnny Juzang",0,0,0,0,0,0
"6412",2148,15,4,5,6,5,12,6,12,11,43,2,3,28,7,1,4,1037917,"2023-12-14T00:00:00.000Z",192,13,"James Harden",5,35,50,43,22,69.9
"6413",2149,0,0,0,0,0,1,1,0,0,7,0,2,2,0,1,0,1037917,"2023-12-14T00:00:00.000Z",56677849,13,"Kobe Brown",1,2,2,2,0,5
"6414",2150,0,0,0,0,0,0,0,0,0,0,0,0,0,0,0,0,1037917,"2023-12-14T00:00:00.000Z",17896022,13,"Brandon Boston Jr.",0,0,0,0,0,0
"6415",2151,0,0,0,0,0,0,0,0,0,0,0,0,0,0,0,0,1038104,"2024-01-09T00:00:00.000Z",17896030,26,"Chris Duarte",0,0,0,0,0,0
"6416",2152,3,0,2,4,3,9,3,2,2,28,1,1,11,3,1,2,1038105,"2024-01-09T00:00:00.000Z",17553983,22,"Trevelin Queen",1,14,17,14,6,20.1
"6417",2153,2,0,5,4,1,9,6,11,8,31,3,3,21,8,2,1,1038105,"2024-01-09T00:00:00.000Z",462,22,"Moritz Wagner",2,29,31,23,10,38.6
"6418",2154,0,0,0,0,0,0,0,0,0,0,0,0,0,0,0,0,1038105,"2024-01-09T00:00:00.000Z",196,22,"Gary Harris",0,0,0,0,0,0
"6419",2155,0,0,0,0,0,0,0,0,0,0,0,0,0,0,0,0,1038105,"2024-01-09T00:00:00.000Z",38017607,22,"Kevon Harris",0,0,0,0,0,0
"6420",2156,0,0,0,0,0,0,0,0,0,0,0,0,0,0,0,0,1038105,"2024-01-09T00:00:00.000Z",56677839,22,"Jett Howard",0,0,0,0,0,0
"6421",2157,0,0,0,0,0,0,0,0,0,0,0,0,0,0,0,0,1038105,"2024-01-09T00:00:00.000Z",229,22,"Jonathan Isaac",0,0,0,0,0,0
"6422",2158,0,0,0,0,0,0,0,0,0,0,0,0,0,0,0,0,1038104,"2024-01-09T00:00:00.000Z",306,26,"JaVale McGee",0,0,0,0,0,0
"6423",2159,0,0,0,0,0,0,0,0,0,0,0,0,0,0,0,0,1038104,"2024-01-09T00:00:00.000Z",4197162,26,"Aleksandar Vezenkov",0,0,0,0,0,0
"6424",2160,0,0,0,0,0,0,0,0,0,0,0,0,0,0,0,0,1038104,"2024-01-09T00:00:00.000Z",17895990,26,"Jordan Ford",0,0,0,0,0,0
"6425",2161,0,0,0,0,0,0,0,0,0,0,0,0,0,0,0,0,1038104,"2024-01-09T00:00:00.000Z",56677845,26,"Colby Jones",0,0,0,0,0,0
"6426",2162,0,0,0,0,0,0,0,0,0,0,0,0,0,0,0,0,1038104,"2024-01-09T00:00:00.000Z",56677862,26,"Jalen Slawson",0,0,0,0,0,0
"6427",2163,2,2,5,9,5,17,13,1,1,35,0,2,32,5,1,1,1038104,"2024-01-09T00:00:00.000Z",38017688,26,"Keegan Murray",3,37,39,34,7,49
"6428",2164,1,0,1,0,0,1,0,2,0,14,0,0,0,1,0,0,1038104,"2024-01-09T00:00:00.000Z",30,26,"Harrison Barnes",0,1,2,1,2,2.7
"6429",2165,13,0,5,1,1,21,16,4,4,38,5,3,37,10,3,5,1038104,"2024-01-09T00:00:00.000Z",406,26,"Domantas Sabonis",3,47,60,50,23,72.5
"6430",2166,5,1,5,6,0,11,2,0,0,29,0,1,4,5,1,0,1038104,"2024-01-09T00:00:00.000Z",221,26,"Kevin Huerter",2,9,14,9,10,23.5
"6431",2167,4,0,3,7,4,19,10,2,2,33,0,2,26,3,2,5,1038104,"2024-01-09T00:00:00.000Z",161,26,"De'Aaron Fox",2,29,33,30,7,36.6
"6432",2168,9,2,2,6,2,15,9,0,0,28,0,5,20,2,1,3,1038104,"2024-01-09T00:00:00.000Z",324,26,"Malik Monk",3,22,31,29,11,41.9
"6433",2169,0,0,0,0,0,0,0,0,0,5,0,1,0,0,0,0,1038104,"2024-01-09T00:00:00.000Z",38017714,26,"Keon Ellis",0,0,0,0,0,0
"6434",2170,3,0,7,3,1,4,1,4,3,32,1,2,6,8,0,1,1038104,"2024-01-09T00:00:00.000Z",290,26,"Trey Lyles",0,14,17,9,11,19.1
"6435",2171,0,0,0,0,0,0,0,0,0,0,0,0,0,0,0,0,1038105,"2024-01-09T00:00:00.000Z",666885,22,"Admiral Schofield",0,0,0,0,0,0
"6436",2172,0,0,2,0,0,2,0,0,0,13,0,3,0,2,3,0,1038104,"2024-01-09T00:00:00.000Z",56677826,9,"Ausar Thompson",3,2,2,0,2,11.4
"6437",2173,0,1,2,6,4,12,9,2,1,29,2,3,23,4,1,1,1038106,"2024-01-09T00:00:00.000Z",18,20,"OG Anunoby",2,27,27,23,4,32.8
"6438",2174,8,1,7,4,2,17,7,4,4,32,0,1,20,7,0,2,1038106,"2024-01-09T00:00:00.000Z",387,20,"Julius Randle",1,27,35,28,15,41.4
"6439",2175,3,1,9,0,0,1,1,4,3,28,5,3,5,14,3,2,1038106,"2024-01-09T00:00:00.000Z",201,20,"Isaiah Hartenstein",4,19,22,8,17,36.3
"6440",2176,2,0,4,7,3,11,7,4,3,29,1,1,20,5,3,1,3277428,"2023-11-14T00:00:00.000Z",666679,3,"Cameron Johnson",3,25,27,22,7,37
"6441",2177,2,1,4,0,0,4,1,8,5,17,5,4,7,9,0,1,3277427,"2023-11-14T00:00:00.000Z",17896035,12,"Isaiah Jackson",1,16,18,9,11,22.8
"6442",2178,3,0,1,0,0,3,1,0,0,19,1,1,2,2,0,3,3277425,"2023-11-14T00:00:00.000Z",422,4,"Ish Smith",0,4,7,5,5,5.9
"6443",2179,0,0,2,1,1,2,1,0,0,15,0,1,3,2,0,0,3277425,"2023-11-14T00:00:00.000Z",56677846,4,"Nick Smith Jr.",0,5,5,3,2,5.4
"6444",2180,0,0,0,0,0,0,0,0,0,0,0,0,0,0,0,0,3277425,"2023-11-14T00:00:00.000Z",17896037,4,"James Bouknight",0,0,0,0,0,0
"6445",2181,0,0,0,0,0,0,0,0,0,0,0,0,0,0,0,0,3277425,"2023-11-14T00:00:00.000Z",62,4,"Miles Bridges",0,0,0,0,0,0
"6446",2182,0,0,0,0,0,0,0,0,0,0,0,0,0,0,0,0,3277425,"2023-11-14T00:00:00.000Z",204,4,"Gordon Hayward",0,0,0,0,0,0
"6447",2183,0,0,0,0,0,0,0,0,0,0,0,0,0,0,0,0,3277425,"2023-11-14T00:00:00.000Z",666748,4,"Cody Martin",0,0,0,0,0,0
"6448",2184,0,0,0,0,0,0,0,0,0,0,0,0,0,0,0,0,3277425,"2023-11-14T00:00:00.000Z",56677823,4,"Brandon Miller",0,0,0,0,0,0
"6449",2185,0,0,0,0,0,0,0,0,0,0,0,0,0,0,0,0,3277425,"2023-11-14T00:00:00.000Z",347,4,"Frank Ntilikina",0,0,0,0,0,0
"6450",2186,0,0,0,0,0,0,0,0,0,0,0,0,0,0,0,0,3277425,"2023-11-14T00:00:00.000Z",403,4,"Terry Rozier",0,0,0,0,0,0
"6451",2187,5,0,1,1,1,14,10,14,11,34,3,1,32,4,2,3,3277425,"2023-11-14T00:00:00.000Z",79,16,"Jimmy Butler",2,36,41,37,9,47.3
"6452",2188,2,2,3,5,2,8,5,0,0,33,1,1,12,4,5,0,3277425,"2023-11-14T00:00:00.000Z",3092,16,"Haywood Highsmith",7,16,18,14,6,40.8
"6453",2189,0,0,0,3,1,3,1,2,2,8,0,2,5,0,0,0,3277426,"2023-11-14T00:00:00.000Z",38017689,1,"AJ Griffin",0,5,5,5,0,5
"6454",2190,2,1,6,0,0,4,4,0,0,21,3,5,8,9,0,2,3277426,"2023-11-14T00:00:00.000Z",3547244,1,"Onyeka Okongwu",1,17,19,10,11,22.8
"6455",2191,0,0,1,1,1,1,1,0,0,2,0,0,3,1,0,0,3277426,"2023-11-14T00:00:00.000Z",666754,1,"Garrison Mathews",0,4,4,3,1,4.2
"6456",2192,0,0,0,0,0,0,0,0,0,0,0,0,0,0,0,0,3277426,"2023-11-14T00:00:00.000Z",301,1,"Wesley Matthews",0,0,0,0,0,0
"6457",2193,0,0,0,0,0,0,0,0,0,0,0,0,0,0,0,0,3277426,"2023-11-14T00:00:00.000Z",319,1,"Patty Mills",0,0,0,0,0,0
"6458",2194,1,0,3,2,0,4,1,0,0,18,0,1,2,3,0,0,3277427,"2023-11-14T00:00:00.000Z",328,23,"Marcus Morris",0,5,6,3,4,7.1
"6459",2195,1,1,0,0,0,1,1,0,0,10,1,1,2,1,0,1,3277427,"2023-11-14T00:00:00.000Z",3547270,23,"Paul Reed",1,3,4,3,2,6.7
"6460",2196,0,0,0,0,0,0,0,0,0,0,0,0,0,0,0,0,3277426,"2023-11-14T00:00:00.000Z",56677838,1,"Kobe Bufkin",0,0,0,0,0,0
"6461",2197,0,0,0,0,0,0,0,0,0,0,0,0,0,0,0,0,3277426,"2023-11-14T00:00:00.000Z",56677806,1,"Mouhamed Gueye",0,0,0,0,0,0
"6462",2198,0,0,0,0,0,0,0,0,0,0,0,0,0,0,0,0,3277426,"2023-11-14T00:00:00.000Z",56677855,1,"Seth Lundy",0,0,0,0,0,0
"6463",2199,0,0,0,0,0,0,0,0,0,0,0,0,0,0,0,0,3277426,"2023-11-14T00:00:00.000Z",56677875,1,"Miles Norris",0,0,0,0,0,0
"6464",2200,0,0,0,0,0,0,0,0,0,0,0,0,0,0,0,0,3277426,"2023-11-14T00:00:00.000Z",490,1,"Trae Young",0,0,0,0,0,0
"6465",2201,0,0,0,0,0,0,0,0,0,0,0,0,0,0,0,0,1037914,"2023-12-14T00:00:00.000Z",17896103,8,"Jay Huff",0,0,0,0,0,0
"6466",2202,0,0,0,0,0,0,0,0,0,0,0,0,0,0,0,0,1037914,"2023-12-14T00:00:00.000Z",17896007,8,"Braxton Key",0,0,0,0,0,0
"6467",2203,0,0,0,0,0,0,0,0,0,0,0,0,0,0,0,0,1037911,"2023-12-14T00:00:00.000Z",404,6,"Ricky Rubio",0,0,0,0,0,0
"6468",2204,0,0,0,0,0,0,0,0,0,0,0,0,0,0,0,0,1037911,"2023-12-14T00:00:00.000Z",56677847,6,"Emoni Bates",0,0,0,0,0,0
"6469",2205,0,0,0,0,0,0,0,0,0,0,0,0,0,0,0,0,1037911,"2023-12-14T00:00:00.000Z",666676,6,"Ty Jerome",0,0,0,0,0,0
"6470",2206,0,0,0,0,0,0,0,0,0,0,0,0,0,0,0,0,1037911,"2023-12-14T00:00:00.000Z",17896076,6,"Evan Mobley",0,0,0,0,0,0
"6471",2207,0,0,0,0,0,0,0,0,0,0,0,0,0,0,0,0,1037911,"2023-12-14T00:00:00.000Z",38017662,6,"Isaiah Mobley",0,0,0,0,0,0
"6472",2208,2,0,1,4,1,7,2,0,0,21,2,1,5,3,0,2,1037916,"2023-12-14T00:00:00.000Z",30,26,"Harrison Barnes",0,8,10,7,5,9.6
"6473",2209,1,0,1,2,0,8,4,8,7,31,2,4,15,3,1,1,1037916,"2023-12-14T00:00:00.000Z",38017688,26,"Keegan Murray",1,18,19,16,4,22.1
"6474",2210,7,0,14,2,1,13,8,2,1,40,2,2,18,16,0,2,1037916,"2023-12-14T00:00:00.000Z",406,26,"Domantas Sabonis",0,34,41,25,23,45.7
"6475",2211,2,1,1,3,0,8,2,0,0,20,1,1,4,2,2,1,1037916,"2023-12-14T00:00:00.000Z",221,26,"Kevin Huerter",3,6,8,6,4,17.4
"6476",2212,7,0,3,11,5,23,14,11,8,34,0,3,41,3,2,6,1037916,"2023-12-14T00:00:00.000Z",161,26,"De'Aaron Fox",2,44,51,48,10,55.1
"6477",2213,9,1,1,8,4,15,7,0,0,33,0,2,18,1,0,4,1037916,"2023-12-14T00:00:00.000Z",324,26,"Malik Monk",1,19,28,27,10,31.7
"6478",2214,3,1,4,7,5,8,6,0,0,27,2,5,17,6,1,0,1037916,"2023-12-14T00:00:00.000Z",38017714,26,"Keon Ellis",2,23,26,20,9,34.7
"6479",2215,1,1,6,4,1,5,2,0,0,19,1,2,5,7,0,0,1037916,"2023-12-14T00:00:00.000Z",290,26,"Trey Lyles",1,12,13,6,8,17.9
"6480",2216,0,0,3,4,1,4,1,0,0,10,1,1,3,4,0,0,1037916,"2023-12-14T00:00:00.000Z",4197162,26,"Aleksandar Vezenkov",0,7,7,3,4,7.8
"6481",2217,0,0,2,0,0,1,1,0,0,4,0,1,2,2,0,2,1037916,"2023-12-14T00:00:00.000Z",306,26,"JaVale McGee",0,4,4,2,2,2.4
"6482",2218,0,0,0,0,0,0,0,0,0,1,0,0,0,0,0,0,1037916,"2023-12-14T00:00:00.000Z",17896044,26,"Kessler Edwards",0,0,0,0,0,0
"6483",2219,0,0,0,0,0,0,0,0,0,0,0,0,0,0,0,0,1037916,"2023-12-14T00:00:00.000Z",17896030,26,"Chris Duarte",0,0,0,0,0,0
"6484",2220,1,0,0,6,2,8,3,2,1,25,0,0,9,0,1,4,1037914,"2023-12-14T00:00:00.000Z",61,3,"Mikal Bridges",1,9,10,10,1,9.5
"6485",2221,0,0,2,7,2,10,4,0,0,22,1,2,10,3,0,1,1037914,"2023-12-14T00:00:00.000Z",666679,3,"Cameron Johnson",0,13,13,10,3,12.6
"6486",2222,0,0,0,0,0,0,0,0,0,0,0,0,0,0,0,0,1037914,"2023-12-14T00:00:00.000Z",56677843,3,"Noah Clowney",0,0,0,0,0,0
"6487",2223,0,0,0,0,0,0,0,0,0,0,0,0,0,0,0,0,1037914,"2023-12-14T00:00:00.000Z",17896041,3,"Keon Johnson",0,0,0,0,0,0
"6488",2224,0,0,0,0,0,0,0,0,0,0,0,0,0,0,0,0,1037914,"2023-12-14T00:00:00.000Z",417,3,"Ben Simmons",0,0,0,0,0,0
"6489",2225,0,0,0,0,0,0,0,0,0,0,0,0,0,0,0,0,1037914,"2023-12-14T00:00:00.000Z",421,3,"Dennis Smith Jr.",0,0,0,0,0,0
"6490",2226,0,0,0,0,0,0,0,0,0,0,0,0,0,0,0,0,1038097,"2024-01-07T00:00:00.000Z",371,13,"Mason Plumlee",0,0,0,0,0,0
"6491",2227,3,1,5,6,3,27,14,7,5,37,5,3,36,10,3,2,1038093,"2024-01-07T00:00:00.000Z",3547238,18,"Anthony Edwards",4,46,49,39,13,62.5
"6492",2228,3,0,1,4,1,9,3,0,0,19,0,1,7,1,1,0,1038097,"2024-01-07T00:00:00.000Z",472,13,"Russell Westbrook",1,8,11,10,4,15.7
"6493",2229,0,0,0,0,0,0,0,0,0,0,0,0,0,0,0,0,1038097,"2024-01-07T00:00:00.000Z",450,13,"PJ Tucker",0,0,0,0,0,0
"6494",2230,0,0,0,0,0,0,0,0,0,0,0,0,0,0,0,0,1038097,"2024-01-07T00:00:00.000Z",38017725,13,"Moussa Diabate",0,0,0,0,0,0
"6495",2231,0,0,0,0,0,0,0,0,0,0,0,0,0,0,0,0,1038097,"2024-01-07T00:00:00.000Z",24417679,13,"Xavier Moon",0,0,0,0,0,0
"6496",2232,0,0,0,0,0,0,0,0,0,0,0,0,0,0,0,0,1038097,"2024-01-07T00:00:00.000Z",17896051,13,"Joshua Primo",0,0,0,0,0,0
"6497",2233,0,0,0,0,0,0,0,0,0,0,0,0,0,0,0,0,1038095,"2024-01-07T00:00:00.000Z",666786,15,"Ja Morant",0,0,0,0,0,0
"6498",2234,2,0,1,5,1,7,1,0,0,24,0,1,3,1,0,0,1038098,"2024-01-08T00:00:00.000Z",38017708,4,"Bryce McGowens",0,4,6,5,3,7.2
"6499",2235,5,2,6,8,4,18,9,3,2,40,2,3,24,8,1,5,1038098,"2024-01-08T00:00:00.000Z",62,4,"Miles Bridges",3,32,37,29,13,45.1
"6500",2236,1,3,7,0,0,6,5,0,0,39,1,4,10,8,0,0,1038098,"2024-01-08T00:00:00.000Z",3547282,4,"Nick Richards",3,18,19,11,9,30.1
"6501",2237,4,0,6,7,0,11,2,0,0,31,0,4,4,6,1,3,1038098,"2024-01-08T00:00:00.000Z",56677823,4,"Brandon Miller",1,10,14,8,10,17.2
"6502",2238,8,0,3,13,7,18,10,12,12,44,0,2,39,3,0,0,1038098,"2024-01-08T00:00:00.000Z",403,4,"Terry Rozier",0,42,50,47,11,54.6
"6503",2239,1,0,0,0,0,4,1,0,0,15,0,1,2,0,0,0,1038098,"2024-01-08T00:00:00.000Z",422,4,"Ish Smith",0,2,3,3,1,3.5
"6504",2241,3,0,2,6,3,15,6,0,0,32,2,2,15,4,1,3,1038098,"2024-01-08T00:00:00.000Z",56677846,4,"Nick Smith Jr.",1,19,22,18,7,24.3
"6505",2242,2,0,2,1,1,1,1,0,0,4,0,1,3,2,0,0,1038098,"2024-01-08T00:00:00.000Z",17896037,4,"James Bouknight",0,5,7,5,4,8.4
"6506",2243,0,0,0,0,0,0,0,0,0,0,0,0,0,0,0,0,1038098,"2024-01-08T00:00:00.000Z",56677866,4,"Leaky Black",0,0,0,0,0,0
"6507",2244,0,0,0,0,0,0,0,0,0,0,0,0,0,0,0,0,1038098,"2024-01-08T00:00:00.000Z",347,4,"Frank Ntilikina",0,0,0,0,0,0
"6508",2245,4,0,4,3,2,8,5,6,5,33,0,4,17,4,1,4,1038100,"2024-01-08T00:00:00.000Z",3547242,30,"Deni Avdija",1,21,25,21,8,26.8
"6509",2246,5,0,11,5,0,24,10,2,2,37,4,1,22,15,0,2,1038100,"2024-01-08T00:00:00.000Z",265,30,"Kyle Kuzma",0,37,42,27,20,45.5
"6510",2247,1,1,5,0,0,7,3,3,3,26,4,2,9,9,0,0,1038100,"2024-01-08T00:00:00.000Z",666577,30,"Daniel Gafford",1,18,19,10,10,24.3
"6511",2248,5,0,0,8,4,17,8,5,4,29,0,5,24,0,0,1,1038100,"2024-01-08T00:00:00.000Z",666848,30,"Jordan Poole",0,24,29,29,5,30.5
"6512",2249,9,0,0,5,3,10,7,2,1,31,0,1,18,0,3,2,1038100,"2024-01-08T00:00:00.000Z",249,30,"Tyus Jones",3,18,27,27,9,38.5
"6513",2250,3,2,4,2,1,4,1,2,2,25,1,2,5,5,0,0,1038100,"2024-01-08T00:00:00.000Z",56677844,30,"Bilal Coulibaly",2,10,13,8,8,21.5
"6514",2251,0,0,0,0,0,0,0,0,0,0,0,0,0,0,0,0,3277428,"2023-11-14T00:00:00.000Z",56677843,3,"Noah Clowney",0,0,0,0,0,0
"6515",2252,0,0,0,0,0,0,0,0,0,0,0,0,0,0,0,0,3277427,"2023-11-14T00:00:00.000Z",56677861,12,"Ben Sheppard",0,0,0,0,0,0
"6516",2253,0,0,0,0,0,0,0,0,0,0,0,0,0,0,0,0,3277427,"2023-11-14T00:00:00.000Z",56677832,12,"Jarace Walker",0,0,0,0,0,0
"6517",2254,0,0,0,0,0,0,0,0,0,0,0,0,0,0,0,0,3277427,"2023-11-14T00:00:00.000Z",38017701,12,"Kendall Brown",0,0,0,0,0,0
"6518",2255,0,0,0,0,0,0,0,0,0,0,0,0,0,0,0,0,3277427,"2023-11-14T00:00:00.000Z",439,12,"Daniel Theis",0,0,0,0,0,0
"6519",2256,0,0,0,0,0,0,0,0,0,0,0,0,0,0,0,0,3277427,"2023-11-14T00:00:00.000Z",56677778,12,"Oscar Tshiebwe",0,0,0,0,0,0
"6520",2257,0,0,0,0,0,0,0,0,0,0,0,0,0,0,0,0,3277427,"2023-11-14T00:00:00.000Z",56677794,12,"Isaiah Wong",0,0,0,0,0,0
"6521",2258,2,0,4,4,1,7,1,0,0,18,0,2,3,4,2,0,3277429,"2023-11-14T00:00:00.000Z",38017706,21,"Jaylin Williams",2,7,9,5,6,16.8
"6522",2259,2,0,0,3,1,7,4,0,0,15,0,3,9,0,0,1,3277429,"2023-11-14T00:00:00.000Z",480,21,"Kenrich Williams",0,9,11,11,2,11
"6523",2260,0,0,0,3,2,3,2,0,0,5,0,0,6,0,0,0,3277429,"2023-11-14T00:00:00.000Z",27924547,21,"Lindy Waters III",0,6,6,6,0,6
"6524",2261,1,0,0,1,1,1,1,0,0,5,0,0,3,0,1,0,3277429,"2023-11-14T00:00:00.000Z",17896078,21,"Aaron Wiggins",1,3,4,4,1,7.5
"6525",2262,0,0,0,0,0,0,0,0,0,0,0,0,0,0,0,0,3277429,"2023-11-14T00:00:00.000Z",38017716,21,"Ousmane Dieng",0,0,0,0,0,0
"6526",2263,0,0,0,0,0,0,0,0,0,0,0,0,0,0,0,0,3277429,"2023-11-14T00:00:00.000Z",56677853,21,"Keyontae Johnson",0,0,0,0,0,0
"6527",2264,0,0,0,0,0,0,0,0,0,0,0,0,0,0,0,0,3277429,"2023-11-14T00:00:00.000Z",24572055,21,"Olivier Sarr",0,0,0,0,0,0
"6528",2265,3,3,2,7,3,14,4,2,2,31,1,0,13,3,4,2,3277429,"2023-11-14T00:00:00.000Z",38017649,27,"Julian Champagnie",7,16,19,16,6,40.1
"6529",2266,2,2,11,3,0,15,4,0,0,28,3,2,8,14,0,5,3277429,"2023-11-14T00:00:00.000Z",56677822,27,"Victor Wembanyama",2,22,24,10,16,28.8
"6530",2267,1,0,5,0,0,5,3,0,0,17,2,1,6,7,0,0,3277429,"2023-11-14T00:00:00.000Z",17895854,27,"Charles Bassey",0,13,14,7,8,15.9
"6531",2268,0,0,1,0,0,0,0,0,0,5,0,0,0,1,0,0,3277429,"2023-11-14T00:00:00.000Z",38017730,27,"Dominick Barlow",0,1,1,0,1,1.2
"6532",2269,4,0,5,0,0,4,3,6,5,21,1,3,11,6,0,1,3277428,"2023-11-14T00:00:00.000Z",462,22,"Moritz Wagner",0,17,21,15,10,23.2
"6533",2270,0,0,0,0,0,0,0,0,0,0,0,0,0,0,0,0,3277428,"2023-11-14T00:00:00.000Z",85,22,"Wendell Carter Jr.",0,0,0,0,0,0
"6534",2271,0,0,0,0,0,0,0,0,0,0,0,0,0,0,0,0,3277428,"2023-11-14T00:00:00.000Z",165,22,"Markelle Fultz",0,0,0,0,0,0
"6535",2272,0,0,0,0,0,0,0,0,0,0,0,0,0,0,0,0,3277428,"2023-11-14T00:00:00.000Z",196,22,"Gary Harris",0,0,0,0,0,0
"6536",2273,0,0,0,0,0,0,0,0,0,0,0,0,0,0,0,0,3277428,"2023-11-14T00:00:00.000Z",38017607,22,"Kevon Harris",0,0,0,0,0,0
"6537",2274,0,0,0,0,0,0,0,0,0,0,0,0,0,0,0,0,3277428,"2023-11-14T00:00:00.000Z",17553983,22,"Trevelin Queen",0,0,0,0,0,0
"6538",2275,0,0,0,0,0,0,0,0,0,0,0,0,0,0,0,0,3277428,"2023-11-14T00:00:00.000Z",666885,22,"Admiral Schofield",0,0,0,0,0,0
"6539",2276,0,0,0,0,0,0,0,0,0,0,0,0,0,0,0,0,1037900,"2023-12-12T00:00:00.000Z",3547298,24,"Saben Lee",0,0,0,0,0,0
"6540",2277,0,0,0,0,0,0,0,0,0,0,0,0,0,0,0,0,1037900,"2023-12-12T00:00:00.000Z",666729,24,"Nassir Little",0,0,0,0,0,0
"6541",2278,1,0,2,3,1,7,1,0,0,15,2,1,3,4,0,3,1037900,"2023-12-12T00:00:00.000Z",475,10,"Andrew Wiggins",0,7,8,4,5,6.3
"6542",2279,3,1,4,3,2,14,11,7,7,31,0,0,31,4,1,1,1037901,"2023-12-12T00:00:00.000Z",274,13,"Kawhi Leonard",2,35,38,34,7,45.3
"6543",2280,1,0,6,5,2,7,3,1,1,16,0,0,9,6,2,3,1037901,"2023-12-12T00:00:00.000Z",172,13,"Paul George",2,15,16,10,7,20.7
"6544",2281,0,0,9,0,0,5,3,1,0,23,0,4,6,9,0,1,1037901,"2023-12-12T00:00:00.000Z",493,13,"Ivica Zubac",0,15,15,6,9,15.8
"6545",2282,2,0,4,3,2,6,3,2,2,30,1,1,10,5,1,1,1037901,"2023-12-12T00:00:00.000Z",666743,13,"Terance Mann",1,15,17,12,7,21
"6546",2283,7,0,6,4,0,9,4,7,7,28,0,3,15,6,2,2,1037901,"2023-12-12T00:00:00.000Z",192,13,"James Harden",2,21,28,22,13,36.7
"6547",2284,2,0,1,4,2,11,5,3,3,27,0,1,15,1,0,1,1037901,"2023-12-12T00:00:00.000Z",380,13,"Norman Powell",0,16,18,17,3,18.2
"6548",2285,0,1,5,3,1,5,3,0,0,24,1,5,7,6,0,1,1037901,"2023-12-12T00:00:00.000Z",56677849,13,"Kobe Brown",1,13,13,7,6,16.2
"6549",2286,0,0,2,1,0,8,4,0,0,16,1,2,8,3,1,0,1037901,"2023-12-12T00:00:00.000Z",439,13,"Daniel Theis",1,11,11,8,3,14.6
"6550",2287,1,0,1,4,2,8,2,0,0,9,0,0,6,1,0,0,1037901,"2023-12-12T00:00:00.000Z",17896031,13,"Nah'Shon Hyland",0,7,8,7,2,8.7
"6551",2288,0,0,0,0,0,1,1,0,0,9,1,0,2,1,0,0,1037901,"2023-12-12T00:00:00.000Z",666511,13,"Amir Coffey",0,3,3,2,1,3.2
"6552",2289,2,0,0,1,0,2,1,0,0,7,0,1,2,0,0,1,1037901,"2023-12-12T00:00:00.000Z",24417679,13,"Xavier Moon",0,2,4,4,2,4
"6553",2290,1,1,0,1,1,1,1,0,0,12,0,0,3,0,0,2,1037901,"2023-12-12T00:00:00.000Z",38017714,26,"Keon Ellis",1,3,4,4,1,5.5
"6554",2291,1,1,2,2,0,3,1,4,4,12,0,1,6,2,0,0,1037901,"2023-12-12T00:00:00.000Z",17896030,26,"Chris Duarte",1,8,9,7,3,12.9
"6555",2292,0,0,0,1,1,3,3,0,0,8,0,0,7,0,0,0,1037901,"2023-12-12T00:00:00.000Z",17896044,26,"Kessler Edwards",0,7,7,7,0,7
"6556",2293,1,0,1,1,1,2,2,0,0,8,0,0,5,1,0,1,1037901,"2023-12-12T00:00:00.000Z",17895990,26,"Jordan Ford",0,6,7,6,2,6.7
"6557",2294,0,0,0,0,0,0,0,0,0,0,0,0,0,0,0,0,1037901,"2023-12-12T00:00:00.000Z",273,26,"Alex Len",0,0,0,0,0,0
"6558",2295,3,0,5,1,0,8,4,0,0,20,2,0,8,7,0,4,1037901,"2023-12-12T00:00:00.000Z",472,13,"Russell Westbrook",0,15,18,11,10,16.9
"6559",2296,0,0,0,0,0,0,0,0,0,0,0,0,0,0,0,0,1037901,"2023-12-12T00:00:00.000Z",450,13,"PJ Tucker",0,0,0,0,0,0
"6560",2297,0,0,0,0,0,0,0,0,0,0,0,0,0,0,0,0,1037901,"2023-12-12T00:00:00.000Z",17896022,13,"Brandon Boston Jr.",0,0,0,0,0,0
"6561",2298,0,0,0,0,0,0,0,0,0,0,0,0,0,0,0,0,1037901,"2023-12-12T00:00:00.000Z",38017725,13,"Moussa Diabate",0,0,0,0,0,0
"6562",2299,0,0,0,0,0,0,0,0,0,0,0,0,0,0,0,0,1037901,"2023-12-12T00:00:00.000Z",56677856,13,"Jordan Miller",0,0,0,0,0,0
"6563",2300,0,0,0,0,0,0,0,0,0,0,0,0,0,0,0,0,1037901,"2023-12-12T00:00:00.000Z",371,13,"Mason Plumlee",0,0,0,0,0,0
"6564",2301,0,0,0,0,0,0,0,0,0,0,0,0,0,0,0,0,1038078,"2024-01-05T00:00:00.000Z",17896021,19,"Jeremiah Robinson-Earl",0,0,0,0,0,0
"6565",2302,0,0,0,0,0,0,0,0,0,0,0,0,0,0,0,0,1038078,"2024-01-05T00:00:00.000Z",3547260,19,"Kira Lewis Jr.",0,0,0,0,0,0
"6566",2303,0,0,0,0,0,0,0,0,0,0,0,0,0,0,0,0,1038078,"2024-01-05T00:00:00.000Z",38017663,19,"E.J. Liddell",0,0,0,0,0,0
"6567",2304,0,0,0,0,0,0,0,0,0,0,0,0,0,0,0,0,1038078,"2024-01-05T00:00:00.000Z",17896017,19,"Matt Ryan",0,0,0,0,0,0
"6568",2305,0,0,0,0,0,0,0,0,0,0,0,0,0,0,0,0,1038078,"2024-01-05T00:00:00.000Z",38017726,19,"Dereon Seabron",0,0,0,0,0,0
"6569",2306,1,1,7,10,6,15,9,0,0,30,0,2,24,7,0,2,1038078,"2024-01-05T00:00:00.000Z",172,13,"Paul George",1,31,32,25,8,34.9
"6570",2307,0,0,0,0,0,0,0,0,0,0,0,0,0,0,0,0,1038073,"2024-01-05T00:00:00.000Z",174,3,"Harry Giles III",0,0,0,0,0,0
"6571",2308,0,0,0,0,0,0,0,0,0,0,0,0,0,0,0,0,1038073,"2024-01-05T00:00:00.000Z",17896058,3,"Trendon Watford",0,0,0,0,0,0
"6572",2309,0,0,0,0,0,0,0,0,0,0,0,0,0,0,0,0,1038073,"2024-01-05T00:00:00.000Z",9051997,3,"Armoni Brooks",0,0,0,0,0,0
"6573",2310,0,0,0,0,0,0,0,0,0,0,0,0,0,0,0,0,1038073,"2024-01-05T00:00:00.000Z",56677843,3,"Noah Clowney",0,0,0,0,0,0
"6574",2311,0,0,0,0,0,0,0,0,0,0,0,0,0,0,0,0,1038073,"2024-01-05T00:00:00.000Z",17896041,3,"Keon Johnson",0,0,0,0,0,0
"6575",2312,0,0,0,0,0,0,0,0,0,0,0,0,0,0,0,0,1038073,"2024-01-05T00:00:00.000Z",417,3,"Ben Simmons",0,0,0,0,0,0
"6576",2313,1,0,0,1,1,9,4,0,0,17,3,2,9,3,1,2,1038078,"2024-01-05T00:00:00.000Z",3547293,19,"Naji Marshall",1,12,13,10,4,15.1
"6577",2314,0,0,3,1,0,3,1,5,4,12,2,0,6,5,0,2,1038071,"2024-01-05T00:00:00.000Z",666881,29,"Luka Samanic",0,11,11,6,5,10
"6578",2315,0,0,4,2,0,4,0,2,0,12,3,1,0,7,0,1,1038071,"2024-01-05T00:00:00.000Z",11891374,29,"Omer Yurtseven",0,7,7,0,7,7.4
"6579",2316,0,0,0,0,0,0,0,0,0,0,0,0,0,0,0,0,1038071,"2024-01-05T00:00:00.000Z",17896023,29,"Josh Christopher",0,0,0,0,0,0
"6580",2317,0,0,1,3,3,7,4,2,2,7,0,0,13,1,0,0,1038078,"2024-01-05T00:00:00.000Z",56677837,19,"Jordan Hawkins",0,14,14,13,1,14.2
"6581",2318,5,2,3,3,1,6,3,2,1,22,2,2,8,5,2,4,1038078,"2024-01-05T00:00:00.000Z",472,13,"Russell Westbrook",4,13,18,13,10,29.5
"6582",2319,0,0,3,1,0,3,1,0,0,17,2,1,2,5,0,1,1038078,"2024-01-05T00:00:00.000Z",439,13,"Daniel Theis",0,7,7,2,5,7
"6583",2320,2,0,3,6,3,13,5,0,0,25,0,1,13,3,1,0,1038078,"2024-01-05T00:00:00.000Z",380,13,"Norman Powell",1,16,18,15,5,22.6
"6584",2321,0,0,2,2,0,4,2,0,0,21,1,1,4,3,1,2,1038078,"2024-01-05T00:00:00.000Z",666511,13,"Amir Coffey",1,7,7,4,3,8.6
"6585",2322,0,0,1,0,0,2,2,5,4,7,1,1,8,2,0,0,1038078,"2024-01-05T00:00:00.000Z",371,13,"Mason Plumlee",0,10,10,8,2,10.4
"6586",2323,1,0,0,0,0,3,0,0,0,6,0,1,0,0,0,0,1038078,"2024-01-05T00:00:00.000Z",17896031,13,"Nah'Shon Hyland",0,0,1,1,1,1.5
"6587",2324,0,0,0,0,0,0,0,0,0,0,0,0,0,0,0,0,1038078,"2024-01-05T00:00:00.000Z",450,13,"PJ Tucker",0,0,0,0,0,0
"6588",2325,0,0,0,0,0,0,0,0,0,0,0,0,0,0,0,0,1038078,"2024-01-05T00:00:00.000Z",38017725,13,"Moussa Diabate",0,0,0,0,0,0
"6589",2326,0,0,0,0,0,0,0,0,0,0,0,0,0,0,0,0,3277430,"2023-11-14T00:00:00.000Z",329,7,"Markieff Morris",0,0,0,0,0,0
"6590",2327,0,0,0,0,0,0,0,0,0,0,0,0,0,0,0,0,3277430,"2023-11-14T00:00:00.000Z",17896028,7,"Greg Brown III",0,0,0,0,0,0
"6591",2328,0,0,1,2,0,2,0,0,0,16,0,2,0,1,0,0,3277431,"2023-11-14T00:00:00.000Z",38017739,29,"Simone Fontecchio",0,1,1,0,1,1.2
"6592",2329,0,0,0,0,0,0,0,0,0,0,0,0,0,0,0,0,3277431,"2023-11-14T00:00:00.000Z",56677824,29,"Taylor Hendricks",0,0,0,0,0,0
"6593",2330,0,0,0,0,0,0,0,0,0,0,0,0,0,0,0,0,3277431,"2023-11-14T00:00:00.000Z",38017630,29,"Johnny Juzang",0,0,0,0,0,0
"6594",2331,0,0,0,0,0,0,0,0,0,0,0,0,0,0,0,0,3277431,"2023-11-14T00:00:00.000Z",38017705,29,"Walker Kessler",0,0,0,0,0,0
"6595",2332,0,0,0,0,0,0,0,0,0,0,0,0,0,0,0,0,3277432,"2023-11-14T00:00:00.000Z",17896022,13,"Brandon Boston Jr.",0,0,0,0,0,0
"6596",2333,0,0,0,0,0,0,0,0,0,0,0,0,0,0,0,0,3277432,"2023-11-14T00:00:00.000Z",56677856,13,"Jordan Miller",0,0,0,0,0,0
"6597",2334,0,0,0,0,0,0,0,0,0,0,0,0,0,0,0,0,3277432,"2023-11-14T00:00:00.000Z",371,13,"Mason Plumlee",0,0,0,0,0,0
"6598",2335,0,0,0,0,0,0,0,0,0,0,0,0,0,0,0,0,3277432,"2023-11-14T00:00:00.000Z",17896051,13,"Joshua Primo",0,0,0,0,0,0
"6599",2336,0,0,0,0,0,0,0,0,0,0,0,0,0,0,0,0,3277433,"2023-11-14T00:00:00.000Z",17896056,18,"Luka Garza",0,0,0,0,0,0
"6600",2337,0,0,0,0,0,0,0,0,0,0,0,0,0,0,0,0,3277433,"2023-11-14T00:00:00.000Z",666767,18,"Jordan McLaughlin",0,0,0,0,0,0
"6601",2338,0,0,0,0,0,0,0,0,0,0,0,0,0,0,0,0,3277433,"2023-11-14T00:00:00.000Z",56677782,18,"Leonard Miller",0,0,0,0,0,0
"6602",2339,0,0,0,0,0,0,0,0,0,0,0,0,0,0,0,0,3277433,"2023-11-14T00:00:00.000Z",38017700,18,"Wendell Moore Jr.",0,0,0,0,0,0
"6603",2340,0,1,0,5,2,6,3,0,0,23,0,1,8,0,0,0,1037755,"2023-11-15T00:00:00.000Z",666400,18,"Nickeil Alexander-Walker",1,8,8,8,0,11
"6604",2341,0,0,0,0,0,0,0,0,0,0,0,0,0,0,0,0,3277431,"2023-11-14T00:00:00.000Z",19465584,29,"Micah Potter",0,0,0,0,0,0
"6605",2342,0,0,0,0,0,0,0,0,0,0,0,0,0,0,0,0,3277431,"2023-11-14T00:00:00.000Z",56677842,29,"Brice Sensabaugh",0,0,0,0,0,0
"6606",2343,1,1,2,6,3,17,10,4,3,27,0,3,26,2,0,2,3277431,"2023-11-14T00:00:00.000Z",182,25,"Jerami Grant",1,28,29,27,3,30.9
"6607",2344,1,2,3,4,2,6,3,2,1,26,2,2,9,5,0,2,3277431,"2023-11-14T00:00:00.000Z",56677850,25,"Toumani Camara",2,14,15,10,6,20.5
"6608",2345,0,0,2,2,1,7,4,4,4,19,2,0,13,4,1,0,1037755,"2023-11-15T00:00:00.000Z",667378,18,"Naz Reid",1,17,17,13,4,20.8
"6609",2346,0,0,3,2,0,8,4,0,0,23,1,3,8,4,0,0,1037755,"2023-11-15T00:00:00.000Z",320,18,"Shake Milton",0,12,12,8,4,12.8
"6610",2347,3,1,1,0,0,5,2,2,2,21,1,0,6,2,2,1,1037755,"2023-11-15T00:00:00.000Z",12,18,"Kyle Anderson",3,8,11,9,5,20.9
"6611",2348,1,0,3,2,0,3,0,4,4,14,1,1,4,4,1,0,1037755,"2023-11-15T00:00:00.000Z",68,18,"Troy Brown Jr.",1,8,9,5,5,13.3
"6612",2349,0,0,0,2,0,3,1,1,0,5,1,0,2,1,0,0,1037755,"2023-11-15T00:00:00.000Z",38017715,18,"Josh Minott",0,3,3,2,1,3.2
"6613",2350,0,0,0,1,0,4,1,4,3,4,2,0,5,2,0,0,1037755,"2023-11-15T00:00:00.000Z",17896056,18,"Luka Garza",0,7,7,5,2,7.4
"6614",2351,1,0,7,5,0,14,6,6,5,31,0,2,17,7,3,0,1037901,"2023-12-12T00:00:00.000Z",38017688,26,"Keegan Murray",3,24,25,18,8,35.9
"6615",2352,0,0,0,0,0,0,0,0,0,0,0,0,0,0,0,0,1037899,"2023-12-12T00:00:00.000Z",56677871,8,"Hunter Tyson",0,0,0,0,0,0
"6616",2353,0,0,0,0,0,0,0,0,0,0,0,0,0,0,0,0,1037899,"2023-12-12T00:00:00.000Z",666489,8,"Vlatko Cancar",0,0,0,0,0,0
"6617",2354,0,0,0,0,0,0,0,0,0,0,0,0,0,0,0,0,1037899,"2023-12-12T00:00:00.000Z",38017727,8,"Collin Gillespie",0,0,0,0,0,0
"6618",2355,0,0,0,0,0,0,0,0,0,0,0,0,0,0,0,0,1037899,"2023-12-12T00:00:00.000Z",17896103,8,"Jay Huff",0,0,0,0,0,0
"6619",2356,0,0,0,0,0,0,0,0,0,0,0,0,0,0,0,0,1037899,"2023-12-12T00:00:00.000Z",17896007,8,"Braxton Key",0,0,0,0,0,0
"6620",2357,0,0,0,0,0,0,0,0,0,0,0,0,0,0,0,0,1037899,"2023-12-12T00:00:00.000Z",335,8,"Jamal Murray",0,0,0,0,0,0
"6621",2358,2,0,2,2,0,3,1,0,0,17,0,3,2,2,0,3,1037900,"2023-12-12T00:00:00.000Z",185,10,"Draymond Green",0,4,6,4,4,4.4
"6622",2359,2,0,3,0,0,0,0,0,0,11,2,2,0,5,1,0,1037900,"2023-12-12T00:00:00.000Z",282,10,"Kevon Looney",1,5,7,2,7,12
"6623",2360,0,0,5,8,1,10,2,2,2,27,0,1,7,5,0,1,1037900,"2023-12-12T00:00:00.000Z",443,10,"Klay Thompson",0,12,12,7,5,12
"6624",2361,4,0,5,15,4,24,8,4,4,32,0,2,24,5,3,1,1037900,"2023-12-12T00:00:00.000Z",115,10,"Stephen Curry",3,29,33,28,9,44
"6625",2362,11,0,5,4,3,8,5,3,2,30,0,4,15,5,2,1,1037900,"2023-12-12T00:00:00.000Z",367,10,"Chris Paul",2,20,31,26,16,42.5
"6626",2363,0,0,3,3,2,6,3,6,4,24,1,3,12,4,0,2,1037900,"2023-12-12T00:00:00.000Z",17553992,10,"Moses Moody",0,16,16,12,4,14.8
"6627",2364,0,0,4,3,1,10,6,7,3,28,2,4,16,6,1,1,1037900,"2023-12-12T00:00:00.000Z",17553979,10,"Jonathan Kuminga",1,22,22,16,6,25.2
"6628",2365,5,0,0,5,2,8,3,0,0,22,0,4,8,0,0,4,1037901,"2023-12-12T00:00:00.000Z",324,26,"Malik Monk",0,8,13,13,5,11.5
"6629",2366,3,0,5,3,0,4,1,2,1,20,1,1,3,6,1,0,1037901,"2023-12-12T00:00:00.000Z",290,26,"Trey Lyles",1,9,12,6,9,17.7
"6630",2367,0,0,0,0,0,3,3,1,0,6,1,1,6,1,0,1,1037901,"2023-12-12T00:00:00.000Z",306,26,"JaVale McGee",0,7,7,6,1,6.2
"6631",2368,3,0,3,3,1,7,4,0,0,20,0,0,9,3,1,0,1037901,"2023-12-12T00:00:00.000Z",4197162,26,"Aleksandar Vezenkov",1,12,15,12,6,20.1
"6632",2369,2,0,0,1,0,3,0,2,1,15,0,1,1,0,0,0,1037901,"2023-12-12T00:00:00.000Z",17553994,26,"Davion Mitchell",0,1,3,3,2,4
"6633",2370,0,0,0,0,0,0,0,0,0,0,0,0,0,0,0,0,1037901,"2023-12-12T00:00:00.000Z",56677845,26,"Colby Jones",0,0,0,0,0,0
"6634",2371,0,0,0,0,0,0,0,0,0,0,0,0,0,0,0,0,1037901,"2023-12-12T00:00:00.000Z",56677862,26,"Jalen Slawson",0,0,0,0,0,0
"6635",2372,7,0,5,3,1,8,4,4,4,30,1,1,13,6,0,2,1037903,"2023-12-13T00:00:00.000Z",3547242,30,"Deni Avdija",0,19,26,20,13,28.7
"6636",2373,4,1,7,8,4,19,10,4,3,29,0,1,27,7,1,1,1037903,"2023-12-13T00:00:00.000Z",265,30,"Kyle Kuzma",2,34,38,31,11,46.4
"6637",2374,3,0,6,1,0,7,5,0,0,30,2,3,10,8,1,0,1037902,"2023-12-13T00:00:00.000Z",56677826,9,"Ausar Thompson",1,18,21,13,11,27.1
"6638",2375,2,0,1,9,5,19,11,8,6,34,0,1,33,1,1,1,1037902,"2023-12-13T00:00:00.000Z",54,9,"Bojan Bogdanovic",1,34,36,35,3,39.2
"6639",2376,0,0,0,0,0,0,0,0,0,0,0,0,0,0,0,0,1038079,"2024-01-05T00:00:00.000Z",151,7,"Dante Exum",0,0,0,0,0,0
"6640",2377,0,0,0,0,0,0,0,0,0,0,0,0,0,0,0,0,1038079,"2024-01-05T00:00:00.000Z",217,7,"Richaun Holmes",0,0,0,0,0,0
"6641",2378,0,0,0,0,0,0,0,0,0,0,0,0,0,0,0,0,1038079,"2024-01-05T00:00:00.000Z",257,7,"Maxi Kleber",0,0,0,0,0,0
"6642",2379,0,0,0,0,0,0,0,0,0,0,0,0,0,0,0,0,1038079,"2024-01-05T00:00:00.000Z",56677840,7,"Dereck Lively II",0,0,0,0,0,0
"6643",2380,0,0,0,0,0,0,0,0,0,0,0,0,0,0,0,0,1038079,"2024-01-05T00:00:00.000Z",329,7,"Markieff Morris",0,0,0,0,0,0
"6644",2381,0,0,0,0,0,0,0,0,0,0,0,0,0,0,0,0,1038079,"2024-01-05T00:00:00.000Z",666965,7,"Grant Williams",0,0,0,0,0,0
"6645",2382,9,0,7,6,2,18,11,1,1,37,1,2,25,8,0,2,1038081,"2024-01-05T00:00:00.000Z",37,24,"Bradley Beal",0,33,42,34,17,46.1
"6646",2383,10,0,5,7,2,19,9,0,0,35,0,2,20,5,2,3,1038081,"2024-01-05T00:00:00.000Z",57,24,"Devin Booker",2,25,35,30,15,44
"6647",2384,4,2,1,1,0,2,0,8,7,24,1,5,7,2,3,0,1038081,"2024-01-05T00:00:00.000Z",356,24,"Josh Okogie",5,9,13,11,6,30.4
"6648",2385,0,0,0,0,0,0,0,0,0,2,0,0,0,0,0,0,1038075,"2024-01-05T00:00:00.000Z",17896063,20,"Jericho Sims",0,0,0,0,0,0
"6649",2386,0,0,0,0,0,0,0,0,0,0,0,0,0,0,0,0,1038075,"2024-01-05T00:00:00.000Z",160,20,"Evan Fournier",0,0,0,0,0,0
"6650",2387,0,0,0,0,0,0,0,0,0,0,0,0,0,0,0,0,1038075,"2024-01-05T00:00:00.000Z",173,20,"Taj Gibson",0,0,0,0,0,0
"6651",2388,13,0,3,6,1,7,2,3,3,29,0,2,8,3,0,1,1038078,"2024-01-05T00:00:00.000Z",192,13,"James Harden",0,11,24,21,16,30.1
"6652",2389,1,1,2,0,0,2,2,1,0,10,1,1,4,3,0,0,1038081,"2024-01-05T00:00:00.000Z",666451,24,"Bol Bol",1,7,8,5,4,12.1
"6653",2390,0,0,4,1,1,8,4,4,2,22,2,1,11,6,1,0,1038081,"2024-01-05T00:00:00.000Z",147,24,"Drew Eubanks",1,17,17,11,6,21.2
"6654",2391,0,0,0,1,0,3,1,0,0,9,1,0,2,1,0,0,1038081,"2024-01-05T00:00:00.000Z",470,24,"Yuta Watanabe",0,3,3,2,1,3.2
"6655",2392,0,0,3,3,0,6,0,0,0,19,1,1,0,4,3,0,1038081,"2024-01-05T00:00:00.000Z",32,24,"Keita Bates-Diop",3,4,4,0,4,13.8
"6656",2393,0,0,0,1,0,1,0,0,0,2,0,0,0,0,0,0,1038081,"2024-01-05T00:00:00.000Z",18678058,24,"Jordan Goodwin",0,0,0,0,0,0
"6657",2394,0,0,0,0,0,0,0,0,0,2,0,0,0,0,0,1,1038081,"2024-01-05T00:00:00.000Z",38017736,16,"Cole Swider",0,0,0,0,0,-1
"6658",2395,0,0,0,0,0,0,0,0,0,0,0,0,0,0,0,0,1038081,"2024-01-05T00:00:00.000Z",79,16,"Jimmy Butler",0,0,0,0,0,0
"6659",2396,0,0,0,0,0,0,0,0,0,0,0,0,0,0,0,0,1038081,"2024-01-05T00:00:00.000Z",3092,16,"Haywood Highsmith",0,0,0,0,0,0
"6660",2397,0,0,0,0,0,0,0,0,0,0,0,0,0,0,0,0,1038081,"2024-01-05T00:00:00.000Z",666747,16,"Caleb Martin",0,0,0,0,0,0
"6661",2398,0,0,0,0,0,0,0,0,0,0,0,0,0,0,0,0,1038081,"2024-01-05T00:00:00.000Z",39398582,16,"Orlando Robinson",0,0,0,0,0,0
"6662",2399,3,1,1,3,2,11,6,5,4,22,0,1,18,1,3,1,1038079,"2024-01-05T00:00:00.000Z",182,25,"Jerami Grant",4,19,22,21,4,34.7
"6663",2400,1,0,6,7,2,10,4,1,0,24,1,2,10,7,1,2,1038079,"2024-01-05T00:00:00.000Z",56677850,25,"Toumani Camara",1,17,18,11,8,20.9
"6664",2401,0,0,0,0,0,0,0,0,0,0,0,0,0,0,0,0,1037726,"2023-11-12T00:00:00.000Z",17896048,3,"Cam Thomas",0,0,0,0,0,0
"6665",2402,1,0,0,3,0,4,0,0,0,9,1,1,0,1,0,0,1037727,"2023-11-12T00:00:00.000Z",17896027,15,"Ziaire Williams",0,1,2,1,2,2.7
"6666",2403,0,0,0,0,0,0,0,0,0,0,0,0,0,0,0,0,1037727,"2023-11-12T00:00:00.000Z",3,15,"Steven Adams",0,0,0,0,0,0
"6667",2404,0,0,0,0,0,0,0,0,0,0,0,0,0,0,0,0,1037727,"2023-11-12T00:00:00.000Z",666505,15,"Brandon Clarke",0,0,0,0,0,0
"6668",2405,0,0,0,0,0,0,0,0,0,0,0,0,0,0,0,0,1037727,"2023-11-12T00:00:00.000Z",56677830,15,"GG Jackson",0,0,0,0,0,0
"6669",2406,0,0,0,0,0,0,0,0,0,0,0,0,0,0,0,0,1037727,"2023-11-12T00:00:00.000Z",38017728,15,"Jake LaRavia",0,0,0,0,0,0
"6670",2407,0,0,0,0,0,0,0,0,0,0,0,0,0,0,0,0,1037727,"2023-11-12T00:00:00.000Z",666786,15,"Ja Morant",0,0,0,0,0,0
"6671",2408,0,0,0,0,0,0,0,0,0,0,0,0,0,0,0,0,1037727,"2023-11-12T00:00:00.000Z",401,15,"Derrick Rose",0,0,0,0,0,0
"6672",2409,0,0,0,0,0,0,0,0,0,0,0,0,0,0,0,0,1037727,"2023-11-12T00:00:00.000Z",3547285,15,"Xavier Tillman",0,0,0,0,0,0
"6673",2410,0,3,5,5,3,5,3,0,0,33,2,2,9,7,1,1,1037728,"2023-11-12T00:00:00.000Z",33,23,"Nicolas Batum",4,16,16,9,7,28.4
"6674",2411,4,0,5,3,0,20,9,0,0,36,4,2,18,9,0,1,1037728,"2023-11-12T00:00:00.000Z",200,23,"Tobias Harris",0,27,31,22,13,33.8
"6675",2412,7,1,5,4,1,26,12,14,12,33,8,2,37,13,1,3,1037728,"2023-11-12T00:00:00.000Z",145,23,"Joel Embiid",2,50,57,44,20,66.1
"6676",2413,6,0,3,3,1,7,4,1,1,30,1,1,10,4,0,2,1037728,"2023-11-12T00:00:00.000Z",313,23,"De'Anthony Melton",0,14,20,16,10,21.8
"6677",2414,5,3,4,11,7,32,20,3,3,39,3,2,50,7,0,2,1037728,"2023-11-12T00:00:00.000Z",3547254,23,"Tyrese Maxey",3,57,62,55,12,72.9
"6678",2415,1,0,1,4,1,4,1,0,0,17,1,3,3,2,1,0,1037728,"2023-11-12T00:00:00.000Z",45,23,"Patrick Beverley",1,5,6,4,3,9.9
"6679",2416,2,0,3,2,0,5,1,0,0,16,2,1,2,5,0,0,1037728,"2023-11-12T00:00:00.000Z",108,23,"Robert Covington",0,7,9,4,7,11
"6680",2417,0,0,0,0,0,1,0,0,0,5,0,0,0,0,1,1,1037728,"2023-11-12T00:00:00.000Z",260,23,"Furkan Korkmaz",1,0,0,0,0,2
"6681",2418,0,0,1,1,1,1,1,2,1,16,0,0,4,1,0,1,1037728,"2023-11-12T00:00:00.000Z",2175,23,"Danuel House Jr.",0,5,5,4,1,4.2
"6682",2419,3,0,4,0,0,4,2,0,0,15,2,2,4,6,1,0,1037728,"2023-11-12T00:00:00.000Z",3547270,23,"Paul Reed",1,10,13,7,9,18.7
"6683",2420,0,0,0,0,0,0,0,0,0,0,0,0,0,0,0,0,1037728,"2023-11-12T00:00:00.000Z",28,23,"Mo Bamba",0,0,0,0,0,0
"6684",2421,0,0,0,0,0,0,0,0,0,0,0,0,0,0,0,0,1037728,"2023-11-12T00:00:00.000Z",3547294,23,"Kenyon Martin Jr.",0,0,0,0,0,0
"6685",2422,0,0,0,0,0,0,0,0,0,0,0,0,0,0,0,0,1037728,"2023-11-12T00:00:00.000Z",328,23,"Marcus Morris",0,0,0,0,0,0
"6686",2423,0,0,0,0,0,0,0,0,0,0,0,0,0,0,0,0,1037728,"2023-11-12T00:00:00.000Z",17896025,23,"Jaden Springer",0,0,0,0,0,0
"6687",2424,0,0,0,0,0,0,0,0,0,0,0,0,0,0,0,0,1037728,"2023-11-12T00:00:00.000Z",56913527,23,"Ricky Council IV",0,0,0,0,0,0
"6688",2425,0,0,0,0,0,0,0,0,0,0,0,0,0,0,0,0,1037728,"2023-11-12T00:00:00.000Z",360,23,"Kelly Oubre Jr.",0,0,0,0,0,0
"6689",2426,0,2,5,0,0,6,5,4,3,24,1,3,13,6,1,1,1037903,"2023-12-13T00:00:00.000Z",666577,30,"Daniel Gafford",3,19,19,13,6,28.2
"6690",2427,4,1,1,5,1,12,5,0,0,31,0,2,11,1,2,5,1037903,"2023-12-13T00:00:00.000Z",666848,30,"Jordan Poole",3,12,16,15,5,22.2
"6691",2428,4,0,0,5,2,6,2,0,0,26,0,0,6,0,1,1,1037903,"2023-12-13T00:00:00.000Z",249,30,"Tyus Jones",1,6,10,10,4,14
"6692",2429,1,1,4,6,4,9,6,2,0,32,1,3,16,5,1,2,1037903,"2023-12-13T00:00:00.000Z",56677844,30,"Bilal Coulibaly",2,21,22,17,6,27.5
"6693",2430,0,1,3,6,3,7,4,2,1,21,0,2,12,3,0,1,1037903,"2023-12-13T00:00:00.000Z",17896045,30,"Corey Kispert",1,15,15,12,3,17.6
"6694",2431,1,0,1,3,1,6,2,4,4,16,0,0,9,1,0,1,1037903,"2023-12-13T00:00:00.000Z",167,30,"Danilo Gallinari",0,10,11,10,2,10.7
"6695",2432,4,0,1,4,2,4,2,2,2,13,0,1,8,1,1,1,1037903,"2023-12-13T00:00:00.000Z",18677954,30,"Jared Butler",1,9,13,12,5,17.2
"6696",2433,2,0,2,1,0,2,1,0,0,10,0,2,2,2,0,0,1037903,"2023-12-13T00:00:00.000Z",3547302,30,"Anthony Gill",0,4,6,4,4,7.4
"6697",2434,1,0,0,1,1,1,1,2,2,4,0,1,5,0,0,0,1037903,"2023-12-13T00:00:00.000Z",38017704,30,"Patrick Baldwin Jr.",0,5,6,6,1,6.5
"6698",2435,0,0,1,2,0,2,0,0,0,4,0,0,0,1,0,0,1037903,"2023-12-13T00:00:00.000Z",337,30,"Mike Muscala",0,1,1,0,1,1.2
"6699",2437,0,0,0,0,0,0,0,0,0,0,0,0,0,0,0,0,1037903,"2023-12-13T00:00:00.000Z",38017687,30,"Johnny Davis",0,0,0,0,0,0
"6700",2438,0,0,0,0,0,0,0,0,0,0,0,0,0,0,0,0,1037903,"2023-12-13T00:00:00.000Z",17896106,30,"Eugene Omoruyi",0,0,0,0,0,0
"6701",2439,0,0,0,0,0,0,0,0,0,0,0,0,0,0,0,0,1037903,"2023-12-13T00:00:00.000Z",38017712,30,"Ryan Rollins",0,0,0,0,0,0
"6702",2440,0,0,0,0,0,0,0,0,0,0,0,0,0,0,0,0,1037903,"2023-12-13T00:00:00.000Z",414,30,"Landry Shamet",0,0,0,0,0,0
"6703",2441,0,0,0,0,0,0,0,0,0,0,0,0,0,0,0,0,1037903,"2023-12-13T00:00:00.000Z",487,30,"Delon Wright",0,0,0,0,0,0
"6704",2442,1,0,1,1,0,9,3,0,0,20,1,3,6,2,2,1,1037903,"2023-12-13T00:00:00.000Z",17896024,19,"Herbert Jones",2,8,9,7,3,14.9
"6705",2443,3,1,1,4,1,23,14,12,11,31,1,2,40,2,0,1,1037903,"2023-12-13T00:00:00.000Z",227,19,"Brandon Ingram",1,42,45,43,5,48.9
"6706",2444,3,1,15,1,1,9,6,4,3,33,3,4,16,18,1,4,1037903,"2023-12-13T00:00:00.000Z",455,19,"Jonas Valanciunas",2,34,37,19,21,44.1
"6707",2445,2,0,2,4,0,6,1,0,0,16,2,0,2,4,2,0,1037903,"2023-12-13T00:00:00.000Z",38017677,19,"Dyson Daniels",2,6,8,4,6,15.8
"6708",2446,6,0,3,6,4,14,8,2,2,32,0,3,22,3,0,0,1037903,"2023-12-13T00:00:00.000Z",303,19,"CJ McCollum",0,25,31,28,9,34.6
"6709",2447,4,1,6,7,6,10,7,8,7,33,0,0,27,6,2,0,1037903,"2023-12-13T00:00:00.000Z",18677986,19,"Trey Murphy III",3,33,37,31,10,49.2
"6710",2448,7,0,4,5,2,11,6,2,2,27,0,1,16,4,2,1,1037903,"2023-12-13T00:00:00.000Z",3547293,19,"Naji Marshall",2,20,27,23,11,36.3
"6711",2449,1,0,1,3,2,3,2,2,1,18,0,2,7,1,2,2,1037903,"2023-12-13T00:00:00.000Z",17896097,19,"Jose Alvarado",2,8,9,8,2,13.7
"6712",2450,1,0,2,2,0,7,1,0,0,19,1,1,2,3,0,0,1037903,"2023-12-13T00:00:00.000Z",56677837,19,"Jordan Hawkins",0,5,6,3,4,7.1
"6713",2451,0,1,3,4,2,8,3,3,2,20,2,6,10,5,2,2,1038064,"2024-01-03T00:00:00.000Z",56677850,25,"Toumani Camara",3,15,15,10,5,23
"6714",2452,12,1,17,0,0,14,8,9,6,45,6,2,22,23,2,6,1038068,"2024-01-03T00:00:00.000Z",406,26,"Domantas Sabonis",3,45,57,34,35,70.6
"6715",2453,1,0,0,1,0,3,0,0,0,10,0,3,0,0,1,2,1038068,"2024-01-03T00:00:00.000Z",17896030,26,"Chris Duarte",1,0,1,1,1,2.5
"6716",2454,7,0,1,5,0,22,6,4,3,44,3,1,15,4,1,3,1038068,"2024-01-03T00:00:00.000Z",161,26,"De'Aaron Fox",1,19,26,22,11,30.3
"6717",2455,2,0,6,4,0,5,0,2,2,18,1,1,2,7,0,1,1038068,"2024-01-03T00:00:00.000Z",221,26,"Kevin Huerter",0,9,11,4,9,12.4
"6718",2456,0,0,0,0,0,0,0,0,0,0,0,0,0,0,0,0,1038068,"2024-01-03T00:00:00.000Z",17896044,26,"Kessler Edwards",0,0,0,0,0,0
"6719",2457,0,0,0,0,0,0,0,0,0,0,0,0,0,0,0,0,1038068,"2024-01-03T00:00:00.000Z",38017714,26,"Keon Ellis",0,0,0,0,0,0
"6720",2458,0,0,0,0,0,1,1,0,0,1,0,0,2,0,0,0,1038085,"2024-01-06T00:00:00.000Z",56677778,12,"Oscar Tshiebwe",0,2,2,2,0,2
"6721",2459,0,0,0,0,0,0,0,0,0,0,0,0,0,0,0,0,1038085,"2024-01-06T00:00:00.000Z",69,12,"Bruce Brown",0,0,0,0,0,0
"6722",2460,0,0,0,0,0,0,0,0,0,0,0,0,0,0,0,0,1038085,"2024-01-06T00:00:00.000Z",38017507,12,"Andrew Nembhard",0,0,0,0,0,0
"6723",2461,0,0,0,0,0,0,0,0,0,0,0,0,0,0,0,0,1038085,"2024-01-06T00:00:00.000Z",56677794,12,"Isaiah Wong",0,0,0,0,0,0
"6724",2462,2,0,2,6,4,8,5,4,4,22,1,0,18,3,0,0,1038090,"2024-01-07T00:00:00.000Z",65,25,"Malcolm Brogdon",0,21,23,20,5,24.6
"6725",2463,0,0,0,0,0,0,0,0,0,0,0,0,0,0,0,0,1038090,"2024-01-07T00:00:00.000Z",47957121,25,"Justin Minaya",0,0,0,0,0,0
"6726",2464,0,0,0,0,0,0,0,0,0,0,0,0,0,0,0,0,1038090,"2024-01-07T00:00:00.000Z",56677829,25,"Rayan Rupert",0,0,0,0,0,0
"6727",2465,0,0,0,0,0,0,0,0,0,0,0,0,0,0,0,0,1038090,"2024-01-07T00:00:00.000Z",38017711,25,"Jabari Walker",0,0,0,0,0,0
"6728",2466,0,0,0,0,0,0,0,0,0,0,0,0,0,0,0,0,1038090,"2024-01-07T00:00:00.000Z",22,25,"Deandre Ayton",0,0,0,0,0,0
"6729",2467,0,0,0,0,0,0,0,0,0,0,0,0,0,0,0,0,1038090,"2024-01-07T00:00:00.000Z",666476,25,"Moses Brown",0,0,0,0,0,0
"6730",2468,2,0,4,1,1,4,3,4,4,22,1,2,11,5,0,1,1038092,"2024-01-07T00:00:00.000Z",3547293,19,"Naji Marshall",0,16,18,13,7,19
"6731",2469,4,1,5,0,0,4,1,0,0,14,2,1,2,7,0,2,1038092,"2024-01-07T00:00:00.000Z",340,19,"Larry Nance Jr.",1,9,13,6,11,17.4
"6732",2470,0,1,0,2,1,4,3,0,0,10,0,1,7,0,0,1,1038092,"2024-01-07T00:00:00.000Z",17896021,19,"Jeremiah Robinson-Earl",1,7,7,7,0,9
"6733",2471,1,0,1,1,1,3,2,2,2,7,1,0,7,2,0,2,1038092,"2024-01-07T00:00:00.000Z",491,19,"Cody Zeller",0,9,10,8,3,8.9
"6734",2472,0,1,0,0,0,0,0,0,0,4,0,1,0,0,0,1,1038092,"2024-01-07T00:00:00.000Z",38017663,19,"E.J. Liddell",1,0,0,0,0,2
"6735",2473,0,0,0,0,0,0,0,0,0,0,0,0,0,0,0,0,1038092,"2024-01-07T00:00:00.000Z",17896097,19,"Jose Alvarado",0,0,0,0,0,0
"6736",2474,0,0,0,0,0,0,0,0,0,0,0,0,0,0,0,0,1038092,"2024-01-07T00:00:00.000Z",3547260,19,"Kira Lewis Jr.",0,0,0,0,0,0
"6737",2475,0,0,0,0,0,0,0,0,0,0,0,0,0,0,0,0,1038092,"2024-01-07T00:00:00.000Z",17896017,19,"Matt Ryan",0,0,0,0,0,0
"6738",2476,4,0,2,8,3,15,7,4,4,36,0,3,21,2,0,1,3277432,"2023-11-14T00:00:00.000Z",192,13,"James Harden",0,23,27,25,6,28.4
"6739",2477,0,0,0,0,0,0,0,0,0,0,0,0,0,0,0,0,3277432,"2023-11-14T00:00:00.000Z",56677849,13,"Kobe Brown",0,0,0,0,0,0
"6740",2478,0,0,0,0,0,0,0,0,0,0,0,0,0,0,0,0,3277432,"2023-11-14T00:00:00.000Z",666511,13,"Amir Coffey",0,0,0,0,0,0
"6741",2479,0,0,0,0,0,0,0,0,0,0,0,0,0,0,0,0,3277432,"2023-11-14T00:00:00.000Z",38017725,13,"Moussa Diabate",0,0,0,0,0,0
"6742",2480,7,0,10,4,4,9,5,3,2,29,2,0,16,12,0,3,3277434,"2023-11-14T00:00:00.000Z",17553995,14,"Austin Reaves",0,28,35,23,19,37.9
"6743",2481,2,1,7,3,0,8,1,0,0,22,3,2,2,10,0,3,3277434,"2023-11-14T00:00:00.000Z",486,14,"Christian Wood",1,12,14,4,12,17
"6744",2482,0,0,0,0,0,0,0,0,0,0,0,0,0,0,0,0,3277434,"2023-11-14T00:00:00.000Z",56677738,14,"Colin Castleton",0,0,0,0,0,0
"6745",2483,0,0,0,0,0,0,0,0,0,0,0,0,0,0,0,0,3277434,"2023-11-14T00:00:00.000Z",56677867,14,"Alex Fudge",0,0,0,0,0,0
"6746",2484,0,0,0,0,0,0,0,0,0,0,0,0,0,0,0,0,3277434,"2023-11-14T00:00:00.000Z",56677868,14,"D'Moi Hodge",0,0,0,0,0,0
"6747",2485,0,0,0,0,0,0,0,0,0,0,0,0,0,0,0,0,3277434,"2023-11-14T00:00:00.000Z",457,14,"Jarred Vanderbilt",0,0,0,0,0,0
"6748",2486,0,0,0,0,0,0,0,0,0,1,0,0,0,0,0,1,3277431,"2023-11-14T00:00:00.000Z",139,29,"Kris Dunn",0,0,0,0,0,-1
"6749",2487,0,0,0,0,0,0,0,0,0,1,0,0,0,0,0,0,3277431,"2023-11-14T00:00:00.000Z",666881,29,"Luka Samanic",0,0,0,0,0,0
"6750",2488,0,0,0,0,0,0,0,0,0,1,0,0,0,0,0,0,3277431,"2023-11-14T00:00:00.000Z",11891374,29,"Omer Yurtseven",0,0,0,0,0,0
"6751",2489,0,0,0,0,0,0,0,0,0,0,0,0,0,0,0,0,3277431,"2023-11-14T00:00:00.000Z",17896023,29,"Josh Christopher",0,0,0,0,0,0
"6752",2490,0,0,0,0,0,0,0,0,0,0,0,0,0,0,0,0,3277434,"2023-11-14T00:00:00.000Z",1603383,14,"Gabe Vincent",0,0,0,0,0,0
"6753",2491,5,0,1,6,2,10,5,3,3,27,0,1,15,1,0,2,3277434,"2023-11-14T00:00:00.000Z",3547287,15,"Desmond Bane",0,16,21,20,6,21.7
"6754",2492,4,0,2,4,3,6,5,2,2,24,1,4,15,3,3,0,1037750,"2023-11-15T00:00:00.000Z",3547242,30,"Deni Avdija",3,18,22,19,7,33.6
"6755",2493,3,0,4,6,2,18,6,10,8,30,2,1,22,6,0,2,1037750,"2023-11-15T00:00:00.000Z",265,30,"Kyle Kuzma",0,28,31,25,9,31.7
"6756",2494,0,0,1,1,0,1,0,0,0,5,0,0,0,1,0,0,3277434,"2023-11-14T00:00:00.000Z",38017731,15,"Vince Williams Jr.",0,1,1,0,1,1.2
"6757",2495,0,0,0,1,0,2,0,0,0,5,0,0,0,0,0,0,3277434,"2023-11-14T00:00:00.000Z",38017732,15,"Kenneth Lofton Jr.",0,0,0,0,0,0
"6758",2496,0,0,0,0,0,0,0,0,0,0,0,0,0,0,0,0,3277434,"2023-11-14T00:00:00.000Z",3,15,"Steven Adams",0,0,0,0,0,0
"6759",2497,0,0,0,0,0,0,0,0,0,0,0,0,0,0,0,0,3277434,"2023-11-14T00:00:00.000Z",666505,15,"Brandon Clarke",0,0,0,0,0,0
"6760",2498,0,0,0,0,0,0,0,0,0,0,0,0,0,0,0,0,3277434,"2023-11-14T00:00:00.000Z",56677830,15,"GG Jackson",0,0,0,0,0,0
"6761",2499,0,0,0,0,0,0,0,0,0,0,0,0,0,0,0,0,3277434,"2023-11-14T00:00:00.000Z",38017728,15,"Jake LaRavia",0,0,0,0,0,0
"6762",2500,0,0,0,0,0,0,0,0,0,0,0,0,0,0,0,0,3277434,"2023-11-14T00:00:00.000Z",666786,15,"Ja Morant",0,0,0,0,0,0
"6763",2501,0,0,0,0,0,0,0,0,0,0,0,0,0,0,0,0,1037904,"2023-12-13T00:00:00.000Z",3547253,4,"Theo Maledon",0,0,0,0,0,0
"6764",2502,0,0,0,0,0,0,0,0,0,0,0,0,0,0,0,0,1037904,"2023-12-13T00:00:00.000Z",347,4,"Frank Ntilikina",0,0,0,0,0,0
"6765",2503,0,0,0,0,0,0,0,0,0,0,0,0,0,0,0,0,1037904,"2023-12-13T00:00:00.000Z",56677848,4,"Amari Bailey",0,0,0,0,0,0
"6766",2504,0,0,0,0,0,0,0,0,0,0,0,0,0,0,0,0,1037904,"2023-12-13T00:00:00.000Z",3547239,4,"LaMelo Ball",0,0,0,0,0,0
"6767",2505,0,0,0,0,0,0,0,0,0,0,0,0,0,0,0,0,1037904,"2023-12-13T00:00:00.000Z",666748,4,"Cody Martin",0,0,0,0,0,0
"6768",2506,0,0,0,0,0,0,0,0,0,0,0,0,0,0,0,0,1037904,"2023-12-13T00:00:00.000Z",56677846,4,"Nick Smith Jr.",0,0,0,0,0,0
"6769",2507,0,0,0,0,0,0,0,0,0,0,0,0,0,0,0,0,1037904,"2023-12-13T00:00:00.000Z",38017698,4,"Mark Williams",0,0,0,0,0,0
"6770",2508,6,1,9,4,3,14,11,3,2,34,1,3,27,10,0,3,1037905,"2023-12-13T00:00:00.000Z",17896055,28,"Scottie Barnes",1,37,43,33,16,48
"6771",2509,7,1,3,4,3,11,5,4,4,37,0,5,17,3,1,2,1037905,"2023-12-13T00:00:00.000Z",409,28,"Dennis Schroder",2,20,27,24,10,35.1
"6772",2510,1,0,0,8,4,11,4,0,0,20,0,0,12,0,0,0,1037905,"2023-12-13T00:00:00.000Z",3089,28,"Gary Trent Jr.",0,12,13,13,1,13.5
"6773",2511,1,2,6,3,1,5,2,2,2,17,1,0,7,7,1,2,1037905,"2023-12-13T00:00:00.000Z",3547249,28,"Precious Achiuwa",3,14,15,8,8,23.9
"6774",2512,8,0,2,3,0,4,0,0,0,17,0,2,0,2,0,2,1037905,"2023-12-13T00:00:00.000Z",3547275,28,"Malachi Flynn",0,2,10,8,10,12.4
"6775",2513,0,2,0,1,0,2,1,0,0,10,0,0,2,0,0,0,1037905,"2023-12-13T00:00:00.000Z",58,28,"Chris Boucher",2,2,2,2,0,8
"6776",2514,0,0,0,0,0,0,0,0,0,0,0,0,0,0,0,0,1037905,"2023-12-13T00:00:00.000Z",56677828,28,"Gradey Dick",0,0,0,0,0,0
"6777",2515,0,0,0,0,0,0,0,0,0,0,0,0,0,0,0,0,1037905,"2023-12-13T00:00:00.000Z",666762,28,"Jalen McDaniels",0,0,0,0,0,0
"6778",2516,0,0,0,0,0,0,0,0,0,0,0,0,0,0,0,0,1037905,"2023-12-13T00:00:00.000Z",376,28,"Otto Porter Jr.",0,0,0,0,0,0
"6779",2517,0,0,0,0,0,0,0,0,0,0,0,0,0,0,0,0,1037905,"2023-12-13T00:00:00.000Z",436,28,"Garrett Temple",0,0,0,0,0,0
"6780",2518,0,0,0,0,0,0,0,0,0,0,0,0,0,0,0,0,1037905,"2023-12-13T00:00:00.000Z",489,28,"Thaddeus Young",0,0,0,0,0,0
"6781",2519,0,0,0,0,0,0,0,0,0,0,0,0,0,0,0,0,1037905,"2023-12-13T00:00:00.000Z",56677805,28,"Javon Freeman-Liberty",0,0,0,0,0,0
"6782",2520,0,0,0,0,0,0,0,0,0,0,0,0,0,0,0,0,1037905,"2023-12-13T00:00:00.000Z",38017710,28,"Christian Koloko",0,0,0,0,0,0
"6783",2521,0,0,0,0,0,0,0,0,0,0,0,0,0,0,0,0,1037905,"2023-12-13T00:00:00.000Z",56677869,28,"Markquis Nowell",0,0,0,0,0,0
"6784",2522,0,0,0,0,0,0,0,0,0,0,0,0,0,0,0,0,1037905,"2023-12-13T00:00:00.000Z",2309958,28,"Jontay Porter",0,0,0,0,0,0
"6785",2523,1,0,1,4,1,6,1,2,2,14,1,3,5,2,2,0,1037905,"2023-12-13T00:00:00.000Z",301,1,"Wesley Matthews",2,7,8,6,3,14.9
"6786",2524,2,0,7,5,0,14,5,3,2,38,3,1,12,10,2,1,1037905,"2023-12-13T00:00:00.000Z",3547256,1,"Saddiq Bey",2,22,24,14,12,32
"6787",2525,1,3,4,0,0,12,7,4,3,34,6,3,17,10,0,0,1037905,"2023-12-13T00:00:00.000Z",83,1,"Clint Capela",3,27,28,18,11,39.5
"6788",2526,6,2,5,3,2,11,7,0,0,30,1,0,16,6,0,1,1038096,"2024-01-07T00:00:00.000Z",416,28,"Pascal Siakam",2,22,28,22,12,37.2
"6789",2527,0,0,0,0,0,0,0,0,0,0,0,0,0,0,0,0,1038091,"2024-01-07T00:00:00.000Z",85,22,"Wendell Carter Jr.",0,0,0,0,0,0
"6790",2528,1,0,3,3,2,6,2,2,1,20,1,1,7,4,2,5,1038097,"2024-01-07T00:00:00.000Z",666860,14,"Cameron Reddish",2,11,12,8,5,14.3
"6791",2529,7,0,7,3,1,19,11,3,2,38,1,2,25,8,1,4,1038097,"2024-01-07T00:00:00.000Z",237,14,"LeBron James",1,33,40,32,15,44.1
"6792",2530,1,1,9,1,0,15,10,4,2,39,1,1,22,10,3,3,1038097,"2024-01-07T00:00:00.000Z",117,14,"Anthony Davis",4,32,33,23,11,44.5
"6793",2531,2,0,1,6,3,8,4,2,2,30,0,3,13,1,1,0,1038097,"2024-01-07T00:00:00.000Z",383,14,"Taurean Prince",1,14,16,15,3,20.2
"6794",2532,2,0,0,3,0,5,2,5,4,32,0,0,8,0,0,2,1038097,"2024-01-07T00:00:00.000Z",17553995,14,"Austin Reaves",0,8,10,10,2,9
"6795",2533,0,2,1,1,1,6,3,0,0,13,2,0,7,3,0,0,1038097,"2024-01-07T00:00:00.000Z",38017697,14,"Max Christie",2,10,10,7,3,16.6
"6796",2534,0,0,0,0,0,0,0,0,0,0,0,0,0,0,0,0,1038097,"2024-01-07T00:00:00.000Z",666626,14,"Jaxson Hayes",0,0,0,0,0,0
"6797",2535,0,0,0,0,0,0,0,0,0,0,0,0,0,0,0,0,1038097,"2024-01-07T00:00:00.000Z",56677835,14,"Jalen Hood-Schifino",0,0,0,0,0,0
"6798",2536,1,0,1,1,0,2,0,0,0,7,0,1,0,1,0,0,1038096,"2024-01-07T00:00:00.000Z",398,10,"Jerome Robinson",0,1,2,1,2,2.7
"6799",2537,0,0,1,2,1,3,2,0,0,6,0,1,5,1,1,1,1038096,"2024-01-07T00:00:00.000Z",45658838,10,"Lester Quinones",1,6,6,5,1,8.2
"6800",2538,1,0,1,5,2,11,6,0,0,26,0,1,14,1,2,0,1038096,"2024-01-07T00:00:00.000Z",3089,28,"Gary Trent Jr.",2,15,16,15,2,22.7
"6801",2539,0,0,0,1,1,2,1,0,0,4,0,0,3,0,0,1,1038096,"2024-01-07T00:00:00.000Z",489,28,"Thaddeus Young",0,3,3,3,0,2
"6802",2540,0,0,0,0,0,0,0,0,0,0,0,0,0,0,0,0,1038096,"2024-01-07T00:00:00.000Z",56677828,28,"Gradey Dick",0,0,0,0,0,0
"6803",2541,0,0,0,0,0,0,0,0,0,0,0,0,0,0,0,0,1038096,"2024-01-07T00:00:00.000Z",56677805,28,"Javon Freeman-Liberty",0,0,0,0,0,0
"6804",2542,0,0,0,0,0,0,0,0,0,0,0,0,0,0,0,0,1038096,"2024-01-07T00:00:00.000Z",38017710,28,"Christian Koloko",0,0,0,0,0,0
"6805",2543,0,0,0,0,0,0,0,0,0,0,0,0,0,0,0,0,1038096,"2024-01-07T00:00:00.000Z",56677869,28,"Markquis Nowell",0,0,0,0,0,0
"6806",2544,0,0,0,0,0,0,0,0,0,0,0,0,0,0,0,0,1038093,"2024-01-07T00:00:00.000Z",329,7,"Markieff Morris",0,0,0,0,0,0
"6807",2545,0,0,0,0,0,0,0,0,0,0,0,0,0,0,0,0,1038093,"2024-01-07T00:00:00.000Z",56677859,7,"Olivier-Maxence Prosper",0,0,0,0,0,0
"6808",2546,0,0,0,0,0,0,0,0,0,0,0,0,0,0,0,0,1038093,"2024-01-07T00:00:00.000Z",24489167,7,"Brandon Williams",0,0,0,0,0,0
"6809",2547,0,0,0,0,0,0,0,0,0,0,0,0,0,0,0,0,1038093,"2024-01-07T00:00:00.000Z",151,7,"Dante Exum",0,0,0,0,0,0
"6810",2548,0,0,0,0,0,0,0,0,0,0,0,0,0,0,0,0,1038093,"2024-01-07T00:00:00.000Z",257,7,"Maxi Kleber",0,0,0,0,0,0
"6811",2549,0,0,0,0,0,0,0,0,0,0,0,0,0,0,0,0,1038093,"2024-01-07T00:00:00.000Z",56677840,7,"Dereck Lively II",0,0,0,0,0,0
"6812",2550,4,0,2,5,0,10,1,0,0,37,1,4,2,3,0,0,1038093,"2024-01-07T00:00:00.000Z",3547259,18,"Jaden McDaniels",0,5,9,6,7,11.6
"6813",2551,0,0,0,0,0,0,0,0,0,0,0,0,0,0,0,0,3277427,"2023-11-14T00:00:00.000Z",439,12,"Daniel Theis",0,0,0,0,0,0
"6814",2552,0,0,0,0,0,0,0,0,0,0,0,0,0,0,0,0,3277427,"2023-11-14T00:00:00.000Z",56677778,12,"Oscar Tshiebwe",0,0,0,0,0,0
"6815",2553,0,0,0,0,0,0,0,0,0,0,0,0,0,0,0,0,3277427,"2023-11-14T00:00:00.000Z",56677794,12,"Isaiah Wong",0,0,0,0,0,0
"6816",2554,2,0,4,4,1,7,1,0,0,18,0,2,3,4,2,0,3277429,"2023-11-14T00:00:00.000Z",38017706,21,"Jaylin Williams",2,7,9,5,6,16.8
"6817",2555,2,0,0,3,1,7,4,0,0,15,0,3,9,0,0,1,3277429,"2023-11-14T00:00:00.000Z",480,21,"Kenrich Williams",0,9,11,11,2,11
"6818",2556,0,0,0,3,2,3,2,0,0,5,0,0,6,0,0,0,3277429,"2023-11-14T00:00:00.000Z",27924547,21,"Lindy Waters III",0,6,6,6,0,6
"6819",2557,1,0,0,1,1,1,1,0,0,5,0,0,3,0,1,0,3277429,"2023-11-14T00:00:00.000Z",17896078,21,"Aaron Wiggins",1,3,4,4,1,7.5
"6820",2558,0,0,0,0,0,0,0,0,0,0,0,0,0,0,0,0,3277429,"2023-11-14T00:00:00.000Z",38017716,21,"Ousmane Dieng",0,0,0,0,0,0
"6821",2559,0,0,0,0,0,0,0,0,0,0,0,0,0,0,0,0,3277429,"2023-11-14T00:00:00.000Z",56677853,21,"Keyontae Johnson",0,0,0,0,0,0
"6822",2560,0,0,0,0,0,0,0,0,0,0,0,0,0,0,0,0,3277429,"2023-11-14T00:00:00.000Z",24572055,21,"Olivier Sarr",0,0,0,0,0,0
"6823",2561,3,3,2,7,3,14,4,2,2,31,1,0,13,3,4,2,3277429,"2023-11-14T00:00:00.000Z",38017649,27,"Julian Champagnie",7,16,19,16,6,40.1
"6824",2562,2,2,11,3,0,15,4,0,0,28,3,2,8,14,0,5,3277429,"2023-11-14T00:00:00.000Z",56677822,27,"Victor Wembanyama",2,22,24,10,16,28.8
"6825",2563,1,0,5,0,0,5,3,0,0,17,2,1,6,7,0,0,3277429,"2023-11-14T00:00:00.000Z",17895854,27,"Charles Bassey",0,13,14,7,8,15.9
"6826",2564,0,0,1,0,0,0,0,0,0,5,0,0,0,1,0,0,3277429,"2023-11-14T00:00:00.000Z",38017730,27,"Dominick Barlow",0,1,1,0,1,1.2
"6827",2565,4,0,5,0,0,4,3,6,5,21,1,3,11,6,0,1,3277428,"2023-11-14T00:00:00.000Z",462,22,"Moritz Wagner",0,17,21,15,10,23.2
"6828",2566,0,0,0,0,0,0,0,0,0,0,0,0,0,0,0,0,3277428,"2023-11-14T00:00:00.000Z",85,22,"Wendell Carter Jr.",0,0,0,0,0,0
"6829",2567,0,0,0,0,0,0,0,0,0,0,0,0,0,0,0,0,3277428,"2023-11-14T00:00:00.000Z",165,22,"Markelle Fultz",0,0,0,0,0,0
"6830",2568,0,0,0,0,0,0,0,0,0,0,0,0,0,0,0,0,3277428,"2023-11-14T00:00:00.000Z",196,22,"Gary Harris",0,0,0,0,0,0
"6831",2569,0,0,0,0,0,0,0,0,0,0,0,0,0,0,0,0,3277428,"2023-11-14T00:00:00.000Z",38017607,22,"Kevon Harris",0,0,0,0,0,0
"6832",2570,0,0,0,0,0,0,0,0,0,0,0,0,0,0,0,0,3277428,"2023-11-14T00:00:00.000Z",17553983,22,"Trevelin Queen",0,0,0,0,0,0
"6833",2571,0,0,0,0,0,0,0,0,0,0,0,0,0,0,0,0,3277428,"2023-11-14T00:00:00.000Z",666885,22,"Admiral Schofield",0,0,0,0,0,0
"6834",2572,0,0,0,5,2,5,2,0,0,14,0,0,6,0,0,0,3277429,"2023-11-14T00:00:00.000Z",359,27,"Cedi Osman",0,6,6,6,0,6
"6835",2573,0,0,1,4,0,13,5,2,1,26,1,2,11,2,1,3,3277429,"2023-11-14T00:00:00.000Z",38017692,27,"Malaki Branham",1,13,13,11,2,13.4
"6836",2574,1,0,1,2,1,4,2,0,0,18,0,0,5,1,0,4,3277429,"2023-11-14T00:00:00.000Z",305,27,"Doug McDermott",0,6,7,6,2,3.7
"6837",2575,7,0,1,2,0,3,1,3,2,17,0,2,4,1,0,2,3277429,"2023-11-14T00:00:00.000Z",180,27,"Devonte' Graham",0,5,12,11,8,13.7
"6838",2576,0,0,0,0,0,0,0,0,0,0,0,0,0,0,0,0,1037918,"2023-12-15T00:00:00.000Z",56677846,4,"Nick Smith Jr.",0,0,0,0,0,0
"6839",2577,0,1,4,3,2,9,6,3,3,30,1,2,17,5,2,4,1037920,"2023-12-15T00:00:00.000Z",56677844,30,"Bilal Coulibaly",3,22,22,17,5,28
"6840",2578,1,1,1,7,3,14,9,3,2,28,0,2,23,1,1,1,1037920,"2023-12-15T00:00:00.000Z",17896045,30,"Corey Kispert",2,24,25,24,2,30.7
"6841",2579,1,0,4,1,0,2,1,2,2,10,1,0,4,5,0,0,1037920,"2023-12-15T00:00:00.000Z",167,30,"Danilo Gallinari",0,9,10,5,6,11.5
"6842",2580,2,1,0,1,0,1,0,0,0,19,0,1,0,0,0,0,1037920,"2023-12-15T00:00:00.000Z",337,30,"Mike Muscala",1,0,2,2,2,6
"6843",2581,0,0,0,0,0,0,0,0,0,3,0,0,0,0,0,0,1037920,"2023-12-15T00:00:00.000Z",3547302,30,"Anthony Gill",0,0,0,0,0,0
"6844",2582,0,0,0,0,0,0,0,0,0,0,0,0,0,0,0,0,1037920,"2023-12-15T00:00:00.000Z",414,30,"Landry Shamet",0,0,0,0,0,0
"6845",2584,0,0,0,0,0,0,0,0,0,0,0,0,0,0,0,0,1037920,"2023-12-15T00:00:00.000Z",38017687,30,"Johnny Davis",0,0,0,0,0,0
"6846",2585,0,0,0,0,0,0,0,0,0,0,0,0,0,0,0,0,1037920,"2023-12-15T00:00:00.000Z",17896106,30,"Eugene Omoruyi",0,0,0,0,0,0
"6847",2586,0,0,0,0,0,0,0,0,0,0,0,0,0,0,0,0,1037920,"2023-12-15T00:00:00.000Z",38017712,30,"Ryan Rollins",0,0,0,0,0,0
"6848",2587,0,0,0,0,0,0,0,0,0,0,0,0,0,0,0,0,1037920,"2023-12-15T00:00:00.000Z",487,30,"Delon Wright",0,0,0,0,0,0
"6849",2588,3,3,3,11,3,14,4,0,0,27,0,1,11,3,2,2,1037920,"2023-12-15T00:00:00.000Z",210,12,"Buddy Hield",5,14,17,14,6,32.1
"6850",2589,1,0,0,1,1,4,4,2,2,16,1,4,11,1,0,2,1037921,"2023-12-15T00:00:00.000Z",666468,2,"Oshae Brissett",0,12,13,12,2,11.7
"6851",2590,1,0,4,6,2,10,3,0,0,20,0,0,8,4,0,0,1037914,"2023-12-14T00:00:00.000Z",56677776,8,"Julian Strawther",0,12,13,9,5,14.3
"6852",2591,5,1,4,5,2,10,7,3,2,24,3,3,18,7,1,1,1037914,"2023-12-14T00:00:00.000Z",38017721,8,"Peyton Watson",2,25,30,23,12,38.9
"6853",2592,1,0,0,1,1,1,1,0,0,2,0,0,3,0,0,0,1037914,"2023-12-14T00:00:00.000Z",56677582,8,"Jalen Pickett",0,3,4,4,1,4.5
"6854",2593,0,0,1,0,0,0,0,0,0,2,0,0,0,1,0,0,1037914,"2023-12-14T00:00:00.000Z",56677871,8,"Hunter Tyson",0,1,1,0,1,1.2
"6855",2594,0,0,0,0,0,0,0,0,0,0,0,0,0,0,0,0,1037914,"2023-12-14T00:00:00.000Z",81,8,"Kentavious Caldwell-Pope",0,0,0,0,0,0
"6856",2595,2,0,12,3,1,14,8,5,4,31,5,1,21,17,0,3,1037913,"2023-12-14T00:00:00.000Z",447,18,"Karl-Anthony Towns",0,38,40,23,19,41.4
"6857",2596,5,1,10,0,0,4,3,6,2,30,2,4,8,12,3,2,1037913,"2023-12-14T00:00:00.000Z",176,18,"Rudy Gobert",4,20,25,13,17,39.9
"6858",2597,11,0,1,3,0,19,3,6,3,35,1,2,9,2,2,5,1037913,"2023-12-14T00:00:00.000Z",3547238,18,"Anthony Edwards",2,11,22,20,13,28.9
"6859",2598,3,0,2,4,2,9,5,2,2,29,0,2,14,2,1,1,1037913,"2023-12-14T00:00:00.000Z",104,18,"Mike Conley",1,16,19,17,5,22.9
"6860",2599,1,1,0,4,3,6,5,0,0,20,1,2,13,1,0,1,1037913,"2023-12-14T00:00:00.000Z",666400,18,"Nickeil Alexander-Walker",1,14,15,14,2,17.7
"6861",2600,3,0,4,11,7,14,8,4,4,31,2,2,27,6,1,2,1037913,"2023-12-14T00:00:00.000Z",667378,18,"Naz Reid",1,33,36,30,9,39.7
"6862",2601,0,0,0,0,0,0,0,0,0,0,0,0,0,0,0,0,1038127,"2024-01-12T00:00:00.000Z",196,22,"Gary Harris",0,0,0,0,0,0
"6863",2602,0,0,0,0,0,0,0,0,0,0,0,0,0,0,0,0,1038127,"2024-01-12T00:00:00.000Z",38017607,22,"Kevon Harris",0,0,0,0,0,0
"6864",2603,0,0,0,0,0,0,0,0,0,0,0,0,0,0,0,0,1038127,"2024-01-12T00:00:00.000Z",56677839,22,"Jett Howard",0,0,0,0,0,0
"6865",2604,0,0,0,0,0,0,0,0,0,0,0,0,0,0,0,0,1038127,"2024-01-12T00:00:00.000Z",229,22,"Jonathan Isaac",0,0,0,0,0,0
"6866",2605,0,1,1,5,3,9,5,0,0,23,1,0,13,2,0,0,1038132,"2024-01-12T00:00:00.000Z",38017739,29,"Simone Fontecchio",1,15,15,13,2,18.4
"6867",2606,2,0,6,6,4,11,7,5,4,29,3,2,22,9,1,3,1038132,"2024-01-12T00:00:00.000Z",297,29,"Lauri Markkanen",1,31,33,24,11,35.8
"6868",2607,1,0,6,1,0,3,2,0,0,14,1,4,4,7,0,1,1038132,"2024-01-12T00:00:00.000Z",101,29,"John Collins",0,11,12,5,8,12.9
"6869",2608,0,0,1,0,0,0,0,0,0,2,0,1,0,1,0,0,1038131,"2024-01-12T00:00:00.000Z",17896103,8,"Jay Huff",0,1,1,0,1,1.2
"6870",2609,0,0,0,1,0,3,1,0,0,14,1,1,2,1,1,0,1038125,"2024-01-12T00:00:00.000Z",319,1,"Patty Mills",1,3,3,2,1,6.2
"6871",2610,0,0,0,1,0,1,0,2,2,4,0,0,2,0,0,0,1038125,"2024-01-12T00:00:00.000Z",56677855,1,"Seth Lundy",0,2,2,2,0,2
"6872",2611,0,0,0,1,0,2,1,0,0,4,0,0,2,0,0,0,1038125,"2024-01-12T00:00:00.000Z",38017689,1,"AJ Griffin",0,2,2,2,0,2
"6873",2612,0,0,1,1,0,1,0,0,0,4,0,0,0,1,0,0,1038125,"2024-01-12T00:00:00.000Z",666564,1,"Bruno Fernando",0,1,1,0,1,1.2
"6874",2613,0,0,0,0,0,0,0,0,0,0,0,0,0,0,0,0,1038125,"2024-01-12T00:00:00.000Z",666754,1,"Garrison Mathews",0,0,0,0,0,0
"6875",2614,1,1,9,5,2,12,8,3,2,33,1,2,20,10,1,1,1038131,"2024-01-12T00:00:00.000Z",375,8,"Michael Porter Jr.",2,30,31,21,11,38.5
"6876",2615,2,0,2,2,0,12,7,3,1,31,3,2,15,5,0,2,1038131,"2024-01-12T00:00:00.000Z",177,8,"Aaron Gordon",0,20,22,17,7,22
"6877",2616,14,1,7,2,1,17,11,4,4,32,3,4,27,10,0,2,1038131,"2024-01-12T00:00:00.000Z",246,8,"Nikola Jokic",1,37,51,41,24,61
"6878",2617,3,0,2,6,3,9,4,0,0,31,0,0,11,2,2,0,1038131,"2024-01-12T00:00:00.000Z",81,8,"Kentavious Caldwell-Pope",2,13,16,14,5,23.9
"6879",2618,9,0,2,5,3,15,8,1,1,34,0,3,20,2,0,2,1038131,"2024-01-12T00:00:00.000Z",335,8,"Jamal Murray",0,22,31,29,11,33.9
"6880",2619,0,0,5,4,1,4,1,2,1,17,1,2,4,6,0,3,1038131,"2024-01-12T00:00:00.000Z",38017709,8,"Christian Braun",0,10,10,4,6,8.2
"6881",2620,0,0,0,0,0,0,0,0,0,2,0,0,0,0,0,1,1038131,"2024-01-12T00:00:00.000Z",215,8,"Justin Holiday",0,0,0,0,0,-1
"6882",2621,0,0,0,0,0,1,1,0,0,2,0,1,2,0,0,0,1038131,"2024-01-12T00:00:00.000Z",38017727,8,"Collin Gillespie",0,2,2,2,0,2
"6883",2622,1,1,2,4,3,6,5,0,0,20,0,1,13,2,2,1,1038131,"2024-01-12T00:00:00.000Z",340,19,"Larry Nance Jr.",3,15,16,14,3,24.9
"6884",2623,4,0,3,8,2,9,2,0,0,28,0,0,6,3,2,0,1038131,"2024-01-12T00:00:00.000Z",18677986,19,"Trey Murphy III",2,9,13,10,7,21.6
"6885",2624,0,0,0,0,0,0,0,0,0,0,0,0,0,0,0,0,1038131,"2024-01-12T00:00:00.000Z",491,19,"Cody Zeller",0,0,0,0,0,0
"6886",2625,0,0,0,0,0,0,0,0,0,0,0,0,0,0,0,0,1038131,"2024-01-12T00:00:00.000Z",3547260,19,"Kira Lewis Jr.",0,0,0,0,0,0
"6887",2626,2,0,4,1,1,10,8,2,2,22,3,4,19,7,1,1,1037792,"2023-11-20T00:00:00.000Z",439,13,"Daniel Theis",1,26,28,21,9,32.4
"6888",2627,0,0,5,0,0,0,0,0,0,16,0,2,0,5,0,0,1037792,"2023-11-20T00:00:00.000Z",450,13,"PJ Tucker",0,5,5,0,5,6
"6889",2628,0,0,0,0,0,0,0,0,0,0,0,0,0,0,0,0,1037792,"2023-11-20T00:00:00.000Z",17896022,13,"Brandon Boston Jr.",0,0,0,0,0,0
"6890",2629,0,0,0,0,0,0,0,0,0,0,0,0,0,0,0,0,1037792,"2023-11-20T00:00:00.000Z",56677849,13,"Kobe Brown",0,0,0,0,0,0
"6891",2630,0,0,0,0,0,0,0,0,0,0,0,0,0,0,0,0,1037792,"2023-11-20T00:00:00.000Z",56677856,13,"Jordan Miller",0,0,0,0,0,0
"6892",2631,0,0,0,0,0,0,0,0,0,0,0,0,0,0,0,0,1037792,"2023-11-20T00:00:00.000Z",24417679,13,"Xavier Moon",0,0,0,0,0,0
"6893",2632,0,0,0,0,0,0,0,0,0,0,0,0,0,0,0,0,1037792,"2023-11-20T00:00:00.000Z",371,13,"Mason Plumlee",0,0,0,0,0,0
"6894",2633,0,0,0,0,0,0,0,0,0,0,0,0,0,0,0,0,1037792,"2023-11-20T00:00:00.000Z",17896051,13,"Joshua Primo",0,0,0,0,0,0
"6895",2634,0,0,1,0,0,2,2,0,0,5,0,0,4,1,0,1,1037790,"2023-11-20T00:00:00.000Z",3547259,18,"Jaden McDaniels",0,5,5,4,1,4.2
"6896",2635,4,2,5,3,2,10,6,7,6,36,0,6,20,5,3,3,1037790,"2023-11-20T00:00:00.000Z",447,18,"Karl-Anthony Towns",5,25,29,24,9,44
"6897",2636,1,2,4,0,0,7,7,7,2,26,3,2,16,7,0,1,1037790,"2023-11-20T00:00:00.000Z",176,18,"Rudy Gobert",2,23,24,17,8,30.9
"6898",2637,5,0,8,6,1,21,9,4,4,39,2,1,23,10,2,3,1037790,"2023-11-20T00:00:00.000Z",3547238,18,"Anthony Edwards",2,33,38,28,15,45.5
"6899",2638,5,1,1,8,3,9,3,2,2,28,0,3,11,1,0,0,1037790,"2023-11-20T00:00:00.000Z",104,18,"Mike Conley",1,12,17,16,6,22.7
"6900",2639,3,0,2,6,3,8,4,0,0,33,1,2,11,3,0,0,1037790,"2023-11-20T00:00:00.000Z",666400,18,"Nickeil Alexander-Walker",0,14,17,14,6,19.1
"6901",2640,5,2,2,0,0,4,3,5,3,23,0,2,9,2,1,1,1037790,"2023-11-20T00:00:00.000Z",12,18,"Kyle Anderson",3,11,16,14,7,26.9
"6902",2641,1,0,3,6,1,8,3,3,3,18,0,6,10,3,1,3,1037790,"2023-11-20T00:00:00.000Z",667378,18,"Naz Reid",1,13,14,11,4,15.1
"6903",2642,6,0,5,8,4,16,11,2,2,32,0,1,28,5,1,2,1037792,"2023-11-20T00:00:00.000Z",172,13,"Paul George",1,33,39,34,11,44
"6904",2643,0,1,9,0,0,5,3,2,2,22,2,0,8,11,0,1,1037792,"2023-11-20T00:00:00.000Z",493,13,"Ivica Zubac",1,19,19,8,11,23.2
"6905",2644,2,0,6,4,0,6,0,0,0,25,0,0,0,6,3,1,1037792,"2023-11-20T00:00:00.000Z",666743,13,"Terance Mann",3,6,8,2,8,18.2
"6906",2645,10,0,2,8,2,12,4,3,3,28,1,2,13,3,2,0,1037792,"2023-11-20T00:00:00.000Z",192,13,"James Harden",2,16,26,23,13,37.6
"6907",2646,0,1,5,6,2,12,5,7,7,30,0,0,19,5,2,1,1037792,"2023-11-20T00:00:00.000Z",380,13,"Norman Powell",3,24,24,19,5,33
"6908",2647,1,0,1,2,1,3,1,0,0,4,0,0,3,1,0,1,1037792,"2023-11-20T00:00:00.000Z",17896031,13,"Nah'Shon Hyland",0,4,5,4,2,4.7
"6909",2648,0,0,0,0,0,1,0,0,0,4,0,0,0,0,0,0,1037792,"2023-11-20T00:00:00.000Z",666511,13,"Amir Coffey",0,0,0,0,0,0
"6910",2649,0,0,0,0,0,2,1,2,1,4,2,0,3,2,2,0,1037792,"2023-11-20T00:00:00.000Z",38017725,13,"Moussa Diabate",2,5,5,3,2,11.4
"6911",2650,1,0,5,4,3,13,4,4,3,22,2,5,14,7,1,4,1037790,"2023-11-20T00:00:00.000Z",666423,20,"RJ Barrett",1,21,22,15,8,22.9
"6912",2651,0,0,0,0,0,0,0,0,0,0,0,0,0,0,0,0,1037949,"2023-12-18T00:00:00.000Z",100,29,"Jordan Clarkson",0,0,0,0,0,0
"6913",2652,0,0,0,0,0,0,0,0,0,0,0,0,0,0,0,0,1037949,"2023-12-18T00:00:00.000Z",38017630,29,"Johnny Juzang",0,0,0,0,0,0
"6914",2653,0,0,0,0,0,0,0,0,0,0,0,0,0,0,0,0,1037949,"2023-12-18T00:00:00.000Z",19465584,29,"Micah Potter",0,0,0,0,0,0
"6915",2654,3,0,4,3,2,3,2,0,0,16,0,0,6,4,0,1,1037947,"2023-12-18T00:00:00.000Z",480,21,"Kenrich Williams",0,10,13,9,7,14.3
"6916",2655,3,0,3,3,1,5,2,0,0,20,1,1,5,4,1,0,1037947,"2023-12-18T00:00:00.000Z",3547272,21,"Isaiah Joe",1,9,12,8,7,17.3
"6917",2656,2,0,1,2,0,5,2,0,0,19,1,1,4,2,0,0,1037947,"2023-12-18T00:00:00.000Z",38017716,21,"Ousmane Dieng",0,6,8,6,4,9.4
"6918",2657,1,0,1,4,0,9,2,0,0,27,1,5,4,2,3,0,1037951,"2023-12-18T00:00:00.000Z",666860,14,"Cameron Reddish",3,6,7,5,3,16.9
"6919",2658,11,0,10,8,2,23,10,4,3,39,1,1,25,11,1,2,1037951,"2023-12-18T00:00:00.000Z",237,14,"LeBron James",1,36,47,36,22,55.7
"6920",2659,2,2,12,1,1,22,14,3,3,35,2,2,32,14,1,2,1037951,"2023-12-18T00:00:00.000Z",117,14,"Anthony Davis",3,46,48,34,16,58.8
"6921",2660,3,1,1,13,3,13,3,0,0,39,1,1,9,2,0,1,1037951,"2023-12-18T00:00:00.000Z",383,14,"Taurean Prince",1,11,14,12,5,17.9
"6922",2661,4,0,3,6,3,10,3,0,0,28,0,1,9,3,1,0,1037951,"2023-12-18T00:00:00.000Z",405,14,"D'Angelo Russell",1,12,16,13,7,21.6
"6923",2662,7,0,3,7,3,15,6,5,5,33,0,2,20,3,1,4,1037951,"2023-12-18T00:00:00.000Z",17553995,14,"Austin Reaves",1,23,30,27,10,33.1
"6924",2663,1,0,0,0,0,0,0,0,0,14,2,3,0,2,0,1,1037951,"2023-12-18T00:00:00.000Z",457,14,"Jarred Vanderbilt",0,2,3,1,3,2.9
"6925",2664,0,0,0,2,1,6,3,1,1,17,2,1,8,2,2,0,1037951,"2023-12-18T00:00:00.000Z",666609,14,"Rui Hachimura",2,10,10,8,2,16.4
"6926",2665,0,0,0,0,0,0,0,0,0,0,0,0,0,0,0,0,1037949,"2023-12-18T00:00:00.000Z",56677842,29,"Brice Sensabaugh",0,0,0,0,0,0
"6927",2666,0,0,0,0,0,0,0,0,0,0,0,0,0,0,0,0,1037949,"2023-12-18T00:00:00.000Z",11891374,29,"Omer Yurtseven",0,0,0,0,0,0
"6928",2667,5,0,1,8,3,16,4,5,2,35,0,3,13,1,0,2,1037949,"2023-12-18T00:00:00.000Z",61,3,"Mikal Bridges",0,14,19,18,6,19.7
"6929",2668,1,0,4,5,1,9,2,2,2,27,1,1,7,5,1,1,1037949,"2023-12-18T00:00:00.000Z",666679,3,"Cameron Johnson",1,12,13,8,6,16.5
"6930",2669,0,3,5,0,0,5,4,4,3,26,2,3,11,7,0,3,1037949,"2023-12-18T00:00:00.000Z",666508,3,"Nicolas Claxton",3,18,18,11,7,25.4
"6931",2670,3,1,2,7,5,23,12,3,3,37,2,1,32,4,1,3,1037949,"2023-12-18T00:00:00.000Z",17896048,3,"Cam Thomas",2,36,39,35,7,44.3
"6932",2671,11,2,7,6,1,15,7,3,2,36,1,0,17,8,0,1,1037949,"2023-12-18T00:00:00.000Z",130,3,"Spencer Dinwiddie",2,25,36,28,19,48.1
"6933",2672,3,0,0,5,2,7,2,0,0,21,2,4,6,2,1,0,1037949,"2023-12-18T00:00:00.000Z",158,3,"Dorian Finney-Smith",1,8,11,9,5,15.9
"6934",2673,0,0,0,0,0,0,0,0,0,0,0,0,0,0,0,0,1037951,"2023-12-18T00:00:00.000Z",486,14,"Christian Wood",0,0,0,0,0,0
"6935",2674,0,0,0,0,0,0,0,0,0,0,0,0,0,0,0,0,1037951,"2023-12-18T00:00:00.000Z",56677738,14,"Colin Castleton",0,0,0,0,0,0
"6936",2675,0,0,0,0,0,0,0,0,0,0,0,0,0,0,0,0,1037951,"2023-12-18T00:00:00.000Z",56677867,14,"Alex Fudge",0,0,0,0,0,0
"6937",2676,1,1,2,3,3,5,5,0,0,19,0,3,13,2,0,1,1037602,"2023-10-25T00:00:00.000Z",56677833,21,"Cason Wallace",1,15,16,14,3,18.9
"6938",2677,5,0,7,1,0,9,3,2,1,30,2,0,7,9,1,1,1037601,"2023-10-25T00:00:00.000Z",12,18,"Kyle Anderson",1,16,21,12,14,27.3
"6939",2678,4,0,3,4,1,5,1,2,1,21,0,4,4,3,3,2,1037601,"2023-10-25T00:00:00.000Z",320,18,"Shake Milton",3,7,11,8,7,20.6
"6940",2679,0,0,1,0,0,0,0,0,0,5,0,0,0,1,0,0,1037601,"2023-10-25T00:00:00.000Z",68,18,"Troy Brown Jr.",0,1,1,0,1,1.2
"6941",2680,0,0,0,0,0,0,0,0,0,0,0,0,0,0,0,0,1037601,"2023-10-25T00:00:00.000Z",17896056,18,"Luka Garza",0,0,0,0,0,0
"6942",2681,0,0,0,0,0,0,0,0,0,0,0,0,0,0,0,0,1037601,"2023-10-25T00:00:00.000Z",666767,18,"Jordan McLaughlin",0,0,0,0,0,0
"6943",2682,0,0,0,0,0,0,0,0,0,0,0,0,0,0,0,0,1037599,"2023-10-25T00:00:00.000Z",3547299,6,"Sam Merrill",0,0,0,0,0,0
"6944",2683,0,0,0,0,0,0,0,0,0,0,0,0,0,0,0,0,1037599,"2023-10-25T00:00:00.000Z",38017662,6,"Isaiah Mobley",0,0,0,0,0,0
"6945",2684,0,0,0,0,0,0,0,0,0,0,0,0,0,0,0,0,1037599,"2023-10-25T00:00:00.000Z",444,6,"Tristan Thompson",0,0,0,0,0,0
"6946",2685,0,0,0,0,0,0,0,0,0,0,0,0,0,0,0,0,1037599,"2023-10-25T00:00:00.000Z",9,6,"Jarrett Allen",0,0,0,0,0,0
"6947",2686,0,0,0,0,0,0,0,0,0,0,0,0,0,0,0,0,1037599,"2023-10-25T00:00:00.000Z",56677872,6,"Craig Porter",0,0,0,0,0,0
"6948",2687,0,0,0,0,0,0,0,0,0,0,0,0,0,0,0,0,1037599,"2023-10-25T00:00:00.000Z",404,6,"Ricky Rubio",0,0,0,0,0,0
"6949",2688,0,0,0,0,0,0,0,0,0,0,0,0,0,0,0,0,1037599,"2023-10-25T00:00:00.000Z",666940,6,"Dean Wade",0,0,0,0,0,0
"6950",2689,1,0,1,3,1,7,2,0,0,20,1,0,5,2,0,0,1037595,"2023-10-25T00:00:00.000Z",18678001,4,"JT Thor",0,7,8,6,3,8.9
"6951",2690,1,1,3,0,0,2,2,4,3,18,1,3,7,4,0,2,1037595,"2023-10-25T00:00:00.000Z",3547282,4,"Nick Richards",1,11,12,8,5,14.3
"6952",2691,4,0,3,2,0,5,2,0,0,16,0,3,4,3,0,1,1037595,"2023-10-25T00:00:00.000Z",3547253,4,"Theo Maledon",0,7,11,8,7,12.6
"6953",2692,0,0,0,0,0,0,0,0,0,1,0,0,0,0,0,0,1037595,"2023-10-25T00:00:00.000Z",56677846,4,"Nick Smith Jr.",0,0,0,0,0,0
"6954",2693,0,0,0,0,0,0,0,0,0,0,0,0,0,0,0,0,1037595,"2023-10-25T00:00:00.000Z",56677848,4,"Amari Bailey",0,0,0,0,0,0
"6955",2694,0,0,0,0,0,0,0,0,0,0,0,0,0,0,0,0,1037595,"2023-10-25T00:00:00.000Z",56677866,4,"Leaky Black",0,0,0,0,0,0
"6956",2695,0,0,0,0,0,0,0,0,0,0,0,0,0,0,0,0,1037595,"2023-10-25T00:00:00.000Z",17896037,4,"James Bouknight",0,0,0,0,0,0
"6957",2696,0,0,0,0,0,0,0,0,0,0,0,0,0,0,0,0,1037601,"2023-10-25T00:00:00.000Z",56677782,18,"Leonard Miller",0,0,0,0,0,0
"6958",2697,0,0,0,0,0,0,0,0,0,0,0,0,0,0,0,0,1037601,"2023-10-25T00:00:00.000Z",38017715,18,"Josh Minott",0,0,0,0,0,0
"6959",2698,0,0,0,0,0,0,0,0,0,0,0,0,0,0,0,0,1037601,"2023-10-25T00:00:00.000Z",38017700,18,"Wendell Moore Jr.",0,0,0,0,0,0
"6960",2699,0,1,5,8,4,11,6,1,1,35,1,4,17,6,0,3,1037605,"2023-10-25T00:00:00.000Z",666965,7,"Grant Williams",1,23,23,17,6,24.2
"6961",2700,2,1,5,5,2,7,2,0,0,23,2,3,6,7,0,0,1037605,"2023-10-25T00:00:00.000Z",257,7,"Maxi Kleber",1,13,15,8,9,20.4
"6962",2701,2,3,3,0,0,6,3,0,0,14,3,1,6,6,0,1,3277502,"2023-11-24T00:00:00.000Z",24,9,"Marvin Bagley III",3,12,14,8,8,24.2
"6963",2702,3,1,0,6,1,16,9,9,6,32,2,3,25,2,1,3,3277502,"2023-11-24T00:00:00.000Z",38017682,9,"Jaden Ivey",2,27,30,28,5,34.9
"6964",2703,5,0,3,4,2,26,10,9,9,38,0,0,31,3,0,4,3277502,"2023-11-24T00:00:00.000Z",17896075,9,"Cade Cunningham",0,34,39,36,8,38.1
"6965",2704,4,1,9,1,0,10,5,4,3,29,4,5,13,13,1,2,3277502,"2023-11-24T00:00:00.000Z",38017694,9,"Jalen Duren",2,26,30,17,17,38.6
"6966",2705,0,0,2,4,2,5,3,0,0,26,0,2,8,2,0,0,3277502,"2023-11-24T00:00:00.000Z",17896071,9,"Isaiah Livers",0,10,10,8,2,10.4
"6967",2706,1,1,2,3,2,6,2,0,0,14,0,1,6,2,1,2,3277502,"2023-11-24T00:00:00.000Z",77,9,"Alec Burks",2,8,9,7,3,13.9
"6968",2707,3,0,1,0,0,6,3,0,0,17,0,0,6,1,0,0,3277502,"2023-11-24T00:00:00.000Z",3547241,9,"Killian Hayes",0,7,10,9,4,11.7
"6969",2708,0,2,1,0,0,1,0,0,0,8,1,3,0,2,1,1,3277502,"2023-11-24T00:00:00.000Z",44477024,9,"Stanley Umude",3,2,2,0,2,10.4
"6970",2709,0,0,0,0,0,1,0,0,0,5,0,0,0,0,0,0,3277502,"2023-11-24T00:00:00.000Z",56677792,9,"Marcus Sasser",0,0,0,0,0,0
"6971",2710,0,0,0,0,0,0,0,0,0,0,0,0,0,0,0,0,3277502,"2023-11-24T00:00:00.000Z",259,9,"Kevin Knox",0,0,0,0,0,0
"6972",2711,1,0,5,10,6,12,7,0,0,33,0,3,20,5,0,3,3277504,"2023-11-24T00:00:00.000Z",17896045,30,"Corey Kispert",0,25,26,21,6,24.5
"6973",2712,1,0,4,2,1,5,2,2,2,18,0,2,7,4,0,0,3277504,"2023-11-24T00:00:00.000Z",167,30,"Danilo Gallinari",0,11,12,8,5,13.3
"6974",2713,0,0,2,7,3,11,6,1,0,24,0,2,15,2,1,0,3277504,"2023-11-24T00:00:00.000Z",414,30,"Landry Shamet",1,17,17,15,2,20.4
"6975",2714,0,0,0,0,0,0,0,0,0,0,0,0,0,0,0,0,3277504,"2023-11-24T00:00:00.000Z",38017704,30,"Patrick Baldwin Jr.",0,0,0,0,0,0
"6976",2715,0,0,0,0,0,0,0,0,0,0,0,0,0,0,0,0,3277504,"2023-11-24T00:00:00.000Z",18677954,30,"Jared Butler",0,0,0,0,0,0
"6977",2716,0,0,0,0,0,0,0,0,0,0,0,0,0,0,0,0,3277504,"2023-11-24T00:00:00.000Z",38124126,30,"John Butler Jr.",0,0,0,0,0,0
"6978",2717,0,0,2,0,0,4,2,2,2,12,3,1,6,5,0,1,3277504,"2023-11-24T00:00:00.000Z",38017687,30,"Johnny Davis",0,11,11,6,5,11
"6979",2718,0,0,0,0,0,0,0,0,0,0,0,0,0,0,0,0,3277504,"2023-11-24T00:00:00.000Z",3547302,30,"Anthony Gill",0,0,0,0,0,0
"6980",2719,0,0,0,0,0,0,0,0,0,0,0,0,0,0,0,0,3277504,"2023-11-24T00:00:00.000Z",337,30,"Mike Muscala",0,0,0,0,0,0
"6981",2720,0,0,0,0,0,0,0,0,0,0,0,0,0,0,0,0,3277504,"2023-11-24T00:00:00.000Z",17896106,30,"Eugene Omoruyi",0,0,0,0,0,0
"6982",2721,0,0,0,0,0,0,0,0,0,0,0,0,0,0,0,0,3277504,"2023-11-24T00:00:00.000Z",56677844,30,"Bilal Coulibaly",0,0,0,0,0,0
"6983",2722,0,0,0,0,0,0,0,0,0,0,0,0,0,0,0,0,3277504,"2023-11-24T00:00:00.000Z",38017712,30,"Ryan Rollins",0,0,0,0,0,0
"6984",2723,0,0,0,0,0,0,0,0,0,0,0,0,0,0,0,0,3277504,"2023-11-24T00:00:00.000Z",487,30,"Delon Wright",0,0,0,0,0,0
"6985",2724,6,0,2,7,3,11,3,7,6,29,1,3,15,3,1,2,3277506,"2023-11-24T00:00:00.000Z",443,10,"Klay Thompson",1,18,24,21,9,28.6
"6986",2725,0,0,4,4,2,10,4,0,0,25,0,3,10,4,0,3,3277506,"2023-11-24T00:00:00.000Z",475,10,"Andrew Wiggins",0,14,14,10,4,11.8
"6987",1,0,0,7,0,0,3,3,2,2,28,3,5,8,10,0,2,1037976,"2023-12-22T00:00:00.000Z",83,1,"Clint Capela",0,18,18,8,10,18
"6988",2,6,0,7,9,3,20,10,3,1,34,1,0,24,8,3,2,1037976,"2023-12-22T00:00:00.000Z",334,1,"Dejounte Murray",3,32,38,30,14,49.6
"6989",3,13,0,3,13,7,22,10,3,3,40,0,1,30,3,2,6,1037976,"2023-12-22T00:00:00.000Z",490,1,"Trae Young",2,33,46,43,16,53.1
"6990",4,1,0,0,1,1,2,1,0,0,12,1,4,3,1,0,1,1037976,"2023-12-22T00:00:00.000Z",319,1,"Patty Mills",0,4,5,4,2,4.7
"6991",5,5,0,1,18,6,24,8,2,1,35,1,3,23,2,1,0,1037976,"2023-12-22T00:00:00.000Z",53,1,"Bogdan Bogdanovic",1,25,30,28,7,35.9
"6992",6,0,0,0,0,0,0,0,0,0,0,0,0,0,0,0,0,1037977,"2023-12-22T00:00:00.000Z",47738533,11,"Jeenathan Williams",0,0,0,0,0,0
"6993",7,1,0,2,1,0,4,1,2,1,22,2,3,3,4,0,1,1037977,"2023-12-22T00:00:00.000Z",247,7,"Derrick Jones Jr.",0,7,8,4,5,8.3
"6994",8,2,1,4,3,0,5,0,0,0,26,0,2,0,4,2,0,1037977,"2023-12-22T00:00:00.000Z",666965,7,"Grant Williams",3,4,6,2,6,16.8
"6995",9,0,0,2,4,1,4,1,2,1,12,0,0,4,2,0,0,1037977,"2023-12-22T00:00:00.000Z",329,7,"Markieff Morris",0,6,6,4,2,6.4
"6996",10,0,1,6,0,0,5,5,2,1,22,5,4,11,11,1,1,1037979,"2023-12-22T00:00:00.000Z",3547095,24,"Udoka Azubuike",2,22,22,11,11,29.2
"6997",11,0,0,1,1,0,6,1,2,1,14,2,2,3,3,1,1,1037979,"2023-12-22T00:00:00.000Z",18678058,24,"Jordan Goodwin",1,6,6,3,3,8.6
"6998",12,0,0,3,2,0,6,3,4,4,13,1,1,10,4,0,1,1037979,"2023-12-22T00:00:00.000Z",314,24,"Chimezie Metu",0,14,14,10,4,13.8
"6999",13,0,0,2,3,0,4,1,0,0,12,0,2,2,2,0,0,1037979,"2023-12-22T00:00:00.000Z",470,24,"Yuta Watanabe",0,4,4,2,2,4.4
"7000",14,4,1,2,3,0,8,2,2,2,20,1,2,6,3,0,1,1037979,"2023-12-22T00:00:00.000Z",3547298,24,"Saben Lee",1,9,13,10,7,17.6
"7001",15,0,0,0,3,0,8,3,0,0,16,0,3,6,0,1,1,1037979,"2023-12-22T00:00:00.000Z",666729,24,"Nassir Little",1,6,6,6,0,8
"7002",16,0,0,0,0,0,2,1,0,0,3,1,0,2,1,0,0,1037979,"2023-12-22T00:00:00.000Z",666451,24,"Bol Bol",0,3,3,2,1,3.2
"7003",17,0,0,0,0,0,0,0,0,0,0,0,0,0,0,0,0,1037979,"2023-12-22T00:00:00.000Z",32,24,"Keita Bates-Diop",0,0,0,0,0,0
"7004",18,0,0,0,0,0,0,0,0,0,0,0,0,0,0,0,0,1037979,"2023-12-22T00:00:00.000Z",37,24,"Bradley Beal",0,0,0,0,0,0
"7005",19,0,0,0,0,0,0,0,0,0,0,0,0,0,0,0,0,1037978,"2023-12-22T00:00:00.000Z",475,10,"Andrew Wiggins",0,0,0,0,0,0
"7006",20,4,0,2,0,0,5,2,3,3,20,2,1,7,4,1,0,1037978,"2023-12-22T00:00:00.000Z",3547242,30,"Deni Avdija",1,11,15,11,8,20.8
"7007",21,3,0,9,5,1,11,3,1,0,25,0,2,7,9,0,3,1037978,"2023-12-22T00:00:00.000Z",265,30,"Kyle Kuzma",0,16,19,10,12,19.3
"7008",22,1,0,3,0,0,7,5,6,5,23,1,1,15,4,1,1,1037978,"2023-12-22T00:00:00.000Z",666577,30,"Daniel Gafford",1,19,20,16,5,23.3
"7009",23,3,0,2,12,3,21,7,9,8,27,1,3,25,3,2,1,1037978,"2023-12-22T00:00:00.000Z",666848,30,"Jordan Poole",2,28,31,28,6,38.1
"7010",24,6,0,2,2,2,8,6,0,0,25,1,0,14,3,1,0,1037978,"2023-12-22T00:00:00.000Z",249,30,"Tyus Jones",1,17,23,20,9,29.6
"7011",25,2,1,3,2,1,8,3,0,0,32,0,1,7,3,1,2,1037978,"2023-12-22T00:00:00.000Z",56677844,30,"Bilal Coulibaly",2,10,12,9,5,17.6
"7012",26,0,0,0,0,0,0,0,0,0,0,0,0,0,0,0,0,1037631,"2023-10-29T00:00:00.000Z",56677865,27,"Charles Bediako",0,0,0,0,0,0
"7013",27,9,1,3,6,2,19,10,1,1,41,0,2,23,3,2,2,1037633,"2023-10-30T00:00:00.000Z",403,4,"Terry Rozier",3,26,35,32,12,47.1
"7014",28,8,0,3,6,0,12,3,2,2,22,0,6,8,3,2,3,1037633,"2023-10-30T00:00:00.000Z",3547239,4,"LaMelo Ball",2,11,19,16,11,26.6
"7015",29,2,0,1,5,0,9,2,5,5,20,0,0,9,1,1,0,1037633,"2023-10-30T00:00:00.000Z",3547253,4,"Theo Maledon",1,10,12,11,3,16.2
"7016",30,0,0,0,0,0,0,0,0,0,0,0,0,0,0,0,0,1037633,"2023-10-30T00:00:00.000Z",56677848,4,"Amari Bailey",0,0,0,0,0,0
"7017",31,0,0,0,0,0,0,0,0,0,0,0,0,0,0,0,0,1037633,"2023-10-30T00:00:00.000Z",56677866,4,"Leaky Black",0,0,0,0,0,0
"7018",32,0,0,0,0,0,0,0,0,0,0,0,0,0,0,0,0,1037633,"2023-10-30T00:00:00.000Z",62,4,"Miles Bridges",0,0,0,0,0,0
"7019",33,0,0,0,0,0,0,0,0,0,0,0,0,0,0,0,0,1037633,"2023-10-30T00:00:00.000Z",38017708,4,"Bryce McGowens",0,0,0,0,0,0
"7020",34,0,0,0,0,0,0,0,0,0,0,0,0,0,0,0,0,1037634,"2023-10-30T00:00:00.000Z",38017701,12,"Kendall Brown",0,0,0,0,0,0
"7021",35,0,0,0,0,0,0,0,0,0,0,0,0,0,0,0,0,1037634,"2023-10-30T00:00:00.000Z",56677778,12,"Oscar Tshiebwe",0,0,0,0,0,0
"7022",36,0,0,0,0,0,0,0,0,0,0,0,0,0,0,0,0,1037634,"2023-10-30T00:00:00.000Z",56677794,12,"Isaiah Wong",0,0,0,0,0,0
"7023",37,4,1,1,1,0,19,6,8,8,35,1,2,20,2,0,0,1037634,"2023-10-30T00:00:00.000Z",125,5,"DeMar DeRozan",1,22,26,24,6,31.4
"7024",38,0,1,4,2,1,6,3,2,2,22,0,0,9,4,1,1,1037634,"2023-10-30T00:00:00.000Z",3547248,5,"Patrick Williams",2,13,13,9,4,18.8
"7025",39,3,0,12,1,0,19,10,6,4,34,5,3,24,17,1,1,1037634,"2023-10-30T00:00:00.000Z",460,5,"Nikola Vucevic",1,41,44,27,20,50.9
"7026",40,1,0,5,6,1,17,6,11,10,36,0,1,23,5,0,1,1037634,"2023-10-30T00:00:00.000Z",268,5,"Zach LaVine",0,28,29,24,6,29.5
"7027",41,3,0,2,2,1,6,3,0,0,25,0,4,7,2,1,1,1037634,"2023-10-30T00:00:00.000Z",666956,5,"Coby White",1,9,12,10,5,15.9
"7028",42,3,1,3,2,1,5,3,2,1,26,1,1,8,4,0,3,1037634,"2023-10-30T00:00:00.000Z",89,5,"Alex Caruso",1,12,15,11,7,17.3
"7029",43,2,1,2,1,1,7,5,0,0,18,0,1,11,2,1,3,1037634,"2023-10-30T00:00:00.000Z",87,5,"Jevon Carter",2,13,15,13,4,19.4
"7030",44,2,0,1,0,0,4,2,2,1,14,2,0,5,3,1,1,1037634,"2023-10-30T00:00:00.000Z",137,5,"Andre Drummond",1,8,10,7,5,13.6
"7031",45,1,1,3,1,1,3,2,0,0,20,1,3,5,4,2,2,1037634,"2023-10-30T00:00:00.000Z",110,5,"Torrey Craig",3,9,10,6,5,18.3
"7032",46,0,1,1,1,0,1,0,0,0,10,0,2,0,1,1,0,1037634,"2023-10-30T00:00:00.000Z",17895983,5,"Ayo Dosunmu",2,1,1,0,1,7.2
"7033",47,0,0,0,0,0,0,0,0,0,0,0,0,0,0,0,0,1037634,"2023-10-30T00:00:00.000Z",56677857,5,"Julian Phillips",0,0,0,0,0,0
"7034",48,0,0,0,0,0,0,0,0,0,0,0,0,0,0,0,0,1037634,"2023-10-30T00:00:00.000Z",38017719,5,"Dalen Terry",0,0,0,0,0,0
"7035",49,0,0,0,0,0,0,0,0,0,0,0,0,0,0,0,0,1037634,"2023-10-30T00:00:00.000Z",27,5,"Lonzo Ball",0,0,0,0,0,0
"7036",50,0,0,0,0,0,0,0,0,0,0,0,0,0,0,0,0,1037634,"2023-10-30T00:00:00.000Z",56677874,5,"Onuralp Bitim",0,0,0,0,0,0
"7037",51,0,0,1,4,1,5,1,0,0,10,0,0,3,1,0,0,1037862,"2023-11-30T00:00:00.000Z",17895968,18,"Daishen Nix",0,4,4,3,1,4.2
"7038",52,0,0,0,0,0,0,0,0,0,0,0,0,0,0,0,0,1037862,"2023-11-30T00:00:00.000Z",17896056,18,"Luka Garza",0,0,0,0,0,0
"7039",53,0,0,0,0,0,0,0,0,0,0,0,0,0,0,0,0,1037862,"2023-11-30T00:00:00.000Z",38017715,18,"Josh Minott",0,0,0,0,0,0
"7040",54,0,0,0,0,0,0,0,0,0,0,0,0,0,0,0,0,1037862,"2023-11-30T00:00:00.000Z",38017700,18,"Wendell Moore Jr.",0,0,0,0,0,0
"7041",55,0,0,0,0,0,0,0,0,0,0,0,0,0,0,0,0,1037862,"2023-11-30T00:00:00.000Z",56677851,18,"Jaylen Clark",0,0,0,0,0,0
"7042",56,0,0,0,0,0,0,0,0,0,0,0,0,0,0,0,0,1037862,"2023-11-30T00:00:00.000Z",3547238,18,"Anthony Edwards",0,0,0,0,0,0
"7043",57,0,0,0,0,0,0,0,0,0,0,0,0,0,0,0,0,1037862,"2023-11-30T00:00:00.000Z",3547259,18,"Jaden McDaniels",0,0,0,0,0,0
"7044",58,0,0,0,0,0,0,0,0,0,0,0,0,0,0,0,0,1037859,"2023-11-30T00:00:00.000Z",3547207,12,"Jordan Nwora",0,0,0,0,0,0
"7045",59,3,0,3,4,1,10,3,5,2,27,0,3,9,3,2,3,1037861,"2023-11-30T00:00:00.000Z",315,17,"Khris Middleton",2,12,15,12,6,20.1
"7046",60,5,5,8,1,0,17,11,4,4,39,6,5,26,14,2,5,1037861,"2023-11-30T00:00:00.000Z",15,17,"Giannis Antetokounmpo",7,40,45,31,19,66.3
"7047",61,7,0,2,3,1,5,1,1,0,24,0,1,3,2,0,2,1037864,"2023-11-30T00:00:00.000Z",3547274,27,"Tre Jones",0,5,12,10,9,13.9
"7048",62,2,0,1,5,1,7,1,0,0,16,0,3,3,1,0,1,1037864,"2023-11-30T00:00:00.000Z",359,27,"Cedi Osman",0,4,6,5,3,6.2
"7049",63,0,0,2,8,5,8,5,0,0,20,1,2,15,3,0,1,1037864,"2023-11-30T00:00:00.000Z",38017649,27,"Julian Champagnie",0,18,18,15,3,17.6
"7050",64,0,0,0,0,0,0,0,0,0,0,0,0,0,0,0,0,1037864,"2023-11-30T00:00:00.000Z",180,27,"Devonte' Graham",0,0,0,0,0,0
"7051",65,0,0,0,0,0,0,0,0,0,0,0,0,0,0,0,0,1037864,"2023-11-30T00:00:00.000Z",17896059,27,"Sandro Mamukelashvili",0,0,0,0,0,0
"7052",66,0,0,0,0,0,0,0,0,0,0,0,0,0,0,0,0,1037860,"2023-11-30T00:00:00.000Z",54,9,"Bojan Bogdanovic",0,0,0,0,0,0
"7053",67,0,0,0,0,0,0,0,0,0,0,0,0,0,0,0,0,1037860,"2023-11-30T00:00:00.000Z",56677729,9,"Malcolm Cazalon",0,0,0,0,0,0
"7054",68,0,0,0,0,0,0,0,0,0,0,0,0,0,0,0,0,1037860,"2023-11-30T00:00:00.000Z",197,9,"Joe Harris",0,0,0,0,0,0
"7055",69,3,0,3,2,0,9,5,6,4,25,2,4,14,5,1,4,1037859,"2023-11-30T00:00:00.000Z",666747,16,"Caleb Martin",1,19,22,17,8,23.5
"7056",70,0,0,4,10,6,12,7,0,0,39,0,5,20,4,0,1,1037861,"2023-11-30T00:00:00.000Z",283,17,"Brook Lopez",0,24,24,20,4,23.8
"7057",71,0,0,0,0,0,0,0,0,0,0,0,0,0,0,0,0,1037864,"2023-11-30T00:00:00.000Z",305,27,"Doug McDermott",0,0,0,0,0,0
"7058",72,0,0,0,0,0,0,0,0,0,0,0,0,0,0,0,0,1037864,"2023-11-30T00:00:00.000Z",56677838,1,"Kobe Bufkin",0,0,0,0,0,0
"7059",73,0,0,0,0,0,0,0,0,0,0,0,0,0,0,0,0,1037864,"2023-11-30T00:00:00.000Z",56677806,1,"Mouhamed Gueye",0,0,0,0,0,0
"7060",74,0,0,0,0,0,0,0,0,0,0,0,0,0,0,0,0,1037864,"2023-11-30T00:00:00.000Z",17896040,1,"Jalen Johnson",0,0,0,0,0,0
"7061",75,1,0,3,0,0,1,1,0,0,6,1,1,2,4,0,0,1037859,"2023-11-30T00:00:00.000Z",74,16,"Thomas Bryant",0,6,7,3,5,8.3
"7062",76,3,0,1,1,0,4,1,4,3,20,0,1,5,1,0,1,1038035,"2023-12-30T00:00:00.000Z",405,14,"D'Angelo Russell",0,6,9,8,4,9.7
"7063",77,0,0,1,5,0,11,2,6,5,29,1,2,9,2,0,1,1038035,"2023-12-30T00:00:00.000Z",17553995,14,"Austin Reaves",0,11,11,9,2,10.4
"7064",78,0,1,5,2,2,4,2,2,1,13,0,1,7,5,0,2,1038035,"2023-12-30T00:00:00.000Z",486,14,"Christian Wood",1,12,12,7,5,14
"7065",79,0,0,0,0,0,0,0,0,0,0,0,0,0,0,0,0,1038035,"2023-12-30T00:00:00.000Z",666626,14,"Jaxson Hayes",0,0,0,0,0,0
"7066",80,0,0,0,0,0,0,0,0,0,0,0,0,0,0,0,0,1038035,"2023-12-30T00:00:00.000Z",56677835,14,"Jalen Hood-Schifino",0,0,0,0,0,0
"7067",81,0,0,0,0,0,0,0,0,0,0,0,0,0,0,0,0,1038035,"2023-12-30T00:00:00.000Z",56677738,14,"Colin Castleton",0,0,0,0,0,0
"7068",82,0,0,0,0,0,0,0,0,0,0,0,0,0,0,0,0,1038035,"2023-12-30T00:00:00.000Z",56677867,14,"Alex Fudge",0,0,0,0,0,0
"7069",83,0,0,0,0,0,0,0,0,0,0,0,0,0,0,0,0,1038035,"2023-12-30T00:00:00.000Z",56677868,14,"D'Moi Hodge",0,0,0,0,0,0
"7070",84,0,0,0,0,0,0,0,0,0,0,0,0,0,0,0,0,1038035,"2023-12-30T00:00:00.000Z",56677836,14,"Maxwell Lewis",0,0,0,0,0,0
"7071",85,0,0,0,0,0,0,0,0,0,0,0,0,0,0,0,0,1038035,"2023-12-30T00:00:00.000Z",1603383,14,"Gabe Vincent",0,0,0,0,0,0
"7072",86,4,0,6,2,0,17,9,7,6,37,0,0,24,6,0,2,1038034,"2023-12-30T00:00:00.000Z",125,5,"DeMar DeRozan",0,30,34,28,10,35.2
"7073",87,3,0,1,3,1,11,6,0,0,33,2,0,13,3,0,2,1038034,"2023-12-30T00:00:00.000Z",3547248,5,"Patrick Williams",0,16,19,16,6,19.1
"7074",88,2,3,20,0,0,8,6,10,3,30,3,4,15,23,2,3,1038034,"2023-12-30T00:00:00.000Z",137,5,"Andre Drummond",5,38,40,17,25,57.6
"7075",89,5,1,2,5,3,7,4,5,3,28,0,2,14,2,1,3,1038034,"2023-12-30T00:00:00.000Z",89,5,"Alex Caruso",2,16,21,19,7,26.9
"7076",90,2,0,6,5,1,15,7,6,5,40,2,3,20,8,0,5,1038034,"2023-12-30T00:00:00.000Z",666956,5,"Coby White",0,28,30,22,10,27.6
"7077",91,2,1,1,4,0,11,3,0,0,29,2,2,6,3,0,0,1038034,"2023-12-30T00:00:00.000Z",17895983,5,"Ayo Dosunmu",1,9,11,8,5,15.6
"7078",92,1,0,2,4,1,5,1,2,1,13,0,3,4,2,1,0,1038034,"2023-12-30T00:00:00.000Z",87,5,"Jevon Carter",1,6,7,5,3,10.9
"7079",93,0,0,0,0,0,0,0,0,0,1,0,0,0,0,0,0,1038034,"2023-12-30T00:00:00.000Z",56677857,5,"Julian Phillips",0,0,0,0,0,0
"7080",94,0,0,0,0,0,0,0,0,0,0,0,0,0,0,0,0,1038034,"2023-12-30T00:00:00.000Z",110,5,"Torrey Craig",0,0,0,0,0,0
"7081",95,0,0,0,0,0,0,0,0,0,0,0,0,0,0,0,0,1038034,"2023-12-30T00:00:00.000Z",56677860,5,"Adama Sanogo",0,0,0,0,0,0
"7082",96,1,1,6,8,2,12,4,2,2,31,0,1,12,6,0,0,1038027,"2023-12-29T00:00:00.000Z",375,8,"Michael Porter Jr.",1,18,19,13,7,23.7
"7083",97,8,1,7,4,0,15,4,12,12,34,0,2,20,7,0,3,1038021,"2023-12-29T00:00:00.000Z",73,20,"Jalen Brunson",1,27,35,28,15,40.4
"7084",98,2,2,2,6,1,12,6,2,1,32,0,4,14,2,1,1,1038027,"2023-12-29T00:00:00.000Z",38017721,8,"Peyton Watson",3,16,18,16,4,27.4
"7085",99,7,1,8,1,1,10,9,0,0,32,2,2,19,10,1,7,1038027,"2023-12-29T00:00:00.000Z",246,8,"Nikola Jokic",2,29,36,26,17,40.5
"7086",100,2,0,0,3,2,5,3,1,0,27,0,3,8,0,1,1,1038027,"2023-12-29T00:00:00.000Z",81,8,"Kentavious Caldwell-Pope",1,8,10,10,2,13
"7087",101,0,0,0,0,0,0,0,0,0,0,0,0,0,0,0,0,1037698,"2023-11-08T00:00:00.000Z",328,23,"Marcus Morris",0,0,0,0,0,0
"7088",102,0,0,1,1,1,2,2,0,0,4,0,0,5,1,1,1,1037696,"2023-11-08T00:00:00.000Z",56677846,4,"Nick Smith Jr.",1,6,6,5,1,8.2
"7089",103,0,1,0,0,0,1,0,0,0,4,0,0,0,0,0,0,1037696,"2023-11-08T00:00:00.000Z",56677866,4,"Leaky Black",1,0,0,0,0,3
"7090",104,0,0,0,0,0,0,0,0,0,0,0,0,0,0,0,0,1037696,"2023-11-08T00:00:00.000Z",56677848,4,"Amari Bailey",0,0,0,0,0,0
"7091",105,0,0,0,0,0,0,0,0,0,0,0,0,0,0,0,0,1037696,"2023-11-08T00:00:00.000Z",17896037,4,"James Bouknight",0,0,0,0,0,0
"7092",106,0,0,0,0,0,0,0,0,0,0,0,0,0,0,0,0,1037696,"2023-11-08T00:00:00.000Z",62,4,"Miles Bridges",0,0,0,0,0,0
"7093",107,0,0,0,0,0,0,0,0,0,0,0,0,0,0,0,0,1037696,"2023-11-08T00:00:00.000Z",666748,4,"Cody Martin",0,0,0,0,0,0
"7094",108,0,0,0,0,0,0,0,0,0,0,0,0,0,0,0,0,1037696,"2023-11-08T00:00:00.000Z",347,4,"Frank Ntilikina",0,0,0,0,0,0
"7095",109,0,0,0,0,0,0,0,0,0,0,0,0,0,0,0,0,1037696,"2023-11-08T00:00:00.000Z",403,4,"Terry Rozier",0,0,0,0,0,0
"7096",110,4,0,6,11,4,24,13,3,3,31,3,1,33,9,0,2,1037696,"2023-11-08T00:00:00.000Z",265,30,"Kyle Kuzma",0,42,46,37,13,47.8
"7097",111,0,1,4,6,3,8,5,0,0,19,0,0,13,4,1,0,1037698,"2023-11-08T00:00:00.000Z",17896060,2,"Sam Hauser",2,17,17,13,4,23.8
"7098",112,3,2,5,6,1,6,1,0,0,26,0,1,3,5,0,1,1037698,"2023-11-08T00:00:00.000Z",219,2,"Al Horford",2,8,11,6,8,18.5
"7099",113,4,0,0,2,0,4,0,0,0,16,2,0,0,2,0,1,1037698,"2023-11-08T00:00:00.000Z",3547276,2,"Payton Pritchard",0,2,6,4,6,7.4
"7100",114,0,0,0,0,0,0,0,0,0,3,0,0,0,0,0,0,1037698,"2023-11-08T00:00:00.000Z",261,2,"Luke Kornet",0,0,0,0,0,0
"7101",115,0,0,0,0,0,0,0,0,0,0,0,0,0,0,0,0,1037698,"2023-11-08T00:00:00.000Z",338,2,"Svi Mykhailiuk",0,0,0,0,0,0
"7102",116,0,0,0,0,0,0,0,0,0,0,0,0,0,0,0,0,1037698,"2023-11-08T00:00:00.000Z",3547279,2,"Lamar Stevens",0,0,0,0,0,0
"7103",117,0,0,0,0,0,0,0,0,0,0,0,0,0,0,0,0,1037698,"2023-11-08T00:00:00.000Z",38017707,2,"JD Davison",0,0,0,0,0,0
"7104",118,0,0,0,0,0,0,0,0,0,0,0,0,0,0,0,0,1037698,"2023-11-08T00:00:00.000Z",3547295,2,"Nathan Knight",0,0,0,0,0,0
"7105",119,0,0,0,0,0,0,0,0,0,0,0,0,0,0,0,0,1037698,"2023-11-08T00:00:00.000Z",17553967,2,"Neemias Queta",0,0,0,0,0,0
"7106",120,0,0,0,0,0,0,0,0,0,0,0,0,0,0,0,0,1037698,"2023-11-08T00:00:00.000Z",56677864,2,"Jordan Walsh",0,0,0,0,0,0
"7107",121,1,2,3,0,0,3,3,0,0,15,1,1,6,4,1,0,1037700,"2023-11-08T00:00:00.000Z",17895854,27,"Charles Bassey",3,10,11,7,5,21.3
"7108",122,0,0,1,0,0,1,1,2,0,3,0,0,2,1,0,0,1037700,"2023-11-08T00:00:00.000Z",38017730,27,"Dominick Barlow",0,3,3,2,1,3.2
"7109",123,0,0,0,2,0,2,0,0,0,3,0,0,0,0,0,0,1037700,"2023-11-08T00:00:00.000Z",38017649,27,"Julian Champagnie",0,0,0,0,0,0
"7110",124,0,0,0,0,0,0,0,0,0,0,0,0,0,0,0,0,1037700,"2023-11-08T00:00:00.000Z",180,27,"Devonte' Graham",0,0,0,0,0,0
"7111",125,0,0,3,6,2,7,2,0,0,18,0,4,6,3,0,1,1037706,"2023-11-08T00:00:00.000Z",3547272,21,"Isaiah Joe",0,9,9,6,3,8.6
"7112",126,9,0,12,1,1,14,6,4,2,34,4,2,15,16,2,4,1037895,"2023-12-11T00:00:00.000Z",406,26,"Domantas Sabonis",2,31,40,24,25,49.7
"7113",127,1,0,1,5,2,6,2,0,0,17,0,4,6,1,0,0,1037895,"2023-12-11T00:00:00.000Z",221,26,"Kevin Huerter",0,7,8,7,2,8.7
"7114",128,8,0,3,10,5,22,10,6,4,33,0,4,29,3,0,3,1037895,"2023-12-11T00:00:00.000Z",161,26,"De'Aaron Fox",0,32,40,37,11,41.6
"7115",129,0,0,0,0,0,0,0,0,0,0,0,0,0,0,0,0,1037888,"2023-12-11T00:00:00.000Z",666656,1,"De'Andre Hunter",0,0,0,0,0,0
"7116",130,0,0,0,0,0,0,0,0,0,0,0,0,0,0,0,0,1037888,"2023-12-11T00:00:00.000Z",17896040,1,"Jalen Johnson",0,0,0,0,0,0
"7117",131,0,0,0,0,0,0,0,0,0,0,0,0,0,0,0,0,1037895,"2023-12-11T00:00:00.000Z",17895990,26,"Jordan Ford",0,0,0,0,0,0
"7118",132,0,0,0,0,0,0,0,0,0,0,0,0,0,0,0,0,1037886,"2023-12-11T00:00:00.000Z",38017662,6,"Isaiah Mobley",0,0,0,0,0,0
"7119",133,0,0,0,0,0,0,0,0,0,0,0,0,0,0,0,0,1037895,"2023-12-11T00:00:00.000Z",273,26,"Alex Len",0,0,0,0,0,0
"7120",134,5,0,3,5,3,13,6,7,7,37,2,1,22,5,0,5,1037895,"2023-12-11T00:00:00.000Z",61,3,"Mikal Bridges",0,27,32,27,10,30.5
"7121",135,2,0,4,4,3,13,6,0,0,31,0,0,15,4,1,1,1037895,"2023-12-11T00:00:00.000Z",666679,3,"Cameron Johnson",1,19,21,17,6,24.8
"7122",136,0,3,6,0,0,6,3,2,2,26,4,2,8,10,0,0,1037895,"2023-12-11T00:00:00.000Z",666508,3,"Nicolas Claxton",3,18,18,8,10,29
"7123",137,3,0,0,6,2,20,7,2,2,31,0,2,18,0,0,2,1037895,"2023-12-11T00:00:00.000Z",17896048,3,"Cam Thomas",0,18,21,21,3,20.5
"7124",138,7,0,2,8,2,15,6,5,4,34,0,2,18,2,0,3,1037895,"2023-12-11T00:00:00.000Z",130,3,"Spencer Dinwiddie",0,20,27,25,9,27.9
"7125",139,2,1,6,0,0,4,2,0,0,14,1,2,4,7,1,1,1037895,"2023-12-11T00:00:00.000Z",17896038,3,"Day'Ron Sharpe",2,11,13,6,9,20.4
"7126",140,1,2,3,4,3,6,5,0,0,25,0,0,13,3,1,0,1037895,"2023-12-11T00:00:00.000Z",158,3,"Dorian Finney-Smith",3,16,17,14,4,27.1
"7127",141,1,0,0,0,0,1,1,0,0,4,0,0,2,0,0,0,1037895,"2023-12-11T00:00:00.000Z",9051997,3,"Armoni Brooks",0,2,3,3,1,3.5
"7128",142,0,1,4,2,0,4,1,0,0,11,1,2,2,5,0,1,1037895,"2023-12-11T00:00:00.000Z",4197162,26,"Aleksandar Vezenkov",1,7,7,2,5,10
"7129",143,5,0,6,8,3,19,11,9,9,39,0,2,34,6,3,1,1037896,"2023-12-11T00:00:00.000Z",274,13,"Kawhi Leonard",3,40,45,39,11,56.7
"7130",144,8,1,5,8,2,17,7,4,4,41,3,4,20,8,1,1,1037896,"2023-12-11T00:00:00.000Z",172,13,"Paul George",2,28,36,28,16,46.6
"7131",145,2,2,3,0,0,13,9,0,0,34,3,2,18,6,0,0,1037896,"2023-12-11T00:00:00.000Z",493,13,"Ivica Zubac",2,24,26,20,8,34.2
"7132",146,4,0,1,4,1,6,3,2,2,29,2,2,9,3,0,0,1037896,"2023-12-11T00:00:00.000Z",666743,13,"Terance Mann",0,12,16,13,7,18.6
"7133",147,7,2,7,6,3,14,7,3,3,37,0,2,20,7,1,3,1037896,"2023-12-11T00:00:00.000Z",192,13,"James Harden",3,27,34,27,14,44.9
"7134",148,6,1,1,2,1,7,5,2,1,16,1,1,12,2,0,4,1037896,"2023-12-11T00:00:00.000Z",472,13,"Russell Westbrook",1,14,20,18,8,22.4
"7135",149,0,0,0,1,0,1,0,0,0,5,0,1,0,0,0,0,1037896,"2023-12-11T00:00:00.000Z",56677849,13,"Kobe Brown",0,0,0,0,0,0
"7136",150,0,0,0,0,0,0,0,0,0,0,0,0,0,0,0,0,1037896,"2023-12-11T00:00:00.000Z",17896022,13,"Brandon Boston Jr.",0,0,0,0,0,0
"7137",151,1,0,1,1,0,1,0,2,2,12,1,1,2,2,0,1,1038098,"2024-01-08T00:00:00.000Z",38017719,5,"Dalen Terry",0,4,5,3,3,4.9
"7138",152,0,0,0,1,0,2,1,0,0,4,0,0,2,0,0,0,1038098,"2024-01-08T00:00:00.000Z",87,5,"Jevon Carter",0,2,2,2,0,2
"7139",153,0,0,0,0,0,0,0,0,0,0,0,0,0,0,0,0,1038098,"2024-01-08T00:00:00.000Z",56677857,5,"Julian Phillips",0,0,0,0,0,0
"7140",154,0,0,0,0,0,0,0,0,0,0,0,0,0,0,0,0,1038098,"2024-01-08T00:00:00.000Z",17896116,5,"Terry Taylor",0,0,0,0,0,0
"7141",155,2,1,2,5,3,10,6,3,2,26,2,2,17,4,0,0,1038099,"2024-01-08T00:00:00.000Z",3547250,12,"Aaron Nesmith",1,21,23,19,6,27.8
"7142",156,1,3,7,4,1,8,3,4,4,27,2,1,11,9,0,2,1038099,"2024-01-08T00:00:00.000Z",3547264,12,"Jalen Smith",3,20,21,12,10,30.3
"7143",157,1,0,6,3,1,13,7,2,1,35,2,2,16,8,0,2,1038099,"2024-01-08T00:00:00.000Z",452,12,"Myles Turner",0,24,25,17,9,25.1
"7144",158,2,0,2,1,1,6,1,4,4,21,0,1,7,2,1,0,1038099,"2024-01-08T00:00:00.000Z",69,12,"Bruce Brown",1,9,11,9,4,15.4
"7145",159,6,0,2,3,1,5,3,0,0,13,0,1,7,2,0,2,1038099,"2024-01-08T00:00:00.000Z",3547245,12,"Tyrese Haliburton",0,9,15,13,8,16.4
"7146",160,3,0,4,9,5,15,8,7,5,29,0,4,26,4,2,2,1038099,"2024-01-08T00:00:00.000Z",38017686,12,"Bennedict Mathurin",2,30,33,29,7,39.3
"7147",161,3,2,3,7,3,11,6,0,0,25,1,3,15,4,1,1,1038099,"2024-01-08T00:00:00.000Z",210,12,"Buddy Hield",3,19,22,18,7,32.3
"7148",162,7,0,3,2,0,12,6,0,0,25,1,1,12,4,2,2,1038099,"2024-01-08T00:00:00.000Z",304,12,"T.J. McConnell",2,16,23,19,11,31.3
"7149",163,0,2,1,0,0,0,0,0,0,7,1,1,0,2,0,0,1038099,"2024-01-08T00:00:00.000Z",17896035,12,"Isaiah Jackson",2,2,2,0,2,8.4
"7150",164,3,0,0,2,1,6,4,0,0,12,0,5,9,0,0,2,1038099,"2024-01-08T00:00:00.000Z",38017507,12,"Andrew Nembhard",0,9,12,12,3,11.5
"7151",165,0,0,0,0,0,0,0,0,0,0,0,0,0,0,0,0,1038099,"2024-01-08T00:00:00.000Z",242,12,"James Johnson",0,0,0,0,0,0
"7152",166,4,0,4,2,1,11,5,4,3,39,0,1,14,4,1,2,1038101,"2024-01-08T00:00:00.000Z",56677785,16,"Jaime Jaquez Jr.",1,18,22,18,8,25.8
"7153",167,6,2,5,5,1,9,2,4,1,21,3,3,6,8,2,2,1038101,"2024-01-08T00:00:00.000Z",38017696,16,"Nikola Jovic",4,14,20,12,14,34.6
"7154",168,3,0,11,0,0,12,9,7,4,32,1,4,22,12,1,3,1038101,"2024-01-08T00:00:00.000Z",4,16,"Bam Adebayo",1,34,37,25,15,40.9
"7155",169,3,0,1,10,5,20,10,3,3,34,2,2,28,3,0,1,1038101,"2024-01-08T00:00:00.000Z",666633,16,"Tyler Herro",0,31,34,31,6,35.1
"7156",170,1,2,1,1,1,3,2,2,1,16,1,1,6,2,0,0,1038101,"2024-01-08T00:00:00.000Z",286,16,"Kyle Lowry",2,8,9,7,3,15.9
"7157",171,4,0,4,3,1,7,4,7,6,23,3,2,15,7,1,1,1038101,"2024-01-08T00:00:00.000Z",285,16,"Kevin Love",1,22,26,19,11,31.4
"7158",172,2,1,2,3,2,6,4,2,2,29,0,2,12,2,0,0,1038101,"2024-01-08T00:00:00.000Z",391,16,"Josh Richardson",1,14,16,14,4,20.4
"7159",173,5,0,6,7,3,19,10,5,4,42,0,3,27,6,0,1,1038098,"2024-01-08T00:00:00.000Z",666956,5,"Coby White",0,33,38,32,11,40.7
"7160",174,1,0,0,4,3,5,4,2,2,20,0,2,13,0,0,0,1038099,"2024-01-08T00:00:00.000Z",3547243,12,"Obi Toppin",0,13,14,14,1,14.5
"7161",175,0,0,0,0,0,0,0,0,0,0,0,0,0,0,0,0,1038099,"2024-01-08T00:00:00.000Z",3547207,12,"Jordan Nwora",0,0,0,0,0,0
"7162",176,3,1,6,8,4,15,7,0,0,39,1,1,18,7,4,2,3277448,"2023-11-17T00:00:00.000Z",666908,6,"Max Strus",5,25,28,21,10,43.9
"7163",177,1,0,7,3,1,11,6,2,1,27,1,0,14,8,1,0,1037698,"2023-11-08T00:00:00.000Z",360,23,"Kelly Oubre Jr.",1,22,23,15,9,28.1
"7164",178,3,0,7,4,1,12,5,6,6,38,2,1,17,9,0,2,1037698,"2023-11-08T00:00:00.000Z",200,23,"Tobias Harris",0,26,29,20,12,30.3
"7165",179,4,4,9,4,1,20,10,6,6,37,1,3,27,10,1,6,1037698,"2023-11-08T00:00:00.000Z",145,23,"Joel Embiid",5,37,41,31,14,54
"7166",180,2,0,4,7,1,9,1,0,0,29,0,2,3,4,1,1,1037698,"2023-11-08T00:00:00.000Z",313,23,"De'Anthony Melton",1,7,9,5,6,12.8
"7167",181,5,2,8,11,3,27,11,1,0,39,1,4,25,9,1,1,1037698,"2023-11-08T00:00:00.000Z",3547254,23,"Tyrese Maxey",3,34,39,30,14,51.3
"7168",182,4,0,5,1,0,2,1,0,0,15,0,2,2,5,0,0,1037698,"2023-11-08T00:00:00.000Z",45,23,"Patrick Beverley",0,7,11,6,9,14
"7169",183,1,1,2,2,1,3,2,0,0,26,2,2,5,4,0,0,1037698,"2023-11-08T00:00:00.000Z",33,23,"Nicolas Batum",1,9,10,6,5,14.3
"7170",184,0,0,1,2,1,4,2,0,0,15,2,2,5,3,2,0,1037698,"2023-11-08T00:00:00.000Z",108,23,"Robert Covington",2,8,8,5,3,14.6
"7171",185,2,0,2,2,0,3,1,2,2,31,0,2,4,2,2,1,1037695,"2023-11-06T00:00:00.000Z",17896024,19,"Herbert Jones",2,6,8,6,4,14.4
"7172",186,0,0,0,0,0,0,0,0,0,0,0,0,0,0,0,0,1037695,"2023-11-06T00:00:00.000Z",38017726,19,"Dereon Seabron",0,0,0,0,0,0
"7173",187,0,0,0,0,0,0,0,0,0,0,0,0,0,0,0,0,1037695,"2023-11-06T00:00:00.000Z",17896097,19,"Jose Alvarado",0,0,0,0,0,0
"7174",188,0,0,0,0,0,0,0,0,0,0,0,0,0,0,0,0,1037695,"2023-11-06T00:00:00.000Z",3547293,19,"Naji Marshall",0,0,0,0,0,0
"7175",189,0,0,0,0,0,0,0,0,0,0,0,0,0,0,0,0,1037695,"2023-11-06T00:00:00.000Z",303,19,"CJ McCollum",0,0,0,0,0,0
"7176",190,0,0,0,0,0,0,0,0,0,0,0,0,0,0,0,0,1037698,"2023-11-08T00:00:00.000Z",28,23,"Mo Bamba",0,0,0,0,0,0
"7177",191,6,1,3,6,2,13,5,3,2,32,0,2,14,3,0,1,3277449,"2023-11-17T00:00:00.000Z",17896055,28,"Scottie Barnes",1,17,23,20,9,28.6
"7178",192,5,0,5,1,0,16,11,1,1,29,1,5,23,6,0,3,3277449,"2023-11-17T00:00:00.000Z",416,28,"Pascal Siakam",0,29,34,28,11,34.7
"7179",193,4,0,6,0,0,5,5,2,1,34,2,0,11,8,1,3,3277449,"2023-11-17T00:00:00.000Z",373,28,"Jakob Poeltl",1,19,23,15,12,26.6
"7180",194,1,0,2,5,3,9,4,4,3,31,0,0,14,2,1,0,3277449,"2023-11-17T00:00:00.000Z",3089,28,"Gary Trent Jr.",1,16,17,15,3,20.9
"7181",195,6,0,7,11,5,19,9,0,0,35,0,2,23,7,0,2,3277449,"2023-11-17T00:00:00.000Z",409,28,"Dennis Schroder",0,30,36,29,13,38.4
"7182",196,1,0,9,2,0,4,2,2,1,25,0,1,5,9,2,1,3277449,"2023-11-17T00:00:00.000Z",3547249,28,"Precious Achiuwa",2,14,15,6,10,22.3
"7183",197,0,0,0,0,0,0,0,0,0,0,0,0,0,0,0,0,3277449,"2023-11-17T00:00:00.000Z",18,28,"OG Anunoby",0,0,0,0,0,0
"7184",198,0,0,1,0,0,2,1,0,0,7,0,0,2,1,0,0,3277445,"2023-11-17T00:00:00.000Z",3547282,4,"Nick Richards",0,3,3,2,1,3.2
"7185",199,0,1,1,1,0,6,1,0,0,9,1,1,2,2,0,1,3277445,"2023-11-17T00:00:00.000Z",56677846,4,"Nick Smith Jr.",1,4,4,2,2,6.4
"7186",200,0,0,1,0,0,1,1,0,0,5,0,1,2,1,0,0,3277445,"2023-11-17T00:00:00.000Z",18678001,4,"JT Thor",0,3,3,2,1,3.2
"7187",201,0,0,0,0,0,0,0,0,0,0,0,0,0,0,0,0,1037947,"2023-12-18T00:00:00.000Z",48,15,"Bismack Biyombo",0,0,0,0,0,0
"7188",202,0,0,0,0,0,0,0,0,0,0,0,0,0,0,0,0,1037947,"2023-12-18T00:00:00.000Z",3,15,"Steven Adams",0,0,0,0,0,0
"7189",203,0,0,0,0,0,0,0,0,0,0,0,0,0,0,0,0,1037947,"2023-12-18T00:00:00.000Z",666505,15,"Brandon Clarke",0,0,0,0,0,0
"7190",204,0,0,0,0,0,0,0,0,0,0,0,0,0,0,0,0,1037947,"2023-12-18T00:00:00.000Z",254,15,"Luke Kennard",0,0,0,0,0,0
"7191",205,0,0,0,0,0,0,0,0,0,0,0,0,0,0,0,0,1037947,"2023-12-18T00:00:00.000Z",38017732,15,"Kenneth Lofton Jr.",0,0,0,0,0,0
"7192",206,0,0,0,0,0,0,0,0,0,0,0,0,0,0,0,0,1037947,"2023-12-18T00:00:00.000Z",666786,15,"Ja Morant",0,0,0,0,0,0
"7193",207,0,0,0,0,0,0,0,0,0,0,0,0,0,0,0,0,1037947,"2023-12-18T00:00:00.000Z",401,15,"Derrick Rose",0,0,0,0,0,0
"7194",208,0,0,0,0,0,0,0,0,0,0,0,0,0,0,0,0,1037947,"2023-12-18T00:00:00.000Z",420,15,"Marcus Smart",0,0,0,0,0,0
"7195",209,1,0,2,3,2,8,3,0,0,23,2,1,8,4,0,2,1037948,"2023-12-18T00:00:00.000Z",375,8,"Michael Porter Jr.",0,12,13,9,5,12.3
"7196",210,3,0,2,3,0,7,1,0,0,25,2,3,2,4,2,1,1037949,"2023-12-18T00:00:00.000Z",38017739,29,"Simone Fontecchio",2,6,9,5,7,16.3
"7197",211,4,1,9,5,1,14,6,7,7,29,1,1,20,10,0,2,1037949,"2023-12-18T00:00:00.000Z",297,29,"Lauri Markkanen",1,30,34,24,14,39
"7198",212,0,5,11,0,0,8,6,4,2,32,3,1,14,14,0,1,1037949,"2023-12-18T00:00:00.000Z",38017705,29,"Walker Kessler",5,28,28,14,14,44.8
"7199",213,6,0,2,7,3,17,6,13,12,35,1,3,27,3,0,2,1037949,"2023-12-18T00:00:00.000Z",413,29,"Collin Sexton",0,30,36,33,9,37.6
"7200",214,6,0,3,7,5,19,11,0,0,31,0,2,27,3,2,1,1037949,"2023-12-18T00:00:00.000Z",666650,29,"Talen Horton-Tucker",2,30,36,33,9,44.6
"7201",215,3,0,4,1,0,2,1,0,0,20,1,4,2,5,1,0,1037949,"2023-12-18T00:00:00.000Z",358,29,"Kelly Olynyk",1,7,10,5,8,15.5
"7202",216,5,0,1,0,0,2,2,0,0,16,2,1,4,3,0,0,1037949,"2023-12-18T00:00:00.000Z",139,29,"Kris Dunn",0,7,12,9,8,15.1
"7203",217,2,1,2,5,1,10,6,0,0,23,1,1,13,3,1,2,1037949,"2023-12-18T00:00:00.000Z",38017620,29,"Ochai Agbaji",2,16,18,15,5,23.6
"7204",218,1,0,1,6,2,6,2,0,0,23,0,2,6,1,1,1,1037949,"2023-12-18T00:00:00.000Z",351,3,"Royce O'Neale",1,7,8,7,2,10.7
"7205",219,0,0,0,0,0,0,0,0,0,3,0,0,0,0,0,0,1037949,"2023-12-18T00:00:00.000Z",174,3,"Harry Giles III",0,0,0,0,0,0
"7206",220,0,1,2,0,0,5,3,1,0,17,3,1,6,5,0,1,1037949,"2023-12-18T00:00:00.000Z",17896038,3,"Day'Ron Sharpe",1,11,11,6,5,14
"7207",221,0,0,0,1,1,1,1,2,2,8,0,2,5,0,0,1,1037949,"2023-12-18T00:00:00.000Z",56677722,3,"Jalen Wilson",0,5,5,5,0,4
"7208",222,1,1,3,1,1,3,2,0,0,7,0,0,5,3,0,0,1037949,"2023-12-18T00:00:00.000Z",17896058,3,"Trendon Watford",1,8,9,6,4,13.1
"7209",223,0,0,0,0,0,0,0,0,0,0,0,0,0,0,0,0,1037949,"2023-12-18T00:00:00.000Z",421,3,"Dennis Smith Jr.",0,0,0,0,0,0
"7210",224,0,0,0,0,0,0,0,0,0,0,0,0,0,0,0,0,1037949,"2023-12-18T00:00:00.000Z",9051997,3,"Armoni Brooks",0,0,0,0,0,0
"7211",225,0,0,0,0,0,0,0,0,0,0,0,0,0,0,0,0,1037949,"2023-12-18T00:00:00.000Z",56677843,3,"Noah Clowney",0,0,0,0,0,0
"7212",226,0,0,0,0,0,0,0,0,0,0,0,0,0,0,0,0,1037606,"2023-10-25T00:00:00.000Z",17896022,13,"Brandon Boston Jr.",0,0,0,0,0,0
"7213",227,0,0,0,0,0,0,0,0,0,0,0,0,0,0,0,0,1037602,"2023-10-25T00:00:00.000Z",38017706,21,"Jaylin Williams",0,0,0,0,0,0
"7214",228,0,0,0,0,0,0,0,0,0,0,0,0,0,0,0,0,1037602,"2023-10-25T00:00:00.000Z",480,21,"Kenrich Williams",0,0,0,0,0,0
"7215",229,6,1,4,5,5,17,9,0,0,29,1,2,23,5,1,4,1037606,"2023-10-25T00:00:00.000Z",274,13,"Kawhi Leonard",2,28,34,29,11,40
"7216",230,0,4,7,0,0,10,8,5,4,26,5,3,20,12,0,2,1037606,"2023-10-25T00:00:00.000Z",493,13,"Ivica Zubac",4,32,32,20,12,44.4
"7217",231,6,0,3,7,4,17,11,1,1,32,0,2,27,3,3,4,1037606,"2023-10-25T00:00:00.000Z",172,13,"Paul George",3,30,36,33,9,44.6
"7218",232,13,0,3,2,1,8,5,0,0,29,2,3,11,5,0,3,1037606,"2023-10-25T00:00:00.000Z",472,13,"Russell Westbrook",0,16,29,24,18,33.5
"7219",233,1,1,3,0,0,0,0,0,0,9,0,0,0,3,1,0,1037606,"2023-10-25T00:00:00.000Z",33,13,"Nicolas Batum",2,3,4,1,4,11.1
"7220",234,0,0,0,1,0,2,0,0,0,5,0,1,0,0,0,0,1037606,"2023-10-25T00:00:00.000Z",56677849,13,"Kobe Brown",0,0,0,0,0,0
"7221",235,1,0,0,0,0,1,0,2,2,4,0,0,2,0,0,0,1037606,"2023-10-25T00:00:00.000Z",666511,13,"Amir Coffey",0,2,3,3,1,3.5
"7222",236,1,0,0,0,0,2,2,0,0,7,0,1,4,0,0,0,1037615,"2023-10-27T00:00:00.000Z",296,11,"Boban Marjanovic",0,4,5,5,1,5.5
"7223",237,0,0,0,0,0,0,0,0,0,0,0,0,0,0,0,0,1037615,"2023-10-27T00:00:00.000Z",56677809,11,"Jermaine Samuels Jr.",0,0,0,0,0,0
"7224",238,0,0,0,0,0,0,0,0,0,0,0,0,0,0,0,0,1037615,"2023-10-27T00:00:00.000Z",56677831,11,"Cam Whitmore",0,0,0,0,0,0
"7225",239,0,0,0,0,0,0,0,0,0,0,0,0,0,0,0,0,1037603,"2023-10-25T00:00:00.000Z",17896097,19,"Jose Alvarado",0,0,0,0,0,0
"7226",240,0,0,0,0,0,0,0,0,0,0,0,0,0,0,0,0,1037603,"2023-10-25T00:00:00.000Z",3547293,19,"Naji Marshall",0,0,0,0,0,0
"7227",241,0,0,0,0,0,0,0,0,0,0,0,0,0,0,0,0,1037605,"2023-10-25T00:00:00.000Z",38017679,7,"Jaden Hardy",0,0,0,0,0,0
"7228",242,0,0,0,0,0,0,0,0,0,0,0,0,0,0,0,0,1037605,"2023-10-25T00:00:00.000Z",217,7,"Richaun Holmes",0,0,0,0,0,0
"7229",243,0,0,0,0,0,0,0,0,0,0,0,0,0,0,0,0,1037605,"2023-10-25T00:00:00.000Z",329,7,"Markieff Morris",0,0,0,0,0,0
"7230",244,3,0,0,8,3,11,6,2,2,22,0,4,17,0,0,2,1037606,"2023-10-25T00:00:00.000Z",17896031,13,"Nah'Shon Hyland",0,17,20,20,3,19.5
"7231",245,1,0,0,2,0,4,0,0,0,13,1,2,0,1,1,0,1037606,"2023-10-25T00:00:00.000Z",3547294,13,"Kenyon Martin Jr.",1,1,2,1,2,5.7
"7232",246,0,0,0,0,0,0,0,0,0,0,0,0,0,0,0,0,1037605,"2023-10-25T00:00:00.000Z",38017649,27,"Julian Champagnie",0,0,0,0,0,0
"7233",247,0,0,0,0,0,0,0,0,0,0,0,0,0,0,0,0,1037605,"2023-10-25T00:00:00.000Z",180,27,"Devonte' Graham",0,0,0,0,0,0
"7234",248,0,0,0,0,0,0,0,0,0,0,0,0,0,0,0,0,1037605,"2023-10-25T00:00:00.000Z",17896059,27,"Sandro Mamukelashvili",0,0,0,0,0,0
"7235",249,0,0,0,0,0,0,0,0,0,0,0,0,0,0,0,0,1037605,"2023-10-25T00:00:00.000Z",38017693,27,"Blake Wesley",0,0,0,0,0,0
"7236",250,0,0,0,0,0,0,0,0,0,0,0,0,0,0,0,0,1037605,"2023-10-25T00:00:00.000Z",56677865,27,"Charles Bediako",0,0,0,0,0,0
"7237",251,2,0,4,3,3,6,5,2,0,23,1,0,13,5,0,0,1037808,"2023-11-22T00:00:00.000Z",480,21,"Kenrich Williams",0,18,20,15,7,22
"7238",252,2,0,0,3,0,4,1,0,0,11,0,0,2,0,0,2,1037808,"2023-11-22T00:00:00.000Z",4197029,21,"Vasilije Micic",0,2,4,4,2,3
"7239",253,1,0,4,0,0,2,2,2,2,11,0,1,6,4,0,1,1037808,"2023-11-22T00:00:00.000Z",17896078,21,"Aaron Wiggins",0,10,11,7,5,11.3
"7240",254,0,0,0,0,0,0,0,0,0,0,0,0,0,0,0,0,1037808,"2023-11-22T00:00:00.000Z",3547271,21,"Aleksej Pokusevski",0,0,0,0,0,0
"7241",255,0,0,0,0,0,0,0,0,0,0,0,0,0,0,0,0,1037808,"2023-11-22T00:00:00.000Z",56677853,21,"Keyontae Johnson",0,0,0,0,0,0
"7242",256,0,0,0,0,0,0,0,0,0,0,0,0,0,0,0,0,1037808,"2023-11-22T00:00:00.000Z",24572055,21,"Olivier Sarr",0,0,0,0,0,0
"7243",257,0,0,0,0,0,0,0,0,0,0,0,0,0,0,0,0,1037808,"2023-11-22T00:00:00.000Z",38017703,21,"Jalen Williams",0,0,0,0,0,0
"7244",258,6,1,1,2,0,17,6,13,13,36,1,3,25,2,2,1,1037808,"2023-11-22T00:00:00.000Z",125,5,"DeMar DeRozan",3,27,33,31,8,44.4
"7245",259,1,0,5,6,2,12,5,0,0,27,1,1,12,6,1,0,1037808,"2023-11-22T00:00:00.000Z",89,5,"Alex Caruso",1,18,19,13,7,23.7
"7246",260,3,0,7,5,2,13,6,2,2,37,5,4,16,12,2,1,1037808,"2023-11-22T00:00:00.000Z",460,5,"Nikola Vucevic",2,28,31,19,15,39.9
"7247",261,0,0,3,3,0,3,0,0,0,15,0,4,0,3,0,1,1037808,"2023-11-22T00:00:00.000Z",110,5,"Torrey Craig",0,3,3,0,3,2.6
"7248",262,2,0,0,6,1,7,1,0,0,19,0,2,3,0,0,0,1037808,"2023-11-22T00:00:00.000Z",87,5,"Jevon Carter",0,3,5,5,2,6
"7249",263,0,0,0,0,0,0,0,0,0,0,0,0,0,0,0,0,1037800,"2023-11-22T00:00:00.000Z",17896103,8,"Jay Huff",0,0,0,0,0,0
"7250",264,0,0,0,0,0,0,0,0,0,0,0,0,0,0,0,0,1037800,"2023-11-22T00:00:00.000Z",335,8,"Jamal Murray",0,0,0,0,0,0
"7251",265,0,0,0,0,0,0,0,0,0,0,0,0,0,0,0,0,1037808,"2023-11-22T00:00:00.000Z",27,5,"Lonzo Ball",0,0,0,0,0,0
"7252",266,0,0,0,0,0,0,0,0,0,0,0,0,0,0,0,0,1037805,"2023-11-22T00:00:00.000Z",357,11,"Victor Oladipo",0,0,0,0,0,0
"7253",267,0,0,0,0,0,0,0,0,0,0,0,0,0,0,0,0,1037805,"2023-11-22T00:00:00.000Z",56677809,11,"Jermaine Samuels Jr.",0,0,0,0,0,0
"7254",268,0,0,0,0,0,0,0,0,0,0,0,0,0,0,0,0,1037805,"2023-11-22T00:00:00.000Z",56677825,11,"Amen Thompson",0,0,0,0,0,0
"7255",269,0,0,0,0,0,0,0,0,0,0,0,0,0,0,0,0,1037805,"2023-11-22T00:00:00.000Z",56677831,11,"Cam Whitmore",0,0,0,0,0,0
"7256",270,0,1,2,3,1,5,2,3,3,22,0,5,8,2,0,0,1037805,"2023-11-22T00:00:00.000Z",17896067,15,"Santi Aldama",1,10,10,8,2,13.4
"7257",271,0,1,6,4,0,21,7,12,9,37,1,4,23,7,1,2,1037805,"2023-11-22T00:00:00.000Z",231,15,"Jaren Jackson Jr.",2,30,30,23,7,35.4
"7258",272,2,2,5,0,0,4,2,2,1,32,0,0,5,5,1,1,1037805,"2023-11-22T00:00:00.000Z",48,15,"Bismack Biyombo",3,10,12,7,7,22
"7259",273,4,0,6,6,2,12,6,10,9,26,1,4,23,7,1,2,1037805,"2023-11-22T00:00:00.000Z",3547287,15,"Desmond Bane",1,30,34,27,11,38.4
"7260",274,1,0,4,5,0,14,4,5,5,27,1,4,13,5,1,1,1037805,"2023-11-22T00:00:00.000Z",66,11,"Dillon Brooks",1,18,19,14,6,22.5
"7261",275,2,1,9,4,3,10,6,4,3,27,0,2,18,9,0,0,1037805,"2023-11-22T00:00:00.000Z",38017684,11,"Jabari Smith Jr.",1,27,29,20,11,34.8
"7262",276,0,0,0,0,0,0,0,0,0,0,0,0,0,0,0,0,1037983,"2023-12-23T00:00:00.000Z",226,22,"Joe Ingles",0,0,0,0,0,0
"7263",277,10,0,7,3,0,7,2,1,0,25,0,2,4,7,1,1,1037978,"2023-12-22T00:00:00.000Z",367,10,"Chris Paul",1,11,21,14,17,29.4
"7264",278,3,1,10,0,0,7,5,0,0,25,5,2,10,15,0,1,1037978,"2023-12-22T00:00:00.000Z",56677799,10,"Trayce Jackson-Davis",1,25,28,13,18,34.5
"7265",279,0,0,2,3,0,4,1,4,3,19,1,1,5,3,1,2,1037978,"2023-12-22T00:00:00.000Z",17553992,10,"Moses Moody",1,8,8,5,3,9.6
"7266",280,0,0,1,1,0,3,0,0,0,14,0,3,0,1,1,1,1037978,"2023-12-22T00:00:00.000Z",251,10,"Cory Joseph",1,1,1,0,1,3.2
"7267",281,1,0,0,0,0,1,0,0,0,2,0,0,0,0,0,0,1037978,"2023-12-22T00:00:00.000Z",17896070,10,"Usman Garuba",0,0,1,1,1,1.5
"7268",282,0,1,1,8,4,10,5,6,5,37,0,2,19,1,2,0,1037979,"2023-12-22T00:00:00.000Z",30,26,"Harrison Barnes",3,20,20,19,1,29.2
"7269",283,2,0,4,7,3,13,8,2,2,33,1,3,21,5,0,1,1037979,"2023-12-22T00:00:00.000Z",38017688,26,"Keegan Murray",0,26,28,23,7,29
"7270",284,11,0,10,2,0,15,12,5,4,35,1,3,28,11,0,3,1037979,"2023-12-22T00:00:00.000Z",406,26,"Domantas Sabonis",0,39,50,39,22,54.7
"7271",285,5,0,1,6,2,9,5,1,1,27,1,1,13,2,1,1,1037979,"2023-12-22T00:00:00.000Z",221,26,"Kevin Huerter",1,15,20,18,7,24.9
"7272",286,7,2,6,6,2,17,9,4,3,32,0,2,23,6,3,2,1037979,"2023-12-22T00:00:00.000Z",161,26,"De'Aaron Fox",5,29,36,30,13,53.7
"7273",287,1,1,2,2,0,3,0,2,1,17,1,3,1,3,1,0,1037979,"2023-12-22T00:00:00.000Z",38017714,26,"Keon Ellis",2,4,5,2,4,12.1
"7274",288,0,0,1,0,0,2,1,4,3,11,0,3,5,1,0,1,1037979,"2023-12-22T00:00:00.000Z",306,26,"JaVale McGee",0,6,6,5,1,5.2
"7275",289,0,0,3,0,0,1,0,0,0,12,1,1,0,4,0,1,1037979,"2023-12-22T00:00:00.000Z",290,26,"Trey Lyles",0,4,4,0,4,3.8
"7276",290,1,0,2,0,0,6,5,3,1,18,1,4,11,3,0,1,1037986,"2023-12-23T00:00:00.000Z",17896038,3,"Day'Ron Sharpe",0,14,15,12,4,15.1
"7277",291,5,0,6,1,1,3,2,0,0,19,0,1,5,6,1,1,1037986,"2023-12-23T00:00:00.000Z",351,3,"Royce O'Neale",1,11,16,10,11,21.7
"7278",292,3,0,0,2,1,6,2,2,1,19,0,3,6,0,0,1,1037986,"2023-12-23T00:00:00.000Z",421,3,"Dennis Smith Jr.",0,6,9,9,3,9.5
"7279",293,1,0,1,0,0,2,1,0,0,6,1,2,2,2,0,0,1037986,"2023-12-23T00:00:00.000Z",56677722,3,"Jalen Wilson",0,4,5,3,3,5.9
"7280",294,0,0,0,0,0,0,0,0,0,1,0,0,0,0,0,0,1037986,"2023-12-23T00:00:00.000Z",17896058,3,"Trendon Watford",0,0,0,0,0,0
"7281",295,0,0,0,0,0,0,0,0,0,1,0,0,0,0,0,0,1037986,"2023-12-23T00:00:00.000Z",174,3,"Harry Giles III",0,0,0,0,0,0
"7282",296,0,0,0,0,0,0,0,0,0,0,0,0,0,0,0,0,1037986,"2023-12-23T00:00:00.000Z",9051997,3,"Armoni Brooks",0,0,0,0,0,0
"7283",297,0,0,0,9,4,12,6,0,0,28,0,0,16,0,1,2,1037987,"2023-12-23T00:00:00.000Z",3089,28,"Gary Trent Jr.",1,16,16,16,0,17
"7284",298,6,0,2,3,1,3,1,0,0,14,0,1,3,2,0,0,1037987,"2023-12-23T00:00:00.000Z",3547275,28,"Malachi Flynn",0,5,11,9,8,14.4
"7285",299,0,0,0,0,0,0,0,0,0,0,0,0,0,0,0,0,1037987,"2023-12-23T00:00:00.000Z",666762,28,"Jalen McDaniels",0,0,0,0,0,0
"7286",300,0,0,0,0,0,0,0,0,0,0,0,0,0,0,0,0,1037976,"2023-12-22T00:00:00.000Z",19465585,16,"Dru Smith",0,0,0,0,0,0
"7287",301,1,1,3,1,1,5,5,4,3,12,3,0,14,6,1,0,1037635,"2023-10-30T00:00:00.000Z",17896106,30,"Eugene Omoruyi",2,20,21,15,7,28.7
"7288",302,0,0,0,0,0,0,0,0,0,0,0,0,0,0,0,0,1037634,"2023-10-30T00:00:00.000Z",3547207,12,"Jordan Nwora",0,0,0,0,0,0
"7289",303,1,0,0,2,0,2,0,0,0,6,0,0,0,0,0,1,1037635,"2023-10-30T00:00:00.000Z",18677954,30,"Jared Butler",0,0,1,1,1,0.5
"7290",304,2,1,6,2,0,10,7,2,2,19,2,3,16,8,2,0,1037639,"2023-10-30T00:00:00.000Z",377,17,"Bobby Portis",3,24,26,18,10,37.6
"7291",305,2,0,0,3,0,4,0,0,0,15,0,3,0,0,0,0,1037639,"2023-10-30T00:00:00.000Z",38017733,17,"A.J. Green",0,0,2,2,2,3
"7292",306,0,0,0,4,3,5,4,0,0,13,1,0,11,1,0,1,1037639,"2023-10-30T00:00:00.000Z",368,17,"Cameron Payne",0,12,12,11,1,11.2
"7293",307,0,0,0,0,0,0,0,0,0,0,0,0,0,0,0,0,1037639,"2023-10-30T00:00:00.000Z",2148,17,"Thanasis Antetokounmpo",0,0,0,0,0,0
"7294",308,0,0,0,0,0,0,0,0,0,0,0,0,0,0,0,0,1037639,"2023-10-30T00:00:00.000Z",56677852,17,"Andre Jackson Jr.",0,0,0,0,0,0
"7295",309,0,0,0,0,0,0,0,0,0,0,0,0,0,0,0,0,1037639,"2023-10-30T00:00:00.000Z",56677854,17,"Chris Livingston",0,0,0,0,0,0
"7296",310,0,0,0,0,0,0,0,0,0,0,0,0,0,0,0,0,1037639,"2023-10-30T00:00:00.000Z",284,17,"Robin Lopez",0,0,0,0,0,0
"7297",311,0,0,0,0,0,0,0,0,0,0,0,0,0,0,0,0,1037639,"2023-10-30T00:00:00.000Z",38017676,17,"MarJon Beauchamp",0,0,0,0,0,0
"7298",312,0,0,0,0,0,0,0,0,0,0,0,0,0,0,0,0,1037639,"2023-10-30T00:00:00.000Z",666453,17,"Marques Bolden",0,0,0,0,0,0
"7299",313,0,0,0,0,0,0,0,0,0,0,0,0,0,0,0,0,1037639,"2023-10-30T00:00:00.000Z",38017691,17,"TyTy Washington Jr.",0,0,0,0,0,0
"7300",314,0,0,0,0,0,0,0,0,0,0,0,0,0,0,0,0,1037637,"2023-10-30T00:00:00.000Z",419,25,"Anfernee Simons",0,0,0,0,0,0
"7301",315,0,0,0,0,0,0,0,0,0,0,0,0,0,0,0,0,1037637,"2023-10-30T00:00:00.000Z",17896120,25,"Ish Wainright",0,0,0,0,0,0
"7302",316,3,0,1,4,2,10,5,0,0,34,1,0,12,2,1,1,1037638,"2023-10-30T00:00:00.000Z",3547258,7,"Josh Green",1,14,17,15,5,20.9
"7303",317,12,1,12,12,6,22,11,10,7,40,0,4,35,12,1,6,1037638,"2023-10-30T00:00:00.000Z",132,7,"Luka Doncic",2,47,59,47,24,67.4
"7304",318,0,0,5,7,3,14,8,2,2,29,0,1,21,5,0,1,1037638,"2023-10-30T00:00:00.000Z",191,7,"Tim Hardaway Jr.",0,26,26,21,5,26
"7305",319,2,0,4,3,1,4,2,2,2,22,1,2,7,5,1,2,1037638,"2023-10-30T00:00:00.000Z",257,7,"Maxi Kleber",1,12,14,9,7,17
"7306",320,1,0,0,4,2,6,2,0,0,10,0,1,6,0,0,1,1037638,"2023-10-30T00:00:00.000Z",38017679,7,"Jaden Hardy",0,6,7,7,1,6.5
"7307",321,2,0,4,0,0,3,1,0,0,6,0,0,2,4,0,0,1037638,"2023-10-30T00:00:00.000Z",151,7,"Dante Exum",0,6,8,4,6,9.8
"7308",322,2,1,2,3,1,5,1,0,0,15,0,2,3,2,1,1,1037638,"2023-10-30T00:00:00.000Z",114,7,"Seth Curry",2,5,7,5,4,13.4
"7309",323,0,0,0,0,0,0,0,0,0,0,0,0,0,0,0,0,1037639,"2023-10-30T00:00:00.000Z",666960,17,"Lindell Wigginton",0,0,0,0,0,0
"7310",324,4,1,2,2,1,11,4,4,4,29,2,0,13,4,0,1,1037639,"2023-10-30T00:00:00.000Z",79,16,"Jimmy Butler",1,17,21,17,8,25.8
"7311",325,3,0,5,5,1,6,1,0,0,18,0,1,3,5,0,2,1037639,"2023-10-30T00:00:00.000Z",285,16,"Kevin Love",0,8,11,6,8,11.5
"7312",326,0,0,0,0,0,0,0,0,0,0,0,0,0,0,0,0,1037852,"2023-11-29T00:00:00.000Z",436,28,"Garrett Temple",0,0,0,0,0,0
"7313",327,0,0,0,0,0,0,0,0,0,0,0,0,0,0,0,0,3277527,"2023-11-28T00:00:00.000Z",45969255,5,"Justin Lewis",0,0,0,0,0,0
"7314",328,0,0,0,0,0,0,0,0,0,0,0,0,0,0,0,0,3277527,"2023-11-28T00:00:00.000Z",56677860,5,"Adama Sanogo",0,0,0,0,0,0
"7315",329,2,0,1,1,0,2,1,3,3,11,1,2,5,2,1,0,3277533,"2023-11-28T00:00:00.000Z",3547301,11,"Jae'Sean Tate",1,7,9,7,4,13.4
"7316",330,0,0,0,0,0,0,0,0,0,0,0,0,0,0,0,0,3277533,"2023-11-28T00:00:00.000Z",296,11,"Boban Marjanovic",0,0,0,0,0,0
"7317",331,0,0,0,0,0,0,0,0,0,0,0,0,0,0,0,0,3277533,"2023-11-28T00:00:00.000Z",56677809,11,"Jermaine Samuels Jr.",0,0,0,0,0,0
"7318",332,0,0,0,0,0,0,0,0,0,0,0,0,0,0,0,0,3277533,"2023-11-28T00:00:00.000Z",56677831,11,"Cam Whitmore",0,0,0,0,0,0
"7319",333,0,0,0,0,0,0,0,0,0,0,0,0,0,0,0,0,3277533,"2023-11-28T00:00:00.000Z",357,11,"Victor Oladipo",0,0,0,0,0,0
"7320",334,0,0,0,0,0,0,0,0,0,0,0,0,0,0,0,0,3277533,"2023-11-28T00:00:00.000Z",56677825,11,"Amen Thompson",0,0,0,0,0,0
"7321",335,0,0,0,0,0,0,0,0,0,0,0,0,0,0,0,0,3277533,"2023-11-28T00:00:00.000Z",47738533,11,"Jeenathan Williams",0,0,0,0,0,0
"7322",336,0,0,0,2,0,4,1,2,2,9,0,2,4,0,1,0,3277534,"2023-11-28T00:00:00.000Z",17553994,26,"Davion Mitchell",1,4,4,4,0,7
"7323",337,0,1,3,4,1,6,2,9,6,24,3,2,11,6,0,1,3277534,"2023-11-28T00:00:00.000Z",290,26,"Trey Lyles",1,17,17,11,6,20.2
"7324",338,0,0,2,1,0,1,0,0,0,5,0,0,0,2,0,0,3277534,"2023-11-28T00:00:00.000Z",17896044,26,"Kessler Edwards",0,2,2,0,2,2.4
"7325",339,0,2,0,0,0,1,0,2,1,5,1,1,1,1,0,1,3277534,"2023-11-28T00:00:00.000Z",306,26,"JaVale McGee",2,2,2,1,1,7.2
"7326",340,0,0,0,2,1,2,1,0,0,6,0,0,3,0,0,0,3277534,"2023-11-28T00:00:00.000Z",38017714,26,"Keon Ellis",0,3,3,3,0,3
"7327",341,0,0,0,0,0,0,0,0,0,0,0,0,0,0,0,0,1037852,"2023-11-29T00:00:00.000Z",666451,24,"Bol Bol",0,0,0,0,0,0
"7328",342,0,0,0,0,0,0,0,0,0,0,0,0,0,0,0,0,1037852,"2023-11-29T00:00:00.000Z",3547298,24,"Saben Lee",0,0,0,0,0,0
"7329",343,0,0,0,0,0,0,0,0,0,0,0,0,0,0,0,0,1037852,"2023-11-29T00:00:00.000Z",8,24,"Grayson Allen",0,0,0,0,0,0
"7330",344,2,0,3,8,3,10,4,6,5,24,2,2,16,5,0,2,1037854,"2023-11-29T00:00:00.000Z",56677837,19,"Jordan Hawkins",0,21,23,18,7,23
"7331",345,1,0,0,2,1,5,2,0,0,9,2,1,5,2,1,2,1037854,"2023-11-29T00:00:00.000Z",17896097,19,"Jose Alvarado",1,7,8,6,3,9.9
"7332",346,1,1,4,1,0,5,2,0,0,14,2,2,4,6,2,1,1037854,"2023-11-29T00:00:00.000Z",38017677,19,"Dyson Daniels",3,10,11,5,7,20.7
"7333",347,1,0,5,9,5,11,7,0,0,25,1,2,19,6,0,0,1037853,"2023-11-29T00:00:00.000Z",38017729,15,"David Roddy",0,25,26,20,7,27.7
"7334",348,1,6,3,3,0,19,8,4,4,35,3,2,20,6,1,1,1037853,"2023-11-29T00:00:00.000Z",231,15,"Jaren Jackson Jr.",7,26,27,21,7,48.7
"7335",349,2,3,6,0,0,3,3,0,0,30,0,3,6,6,1,5,1037853,"2023-11-29T00:00:00.000Z",48,15,"Bismack Biyombo",4,12,14,8,8,23.2
"7336",350,9,0,6,11,3,17,7,0,0,36,1,2,17,7,3,3,1037853,"2023-11-29T00:00:00.000Z",3547287,15,"Desmond Bane",3,24,33,26,16,44.9
"7337",351,6,0,2,1,1,11,5,0,0,24,0,4,11,2,0,4,1038015,"2023-12-28T00:00:00.000Z",151,7,"Dante Exum",0,13,19,17,8,18.4
"7338",352,3,0,3,11,5,19,11,7,5,32,0,2,32,3,2,1,1038015,"2023-12-28T00:00:00.000Z",191,7,"Tim Hardaway Jr.",2,35,38,35,6,45.1
"7339",353,3,0,2,4,2,8,3,4,3,30,0,2,11,2,0,3,1038015,"2023-12-28T00:00:00.000Z",114,7,"Seth Curry",0,13,16,14,5,14.9
"7340",354,5,0,0,1,0,3,1,0,0,15,0,0,2,0,0,1,1038015,"2023-12-28T00:00:00.000Z",3547258,7,"Josh Green",0,2,7,7,5,8.5
"7341",355,0,0,0,0,0,0,0,0,0,0,0,0,0,0,0,0,1038015,"2023-12-28T00:00:00.000Z",217,7,"Richaun Holmes",0,0,0,0,0,0
"7342",356,0,0,0,0,0,0,0,0,0,0,0,0,0,0,0,0,1038015,"2023-12-28T00:00:00.000Z",17554004,7,"AJ Lawson",0,0,0,0,0,0
"7343",357,0,0,0,0,0,0,0,0,0,0,0,0,0,0,0,0,1038014,"2023-12-28T00:00:00.000Z",27,5,"Lonzo Ball",0,0,0,0,0,0
"7344",358,0,0,0,0,0,0,0,0,0,0,0,0,0,0,0,0,1038014,"2023-12-28T00:00:00.000Z",56677874,5,"Onuralp Bitim",0,0,0,0,0,0
"7345",360,2,0,2,1,1,5,4,0,0,16,0,1,9,2,0,3,1038016,"2023-12-28T00:00:00.000Z",3547293,19,"Naji Marshall",0,11,13,11,4,11.4
"7346",361,0,0,0,0,0,0,0,0,0,0,0,0,0,0,0,0,1038014,"2023-12-28T00:00:00.000Z",268,5,"Zach LaVine",0,0,0,0,0,0
"7347",362,0,1,6,2,1,6,4,0,0,25,1,0,9,7,5,2,1038016,"2023-12-28T00:00:00.000Z",340,19,"Larry Nance Jr.",6,16,16,9,7,33.4
"7348",363,2,0,1,7,2,8,2,0,0,23,0,2,6,1,0,1,1038016,"2023-12-28T00:00:00.000Z",18677986,19,"Trey Murphy III",0,7,9,8,3,9.2
"7349",364,2,1,2,1,0,1,0,0,0,14,0,2,0,2,2,1,1038016,"2023-12-28T00:00:00.000Z",38017677,19,"Dyson Daniels",3,2,4,2,4,13.4
"7350",365,0,0,0,0,0,0,0,0,0,0,0,0,0,0,0,0,1038014,"2023-12-28T00:00:00.000Z",460,5,"Nikola Vucevic",0,0,0,0,0,0
"7351",366,1,2,5,6,4,9,4,0,0,34,0,4,12,5,1,1,1038014,"2023-12-28T00:00:00.000Z",3547250,12,"Aaron Nesmith",3,17,18,13,6,27.5
"7352",367,1,0,5,2,1,7,6,5,2,24,2,3,15,7,0,0,1038014,"2023-12-28T00:00:00.000Z",3547264,12,"Jalen Smith",0,22,23,16,8,24.9
"7353",368,0,3,6,2,1,12,8,7,7,26,0,5,24,6,0,3,1038014,"2023-12-28T00:00:00.000Z",452,12,"Myles Turner",3,30,30,24,6,37.2
"7354",369,0,0,0,0,0,0,0,0,0,0,0,0,0,0,0,0,1038016,"2023-12-28T00:00:00.000Z",3547260,19,"Kira Lewis Jr.",0,0,0,0,0,0
"7355",370,0,0,0,0,0,0,0,0,0,0,0,0,0,0,0,0,1038016,"2023-12-28T00:00:00.000Z",17896021,19,"Jeremiah Robinson-Earl",0,0,0,0,0,0
"7356",371,0,0,0,0,0,0,0,0,0,0,0,0,0,0,0,0,1038016,"2023-12-28T00:00:00.000Z",491,19,"Cody Zeller",0,0,0,0,0,0
"7357",372,0,0,0,0,0,0,0,0,0,0,0,0,0,0,0,0,1038016,"2023-12-28T00:00:00.000Z",56677837,19,"Jordan Hawkins",0,0,0,0,0,0
"7358",373,0,0,0,0,0,0,0,0,0,0,0,0,0,0,0,0,1038016,"2023-12-28T00:00:00.000Z",38017663,19,"E.J. Liddell",0,0,0,0,0,0
"7359",374,0,0,0,0,0,0,0,0,0,0,0,0,0,0,0,0,1038016,"2023-12-28T00:00:00.000Z",17896017,19,"Matt Ryan",0,0,0,0,0,0
"7360",375,0,0,0,0,0,0,0,0,0,0,0,0,0,0,0,0,1038016,"2023-12-28T00:00:00.000Z",38017726,19,"Dereon Seabron",0,0,0,0,0,0
"7361",376,0,0,0,0,0,0,0,0,0,0,0,0,0,0,0,0,1037685,"2023-11-06T00:00:00.000Z",56677870,27,"Sir'Jabari Rice",0,0,0,0,0,0
"7362",377,8,0,6,1,0,4,2,2,2,27,3,2,6,9,0,2,1037684,"2023-11-06T00:00:00.000Z",185,10,"Draymond Green",0,15,23,14,17,26.8
"7363",378,6,0,4,1,0,18,8,6,6,37,1,5,22,5,0,6,1037686,"2023-11-06T00:00:00.000Z",38017683,22,"Paolo Banchero",0,27,33,28,11,31
"7364",379,0,1,4,1,0,5,3,1,1,22,2,3,7,6,2,1,1037686,"2023-11-06T00:00:00.000Z",666442,22,"Goga Bitadze",3,13,13,7,6,22.2
"7365",380,7,1,3,6,1,12,4,2,1,24,1,3,10,4,1,4,1037686,"2023-11-06T00:00:00.000Z",17896073,22,"Jalen Suggs",2,14,21,17,11,27.3
"7366",381,2,0,3,4,2,7,3,0,0,33,2,2,8,5,0,1,1037686,"2023-11-06T00:00:00.000Z",56677827,22,"Anthony Black",0,13,15,10,7,16
"7367",382,3,0,5,0,0,2,1,0,0,21,0,1,2,5,0,2,1037686,"2023-11-06T00:00:00.000Z",226,22,"Joe Ingles",0,7,10,5,8,10.5
"7368",383,5,2,2,5,2,13,7,5,3,30,0,3,19,2,1,3,1037686,"2023-11-06T00:00:00.000Z",3547251,22,"Cole Anthony",3,21,26,24,7,34.9
"7369",384,6,0,2,4,3,15,9,7,7,37,2,0,28,4,2,3,1037689,"2023-11-06T00:00:00.000Z",79,16,"Jimmy Butler",2,32,38,34,10,44.8
"7370",385,0,1,1,5,1,6,2,0,0,22,0,2,5,1,1,0,1037689,"2023-11-06T00:00:00.000Z",3092,16,"Haywood Highsmith",2,6,6,5,1,12.2
"7371",386,10,2,15,1,1,20,9,5,3,38,5,2,22,20,2,4,1037689,"2023-11-06T00:00:00.000Z",4,16,"Bam Adebayo",4,42,52,32,30,69
"7372",387,5,0,4,10,2,20,8,4,4,35,1,1,22,5,3,6,1037689,"2023-11-06T00:00:00.000Z",666633,16,"Tyler Herro",3,27,32,27,10,38.5
"7373",388,5,0,2,5,1,6,2,0,0,33,2,2,5,4,1,0,1037689,"2023-11-06T00:00:00.000Z",286,16,"Kyle Lowry",1,9,14,10,9,20.3
"7374",389,3,0,2,6,2,11,5,0,0,26,0,1,12,2,1,1,1037689,"2023-11-06T00:00:00.000Z",397,16,"Duncan Robinson",1,14,17,15,5,20.9
"7375",390,0,0,2,2,1,2,1,0,0,21,0,4,3,2,0,1,1037689,"2023-11-06T00:00:00.000Z",391,16,"Josh Richardson",0,5,5,3,2,4.4
"7376",391,1,0,1,4,1,7,4,0,0,18,1,1,9,2,1,1,1037689,"2023-11-06T00:00:00.000Z",56677785,16,"Jaime Jaquez Jr.",1,11,12,10,3,14.9
"7377",392,3,0,3,16,6,33,17,6,5,40,1,3,45,4,1,1,1037688,"2023-11-06T00:00:00.000Z",17896048,3,"Cam Thomas",1,49,52,48,7,56.3
"7378",393,4,1,4,5,1,21,12,7,6,39,1,2,31,5,0,1,1037688,"2023-11-06T00:00:00.000Z",61,3,"Mikal Bridges",1,36,40,35,9,45
"7379",394,2,1,2,7,1,12,3,0,0,37,4,2,7,6,1,1,1037688,"2023-11-06T00:00:00.000Z",158,3,"Dorian Finney-Smith",2,13,15,9,8,22.2
"7380",395,3,0,2,3,1,4,1,0,0,24,1,0,3,3,0,0,1037688,"2023-11-06T00:00:00.000Z",130,3,"Spencer Dinwiddie",0,6,9,6,6,11.1
"7381",396,4,0,12,0,0,3,1,0,0,33,3,3,2,15,0,1,1037688,"2023-11-06T00:00:00.000Z",417,3,"Ben Simmons",0,17,21,6,19,25
"7382",397,0,0,0,0,0,0,0,0,0,0,0,0,0,0,0,0,1037688,"2023-11-06T00:00:00.000Z",9051997,3,"Armoni Brooks",0,0,0,0,0,0
"7383",398,0,0,0,0,0,0,0,0,0,0,0,0,0,0,0,0,1037688,"2023-11-06T00:00:00.000Z",174,3,"Harry Giles III",0,0,0,0,0,0
"7384",399,2,0,6,2,1,8,3,4,4,26,0,2,11,6,2,1,1037688,"2023-11-06T00:00:00.000Z",377,17,"Bobby Portis",2,17,19,13,8,26.2
"7385",400,0,0,3,9,4,10,5,2,1,30,2,1,15,5,1,2,1037688,"2023-11-06T00:00:00.000Z",112,17,"Jae Crowder",1,20,20,15,5,22
"7386",401,3,0,0,1,0,1,0,0,0,11,0,1,0,0,1,1,7049319,"2023-12-06T00:00:00.000Z",87,5,"Jevon Carter",1,0,3,3,3,6.5
"7387",402,0,0,0,0,0,0,0,0,0,0,0,0,0,0,0,0,7049317,"2023-12-06T00:00:00.000Z",666564,1,"Bruno Fernando",0,0,0,0,0,0
"7388",403,0,0,0,0,0,0,0,0,0,0,0,0,0,0,0,0,7049317,"2023-12-06T00:00:00.000Z",3547297,1,"Trent Forrest",0,0,0,0,0,0
"7389",404,0,0,0,0,0,0,0,0,0,0,0,0,0,0,0,0,7049317,"2023-12-06T00:00:00.000Z",38017689,1,"AJ Griffin",0,0,0,0,0,0
"7390",405,6,1,7,10,5,13,8,2,2,39,1,2,23,8,1,2,7049315,"2023-12-06T00:00:00.000Z",18,28,"OG Anunoby",2,31,37,29,14,45.6
"7391",406,6,1,3,1,1,13,9,11,11,36,1,1,30,4,0,2,7049315,"2023-12-06T00:00:00.000Z",416,28,"Pascal Siakam",1,34,40,36,10,44.8
"7392",407,1,4,5,0,0,2,1,2,0,28,1,2,2,6,0,0,7049315,"2023-12-06T00:00:00.000Z",373,28,"Jakob Poeltl",4,8,9,3,7,22.7
"7393",408,5,1,8,7,2,17,5,0,0,34,3,2,12,11,0,3,7049315,"2023-12-06T00:00:00.000Z",17896055,28,"Scottie Barnes",1,23,28,17,16,32.7
"7394",409,5,0,3,5,1,18,4,0,0,35,2,5,9,5,0,3,7049315,"2023-12-06T00:00:00.000Z",409,28,"Dennis Schroder",0,14,19,14,10,19.5
"7395",410,0,0,0,0,0,0,0,0,0,0,0,0,0,0,0,0,7049315,"2023-12-06T00:00:00.000Z",56677828,28,"Gradey Dick",0,0,0,0,0,0
"7396",411,2,2,15,0,0,8,7,2,2,30,6,3,16,21,0,1,7049318,"2023-12-06T00:00:00.000Z",176,18,"Rudy Gobert",2,37,39,18,23,49.2
"7397",412,6,1,6,5,2,17,4,8,7,37,1,2,17,7,1,3,7049318,"2023-12-06T00:00:00.000Z",3547238,18,"Anthony Edwards",2,24,30,23,13,37.4
"7398",413,4,0,4,10,4,13,5,4,4,33,0,3,18,4,3,1,7049318,"2023-12-06T00:00:00.000Z",104,18,"Mike Conley",3,22,26,22,8,36.8
"7399",414,2,0,7,2,0,5,1,0,0,24,2,4,2,9,1,1,7049317,"2023-12-06T00:00:00.000Z",3547244,1,"Onyeka Okongwu",1,11,13,4,11,17.8
"7400",415,0,0,0,0,0,0,0,0,0,0,0,0,0,0,0,0,7049317,"2023-12-06T00:00:00.000Z",319,1,"Patty Mills",0,0,0,0,0,0
"7401",416,0,0,0,0,0,0,0,0,0,0,0,0,0,0,0,0,7049317,"2023-12-06T00:00:00.000Z",56677838,1,"Kobe Bufkin",0,0,0,0,0,0
"7402",417,0,0,0,0,0,0,0,0,0,0,0,0,0,0,0,0,7049317,"2023-12-06T00:00:00.000Z",56677806,1,"Mouhamed Gueye",0,0,0,0,0,0
"7403",418,0,0,0,0,0,0,0,0,0,0,0,0,0,0,0,0,7049317,"2023-12-06T00:00:00.000Z",17896040,1,"Jalen Johnson",0,0,0,0,0,0
"7404",419,0,0,0,0,0,0,0,0,0,0,0,0,0,0,0,0,7049317,"2023-12-06T00:00:00.000Z",56677855,1,"Seth Lundy",0,0,0,0,0,0
"7405",420,0,0,0,0,0,0,0,0,0,0,0,0,0,0,0,0,7049317,"2023-12-06T00:00:00.000Z",56677875,1,"Miles Norris",0,0,0,0,0,0
"7406",421,0,0,0,0,0,0,0,0,0,0,0,0,0,0,0,0,7049319,"2023-12-06T00:00:00.000Z",666748,4,"Cody Martin",0,0,0,0,0,0
"7407",422,0,0,0,0,0,0,0,0,0,0,0,0,0,0,0,0,7049319,"2023-12-06T00:00:00.000Z",347,4,"Frank Ntilikina",0,0,0,0,0,0
"7408",423,0,0,0,0,0,0,0,0,0,0,0,0,0,0,0,0,7049319,"2023-12-06T00:00:00.000Z",38017698,4,"Mark Williams",0,0,0,0,0,0
"7409",424,4,2,6,4,2,6,2,4,3,22,2,2,9,8,0,1,7049320,"2023-12-06T00:00:00.000Z",38017695,11,"Tari Eason",2,17,21,13,12,29.6
"7410",425,0,0,0,1,0,2,1,1,1,6,0,0,3,0,0,0,7049320,"2023-12-06T00:00:00.000Z",75,11,"Reggie Bullock",0,3,3,3,0,3
"7411",426,0,0,0,0,0,0,0,0,0,4,0,1,0,0,0,0,1038065,"2024-01-03T00:00:00.000Z",147,24,"Drew Eubanks",0,0,0,0,0,0
"7412",427,0,0,0,0,0,0,0,0,0,0,0,0,0,0,0,0,1038065,"2024-01-03T00:00:00.000Z",18678058,24,"Jordan Goodwin",0,0,0,0,0,0
"7413",428,0,0,0,0,0,0,0,0,0,0,0,0,0,0,0,0,1038065,"2024-01-03T00:00:00.000Z",17896022,13,"Brandon Boston Jr.",0,0,0,0,0,0
"7414",430,0,0,0,0,0,0,0,0,0,0,0,0,0,0,0,0,1038086,"2024-01-06T00:00:00.000Z",38017712,30,"Ryan Rollins",0,0,0,0,0,0
"7415",431,0,0,0,0,0,0,0,0,0,0,0,0,0,0,0,0,1038086,"2024-01-06T00:00:00.000Z",414,30,"Landry Shamet",0,0,0,0,0,0
"7416",432,2,0,3,3,1,7,4,0,0,31,2,3,9,5,1,1,1038086,"2024-01-06T00:00:00.000Z",18,20,"OG Anunoby",1,14,16,11,7,20
"7417",433,5,0,4,8,3,23,13,13,10,38,3,2,39,7,1,2,1038086,"2024-01-06T00:00:00.000Z",387,20,"Julius Randle",1,46,51,44,12,55.9
"7418",434,2,2,17,0,0,8,4,0,0,39,2,3,8,19,4,5,1038086,"2024-01-06T00:00:00.000Z",201,20,"Isaiah Hartenstein",6,27,29,10,21,46.8
"7419",435,3,0,4,7,2,10,4,0,0,26,1,1,10,5,1,1,1038086,"2024-01-06T00:00:00.000Z",131,20,"Donte DiVincenzo",1,15,18,13,8,22.5
"7420",436,8,3,6,5,2,8,4,2,0,30,1,1,10,7,1,2,1038085,"2024-01-06T00:00:00.000Z",219,2,"Al Horford",4,17,25,18,15,40.4
"7421",437,0,0,2,3,1,5,2,0,0,15,0,0,5,2,1,0,1038085,"2024-01-06T00:00:00.000Z",3547276,2,"Payton Pritchard",1,7,7,5,2,10.4
"7422",438,3,0,1,0,0,2,1,2,2,16,3,1,4,4,1,1,1038085,"2024-01-06T00:00:00.000Z",261,2,"Luke Kornet",1,8,11,7,7,15.3
"7423",439,0,0,0,0,0,0,0,0,0,1,0,0,0,0,0,0,1038085,"2024-01-06T00:00:00.000Z",338,2,"Svi Mykhailiuk",0,0,0,0,0,0
"7424",440,0,0,0,0,0,0,0,0,0,0,0,0,0,0,0,0,1038085,"2024-01-06T00:00:00.000Z",17553967,2,"Neemias Queta",0,0,0,0,0,0
"7425",441,0,0,0,0,0,0,0,0,0,0,0,0,0,0,0,0,1038059,"2024-01-03T00:00:00.000Z",17896036,21,"Tre Mann",0,0,0,0,0,0
"7426",442,0,0,0,0,0,0,0,0,0,0,0,0,0,0,0,0,1038059,"2024-01-03T00:00:00.000Z",4197029,21,"Vasilije Micic",0,0,0,0,0,0
"7427",443,0,0,0,0,0,0,0,0,0,0,0,0,0,0,0,0,1038059,"2024-01-03T00:00:00.000Z",24572055,21,"Olivier Sarr",0,0,0,0,0,0
"7428",444,0,0,0,0,0,0,0,0,0,0,0,0,0,0,0,0,1038059,"2024-01-03T00:00:00.000Z",480,21,"Kenrich Williams",0,0,0,0,0,0
"7429",445,0,0,0,0,0,0,0,0,0,0,0,0,0,0,0,0,1038059,"2024-01-03T00:00:00.000Z",38017716,21,"Ousmane Dieng",0,0,0,0,0,0
"7430",446,0,0,0,0,0,0,0,0,0,0,0,0,0,0,0,0,1038059,"2024-01-03T00:00:00.000Z",56677853,21,"Keyontae Johnson",0,0,0,0,0,0
"7431",447,0,0,0,0,0,0,0,0,0,0,0,0,0,0,0,0,1038059,"2024-01-03T00:00:00.000Z",3547271,21,"Aleksej Pokusevski",0,0,0,0,0,0
"7432",448,0,0,0,0,0,0,0,0,0,0,0,0,0,0,0,0,1038085,"2024-01-06T00:00:00.000Z",3547279,2,"Lamar Stevens",0,0,0,0,0,0
"7433",449,0,0,0,0,0,0,0,0,0,0,0,0,0,0,0,0,1038085,"2024-01-06T00:00:00.000Z",38017707,2,"JD Davison",0,0,0,0,0,0
"7434",451,0,0,0,0,0,0,0,0,0,0,0,0,0,0,0,0,3277425,"2023-11-14T00:00:00.000Z",38017734,16,"Jamal Cain",0,0,0,0,0,0
"7435",452,0,1,1,5,1,9,4,1,1,19,0,1,10,1,0,0,3277426,"2023-11-14T00:00:00.000Z",3547267,9,"Isaiah Stewart",1,11,11,10,1,14.2
"7436",453,1,1,4,0,0,12,9,4,4,30,6,2,22,10,0,4,3277426,"2023-11-14T00:00:00.000Z",24,9,"Marvin Bagley III",1,32,33,23,11,34.5
"7437",454,12,0,3,3,1,14,4,0,0,38,1,3,9,4,3,6,3277426,"2023-11-14T00:00:00.000Z",17896075,9,"Cade Cunningham",3,13,25,21,16,34.8
"7438",455,5,2,3,3,1,8,3,2,1,23,0,2,8,3,1,1,3277426,"2023-11-14T00:00:00.000Z",3547241,9,"Killian Hayes",3,11,16,13,8,27.1
"7439",456,5,0,1,9,4,12,4,4,4,23,1,3,16,2,1,1,3277426,"2023-11-14T00:00:00.000Z",77,9,"Alec Burks",1,18,23,21,7,27.9
"7440",457,1,0,3,0,0,6,5,2,1,14,1,2,11,4,0,0,3277426,"2023-11-14T00:00:00.000Z",3547240,9,"James Wiseman",0,15,16,12,5,17.3
"7441",458,1,0,3,4,2,8,5,0,0,29,1,3,12,4,0,2,3277426,"2023-11-14T00:00:00.000Z",259,9,"Kevin Knox",0,16,17,13,5,16.3
"7442",459,5,0,2,2,1,7,4,4,2,21,3,1,11,5,1,1,3277426,"2023-11-14T00:00:00.000Z",38017682,9,"Jaden Ivey",1,16,21,16,10,26.5
"7443",460,1,0,1,2,0,2,0,0,0,8,0,0,0,1,0,0,3277426,"2023-11-14T00:00:00.000Z",56677792,9,"Marcus Sasser",0,1,2,1,2,2.7
"7444",461,0,0,0,0,0,0,0,0,0,0,0,0,0,0,0,0,3277426,"2023-11-14T00:00:00.000Z",38017694,9,"Jalen Duren",0,0,0,0,0,0
"7445",462,0,0,0,0,0,0,0,0,0,0,0,0,0,0,0,0,3277426,"2023-11-14T00:00:00.000Z",197,9,"Joe Harris",0,0,0,0,0,0
"7446",463,0,0,0,0,0,0,0,0,0,0,0,0,0,0,0,0,3277426,"2023-11-14T00:00:00.000Z",17896071,9,"Isaiah Livers",0,0,0,0,0,0
"7447",464,0,0,0,0,0,0,0,0,0,0,0,0,0,0,0,0,3277426,"2023-11-14T00:00:00.000Z",54,9,"Bojan Bogdanovic",0,0,0,0,0,0
"7448",465,0,0,0,0,0,0,0,0,0,0,0,0,0,0,0,0,3277426,"2023-11-14T00:00:00.000Z",56677729,9,"Malcolm Cazalon",0,0,0,0,0,0
"7449",466,0,0,0,0,0,0,0,0,0,0,0,0,0,0,0,0,3277426,"2023-11-14T00:00:00.000Z",330,9,"Monte Morris",0,0,0,0,0,0
"7450",467,3,0,5,2,0,11,5,4,4,36,0,4,14,5,1,0,3277427,"2023-11-14T00:00:00.000Z",69,12,"Bruce Brown",1,19,22,17,8,27.5
"7451",468,15,1,6,12,7,18,11,5,4,38,1,1,33,7,2,0,3277427,"2023-11-14T00:00:00.000Z",3547245,12,"Tyrese Haliburton",3,40,55,48,22,72.9
"7452",469,1,0,0,1,1,2,2,1,0,3,0,2,5,0,0,0,3277427,"2023-11-14T00:00:00.000Z",3547264,12,"Jalen Smith",0,5,6,6,1,6.5
"7453",470,1,0,2,3,0,5,1,0,0,29,0,2,2,2,1,5,3277427,"2023-11-14T00:00:00.000Z",210,12,"Buddy Hield",1,4,5,3,3,3.9
"7454",471,3,0,2,2,0,8,5,1,1,13,1,3,11,3,0,1,3277427,"2023-11-14T00:00:00.000Z",304,12,"T.J. McConnell",0,14,17,14,6,18.1
"7455",472,2,1,4,0,0,4,1,8,5,17,5,4,7,9,0,1,3277427,"2023-11-14T00:00:00.000Z",17896035,12,"Isaiah Jackson",1,16,18,9,11,22.8
"7456",473,3,0,1,0,0,3,1,0,0,19,1,1,2,2,0,3,3277425,"2023-11-14T00:00:00.000Z",422,4,"Ish Smith",0,4,7,5,5,5.9
"7457",474,0,0,2,1,1,2,1,0,0,15,0,1,3,2,0,0,3277425,"2023-11-14T00:00:00.000Z",56677846,4,"Nick Smith Jr.",0,5,5,3,2,5.4
"7458",475,0,0,0,0,0,0,0,0,0,0,0,0,0,0,0,0,3277425,"2023-11-14T00:00:00.000Z",17896037,4,"James Bouknight",0,0,0,0,0,0
"7459",476,0,0,0,0,0,0,0,0,0,0,0,0,0,0,0,0,1037913,"2023-12-14T00:00:00.000Z",17896056,18,"Luka Garza",0,0,0,0,0,0
"7460",477,0,0,0,0,0,0,0,0,0,0,0,0,0,0,0,0,1037913,"2023-12-14T00:00:00.000Z",56677782,18,"Leonard Miller",0,0,0,0,0,0
"7461",478,0,0,0,0,0,0,0,0,0,0,0,0,0,0,0,0,1037913,"2023-12-14T00:00:00.000Z",17895968,18,"Daishen Nix",0,0,0,0,0,0
"7462",479,2,0,2,4,0,5,1,0,0,20,1,1,2,3,1,0,1037917,"2023-12-14T00:00:00.000Z",666743,13,"Terance Mann",1,5,7,4,5,11.6
"7463",480,1,2,1,0,0,7,2,0,0,22,3,3,4,4,1,2,1037915,"2023-12-14T00:00:00.000Z",11891374,29,"Omer Yurtseven",3,8,9,5,5,17.3
"7464",481,0,0,4,5,2,9,4,0,0,25,3,1,10,7,1,2,1037915,"2023-12-14T00:00:00.000Z",56677824,29,"Taylor Hendricks",1,17,17,10,7,19.4
"7465",482,5,0,1,2,0,8,3,0,0,26,1,2,6,2,0,0,1037915,"2023-12-14T00:00:00.000Z",139,29,"Kris Dunn",0,8,13,11,7,15.9
"7466",483,0,0,0,0,0,0,0,0,0,3,0,0,0,0,0,0,1037915,"2023-12-14T00:00:00.000Z",19465584,29,"Micah Potter",0,0,0,0,0,0
"7467",484,0,0,0,0,0,0,0,0,0,0,0,0,0,0,0,0,1037915,"2023-12-14T00:00:00.000Z",101,29,"John Collins",0,0,0,0,0,0
"7468",485,0,0,0,0,0,0,0,0,0,0,0,0,0,0,0,0,1037915,"2023-12-14T00:00:00.000Z",666881,29,"Luka Samanic",0,0,0,0,0,0
"7469",486,0,0,0,0,0,0,0,0,0,0,0,0,0,0,0,0,1037915,"2023-12-14T00:00:00.000Z",17896023,29,"Josh Christopher",0,0,0,0,0,0
"7470",487,2,1,5,4,2,16,9,9,7,39,3,2,27,8,1,2,1037917,"2023-12-14T00:00:00.000Z",274,13,"Kawhi Leonard",2,35,37,29,10,43.6
"7471",488,2,2,5,0,0,10,5,0,0,30,3,5,10,8,0,3,1037917,"2023-12-14T00:00:00.000Z",493,13,"Ivica Zubac",2,18,20,12,10,25.6
"7472",489,1,0,3,11,4,15,6,3,2,30,1,2,18,4,0,1,1037917,"2023-12-14T00:00:00.000Z",666511,13,"Amir Coffey",0,22,23,19,5,23.3
"7473",490,0,0,0,0,0,0,0,0,0,0,0,0,0,0,0,0,1037915,"2023-12-14T00:00:00.000Z",100,29,"Jordan Clarkson",0,0,0,0,0,0
"7474",491,0,0,0,0,0,0,0,0,0,0,0,0,0,0,0,0,1037915,"2023-12-14T00:00:00.000Z",56677834,29,"Keyonte George",0,0,0,0,0,0
"7475",492,0,0,0,0,0,0,0,0,0,0,0,0,0,0,0,0,1037915,"2023-12-14T00:00:00.000Z",38017630,29,"Johnny Juzang",0,0,0,0,0,0
"7476",493,3,2,0,5,2,9,3,2,1,32,2,5,9,2,2,0,1037912,"2023-12-14T00:00:00.000Z",3547248,5,"Patrick Williams",4,11,14,12,5,27.9
"7477",494,7,0,10,5,2,21,10,2,2,36,2,2,24,12,3,0,1037912,"2023-12-14T00:00:00.000Z",460,5,"Nikola Vucevic",3,36,43,31,19,57.9
"7478",495,1,0,0,3,2,4,2,0,0,5,0,0,6,0,0,0,1037912,"2023-12-14T00:00:00.000Z",89,5,"Alex Caruso",0,6,7,7,1,7.5
"7479",496,11,0,6,11,4,20,9,8,4,40,1,1,26,7,1,0,1037912,"2023-12-14T00:00:00.000Z",666956,5,"Coby White",1,33,44,37,18,53.9
"7480",497,0,0,2,3,0,7,2,1,1,23,1,3,5,3,1,0,1037912,"2023-12-14T00:00:00.000Z",110,5,"Torrey Craig",1,8,8,5,3,11.6
"7481",498,1,0,0,2,0,2,0,0,0,13,0,3,0,0,1,1,1037912,"2023-12-14T00:00:00.000Z",87,5,"Jevon Carter",1,0,1,1,1,3.5
"7482",499,5,0,3,5,2,20,10,0,0,36,2,3,22,5,2,2,1037911,"2023-12-14T00:00:00.000Z",70,2,"Jaylen Brown",2,27,32,27,10,39.5
"7483",500,3,3,8,10,3,22,9,8,6,36,3,1,27,11,0,3,1037911,"2023-12-14T00:00:00.000Z",434,2,"Jayson Tatum",3,38,41,30,14,50.7
"7484",501,14,1,4,0,0,5,3,0,0,25,0,0,6,4,3,5,1038125,"2024-01-12T00:00:00.000Z",304,12,"T.J. McConnell",4,10,24,20,18,38.8
"7485",502,6,1,3,3,0,9,4,2,1,27,0,2,9,3,1,0,1038130,"2024-01-12T00:00:00.000Z",3547238,18,"Anthony Edwards",2,12,18,15,9,27.6
"7486",503,10,0,4,5,3,7,3,0,0,20,0,1,9,4,0,0,1038130,"2024-01-12T00:00:00.000Z",104,18,"Mike Conley",0,13,23,19,14,28.8
"7487",504,1,0,2,0,0,2,1,0,0,15,0,2,2,2,0,2,1038130,"2024-01-12T00:00:00.000Z",12,18,"Kyle Anderson",0,4,5,3,3,3.9
"7488",505,3,0,2,2,0,3,1,0,0,19,0,1,2,2,2,2,1038130,"2024-01-12T00:00:00.000Z",666400,18,"Nickeil Alexander-Walker",2,4,7,5,5,12.9
"7489",506,5,0,0,2,0,3,1,0,0,13,0,2,2,0,1,2,1038130,"2024-01-12T00:00:00.000Z",666767,18,"Jordan McLaughlin",1,2,7,7,5,10.5
"7490",507,2,0,0,0,0,5,3,0,0,10,0,1,6,0,0,0,1038130,"2024-01-12T00:00:00.000Z",320,18,"Shake Milton",0,6,8,8,2,9
"7491",508,0,1,0,0,0,3,0,2,2,9,0,2,2,0,1,0,1038130,"2024-01-12T00:00:00.000Z",38017715,18,"Josh Minott",2,2,2,2,0,8
"7492",509,3,0,1,5,2,5,2,0,0,9,1,1,6,2,0,3,1038130,"2024-01-12T00:00:00.000Z",68,18,"Troy Brown Jr.",0,8,11,9,5,9.9
"7493",510,0,0,0,0,0,2,2,0,0,8,0,2,4,0,2,0,1038130,"2024-01-12T00:00:00.000Z",38017700,18,"Wendell Moore Jr.",2,4,4,4,0,10
"7494",511,0,1,2,2,0,4,2,0,0,8,0,2,4,2,1,1,1038130,"2024-01-12T00:00:00.000Z",56677782,18,"Leonard Miller",2,6,6,4,2,11.4
"7495",512,0,0,0,0,0,0,0,0,0,0,0,0,0,0,0,0,1038130,"2024-01-12T00:00:00.000Z",17895968,18,"Daishen Nix",0,0,0,0,0,0
"7496",513,5,0,5,5,2,21,15,8,7,41,1,5,39,6,0,1,1038128,"2024-01-12T00:00:00.000Z",125,5,"DeMar DeRozan",0,45,50,44,11,52.7
"7497",514,2,1,1,6,2,6,2,0,0,29,1,0,6,2,0,0,1038128,"2024-01-12T00:00:00.000Z",89,5,"Alex Caruso",1,8,10,8,4,14.4
"7498",515,2,0,5,5,2,12,6,0,0,33,2,1,14,7,0,3,1038128,"2024-01-12T00:00:00.000Z",460,5,"Nikola Vucevic",0,21,23,16,9,22.4
"7499",516,7,1,8,8,4,15,9,3,3,35,0,3,25,8,0,1,1038128,"2024-01-12T00:00:00.000Z",268,5,"Zach LaVine",1,33,40,32,15,47.1
"7500",517,7,0,4,7,5,13,9,3,2,37,0,4,25,4,0,1,1038128,"2024-01-12T00:00:00.000Z",666956,5,"Coby White",0,29,36,32,11,39.3
"7501",518,0,0,0,3,2,4,2,0,0,17,0,4,6,0,0,3,1038128,"2024-01-12T00:00:00.000Z",17895983,5,"Ayo Dosunmu",0,6,6,6,0,3
"7502",519,0,0,0,0,0,0,0,0,0,0,0,0,0,0,0,0,1038126,"2024-01-12T00:00:00.000Z",56677809,11,"Jermaine Samuels Jr.",0,0,0,0,0,0
"7503",520,0,0,0,0,0,0,0,0,0,0,0,0,0,0,0,0,1038126,"2024-01-12T00:00:00.000Z",47738533,11,"Jeenathan Williams",0,0,0,0,0,0
"7504",521,3,0,2,1,0,4,0,0,0,9,1,3,0,3,1,1,1038124,"2024-01-12T00:00:00.000Z",56677845,26,"Colby Jones",1,3,6,3,6,10.1
"7505",522,1,0,2,0,0,1,1,0,0,8,2,1,2,4,0,0,1038124,"2024-01-12T00:00:00.000Z",273,26,"Alex Len",0,6,7,3,5,8.3
"7506",523,4,0,4,0,0,7,7,4,4,21,2,4,18,6,0,1,1038125,"2024-01-12T00:00:00.000Z",3547243,12,"Obi Toppin",0,24,28,22,10,30.2
"7507",524,2,0,1,0,0,1,0,0,0,4,0,0,0,1,0,0,1038125,"2024-01-12T00:00:00.000Z",3547207,12,"Jordan Nwora",0,1,3,2,3,4.2
"7508",525,0,0,0,0,0,0,0,0,0,4,0,0,0,0,0,0,1038125,"2024-01-12T00:00:00.000Z",56677861,12,"Ben Sheppard",0,0,0,0,0,0
"7509",526,1,0,3,3,1,16,7,2,0,37,7,3,15,10,2,2,1037800,"2023-11-22T00:00:00.000Z",177,8,"Aaron Gordon",2,25,26,16,11,32.5
"7510",527,0,0,0,0,0,0,0,0,0,0,0,0,0,0,0,0,1037799,"2023-11-22T00:00:00.000Z",3547253,4,"Theo Maledon",0,0,0,0,0,0
"7511",528,1,0,6,2,2,7,4,3,3,21,1,4,13,7,0,3,1037800,"2023-11-22T00:00:00.000Z",38017709,8,"Christian Braun",0,20,21,14,8,19.9
"7512",529,2,0,1,4,1,6,2,2,2,17,1,5,7,2,0,0,1037800,"2023-11-22T00:00:00.000Z",56677776,8,"Julian Strawther",0,9,11,9,4,12.4
"7513",530,0,0,1,3,0,4,0,0,0,8,0,0,0,1,0,1,1037800,"2023-11-22T00:00:00.000Z",56677582,8,"Jalen Pickett",0,1,1,0,1,0.2
"7514",531,0,0,0,0,0,1,1,2,0,10,1,1,2,1,0,0,1037800,"2023-11-22T00:00:00.000Z",38017721,8,"Peyton Watson",0,3,3,2,1,3.2
"7515",532,2,0,0,0,0,2,1,2,1,12,1,1,3,1,0,0,1037800,"2023-11-22T00:00:00.000Z",3547268,8,"Zeke Nnaji",0,4,6,5,3,7.2
"7516",533,0,0,0,0,0,0,0,0,0,0,0,0,0,0,0,0,1037800,"2023-11-22T00:00:00.000Z",215,8,"Justin Holiday",0,0,0,0,0,0
"7517",534,0,0,0,0,0,0,0,0,0,0,0,0,0,0,0,0,1037800,"2023-11-22T00:00:00.000Z",38017727,8,"Collin Gillespie",0,0,0,0,0,0
"7518",535,0,0,0,0,0,0,0,0,0,0,0,0,0,0,0,0,1037800,"2023-11-22T00:00:00.000Z",250,8,"DeAndre Jordan",0,0,0,0,0,0
"7519",536,0,0,0,0,0,0,0,0,0,0,0,0,0,0,0,0,1037800,"2023-11-22T00:00:00.000Z",17896007,8,"Braxton Key",0,0,0,0,0,0
"7520",537,0,0,0,0,0,0,0,0,0,0,0,0,0,0,0,0,1037800,"2023-11-22T00:00:00.000Z",56677871,8,"Hunter Tyson",0,0,0,0,0,0
"7521",538,0,0,0,0,0,0,0,0,0,0,0,0,0,0,0,0,1037800,"2023-11-22T00:00:00.000Z",666489,8,"Vlatko Cancar",0,0,0,0,0,0
"7522",539,0,0,6,0,0,6,2,0,0,21,1,2,4,7,0,0,1037802,"2023-11-22T00:00:00.000Z",377,17,"Bobby Portis",0,11,11,4,7,12.4
"7523",540,2,0,0,3,1,5,1,0,0,10,0,0,3,0,0,0,1037802,"2023-11-22T00:00:00.000Z",368,17,"Cameron Payne",0,3,5,5,2,6
"7524",541,0,0,0,0,0,0,0,0,0,0,0,0,0,0,0,0,1037802,"2023-11-22T00:00:00.000Z",666453,17,"Marques Bolden",0,0,0,0,0,0
"7525",542,0,0,0,0,0,0,0,0,0,0,0,0,0,0,0,0,1037802,"2023-11-22T00:00:00.000Z",112,17,"Jae Crowder",0,0,0,0,0,0
"7526",543,0,0,0,0,0,0,0,0,0,0,0,0,0,0,0,0,1037802,"2023-11-22T00:00:00.000Z",38017691,17,"TyTy Washington Jr.",0,0,0,0,0,0
"7527",544,0,0,0,0,0,0,0,0,0,0,0,0,0,0,0,0,1037802,"2023-11-22T00:00:00.000Z",666960,17,"Lindell Wigginton",0,0,0,0,0,0
"7528",545,1,0,4,3,1,5,2,0,0,23,0,1,5,4,0,0,1037799,"2023-11-22T00:00:00.000Z",18678001,4,"JT Thor",0,9,10,6,5,11.3
"7529",546,0,0,0,0,0,1,1,0,0,1,0,1,2,0,0,0,1037799,"2023-11-22T00:00:00.000Z",56677846,4,"Nick Smith Jr.",0,2,2,2,0,2
"7530",547,0,0,0,0,0,0,0,0,0,0,0,0,0,0,0,0,1037799,"2023-11-22T00:00:00.000Z",666950,4,"P.J. Washington",0,0,0,0,0,0
"7531",548,0,0,0,0,0,0,0,0,0,0,0,0,0,0,0,0,1037799,"2023-11-22T00:00:00.000Z",56677848,4,"Amari Bailey",0,0,0,0,0,0
"7532",549,0,0,0,0,0,0,0,0,0,0,0,0,0,0,0,0,1037799,"2023-11-22T00:00:00.000Z",56677866,4,"Leaky Black",0,0,0,0,0,0
"7533",550,0,0,0,0,0,0,0,0,0,0,0,0,0,0,0,0,1037799,"2023-11-22T00:00:00.000Z",666748,4,"Cody Martin",0,0,0,0,0,0
"7534",551,0,0,0,0,0,0,0,0,0,0,0,0,0,0,0,0,1037988,"2023-12-23T00:00:00.000Z",27,5,"Lonzo Ball",0,0,0,0,0,0
"7535",552,0,0,0,0,0,0,0,0,0,0,0,0,0,0,0,0,1037988,"2023-12-23T00:00:00.000Z",56677874,5,"Onuralp Bitim",0,0,0,0,0,0
"7536",554,0,0,0,0,0,0,0,0,0,0,0,0,0,0,0,0,1037988,"2023-12-23T00:00:00.000Z",268,5,"Zach LaVine",0,0,0,0,0,0
"7537",555,0,0,0,0,0,0,0,0,0,0,0,0,0,0,0,0,1037988,"2023-12-23T00:00:00.000Z",56677860,5,"Adama Sanogo",0,0,0,0,0,0
"7538",556,3,0,3,5,0,9,3,7,6,34,0,2,12,3,0,1,1037988,"2023-12-23T00:00:00.000Z",3547247,6,"Isaac Okoro",0,15,18,15,6,19.1
"7539",557,1,0,6,10,3,12,4,0,0,36,1,1,11,7,2,1,1037988,"2023-12-23T00:00:00.000Z",666940,6,"Dean Wade",2,18,19,12,8,25.9
"7540",558,7,1,9,1,0,9,6,10,7,35,8,0,19,17,1,0,1037988,"2023-12-23T00:00:00.000Z",9,6,"Jarrett Allen",2,36,43,26,24,55.9
"7541",559,7,1,1,17,5,22,9,3,3,41,0,2,26,1,2,3,1037988,"2023-12-23T00:00:00.000Z",666908,6,"Max Strus",3,27,34,33,8,43.7
"7542",560,8,1,6,3,1,14,8,5,2,39,1,1,19,7,1,3,1037988,"2023-12-23T00:00:00.000Z",56677872,6,"Craig Porter",2,26,34,27,15,42.4
"7543",561,0,0,4,5,1,12,3,0,0,21,1,4,7,5,0,2,1037988,"2023-12-23T00:00:00.000Z",344,6,"Georges Niang",0,12,12,7,5,11
"7544",562,0,1,0,2,1,2,1,0,0,9,0,0,3,0,0,0,1037988,"2023-12-23T00:00:00.000Z",56677847,6,"Emoni Bates",1,3,3,3,0,6
"7545",563,1,0,2,2,1,4,2,1,1,12,0,5,6,2,1,1,1037988,"2023-12-23T00:00:00.000Z",248,6,"Damian Jones",1,8,9,7,3,11.9
"7546",564,0,0,0,0,0,0,0,0,0,0,0,0,0,0,0,0,1037988,"2023-12-23T00:00:00.000Z",277,6,"Caris LeVert",0,0,0,0,0,0
"7547",565,0,0,0,0,0,0,0,0,0,0,0,0,0,0,0,0,1037988,"2023-12-23T00:00:00.000Z",3547299,6,"Sam Merrill",0,0,0,0,0,0
"7548",566,0,0,0,0,0,0,0,0,0,0,0,0,0,0,0,0,1037988,"2023-12-23T00:00:00.000Z",38017662,6,"Isaiah Mobley",0,0,0,0,0,0
"7549",567,0,1,2,2,0,2,0,0,0,5,0,1,0,2,0,3,1037990,"2023-12-23T00:00:00.000Z",56677873,7,"Dexter Dennis",1,2,2,0,2,2.4
"7550",568,0,1,0,0,0,1,0,0,0,5,0,1,0,0,0,2,1037990,"2023-12-23T00:00:00.000Z",17896028,7,"Greg Brown III",1,0,0,0,0,1
"7551",569,0,0,0,0,0,0,0,0,0,0,0,0,0,0,0,0,1037990,"2023-12-23T00:00:00.000Z",114,7,"Seth Curry",0,0,0,0,0,0
"7552",570,0,0,0,0,0,0,0,0,0,0,0,0,0,0,0,0,1037990,"2023-12-23T00:00:00.000Z",217,7,"Richaun Holmes",0,0,0,0,0,0
"7553",571,1,0,1,0,0,0,0,0,0,3,1,1,0,2,0,0,1037989,"2023-12-23T00:00:00.000Z",24572055,21,"Olivier Sarr",0,2,3,1,3,3.9
"7554",572,0,0,0,0,0,0,0,0,0,0,0,0,0,0,0,0,1037989,"2023-12-23T00:00:00.000Z",4197029,21,"Vasilije Micic",0,0,0,0,0,0
"7555",573,0,0,0,0,0,0,0,0,0,0,0,0,0,0,0,0,1037989,"2023-12-23T00:00:00.000Z",27924547,21,"Lindy Waters III",0,0,0,0,0,0
"7556",574,7,2,5,5,5,20,13,9,9,37,2,0,40,7,2,3,1037989,"2023-12-23T00:00:00.000Z",237,14,"LeBron James",4,47,54,47,14,67.9
"7557",575,10,0,3,5,2,8,4,1,1,28,0,3,11,3,0,1,1037989,"2023-12-23T00:00:00.000Z",17553995,14,"Austin Reaves",0,14,24,21,13,28.6
"7558",576,6,0,6,2,2,4,3,2,2,25,1,2,10,7,1,1,1037661,"2023-11-02T00:00:00.000Z",38017677,19,"Dyson Daniels",1,17,23,16,13,29.4
"7559",577,1,0,0,0,0,2,0,0,0,14,0,1,0,0,0,1,1037660,"2023-11-02T00:00:00.000Z",56677828,28,"Gradey Dick",0,0,1,1,1,0.5
"7560",578,1,0,2,3,2,5,2,0,0,17,1,2,6,3,2,1,1037660,"2023-11-02T00:00:00.000Z",3547275,28,"Malachi Flynn",2,9,10,7,4,16.1
"7561",579,0,1,2,2,0,4,2,2,2,13,2,3,6,4,0,1,1037660,"2023-11-02T00:00:00.000Z",58,28,"Chris Boucher",1,10,10,6,4,12.8
"7562",580,5,0,3,5,2,21,9,2,1,38,1,4,21,4,4,2,1037662,"2023-11-02T00:00:00.000Z",17896026,22,"Franz Wagner",4,25,30,26,9,43.3
"7563",581,5,2,7,2,1,13,9,15,11,36,2,4,30,9,3,6,1037662,"2023-11-02T00:00:00.000Z",38017683,22,"Paolo Banchero",5,39,44,35,14,57.3
"7564",582,2,1,8,6,3,12,5,2,1,29,2,4,14,10,0,2,1037662,"2023-11-02T00:00:00.000Z",85,22,"Wendell Carter Jr.",1,24,26,16,12,30
"7565",583,1,1,0,2,0,2,0,0,0,14,0,1,0,0,0,0,1037662,"2023-11-02T00:00:00.000Z",196,22,"Gary Harris",1,0,1,1,1,4.5
"7566",584,3,0,2,0,0,7,1,4,4,21,2,4,6,4,4,3,1037662,"2023-11-02T00:00:00.000Z",17896073,22,"Jalen Suggs",4,10,13,9,7,24.3
"7567",585,1,0,1,4,1,5,1,2,1,24,1,0,4,2,0,0,1037662,"2023-11-02T00:00:00.000Z",226,22,"Joe Ingles",0,6,7,5,3,7.9
"7568",586,9,0,2,4,2,8,4,0,0,39,3,4,10,5,1,0,1037661,"2023-11-02T00:00:00.000Z",3547241,9,"Killian Hayes",1,15,24,19,14,32.5
"7569",587,11,0,2,7,2,22,8,5,4,34,0,4,22,2,1,6,1037661,"2023-11-02T00:00:00.000Z",17896075,9,"Cade Cunningham",1,24,35,33,13,37.9
"7570",588,3,0,1,8,5,10,6,2,2,23,1,2,19,2,1,0,1037661,"2023-11-02T00:00:00.000Z",56677792,9,"Marcus Sasser",1,21,24,22,5,28.9
"7571",589,0,1,4,3,1,6,4,4,3,21,3,4,12,7,0,2,1037661,"2023-11-02T00:00:00.000Z",38017682,9,"Jaden Ivey",1,19,19,12,7,21.4
"7572",590,0,1,5,0,0,7,3,0,0,13,4,0,6,9,0,1,1037661,"2023-11-02T00:00:00.000Z",24,9,"Marvin Bagley III",1,15,15,6,9,18.8
"7573",591,1,0,2,6,2,8,3,0,0,24,1,4,8,3,1,1,1037661,"2023-11-02T00:00:00.000Z",197,9,"Joe Harris",1,11,12,9,4,15.1
"7574",592,0,0,0,1,0,1,0,0,0,1,0,0,0,0,0,0,1037661,"2023-11-02T00:00:00.000Z",44477024,9,"Stanley Umude",0,0,0,0,0,0
"7575",593,0,0,0,0,0,0,0,0,0,0,0,0,0,0,0,0,1037661,"2023-11-02T00:00:00.000Z",56677729,9,"Malcolm Cazalon",0,0,0,0,0,0
"7576",594,0,0,0,0,0,0,0,0,0,0,0,0,0,0,0,0,1037661,"2023-11-02T00:00:00.000Z",42097199,9,"Jared Rhoden",0,0,0,0,0,0
"7577",595,1,0,2,6,3,8,5,0,0,23,0,1,13,2,1,0,1037663,"2023-11-02T00:00:00.000Z",359,27,"Cedi Osman",1,15,16,14,3,19.9
"7578",596,10,0,4,4,2,8,3,4,4,28,1,3,12,5,1,1,1037663,"2023-11-02T00:00:00.000Z",3547274,27,"Tre Jones",1,17,27,22,15,35
"7579",597,0,0,0,3,2,4,2,0,0,16,0,0,6,0,1,0,1037663,"2023-11-02T00:00:00.000Z",305,27,"Doug McDermott",1,6,6,6,0,9
"7580",598,0,0,0,0,0,0,0,0,0,0,0,0,0,0,0,0,1037663,"2023-11-02T00:00:00.000Z",38017649,27,"Julian Champagnie",0,0,0,0,0,0
"7581",599,0,0,0,0,0,0,0,0,0,0,0,0,0,0,0,0,1037663,"2023-11-02T00:00:00.000Z",180,27,"Devonte' Graham",0,0,0,0,0,0
"7582",600,0,0,0,0,0,0,0,0,0,0,0,0,0,0,0,0,1037663,"2023-11-02T00:00:00.000Z",17896059,27,"Sandro Mamukelashvili",0,0,0,0,0,0
"7583",601,0,0,0,0,0,0,0,0,0,0,0,0,0,0,0,0,7049323,"2023-12-06T00:00:00.000Z",56677582,8,"Jalen Pickett",0,0,0,0,0,0
"7584",602,0,0,0,0,0,0,0,0,0,0,0,0,0,0,0,0,7049321,"2023-12-06T00:00:00.000Z",19465584,29,"Micah Potter",0,0,0,0,0,0
"7585",603,0,0,0,0,0,0,0,0,0,0,0,0,0,0,0,0,7049321,"2023-12-06T00:00:00.000Z",56677842,29,"Brice Sensabaugh",0,0,0,0,0,0
"7586",604,1,1,4,2,0,8,4,2,1,16,4,1,9,8,0,1,7049323,"2023-12-06T00:00:00.000Z",472,13,"Russell Westbrook",1,17,18,10,9,22.1
"7587",605,0,3,6,4,2,8,3,0,0,21,5,2,8,11,0,1,7049323,"2023-12-06T00:00:00.000Z",439,13,"Daniel Theis",3,19,19,8,11,29.2
"7588",606,2,0,4,3,1,12,5,6,6,31,0,0,17,4,1,1,7049323,"2023-12-06T00:00:00.000Z",380,13,"Norman Powell",1,21,23,19,6,26.8
"7589",607,0,0,0,0,0,0,0,0,0,0,0,0,0,0,0,0,7049323,"2023-12-06T00:00:00.000Z",17896031,13,"Nah'Shon Hyland",0,0,0,0,0,0
"7590",608,0,0,0,0,0,0,0,0,0,0,0,0,0,0,0,0,7049323,"2023-12-06T00:00:00.000Z",450,13,"PJ Tucker",0,0,0,0,0,0
"7591",609,0,0,0,0,0,0,0,0,0,0,0,0,0,0,0,0,7049323,"2023-12-06T00:00:00.000Z",17896022,13,"Brandon Boston Jr.",0,0,0,0,0,0
"7592",610,0,0,0,0,0,0,0,0,0,0,0,0,0,0,0,0,7049323,"2023-12-06T00:00:00.000Z",38017725,13,"Moussa Diabate",0,0,0,0,0,0
"7593",611,0,0,0,0,0,0,0,0,0,0,0,0,0,0,0,0,7049323,"2023-12-06T00:00:00.000Z",56677856,13,"Jordan Miller",0,0,0,0,0,0
"7594",612,0,0,0,0,0,0,0,0,0,0,0,0,0,0,0,0,7049323,"2023-12-06T00:00:00.000Z",24417679,13,"Xavier Moon",0,0,0,0,0,0
"7595",613,0,0,0,0,0,0,0,0,0,0,0,0,0,0,0,0,7049323,"2023-12-06T00:00:00.000Z",371,13,"Mason Plumlee",0,0,0,0,0,0
"7596",614,0,0,0,0,0,0,0,0,0,0,0,0,0,0,0,0,7049323,"2023-12-06T00:00:00.000Z",17896051,13,"Joshua Primo",0,0,0,0,0,0
"7597",615,0,1,6,5,4,8,7,0,0,34,3,2,18,9,0,2,7049323,"2023-12-06T00:00:00.000Z",375,8,"Michael Porter Jr.",1,27,27,18,9,29.8
"7598",616,2,0,4,0,0,8,4,0,0,31,1,2,8,5,2,0,7049323,"2023-12-06T00:00:00.000Z",177,8,"Aaron Gordon",2,13,15,10,7,23
"7599",617,10,0,10,7,2,32,9,2,2,37,5,2,22,15,1,4,7049323,"2023-12-06T00:00:00.000Z",246,8,"Nikola Jokic",1,37,47,32,25,54
"7600",618,0,0,0,0,0,0,0,0,0,0,0,0,0,0,0,0,7049322,"2023-12-06T00:00:00.000Z",476,25,"Robert Williams III",0,0,0,0,0,0
"7601",619,0,0,0,0,0,0,0,0,0,0,0,0,0,0,0,0,7049322,"2023-12-06T00:00:00.000Z",45658838,10,"Lester Quinones",0,0,0,0,0,0
"7602",620,0,0,0,0,0,0,0,0,0,0,0,0,0,0,0,0,7049322,"2023-12-06T00:00:00.000Z",398,10,"Jerome Robinson",0,0,0,0,0,0
"7603",621,0,0,0,0,0,0,0,0,0,0,0,0,0,0,0,0,7049322,"2023-12-06T00:00:00.000Z",57875092,10,"Gui Santos",0,0,0,0,0,0
"7604",622,5,0,6,9,4,18,10,4,2,42,0,1,26,6,0,1,7049322,"2023-12-06T00:00:00.000Z",38017690,25,"Shaedon Sharpe",0,32,37,31,11,39.7
"7605",623,2,0,8,4,0,14,3,0,0,27,5,6,6,13,0,3,7049322,"2023-12-06T00:00:00.000Z",56677850,25,"Toumani Camara",0,19,21,8,15,21.6
"7606",624,2,1,5,5,1,6,2,6,5,22,1,5,10,6,1,0,7049322,"2023-12-06T00:00:00.000Z",56783340,25,"Duop Reath",2,16,18,12,8,26.2
"7607",625,4,0,0,13,6,27,10,2,2,37,1,3,28,1,0,1,7049322,"2023-12-06T00:00:00.000Z",419,25,"Anfernee Simons",0,29,33,32,5,34.2
"7608",626,1,0,1,2,1,2,1,0,0,3,0,0,3,1,0,0,1038077,"2024-01-05T00:00:00.000Z",68,18,"Troy Brown Jr.",0,4,5,4,2,5.7
"7609",627,0,0,0,2,0,4,1,0,0,3,1,1,2,1,0,1,1038077,"2024-01-05T00:00:00.000Z",17896056,18,"Luka Garza",0,3,3,2,1,2.2
"7610",628,0,1,2,0,0,0,0,0,0,3,0,0,0,2,0,0,1038077,"2024-01-05T00:00:00.000Z",38017700,18,"Wendell Moore Jr.",1,2,2,0,2,5.4
"7611",629,0,0,0,0,0,0,0,2,2,3,0,0,2,0,0,0,1038077,"2024-01-05T00:00:00.000Z",38017715,18,"Josh Minott",0,2,2,2,0,2
"7612",630,0,0,0,0,0,0,0,0,0,0,0,0,0,0,0,0,1038077,"2024-01-05T00:00:00.000Z",56677782,18,"Leonard Miller",0,0,0,0,0,0
"7613",631,0,0,0,0,0,0,0,0,0,0,0,0,0,0,0,0,1038077,"2024-01-05T00:00:00.000Z",56677851,18,"Jaylen Clark",0,0,0,0,0,0
"7614",632,0,0,0,0,0,0,0,0,0,0,0,0,0,0,0,0,1038075,"2024-01-05T00:00:00.000Z",56677795,20,"Jacob Toppin",0,0,0,0,0,0
"7615",633,0,0,0,0,0,0,0,0,0,0,0,0,0,0,0,0,1038075,"2024-01-05T00:00:00.000Z",17896089,20,"Duane Washington Jr.",0,0,0,0,0,0
"7616",634,0,0,0,0,0,0,0,0,0,0,0,0,0,0,0,0,1038088,"2024-01-06T00:00:00.000Z",66,11,"Dillon Brooks",0,0,0,0,0,0
"7617",635,0,0,0,0,0,0,0,0,0,0,0,0,0,0,0,0,1038088,"2024-01-06T00:00:00.000Z",38017695,11,"Tari Eason",0,0,0,0,0,0
"7618",636,0,0,0,0,0,0,0,0,0,0,0,0,0,0,0,0,1038088,"2024-01-06T00:00:00.000Z",3547281,11,"Nate Hinton",0,0,0,0,0,0
"7619",637,0,0,0,0,0,0,0,0,0,0,0,0,0,0,0,0,1038088,"2024-01-06T00:00:00.000Z",357,11,"Victor Oladipo",0,0,0,0,0,0
"7620",638,0,0,0,0,0,0,0,0,0,0,0,0,0,0,0,0,1038088,"2024-01-06T00:00:00.000Z",56677809,11,"Jermaine Samuels Jr.",0,0,0,0,0,0
"7621",639,0,0,0,0,0,0,0,0,0,0,0,0,0,0,0,0,1038088,"2024-01-06T00:00:00.000Z",47738533,11,"Jeenathan Williams",0,0,0,0,0,0
"7622",640,5,0,3,5,0,9,3,6,4,33,0,5,10,3,1,3,1038088,"2024-01-06T00:00:00.000Z",315,17,"Khris Middleton",1,13,18,15,8,21.1
"7623",642,0,0,0,0,0,0,0,0,0,0,0,0,0,0,0,0,1038076,"2024-01-05T00:00:00.000Z",56677860,5,"Adama Sanogo",0,0,0,0,0,0
"7624",643,0,0,0,0,0,0,0,0,0,0,0,0,0,0,0,0,1038076,"2024-01-05T00:00:00.000Z",3547248,5,"Patrick Williams",0,0,0,0,0,0
"7625",644,2,0,3,7,3,11,5,0,0,36,2,4,13,5,2,1,1038076,"2024-01-05T00:00:00.000Z",666748,4,"Cody Martin",2,18,20,15,7,27
"7626",645,2,0,5,7,3,18,12,2,1,42,0,1,28,5,0,2,1038076,"2024-01-05T00:00:00.000Z",62,4,"Miles Bridges",0,33,35,30,7,35
"7627",646,1,0,7,0,0,6,2,2,0,27,5,4,4,12,0,2,1038076,"2024-01-05T00:00:00.000Z",3547282,4,"Nick Richards",0,16,17,5,13,17.9
"7628",647,1,0,3,7,1,13,3,2,2,23,0,3,9,3,1,0,1038076,"2024-01-05T00:00:00.000Z",56677823,4,"Brandon Miller",1,12,13,10,4,17.1
"7629",648,7,0,3,7,1,17,5,4,4,36,1,2,15,4,1,3,1038076,"2024-01-05T00:00:00.000Z",403,4,"Terry Rozier",1,19,26,22,11,30.3
"7630",649,4,0,1,2,0,9,3,0,0,16,1,1,6,2,1,0,1038076,"2024-01-05T00:00:00.000Z",422,4,"Ish Smith",1,8,12,10,6,17.4
"7631",650,2,0,2,1,0,2,0,0,0,6,1,0,0,3,0,0,1038076,"2024-01-05T00:00:00.000Z",666950,4,"P.J. Washington",0,3,5,2,5,6.6
"7632",651,0,0,0,3,1,4,2,0,0,15,1,3,5,1,1,1,1037752,"2023-11-15T00:00:00.000Z",338,2,"Svi Mykhailiuk",1,6,6,5,1,8.2
"7633",652,3,0,2,1,1,9,6,0,0,20,2,2,13,4,0,1,1037755,"2023-11-15T00:00:00.000Z",147,24,"Drew Eubanks",0,17,20,16,7,21.3
"7634",653,3,0,2,4,1,6,1,0,0,23,0,1,3,2,0,0,1037755,"2023-11-15T00:00:00.000Z",470,24,"Yuta Watanabe",0,5,8,6,5,9.9
"7635",654,1,0,1,0,0,1,1,0,0,13,1,1,2,2,0,0,1037755,"2023-11-15T00:00:00.000Z",32,24,"Keita Bates-Diop",0,4,5,3,3,5.9
"7636",655,3,1,3,1,1,1,1,0,0,16,0,2,3,3,1,0,1037755,"2023-11-15T00:00:00.000Z",18678058,24,"Jordan Goodwin",2,6,9,6,6,17.1
"7637",656,0,0,2,1,0,4,2,0,0,4,0,2,4,2,0,1,1037755,"2023-11-15T00:00:00.000Z",314,24,"Chimezie Metu",0,6,6,4,2,5.4
"7638",657,0,0,0,0,0,1,1,0,0,3,0,1,2,0,0,0,1037755,"2023-11-15T00:00:00.000Z",666729,24,"Nassir Little",0,2,2,2,0,2
"7639",658,0,0,0,0,0,0,0,0,0,0,0,0,0,0,0,0,1037755,"2023-11-15T00:00:00.000Z",3547095,24,"Udoka Azubuike",0,0,0,0,0,0
"7640",659,0,0,0,0,0,0,0,0,0,0,0,0,0,0,0,0,1037755,"2023-11-15T00:00:00.000Z",666451,24,"Bol Bol",0,0,0,0,0,0
"7641",660,0,0,0,0,0,0,0,0,0,0,0,0,0,0,0,0,1037755,"2023-11-15T00:00:00.000Z",3547298,24,"Saben Lee",0,0,0,0,0,0
"7642",661,0,0,0,0,0,0,0,0,0,0,0,0,0,0,0,0,1037755,"2023-11-15T00:00:00.000Z",37,24,"Bradley Beal",0,0,0,0,0,0
"7643",662,2,0,3,6,1,17,7,2,2,32,0,2,17,3,2,3,1037757,"2023-11-15T00:00:00.000Z",182,25,"Jerami Grant",2,20,22,19,5,26.6
"7644",663,3,0,1,3,0,4,0,0,0,22,0,1,0,1,2,1,1037757,"2023-11-15T00:00:00.000Z",56677850,25,"Toumani Camara",2,1,4,3,4,10.7
"7645",664,0,0,4,0,0,10,3,0,0,26,2,3,6,6,0,2,1037757,"2023-11-15T00:00:00.000Z",22,25,"Deandre Ayton",0,12,12,6,6,11.2
"7646",665,5,0,4,5,1,12,2,7,6,27,3,3,11,7,0,0,1037757,"2023-11-15T00:00:00.000Z",38017690,25,"Shaedon Sharpe",0,18,23,16,12,26.9
"7647",666,4,0,1,4,2,13,4,3,3,31,0,4,13,1,1,2,1037757,"2023-11-15T00:00:00.000Z",3547289,25,"Skylar Mays",1,14,18,17,5,21.2
"7648",667,0,0,2,3,0,6,1,0,0,9,0,1,2,2,0,0,1037757,"2023-11-15T00:00:00.000Z",44477062,25,"Jamaree Bouyea",0,4,4,2,2,4.4
"7649",668,3,0,0,5,2,10,6,2,2,20,2,2,16,2,0,1,1037757,"2023-11-15T00:00:00.000Z",56783340,25,"Duop Reath",0,18,21,19,5,21.9
"7650",669,3,0,2,3,1,5,2,0,0,17,0,1,5,2,1,0,1037757,"2023-11-15T00:00:00.000Z",56677791,25,"Kris Murray",1,7,10,8,5,14.9
"7651",670,0,0,0,0,0,0,0,0,0,2,0,0,0,0,0,0,1037757,"2023-11-15T00:00:00.000Z",47957121,25,"Justin Minaya",0,0,0,0,0,0
"7652",671,0,0,0,0,0,0,0,0,0,0,0,0,0,0,0,0,1037757,"2023-11-15T00:00:00.000Z",666476,25,"Moses Brown",0,0,0,0,0,0
"7653",672,0,0,0,0,0,0,0,0,0,0,0,0,0,0,0,0,1037753,"2023-11-15T00:00:00.000Z",38017717,28,"Ron Harper Jr.",0,0,0,0,0,0
"7654",673,0,0,0,0,0,0,0,0,0,0,0,0,0,0,0,0,1037753,"2023-11-15T00:00:00.000Z",38017710,28,"Christian Koloko",0,0,0,0,0,0
"7655",674,0,0,0,0,0,0,0,0,0,0,0,0,0,0,0,0,1037753,"2023-11-15T00:00:00.000Z",3089,28,"Gary Trent Jr.",0,0,0,0,0,0
"7656",675,4,0,4,2,1,9,5,0,0,20,1,3,11,5,2,4,1037753,"2023-11-15T00:00:00.000Z",315,17,"Khris Middleton",2,16,20,15,9,25
"7657",676,3,1,2,7,5,23,12,3,3,37,2,1,32,4,1,3,1037949,"2023-12-18T00:00:00.000Z",17896048,3,"Cam Thomas",2,36,39,35,7,44.3
"7658",677,11,2,7,6,1,15,7,3,2,36,1,0,17,8,0,1,1037949,"2023-12-18T00:00:00.000Z",130,3,"Spencer Dinwiddie",2,25,36,28,19,48.1
"7659",678,3,0,0,5,2,7,2,0,0,21,2,4,6,2,1,0,1037949,"2023-12-18T00:00:00.000Z",158,3,"Dorian Finney-Smith",1,8,11,9,5,15.9
"7660",679,0,0,0,0,0,0,0,0,0,0,0,0,0,0,0,0,1037951,"2023-12-18T00:00:00.000Z",486,14,"Christian Wood",0,0,0,0,0,0
"7661",680,0,0,0,0,0,0,0,0,0,0,0,0,0,0,0,0,1037951,"2023-12-18T00:00:00.000Z",56677738,14,"Colin Castleton",0,0,0,0,0,0
"7662",681,0,0,0,0,0,0,0,0,0,0,0,0,0,0,0,0,1037951,"2023-12-18T00:00:00.000Z",56677867,14,"Alex Fudge",0,0,0,0,0,0
"7663",682,0,0,0,0,0,0,0,0,0,0,0,0,0,0,0,0,1037951,"2023-12-18T00:00:00.000Z",56677868,14,"D'Moi Hodge",0,0,0,0,0,0
"7664",683,0,0,0,0,0,0,0,0,0,0,0,0,0,0,0,0,1037951,"2023-12-18T00:00:00.000Z",56677835,14,"Jalen Hood-Schifino",0,0,0,0,0,0
"7665",684,0,0,0,0,0,0,0,0,0,0,0,0,0,0,0,0,1037951,"2023-12-18T00:00:00.000Z",1603383,14,"Gabe Vincent",0,0,0,0,0,0
"7666",685,4,1,4,2,0,10,3,6,6,30,1,2,12,5,0,1,1037951,"2023-12-18T00:00:00.000Z",666423,20,"RJ Barrett",1,17,21,16,9,26
"7667",686,3,0,13,4,1,22,12,2,2,43,1,3,27,14,0,2,1037951,"2023-12-18T00:00:00.000Z",387,20,"Julius Randle",0,41,44,30,17,46.3
"7668",687,0,0,0,0,0,0,0,0,0,4,0,2,0,0,0,0,1037951,"2023-12-18T00:00:00.000Z",17896063,20,"Jericho Sims",0,0,0,0,0,0
"7669",688,3,1,1,4,2,5,3,0,0,19,0,1,8,1,0,1,1037951,"2023-12-18T00:00:00.000Z",131,20,"Donte DiVincenzo",1,9,12,11,4,15.7
"7670",689,3,1,3,6,3,21,10,6,6,37,1,0,29,4,1,4,1037951,"2023-12-18T00:00:00.000Z",73,20,"Jalen Brunson",2,33,36,32,7,40.3
"7671",690,2,2,10,0,0,4,3,6,3,39,7,3,9,17,2,1,1037951,"2023-12-18T00:00:00.000Z",201,20,"Isaiah Hartenstein",4,26,28,11,19,43.4
"7672",691,2,1,5,3,0,6,2,2,2,22,0,1,6,5,0,4,1037951,"2023-12-18T00:00:00.000Z",202,20,"Josh Hart",1,11,13,8,7,14
"7673",692,2,0,3,7,3,15,8,1,1,29,0,2,20,3,1,1,1037951,"2023-12-18T00:00:00.000Z",3547269,20,"Immanuel Quickley",1,23,25,22,5,28.6
"7674",693,2,0,0,4,1,5,1,0,0,11,0,0,3,0,1,0,1037951,"2023-12-18T00:00:00.000Z",17895858,20,"Quentin Grimes",1,3,5,5,2,9
"7675",694,0,0,2,0,0,0,0,0,0,6,1,2,0,3,0,1,1037951,"2023-12-18T00:00:00.000Z",173,20,"Taj Gibson",0,3,3,0,3,2.6
"7676",695,0,0,0,0,0,0,0,0,0,0,0,0,0,0,0,0,1037951,"2023-12-18T00:00:00.000Z",19,20,"Ryan Arcidiacono",0,0,0,0,0,0
"7677",696,0,0,0,0,0,0,0,0,0,0,0,0,0,0,0,0,1037951,"2023-12-18T00:00:00.000Z",160,20,"Evan Fournier",0,0,0,0,0,0
"7678",697,0,0,0,0,0,0,0,0,0,0,0,0,0,0,0,0,1037951,"2023-12-18T00:00:00.000Z",666675,20,"DaQuan Jeffries",0,0,0,0,0,0
"7679",698,0,0,0,0,0,0,0,0,0,0,0,0,0,0,0,0,1037951,"2023-12-18T00:00:00.000Z",17896033,20,"Miles McBride",0,0,0,0,0,0
"7680",699,0,0,0,0,0,0,0,0,0,0,0,0,0,0,0,0,1037951,"2023-12-18T00:00:00.000Z",666474,20,"Charles Brown",0,0,0,0,0,0
"7681",700,6,0,3,1,1,18,11,12,11,37,1,4,34,4,2,2,1037952,"2023-12-19T00:00:00.000Z",227,19,"Brandon Ingram",2,38,44,40,10,51.8
"7682",701,0,0,0,0,0,0,0,0,0,0,0,0,0,0,0,0,1037630,"2023-10-29T00:00:00.000Z",192,23,"James Harden",0,0,0,0,0,0
"7683",702,0,0,0,0,0,0,0,0,0,0,0,0,0,0,0,0,1037630,"2023-10-29T00:00:00.000Z",17554001,23,"Javonte Smart",0,0,0,0,0,0
"7684",703,0,0,0,0,0,0,0,0,0,0,0,0,0,0,0,0,1037630,"2023-10-29T00:00:00.000Z",56677788,23,"Terquavion Smith",0,0,0,0,0,0
"7685",704,0,0,0,2,0,3,1,0,0,11,0,1,2,0,0,0,1037630,"2023-10-29T00:00:00.000Z",666923,25,"Matisse Thybulle",0,2,2,2,0,2
"7686",705,1,2,3,4,1,16,5,7,6,28,2,2,17,5,0,2,1037630,"2023-10-29T00:00:00.000Z",182,25,"Jerami Grant",2,22,23,18,6,28.5
"7687",706,2,1,7,0,0,7,3,1,1,20,2,3,7,9,2,0,1037630,"2023-10-29T00:00:00.000Z",22,25,"Deandre Ayton",3,16,18,9,11,29.8
"7688",707,1,1,6,3,2,10,6,0,0,26,1,4,14,7,2,2,1037629,"2023-10-29T00:00:00.000Z",17896040,1,"Jalen Johnson",3,21,22,15,8,30.9
"7689",708,1,0,10,0,0,10,5,2,2,23,2,1,12,12,1,0,1037629,"2023-10-29T00:00:00.000Z",83,1,"Clint Capela",1,24,25,13,13,30.9
"7690",709,1,0,2,3,1,8,3,3,2,19,0,4,9,2,1,3,1037628,"2023-10-29T00:00:00.000Z",17553979,10,"Jonathan Kuminga",1,11,12,10,3,12.9
"7691",710,7,0,5,3,0,8,3,2,2,27,0,1,8,5,1,1,1037628,"2023-10-29T00:00:00.000Z",367,10,"Chris Paul",1,13,20,15,12,26.5
"7692",711,1,1,4,4,3,8,6,0,0,19,0,1,15,4,3,0,1037628,"2023-10-29T00:00:00.000Z",2189,10,"Gary Payton II",4,19,20,16,5,33.3
"7693",712,5,1,5,3,1,6,1,2,1,21,3,0,4,8,0,1,1037628,"2023-10-29T00:00:00.000Z",407,10,"Dario Saric",1,12,17,9,13,23.1
"7694",713,1,1,3,5,1,6,1,2,2,18,0,1,5,3,0,0,1037628,"2023-10-29T00:00:00.000Z",17553992,10,"Moses Moody",1,8,9,6,4,13.1
"7695",714,0,0,0,0,0,0,0,0,0,0,0,0,0,0,0,0,1037628,"2023-10-29T00:00:00.000Z",56677858,10,"Brandin Podziemski",0,0,0,0,0,0
"7696",715,0,0,0,0,0,0,0,0,0,0,0,0,0,0,0,0,1037628,"2023-10-29T00:00:00.000Z",17896070,10,"Usman Garuba",0,0,0,0,0,0
"7697",716,0,0,0,0,0,0,0,0,0,0,0,0,0,0,0,0,1037628,"2023-10-29T00:00:00.000Z",45658838,10,"Lester Quinones",0,0,0,0,0,0
"7698",717,0,0,0,0,0,0,0,0,0,0,0,0,0,0,0,0,1037628,"2023-10-29T00:00:00.000Z",398,10,"Jerome Robinson",0,0,0,0,0,0
"7699",718,2,1,2,4,0,9,3,2,2,39,0,1,8,2,0,0,1037632,"2023-10-29T00:00:00.000Z",30,26,"Harrison Barnes",1,10,12,10,4,16.4
"7700",719,5,1,5,9,3,14,6,3,2,33,3,4,17,8,2,1,1037632,"2023-10-29T00:00:00.000Z",38017688,26,"Keegan Murray",3,25,30,22,13,42.1
"7701",720,5,0,14,1,1,8,5,3,1,34,1,6,12,15,1,3,1037632,"2023-10-29T00:00:00.000Z",406,26,"Domantas Sabonis",1,27,32,17,20,37.5
"7702",721,4,2,7,7,3,12,4,2,1,37,0,3,12,7,0,0,1037632,"2023-10-29T00:00:00.000Z",221,26,"Kevin Huerter",2,19,23,16,11,32.4
"7703",722,8,1,3,8,3,24,14,8,6,34,1,5,37,4,1,3,1037632,"2023-10-29T00:00:00.000Z",161,26,"De'Aaron Fox",2,41,49,45,12,56.8
"7704",723,2,0,2,2,1,4,2,0,0,15,0,4,5,2,0,0,1037632,"2023-10-29T00:00:00.000Z",17553994,26,"Davion Mitchell",0,7,9,7,4,10.4
"7705",724,0,1,0,0,0,2,2,0,0,15,0,1,4,0,1,1,1037632,"2023-10-29T00:00:00.000Z",306,26,"JaVale McGee",2,4,4,4,0,9
"7706",725,0,0,2,2,0,4,2,0,0,14,0,3,4,2,1,0,1037632,"2023-10-29T00:00:00.000Z",17896030,26,"Chris Duarte",1,6,6,4,2,9.4
"7707",726,2,3,6,0,0,3,3,0,0,30,0,3,6,6,1,5,1037853,"2023-11-29T00:00:00.000Z",48,15,"Bismack Biyombo",4,12,14,8,8,23.2
"7708",727,9,0,6,11,3,17,7,0,0,36,1,2,17,7,3,3,1037853,"2023-11-29T00:00:00.000Z",3547287,15,"Desmond Bane",3,24,33,26,16,44.9
"7709",728,9,0,4,3,0,11,7,0,0,27,0,2,14,4,0,1,1037853,"2023-11-29T00:00:00.000Z",401,15,"Derrick Rose",0,18,27,23,13,31.3
"7710",729,1,1,2,4,1,9,4,4,2,25,2,1,11,4,1,1,1037853,"2023-11-29T00:00:00.000Z",17896067,15,"Santi Aldama",2,15,16,12,5,22.3
"7711",730,0,0,0,0,0,0,0,0,0,0,0,0,0,0,0,0,1037853,"2023-11-29T00:00:00.000Z",48248287,15,"Jacob Gilyard",0,0,0,0,0,0
"7712",731,0,0,0,0,0,0,0,0,0,0,0,0,0,0,0,0,1037853,"2023-11-29T00:00:00.000Z",199,15,"Shaquille Harrison",0,0,0,0,0,0
"7713",732,0,0,0,0,0,0,0,0,0,0,0,0,0,0,0,0,1037853,"2023-11-29T00:00:00.000Z",666703,15,"John Konchar",0,0,0,0,0,0
"7714",733,0,0,0,0,0,0,0,0,0,0,0,0,0,0,0,0,1037853,"2023-11-29T00:00:00.000Z",38017732,15,"Kenneth Lofton Jr.",0,0,0,0,0,0
"7715",734,0,0,0,0,0,0,0,0,0,0,0,0,0,0,0,0,1037854,"2023-11-29T00:00:00.000Z",3547260,19,"Kira Lewis Jr.",0,0,0,0,0,0
"7716",735,4,0,3,3,1,8,4,0,0,23,3,2,9,6,0,2,1037852,"2023-11-29T00:00:00.000Z",18678058,24,"Jordan Goodwin",0,15,19,13,10,20.2
"7717",736,0,2,0,3,0,5,0,2,1,16,1,0,1,1,1,1,1037852,"2023-11-29T00:00:00.000Z",470,24,"Yuta Watanabe",3,2,2,1,1,10.2
"7718",737,1,1,3,0,0,6,2,0,0,18,1,0,4,4,0,0,1037852,"2023-11-29T00:00:00.000Z",147,24,"Drew Eubanks",1,8,9,5,5,13.3
"7719",738,0,0,2,1,1,3,2,0,0,15,0,3,5,2,0,1,1037852,"2023-11-29T00:00:00.000Z",314,24,"Chimezie Metu",0,7,7,5,2,6.4
"7720",739,6,1,4,4,2,7,4,5,5,35,0,1,15,4,1,1,1037854,"2023-11-29T00:00:00.000Z",227,19,"Brandon Ingram",2,19,25,21,10,33.8
"7721",740,6,0,7,0,0,11,11,12,11,33,1,1,33,8,3,2,1037854,"2023-11-29T00:00:00.000Z",666969,19,"Zion Williamson",3,41,47,39,14,58.6
"7722",741,3,0,3,1,0,9,8,3,3,32,3,5,19,6,0,2,1037854,"2023-11-29T00:00:00.000Z",455,19,"Jonas Valanciunas",0,25,28,22,9,28.7
"7723",742,6,0,2,3,0,8,3,1,1,33,1,2,7,3,0,5,1037854,"2023-11-29T00:00:00.000Z",17896024,19,"Herbert Jones",0,10,16,13,9,14.6
"7724",743,5,1,2,8,3,16,7,3,3,28,1,3,20,3,2,2,1037854,"2023-11-29T00:00:00.000Z",303,19,"CJ McCollum",3,23,28,25,8,38.1
"7725",744,1,0,1,3,0,6,0,0,0,18,1,0,0,2,0,0,1037853,"2023-11-29T00:00:00.000Z",666809,15,"Jaylen Nowell",0,2,3,1,3,3.9
"7726",745,2,0,6,3,1,3,1,0,0,19,2,3,3,8,1,2,1037853,"2023-11-29T00:00:00.000Z",38017731,15,"Vince Williams Jr.",1,11,13,5,10,16.6
"7727",746,0,0,6,3,3,8,6,0,0,25,2,0,15,8,2,2,1037853,"2023-11-29T00:00:00.000Z",17896027,15,"Ziaire Williams",2,23,23,15,8,28.6
"7728",747,2,0,3,0,0,4,2,6,6,24,4,1,10,7,0,0,1037852,"2023-11-29T00:00:00.000Z",356,24,"Josh Okogie",0,17,19,12,9,21.4
"7729",748,6,0,4,8,2,30,11,6,6,35,0,1,30,4,1,1,1037852,"2023-11-29T00:00:00.000Z",140,24,"Kevin Durant",1,34,40,36,10,45.8
"7730",749,6,2,13,1,1,12,8,2,2,30,1,3,19,14,0,2,1037852,"2023-11-29T00:00:00.000Z",349,24,"Jusuf Nurkic",2,33,39,25,20,48.8
"7731",750,1,0,1,5,2,9,4,0,0,34,0,2,10,1,1,0,1037852,"2023-11-29T00:00:00.000Z",178,24,"Eric Gordon",1,11,12,11,2,15.7
"7732",751,1,1,6,4,0,5,1,2,2,26,0,2,4,6,2,2,1038031,"2023-12-30T00:00:00.000Z",3092,16,"Haywood Highsmith",3,10,11,5,7,19.7
"7733",752,1,0,1,0,0,4,3,0,0,11,0,2,6,1,0,1,1038031,"2023-12-30T00:00:00.000Z",38017734,16,"Jamal Cain",0,7,8,7,2,7.7
"7734",753,0,0,0,0,0,0,0,0,0,0,0,0,0,0,0,0,1038031,"2023-12-30T00:00:00.000Z",74,16,"Thomas Bryant",0,0,0,0,0,0
"7735",754,0,0,0,0,0,0,0,0,0,0,0,0,0,0,0,0,1038031,"2023-12-30T00:00:00.000Z",56677842,29,"Brice Sensabaugh",0,0,0,0,0,0
"7736",755,1,1,2,0,0,3,2,4,4,23,0,2,8,2,0,2,1038031,"2023-12-30T00:00:00.000Z",79,16,"Jimmy Butler",1,10,11,9,3,12.9
"7737",756,1,0,1,2,2,2,2,0,0,10,1,5,6,2,0,1,1038031,"2023-12-30T00:00:00.000Z",38017696,16,"Nikola Jovic",0,8,9,7,3,8.9
"7738",757,3,3,13,0,0,13,7,20,14,36,3,1,28,16,3,4,1038031,"2023-12-30T00:00:00.000Z",4,16,"Bam Adebayo",6,44,47,31,19,65.7
"7739",758,6,1,4,7,2,22,9,5,5,39,2,2,25,6,1,1,1038031,"2023-12-30T00:00:00.000Z",666633,16,"Tyler Herro",2,31,37,31,12,46.2
"7740",759,0,0,2,1,0,1,0,0,0,8,0,1,0,2,0,1,1038031,"2023-12-30T00:00:00.000Z",3547257,16,"R.J. Hampton",0,2,2,0,2,1.4
"7741",760,1,0,1,4,0,9,2,5,5,35,0,4,9,1,0,2,1038031,"2023-12-30T00:00:00.000Z",56677785,16,"Jaime Jaquez Jr.",0,10,11,10,2,9.7
"7742",761,2,0,4,8,2,11,4,4,2,20,2,1,12,6,0,1,1038031,"2023-12-30T00:00:00.000Z",285,16,"Kevin Love",0,18,20,14,8,21.2
"7743",762,3,0,1,1,0,4,1,4,3,20,0,1,5,1,0,1,1038035,"2023-12-30T00:00:00.000Z",405,14,"D'Angelo Russell",0,6,9,8,4,9.7
"7744",763,0,0,1,5,0,11,2,6,5,29,1,2,9,2,0,1,1038035,"2023-12-30T00:00:00.000Z",17553995,14,"Austin Reaves",0,11,11,9,2,10.4
"7745",764,0,1,5,2,2,4,2,2,1,13,0,1,7,5,0,2,1038035,"2023-12-30T00:00:00.000Z",486,14,"Christian Wood",1,12,12,7,5,14
"7746",765,0,0,0,0,0,0,0,0,0,0,0,0,0,0,0,0,1038035,"2023-12-30T00:00:00.000Z",666626,14,"Jaxson Hayes",0,0,0,0,0,0
"7747",766,0,0,0,0,0,0,0,0,0,0,0,0,0,0,0,0,1038035,"2023-12-30T00:00:00.000Z",56677835,14,"Jalen Hood-Schifino",0,0,0,0,0,0
"7748",767,0,0,0,0,0,0,0,0,0,0,0,0,0,0,0,0,1038035,"2023-12-30T00:00:00.000Z",56677738,14,"Colin Castleton",0,0,0,0,0,0
"7749",768,0,0,0,0,0,0,0,0,0,0,0,0,0,0,0,0,1038035,"2023-12-30T00:00:00.000Z",56677867,14,"Alex Fudge",0,0,0,0,0,0
"7750",769,0,0,0,0,0,0,0,0,0,0,0,0,0,0,0,0,1038035,"2023-12-30T00:00:00.000Z",56677868,14,"D'Moi Hodge",0,0,0,0,0,0
"7751",770,0,0,0,0,0,0,0,0,0,0,0,0,0,0,0,0,1038035,"2023-12-30T00:00:00.000Z",56677836,14,"Maxwell Lewis",0,0,0,0,0,0
"7752",771,0,0,0,0,0,0,0,0,0,0,0,0,0,0,0,0,1038035,"2023-12-30T00:00:00.000Z",1603383,14,"Gabe Vincent",0,0,0,0,0,0
"7753",772,4,0,6,2,0,17,9,7,6,37,0,0,24,6,0,2,1038034,"2023-12-30T00:00:00.000Z",125,5,"DeMar DeRozan",0,30,34,28,10,35.2
"7754",773,3,0,1,3,1,11,6,0,0,33,2,0,13,3,0,2,1038034,"2023-12-30T00:00:00.000Z",3547248,5,"Patrick Williams",0,16,19,16,6,19.1
"7755",774,2,3,20,0,0,8,6,10,3,30,3,4,15,23,2,3,1038034,"2023-12-30T00:00:00.000Z",137,5,"Andre Drummond",5,38,40,17,25,57.6
"7756",775,5,1,2,5,3,7,4,5,3,28,0,2,14,2,1,3,1038034,"2023-12-30T00:00:00.000Z",89,5,"Alex Caruso",2,16,21,19,7,26.9
"7757",776,0,0,0,0,0,0,0,0,0,0,0,0,0,0,0,0,3277403,"2023-11-10T00:00:00.000Z",217,7,"Richaun Holmes",0,0,0,0,0,0
"7758",777,0,0,0,0,0,0,0,0,0,0,0,0,0,0,0,0,3277402,"2023-11-10T00:00:00.000Z",180,27,"Devonte' Graham",0,0,0,0,0,0
"7759",778,0,0,0,0,0,0,0,0,0,0,0,0,0,0,0,0,3277402,"2023-11-10T00:00:00.000Z",17896059,27,"Sandro Mamukelashvili",0,0,0,0,0,0
"7760",779,0,0,3,2,0,11,5,0,0,26,2,6,10,5,2,0,3277402,"2023-11-10T00:00:00.000Z",3547259,18,"Jaden McDaniels",2,15,15,10,5,22
"7761",780,2,0,11,7,3,21,11,4,4,34,1,1,29,12,0,3,3277402,"2023-11-10T00:00:00.000Z",447,18,"Karl-Anthony Towns",0,41,43,31,14,43.4
"7762",781,1,0,6,0,0,10,5,1,1,34,4,3,11,10,1,1,3277402,"2023-11-10T00:00:00.000Z",176,18,"Rudy Gobert",1,21,22,12,11,26.5
"7763",782,5,1,5,8,2,21,9,11,8,37,2,1,28,7,2,4,3277402,"2023-11-10T00:00:00.000Z",3547238,18,"Anthony Edwards",3,35,40,33,12,48.9
"7764",783,6,0,1,3,1,7,3,4,4,31,2,3,11,3,0,4,3277402,"2023-11-10T00:00:00.000Z",104,18,"Mike Conley",0,14,20,17,9,19.6
"7765",784,4,1,3,1,1,4,3,2,2,19,0,0,9,3,0,0,3277402,"2023-11-10T00:00:00.000Z",666400,18,"Nickeil Alexander-Walker",1,12,16,13,7,21.6
"7766",785,0,2,2,3,1,7,3,0,0,18,1,1,7,3,0,0,3277402,"2023-11-10T00:00:00.000Z",667378,18,"Naz Reid",2,10,10,7,3,16.6
"7767",786,0,0,0,0,0,0,0,0,0,0,0,0,0,0,0,0,3277402,"2023-11-10T00:00:00.000Z",38017715,18,"Josh Minott",0,0,0,0,0,0
"7768",787,0,0,0,0,0,0,0,0,0,0,0,0,0,0,0,0,3277402,"2023-11-10T00:00:00.000Z",17895968,18,"Daishen Nix",0,0,0,0,0,0
"7769",788,0,0,0,0,0,0,0,0,0,0,0,0,0,0,0,0,3277402,"2023-11-10T00:00:00.000Z",56677851,18,"Jaylen Clark",0,0,0,0,0,0
"7770",789,0,0,0,0,0,0,0,0,0,0,0,0,0,0,0,0,3277402,"2023-11-10T00:00:00.000Z",17896056,18,"Luka Garza",0,0,0,0,0,0
"7771",790,0,0,0,0,0,0,0,0,0,0,0,0,0,0,0,0,3277402,"2023-11-10T00:00:00.000Z",666767,18,"Jordan McLaughlin",0,0,0,0,0,0
"7772",791,0,0,0,0,0,0,0,0,0,0,0,0,0,0,0,0,3277402,"2023-11-10T00:00:00.000Z",56677782,18,"Leonard Miller",0,0,0,0,0,0
"7773",792,0,0,0,0,0,0,0,0,0,0,0,0,0,0,0,0,3277402,"2023-11-10T00:00:00.000Z",38017700,18,"Wendell Moore Jr.",0,0,0,0,0,0
"7774",793,0,0,0,0,0,1,0,0,0,3,1,0,0,1,0,0,3277399,"2023-11-10T00:00:00.000Z",17896094,2,"Dalano Banton",0,1,1,0,1,1.2
"7775",794,0,0,0,0,0,0,0,0,0,0,0,0,0,0,0,0,3277399,"2023-11-10T00:00:00.000Z",3547279,2,"Lamar Stevens",0,0,0,0,0,0
"7776",795,0,0,0,0,0,0,0,0,0,0,0,0,0,0,0,0,3277399,"2023-11-10T00:00:00.000Z",38017707,2,"JD Davison",0,0,0,0,0,0
"7777",796,0,0,0,0,0,0,0,0,0,0,0,0,0,0,0,0,3277403,"2023-11-10T00:00:00.000Z",56677873,7,"Dexter Dennis",0,0,0,0,0,0
"7778",797,0,0,0,0,0,0,0,0,0,0,0,0,0,0,0,0,3277403,"2023-11-10T00:00:00.000Z",257,7,"Maxi Kleber",0,0,0,0,0,0
"7779",798,0,0,0,0,0,0,0,0,0,0,0,0,0,0,0,0,3277403,"2023-11-10T00:00:00.000Z",17554004,7,"AJ Lawson",0,0,0,0,0,0
"7780",799,2,0,3,7,1,12,3,1,1,23,0,3,8,3,1,2,3277403,"2023-11-10T00:00:00.000Z",172,13,"Paul George",1,11,13,10,5,15.6
"7781",800,4,0,2,4,2,15,8,8,8,29,1,2,26,3,0,2,3277403,"2023-11-10T00:00:00.000Z",274,13,"Kawhi Leonard",0,29,33,30,7,33.6
"7782",801,1,4,7,0,0,12,8,3,3,33,5,1,19,12,0,2,1037931,"2023-12-16T00:00:00.000Z",666508,3,"Nicolas Claxton",4,31,32,20,13,44.9
"7783",802,2,0,5,13,5,24,15,6,6,37,0,5,41,5,1,5,1037931,"2023-12-16T00:00:00.000Z",17896048,3,"Cam Thomas",1,46,48,43,7,48
"7784",803,14,1,4,10,3,13,6,2,1,40,1,1,16,5,3,2,1037931,"2023-12-16T00:00:00.000Z",130,3,"Spencer Dinwiddie",4,21,35,30,19,53
"7785",804,1,0,0,1,0,2,1,1,0,14,1,2,2,1,0,0,1037929,"2023-12-16T00:00:00.000Z",3092,16,"Haywood Highsmith",0,3,4,3,2,4.7
"7786",805,0,1,2,0,0,2,1,0,0,6,0,2,2,2,0,0,1037929,"2023-12-16T00:00:00.000Z",74,16,"Thomas Bryant",1,4,4,2,2,7.4
"7787",806,0,0,0,0,0,0,0,0,0,0,0,0,0,0,0,0,1037929,"2023-12-16T00:00:00.000Z",38017734,16,"Jamal Cain",0,0,0,0,0,0
"7788",807,0,0,0,0,0,0,0,0,0,0,0,0,0,0,0,0,1037929,"2023-12-16T00:00:00.000Z",38017696,16,"Nikola Jovic",0,0,0,0,0,0
"7789",808,0,0,0,0,0,0,0,0,0,0,0,0,0,0,0,0,1037929,"2023-12-16T00:00:00.000Z",4,16,"Bam Adebayo",0,0,0,0,0,0
"7790",809,0,0,0,0,0,0,0,0,0,0,0,0,0,0,0,0,1037929,"2023-12-16T00:00:00.000Z",3547257,16,"R.J. Hampton",0,0,0,0,0,0
"7791",810,0,0,0,0,0,0,0,0,0,0,0,0,0,0,0,0,1037929,"2023-12-16T00:00:00.000Z",666633,16,"Tyler Herro",0,0,0,0,0,0
"7792",811,4,0,6,5,4,10,8,5,5,33,1,3,25,7,0,3,1037929,"2023-12-16T00:00:00.000Z",3547248,5,"Patrick Williams",0,32,36,29,11,36.4
"7793",812,3,0,7,4,1,13,3,6,5,32,4,1,12,11,1,2,1037929,"2023-12-16T00:00:00.000Z",460,5,"Nikola Vucevic",1,23,26,15,14,30.7
"7794",813,3,1,3,7,2,11,3,0,0,41,1,4,8,4,2,2,1037929,"2023-12-16T00:00:00.000Z",17895983,5,"Ayo Dosunmu",3,12,15,11,7,24.3
"7795",814,8,1,4,12,4,16,6,2,2,26,0,0,18,4,0,1,1037934,"2023-12-16T00:00:00.000Z",324,26,"Malik Monk",1,22,30,26,12,36.8
"7796",815,0,0,0,0,0,3,2,0,0,4,0,1,4,0,0,1,1037934,"2023-12-16T00:00:00.000Z",306,26,"JaVale McGee",0,4,4,4,0,3
"7797",816,2,0,4,2,1,3,1,0,0,11,0,0,3,4,0,0,1037934,"2023-12-16T00:00:00.000Z",4197162,26,"Aleksandar Vezenkov",0,7,9,5,6,10.8
"7798",817,1,0,0,1,0,5,2,0,0,18,0,3,4,0,0,0,1037934,"2023-12-16T00:00:00.000Z",17553994,26,"Davion Mitchell",0,4,5,5,1,5.5
"7799",818,4,0,6,6,5,16,12,7,7,30,1,1,36,7,2,0,1037935,"2023-12-16T00:00:00.000Z",274,13,"Kawhi Leonard",2,43,47,40,11,56.4
"7800",819,7,0,4,6,3,18,11,0,0,31,0,4,25,4,2,2,1037935,"2023-12-16T00:00:00.000Z",172,13,"Paul George",2,29,36,32,11,44.3
"7801",820,2,2,7,0,0,9,5,4,3,28,4,2,13,11,1,0,1037935,"2023-12-16T00:00:00.000Z",493,13,"Ivica Zubac",3,24,26,15,13,38.2
"7802",821,4,0,1,4,2,8,4,3,3,27,0,1,13,1,0,0,1037935,"2023-12-16T00:00:00.000Z",666743,13,"Terance Mann",0,14,18,17,5,20.2
"7803",822,12,2,4,4,1,6,2,7,5,28,0,3,10,4,1,1,1037935,"2023-12-16T00:00:00.000Z",192,13,"James Harden",3,14,26,22,16,40.8
"7804",823,0,1,2,2,1,10,6,3,3,24,0,1,16,2,0,1,1037935,"2023-12-16T00:00:00.000Z",380,13,"Norman Powell",1,18,18,16,2,20.4
"7805",824,0,0,1,3,1,3,1,0,0,17,0,3,3,1,0,0,1037935,"2023-12-16T00:00:00.000Z",666511,13,"Amir Coffey",0,4,4,3,1,4.2
"7806",825,0,0,1,0,0,3,1,6,5,15,0,4,7,1,1,0,1037935,"2023-12-16T00:00:00.000Z",439,13,"Daniel Theis",1,8,8,7,1,11.2
"7807",826,1,0,0,1,0,4,2,1,0,14,3,2,4,3,0,1,1037598,"2023-10-25T00:00:00.000Z",188,11,"Jeff Green",0,7,8,5,4,8.1
"7808",827,0,1,1,1,1,1,1,0,0,11,0,1,3,1,1,0,1037598,"2023-10-25T00:00:00.000Z",75,11,"Reggie Bullock",2,4,4,3,1,10.2
"7809",828,0,0,1,2,0,4,0,0,0,10,0,0,0,1,0,1,1037598,"2023-10-25T00:00:00.000Z",56677831,11,"Cam Whitmore",0,1,1,0,1,0.2
"7810",829,0,0,0,0,0,0,0,0,0,6,0,1,0,0,0,0,1037598,"2023-10-25T00:00:00.000Z",56677809,11,"Jermaine Samuels Jr.",0,0,0,0,0,0
"7811",830,0,0,0,1,0,3,0,0,0,5,0,0,0,0,0,0,1037598,"2023-10-25T00:00:00.000Z",213,11,"Aaron Holiday",0,0,0,0,0,0
"7812",831,0,0,0,1,0,3,2,0,0,5,0,0,4,0,0,0,1037598,"2023-10-25T00:00:00.000Z",47738533,11,"Jeenathan Williams",0,4,4,4,0,4
"7813",832,0,0,0,0,0,0,0,0,0,0,0,0,0,0,0,0,1037598,"2023-10-25T00:00:00.000Z",296,11,"Boban Marjanovic",0,0,0,0,0,0
"7814",833,0,0,0,0,0,0,0,0,0,0,0,0,0,0,0,0,1037598,"2023-10-25T00:00:00.000Z",38017695,11,"Tari Eason",0,0,0,0,0,0
"7815",834,2,0,4,6,2,8,4,1,0,28,1,1,10,5,0,3,1037599,"2023-10-25T00:00:00.000Z",158,3,"Dorian Finney-Smith",0,15,17,12,7,16
"7816",835,2,0,7,4,1,6,2,0,0,23,0,2,5,7,0,1,1037599,"2023-10-25T00:00:00.000Z",351,3,"Royce O'Neale",0,12,14,7,9,15.4
"7817",836,1,0,2,3,2,5,4,0,0,16,2,1,10,4,0,1,1037599,"2023-10-25T00:00:00.000Z",421,3,"Dennis Smith Jr.",0,14,15,11,5,15.3
"7818",837,0,0,0,0,0,0,0,0,0,0,0,0,0,0,0,0,1037599,"2023-10-25T00:00:00.000Z",56677843,3,"Noah Clowney",0,0,0,0,0,0
"7819",838,0,0,0,0,0,0,0,0,0,0,0,0,0,0,0,0,1037599,"2023-10-25T00:00:00.000Z",174,3,"Harry Giles III",0,0,0,0,0,0
"7820",839,1,0,8,6,2,15,6,6,5,32,2,1,19,10,2,1,1037604,"2023-10-25T00:00:00.000Z",297,29,"Lauri Markkanen",2,29,30,20,11,37.5
"7821",840,2,0,8,3,1,11,6,2,2,31,3,3,15,11,1,0,1037604,"2023-10-25T00:00:00.000Z",101,29,"John Collins",1,26,28,17,13,34.2
"7822",841,0,1,4,0,0,5,4,0,0,22,4,3,8,8,0,1,1037604,"2023-10-25T00:00:00.000Z",38017705,29,"Walker Kessler",1,16,16,8,8,19.6
"7823",842,6,0,2,5,2,16,8,8,6,31,2,4,24,4,0,2,1037604,"2023-10-25T00:00:00.000Z",100,29,"Jordan Clarkson",0,28,34,30,10,35.8
"7824",843,4,1,1,4,2,9,3,0,0,22,0,1,8,1,0,1,1037604,"2023-10-25T00:00:00.000Z",666650,29,"Talen Horton-Tucker",1,9,13,12,5,17.2
"7825",844,4,0,3,0,0,3,2,1,1,17,3,3,5,6,1,1,1037604,"2023-10-25T00:00:00.000Z",358,29,"Kelly Olynyk",1,11,15,9,10,20.2
"7826",845,2,0,1,1,0,6,3,4,2,16,0,0,8,1,2,4,1037604,"2023-10-25T00:00:00.000Z",139,29,"Kris Dunn",2,9,11,10,3,14.2
"7827",846,0,0,3,2,1,6,2,0,0,20,0,2,5,3,0,0,1037604,"2023-10-25T00:00:00.000Z",38017620,29,"Ochai Agbaji",0,8,8,5,3,8.6
"7828",847,1,0,0,1,0,2,1,0,0,2,1,0,2,1,0,0,1037604,"2023-10-25T00:00:00.000Z",38017739,29,"Simone Fontecchio",0,3,4,3,2,4.7
"7829",848,5,2,6,2,1,14,8,7,5,32,6,3,22,12,1,3,1037604,"2023-10-25T00:00:00.000Z",406,26,"Domantas Sabonis",3,34,39,27,17,49.9
"7830",849,2,0,3,5,1,9,3,0,0,24,2,3,7,5,0,1,1037604,"2023-10-25T00:00:00.000Z",221,26,"Kevin Huerter",0,12,14,9,7,15
"7831",850,6,1,3,7,1,18,6,6,5,33,2,4,18,5,1,3,1037604,"2023-10-25T00:00:00.000Z",161,26,"De'Aaron Fox",2,23,29,24,11,36
"7832",851,2,6,5,2,0,11,4,2,1,28,3,0,9,8,1,1,1037853,"2023-11-29T00:00:00.000Z",38017705,29,"Walker Kessler",7,17,19,11,10,41.6
"7833",852,3,0,1,4,1,10,3,3,2,22,1,3,9,2,1,2,1037853,"2023-11-29T00:00:00.000Z",413,29,"Collin Sexton",1,11,14,12,5,16.9
"7834",853,0,0,0,0,0,0,0,0,0,0,0,0,0,0,0,0,1037853,"2023-11-29T00:00:00.000Z",17896023,29,"Josh Christopher",0,0,0,0,0,0
"7835",854,0,0,0,0,0,0,0,0,0,0,0,0,0,0,0,0,1037853,"2023-11-29T00:00:00.000Z",139,29,"Kris Dunn",0,0,0,0,0,0
"7836",855,0,0,0,0,0,0,0,0,0,0,0,0,0,0,0,0,1037853,"2023-11-29T00:00:00.000Z",56677824,29,"Taylor Hendricks",0,0,0,0,0,0
"7837",856,0,0,0,0,0,0,0,0,0,0,0,0,0,0,0,0,1037853,"2023-11-29T00:00:00.000Z",38017630,29,"Johnny Juzang",0,0,0,0,0,0
"7838",857,0,0,0,0,0,0,0,0,0,0,0,0,0,0,0,0,1037853,"2023-11-29T00:00:00.000Z",297,29,"Lauri Markkanen",0,0,0,0,0,0
"7839",858,0,0,0,3,1,7,2,1,1,10,1,1,6,1,0,0,1037850,"2023-11-29T00:00:00.000Z",77,9,"Alec Burks",0,7,7,6,1,7.2
"7840",859,8,0,1,3,0,9,3,1,1,22,0,2,7,1,2,0,1037850,"2023-11-29T00:00:00.000Z",3547241,9,"Killian Hayes",2,8,16,15,9,26.2
"7841",860,2,0,6,5,2,9,2,2,2,20,0,5,8,6,1,3,1037850,"2023-11-29T00:00:00.000Z",44477024,9,"Stanley Umude",1,14,16,10,8,18.2
"7842",861,0,0,1,0,0,4,2,2,0,14,1,0,4,2,0,0,1037850,"2023-11-29T00:00:00.000Z",24,9,"Marvin Bagley III",0,6,6,4,2,6.4
"7843",862,0,0,0,1,1,1,1,0,0,6,0,0,3,0,0,0,1037850,"2023-11-29T00:00:00.000Z",259,9,"Kevin Knox",0,3,3,3,0,3
"7844",863,0,0,0,0,0,0,0,0,0,0,0,0,0,0,0,0,1037850,"2023-11-29T00:00:00.000Z",54,9,"Bojan Bogdanovic",0,0,0,0,0,0
"7845",864,0,0,0,0,0,0,0,0,0,0,0,0,0,0,0,0,1037850,"2023-11-29T00:00:00.000Z",56677729,9,"Malcolm Cazalon",0,0,0,0,0,0
"7846",865,0,0,0,0,0,0,0,0,0,0,0,0,0,0,0,0,1037850,"2023-11-29T00:00:00.000Z",197,9,"Joe Harris",0,0,0,0,0,0
"7847",866,0,0,0,0,0,0,0,0,0,0,0,0,0,0,0,0,1037850,"2023-11-29T00:00:00.000Z",330,9,"Monte Morris",0,0,0,0,0,0
"7848",867,0,0,0,0,0,0,0,0,0,0,0,0,0,0,0,0,1037850,"2023-11-29T00:00:00.000Z",42097199,9,"Jared Rhoden",0,0,0,0,0,0
"7849",868,1,0,1,4,3,4,3,0,0,23,0,0,9,1,1,1,1037850,"2023-11-29T00:00:00.000Z",383,14,"Taurean Prince",1,10,11,10,2,13.7
"7850",869,4,0,6,6,2,19,9,5,5,29,2,0,25,8,0,1,1037850,"2023-11-29T00:00:00.000Z",237,14,"LeBron James",0,33,37,29,12,39.6
"7851",870,4,3,12,0,0,15,9,13,10,29,4,1,28,16,1,0,1037850,"2023-11-29T00:00:00.000Z",117,14,"Anthony Davis",4,44,48,32,20,65.2
"7852",871,0,1,2,2,0,3,0,5,5,22,0,1,5,2,0,2,1037850,"2023-11-29T00:00:00.000Z",38017697,14,"Max Christie",1,7,7,5,2,8.4
"7853",872,9,2,4,7,5,17,13,5,4,34,0,0,35,4,1,3,1037850,"2023-11-29T00:00:00.000Z",405,14,"D'Angelo Russell",3,39,48,44,13,59.3
"7854",873,0,0,0,0,0,0,0,0,0,0,0,0,0,0,0,0,1037853,"2023-11-29T00:00:00.000Z",56677842,29,"Brice Sensabaugh",0,0,0,0,0,0
"7855",874,0,0,0,0,0,0,0,0,0,0,0,0,0,0,0,0,1037855,"2023-11-29T00:00:00.000Z",666489,8,"Vlatko Cancar",0,0,0,0,0,0
"7856",875,0,0,0,0,0,0,0,0,0,0,0,0,0,0,0,0,1037855,"2023-11-29T00:00:00.000Z",177,8,"Aaron Gordon",0,0,0,0,0,0
"7857",876,11,1,3,6,1,15,4,1,0,36,0,1,9,3,1,2,1038027,"2023-12-29T00:00:00.000Z",335,8,"Jamal Murray",2,12,23,20,14,33.1
"7858",877,2,0,1,2,0,3,0,0,0,16,0,1,0,1,0,0,1038027,"2023-12-29T00:00:00.000Z",215,8,"Justin Holiday",0,1,3,2,3,4.2
"7859",878,1,0,3,2,0,3,0,4,4,17,0,1,4,3,0,1,1038027,"2023-12-29T00:00:00.000Z",38017709,8,"Christian Braun",0,7,8,5,4,8.1
"7860",879,0,0,1,4,1,7,3,4,3,12,0,3,10,1,0,3,1038027,"2023-12-29T00:00:00.000Z",56677776,8,"Julian Strawther",0,11,11,10,1,8.2
"7861",880,1,0,5,0,0,4,3,0,0,13,3,0,6,8,1,1,1038027,"2023-12-29T00:00:00.000Z",250,8,"DeAndre Jordan",1,14,15,7,9,19.1
"7862",881,3,0,2,5,2,10,3,0,0,15,0,0,8,2,1,0,1038027,"2023-12-29T00:00:00.000Z",236,8,"Reggie Jackson",1,10,13,11,5,17.9
"7863",882,0,0,0,0,0,2,1,1,1,3,0,0,3,0,0,0,1038027,"2023-12-29T00:00:00.000Z",17896007,8,"Braxton Key",0,3,3,3,0,3
"7864",883,0,0,0,0,0,1,0,0,0,3,0,0,0,0,0,0,1038027,"2023-12-29T00:00:00.000Z",3547268,8,"Zeke Nnaji",0,0,0,0,0,0
"7865",884,0,0,0,0,0,1,0,0,0,3,0,1,0,0,0,0,1038027,"2023-12-29T00:00:00.000Z",56677582,8,"Jalen Pickett",0,0,0,0,0,0
"7866",885,0,0,0,0,0,0,0,0,0,0,0,0,0,0,0,0,1038027,"2023-12-29T00:00:00.000Z",666489,8,"Vlatko Cancar",0,0,0,0,0,0
"7867",886,0,0,0,0,0,0,0,0,0,0,0,0,0,0,0,0,1038027,"2023-12-29T00:00:00.000Z",38017727,8,"Collin Gillespie",0,0,0,0,0,0
"7868",887,0,0,0,0,0,0,0,0,0,0,0,0,0,0,0,0,1038027,"2023-12-29T00:00:00.000Z",177,8,"Aaron Gordon",0,0,0,0,0,0
"7869",888,0,0,0,0,0,0,0,0,0,0,0,0,0,0,0,0,1038027,"2023-12-29T00:00:00.000Z",17896103,8,"Jay Huff",0,0,0,0,0,0
"7870",889,0,0,0,0,0,0,0,0,0,0,0,0,0,0,0,0,1038027,"2023-12-29T00:00:00.000Z",56677871,8,"Hunter Tyson",0,0,0,0,0,0
"7871",890,1,1,3,3,0,6,2,0,0,32,1,3,4,4,3,1,1038027,"2023-12-29T00:00:00.000Z",666541,21,"Luguentz Dort",4,8,9,5,5,21.3
"7872",891,2,0,2,2,0,2,0,0,0,19,0,2,0,2,0,1,1038040,"2023-12-31T00:00:00.000Z",38017649,27,"Julian Champagnie",0,2,4,2,4,4.4
"7873",892,5,0,3,4,1,11,4,0,0,24,0,1,9,3,0,1,1038040,"2023-12-31T00:00:00.000Z",38017699,27,"Jeremy Sochan",0,12,17,14,8,19.1
"7874",893,3,1,5,8,3,16,8,2,2,24,2,0,21,7,0,3,1038040,"2023-12-31T00:00:00.000Z",56677822,27,"Victor Wembanyama",1,28,31,24,10,33.9
"7875",894,1,0,4,4,2,15,9,2,2,31,1,3,22,5,2,2,1038040,"2023-12-31T00:00:00.000Z",3547246,27,"Devin Vassell",2,27,28,23,6,33.5
"7876",895,0,0,1,5,1,9,4,3,2,23,0,0,11,1,0,1,1038040,"2023-12-31T00:00:00.000Z",38017692,27,"Malaki Branham",0,12,12,11,1,11.2
"7877",896,4,0,5,5,1,9,3,0,0,20,2,1,7,7,0,0,1038040,"2023-12-31T00:00:00.000Z",17896059,27,"Sandro Mamukelashvili",0,14,18,11,11,21.4
"7878",897,2,0,0,2,1,4,2,0,0,16,0,2,5,0,1,0,1038040,"2023-12-31T00:00:00.000Z",359,27,"Cedi Osman",1,5,7,7,2,11
"7879",898,1,0,0,3,0,3,0,0,0,16,0,1,0,0,0,1,1038040,"2023-12-31T00:00:00.000Z",305,27,"Doug McDermott",0,0,1,1,1,0.5
"7880",899,2,0,3,5,0,10,4,0,0,22,1,3,8,4,0,1,1038040,"2023-12-31T00:00:00.000Z",3547274,27,"Tre Jones",0,12,14,10,6,14.8
"7881",900,6,0,1,2,0,3,0,2,1,17,0,2,1,1,0,1,1038040,"2023-12-31T00:00:00.000Z",38017693,27,"Blake Wesley",0,2,8,7,7,10.2
"7882",901,0,0,0,3,1,4,1,0,0,14,1,5,3,1,0,0,3277404,"2023-11-10T00:00:00.000Z",470,24,"Yuta Watanabe",0,4,4,3,1,4.2
"7883",902,0,0,1,8,3,9,3,0,0,20,0,0,9,1,1,1,3277405,"2023-11-10T00:00:00.000Z",3547272,21,"Isaiah Joe",1,10,10,9,1,12.2
"7884",903,1,0,1,1,0,1,0,0,0,8,0,1,0,1,0,0,3277405,"2023-11-10T00:00:00.000Z",38017716,21,"Ousmane Dieng",0,1,2,1,2,2.7
"7885",904,0,0,0,0,0,0,0,0,0,0,0,0,0,0,0,0,3277405,"2023-11-10T00:00:00.000Z",44,21,"Davis Bertans",0,0,0,0,0,0
"7886",905,8,0,2,5,2,12,5,0,0,29,0,3,12,2,1,2,3277405,"2023-11-10T00:00:00.000Z",324,26,"Malik Monk",1,14,22,20,10,27.4
"7887",906,1,0,1,6,1,6,1,0,0,16,0,1,3,1,0,0,3277405,"2023-11-10T00:00:00.000Z",17553994,26,"Davion Mitchell",0,4,5,4,2,5.7
"7888",907,0,0,1,3,2,3,2,0,0,8,0,1,6,1,1,0,3277405,"2023-11-10T00:00:00.000Z",4197162,26,"Aleksandar Vezenkov",1,7,7,6,1,10.2
"7889",908,0,0,0,0,0,0,0,0,0,0,0,0,0,0,0,0,3277404,"2023-11-10T00:00:00.000Z",56677867,14,"Alex Fudge",0,0,0,0,0,0
"7890",909,0,0,0,0,0,0,0,0,0,0,0,0,0,0,0,0,3277404,"2023-11-10T00:00:00.000Z",56677868,14,"D'Moi Hodge",0,0,0,0,0,0
"7891",910,0,0,0,0,0,0,0,0,0,0,0,0,0,0,0,0,3277404,"2023-11-10T00:00:00.000Z",457,14,"Jarred Vanderbilt",0,0,0,0,0,0
"7892",911,0,0,0,0,0,0,0,0,0,0,0,0,0,0,0,0,3277404,"2023-11-10T00:00:00.000Z",1603383,14,"Gabe Vincent",0,0,0,0,0,0
"7893",912,0,0,0,0,0,0,0,0,0,0,0,0,0,0,0,0,3277405,"2023-11-10T00:00:00.000Z",161,26,"De'Aaron Fox",0,0,0,0,0,0
"7894",913,0,0,0,0,0,0,0,0,0,0,0,0,0,0,0,0,3277405,"2023-11-10T00:00:00.000Z",290,26,"Trey Lyles",0,0,0,0,0,0
"7895",914,0,0,0,0,0,0,0,0,0,0,0,0,0,0,0,0,3277405,"2023-11-10T00:00:00.000Z",17895941,26,"Filip Petrusev",0,0,0,0,0,0
"7896",915,0,0,0,0,0,0,0,0,0,0,0,0,0,0,0,0,3277405,"2023-11-10T00:00:00.000Z",56677862,26,"Jalen Slawson",0,0,0,0,0,0
"7897",916,2,1,4,3,2,5,2,2,2,25,2,4,8,6,3,2,3277405,"2023-11-10T00:00:00.000Z",666541,21,"Luguentz Dort",4,14,16,10,8,28.2
"7898",917,1,0,5,3,0,14,6,2,2,31,0,1,14,5,1,3,3277405,"2023-11-10T00:00:00.000Z",38017703,21,"Jalen Williams",1,19,20,15,6,21.5
"7899",918,1,1,6,3,0,12,5,3,2,30,1,2,12,7,1,4,3277405,"2023-11-10T00:00:00.000Z",38017685,21,"Chet Holmgren",2,19,20,13,8,23.9
"7900",919,3,0,2,4,1,12,6,2,0,29,3,2,13,5,0,3,1037724,"2023-11-11T00:00:00.000Z",475,10,"Andrew Wiggins",0,18,21,16,8,20.5
"7901",920,4,0,3,3,2,4,3,0,0,18,2,3,8,5,0,1,1037724,"2023-11-11T00:00:00.000Z",185,10,"Draymond Green",0,13,17,12,9,19
"7902",921,2,0,10,0,0,2,1,0,0,24,3,5,2,13,0,1,1037724,"2023-11-11T00:00:00.000Z",282,10,"Kevon Looney",0,15,17,4,15,19.6
"7903",922,1,1,4,5,2,16,5,2,2,28,1,3,14,5,0,3,1037724,"2023-11-11T00:00:00.000Z",443,10,"Klay Thompson",1,19,20,15,6,21.5
"7904",923,2,1,2,14,4,24,9,8,8,33,1,1,30,3,1,4,1037724,"2023-11-11T00:00:00.000Z",115,10,"Stephen Curry",2,33,35,32,5,38.6
"7905",924,0,0,3,1,0,4,1,2,1,11,2,0,3,5,0,1,1037724,"2023-11-11T00:00:00.000Z",2189,10,"Gary Payton II",0,8,8,3,5,8
"7906",925,1,1,5,3,0,5,2,1,1,16,0,3,5,5,0,0,1037724,"2023-11-11T00:00:00.000Z",407,10,"Dario Saric",1,10,11,6,6,15.5
"7907",926,4,0,3,5,3,7,5,4,3,22,0,0,16,3,1,1,1037937,"2023-12-17T00:00:00.000Z",17896097,19,"Jose Alvarado",1,19,23,20,7,27.6
"7908",927,4,0,4,0,0,2,1,0,0,18,1,4,2,5,0,1,1037937,"2023-12-17T00:00:00.000Z",491,19,"Cody Zeller",0,7,11,6,9,13
"7909",928,4,0,3,2,1,4,2,0,0,18,1,0,5,4,1,1,1037937,"2023-12-17T00:00:00.000Z",38017677,19,"Dyson Daniels",1,9,13,9,8,17.8
"7910",929,0,0,2,4,1,6,3,0,0,12,0,0,7,2,0,0,1037937,"2023-12-17T00:00:00.000Z",56677837,19,"Jordan Hawkins",0,9,9,7,2,9.4
"7911",930,0,0,1,0,0,2,2,0,0,4,0,0,4,1,0,0,1037937,"2023-12-17T00:00:00.000Z",17896021,19,"Jeremiah Robinson-Earl",0,5,5,4,1,5.2
"7912",931,0,0,0,0,0,0,0,0,0,0,0,0,0,0,0,0,1037937,"2023-12-17T00:00:00.000Z",3547260,19,"Kira Lewis Jr.",0,0,0,0,0,0
"7913",932,0,0,0,0,0,0,0,0,0,0,0,0,0,0,0,0,1037937,"2023-12-17T00:00:00.000Z",38017663,19,"E.J. Liddell",0,0,0,0,0,0
"7914",933,0,0,0,0,0,0,0,0,0,0,0,0,0,0,0,0,1037937,"2023-12-17T00:00:00.000Z",340,19,"Larry Nance Jr.",0,0,0,0,0,0
"7915",934,0,0,0,0,0,0,0,0,0,0,0,0,0,0,0,0,1037937,"2023-12-17T00:00:00.000Z",17896017,19,"Matt Ryan",0,0,0,0,0,0
"7916",935,7,0,2,4,2,11,6,2,2,29,0,0,16,2,0,1,1037938,"2023-12-17T00:00:00.000Z",17895966,11,"Jalen Green",0,18,25,23,9,27.9
"7917",936,6,2,1,8,4,16,8,2,2,39,1,2,22,2,1,1,1037938,"2023-12-17T00:00:00.000Z",458,11,"Fred VanVleet",3,24,30,28,8,41.4
"7918",937,1,0,6,2,1,8,5,0,0,30,0,2,11,6,2,0,1037938,"2023-12-17T00:00:00.000Z",38017695,11,"Tari Eason",2,17,18,12,7,25.7
"7919",938,2,0,1,1,0,3,0,0,0,12,0,2,0,1,1,2,1037938,"2023-12-17T00:00:00.000Z",213,11,"Aaron Holiday",1,1,3,2,3,5.2
"7920",939,1,0,0,1,1,5,4,8,7,17,0,0,16,0,0,1,1037938,"2023-12-17T00:00:00.000Z",188,11,"Jeff Green",0,16,17,17,1,16.5
"7921",940,1,0,1,0,0,2,0,0,0,19,2,2,0,3,1,2,1037938,"2023-12-17T00:00:00.000Z",3547301,11,"Jae'Sean Tate",1,3,4,1,4,6.1
"7922",941,0,0,0,0,0,0,0,0,0,0,0,0,0,0,0,0,1037938,"2023-12-17T00:00:00.000Z",75,11,"Reggie Bullock",0,0,0,0,0,0
"7923",942,0,0,0,0,0,0,0,0,0,0,0,0,0,0,0,0,1037938,"2023-12-17T00:00:00.000Z",19465326,11,"Jock Landale",0,0,0,0,0,0
"7924",943,0,0,0,0,0,0,0,0,0,0,0,0,0,0,0,0,1037938,"2023-12-17T00:00:00.000Z",296,11,"Boban Marjanovic",0,0,0,0,0,0
"7925",944,0,0,0,0,0,0,0,0,0,0,0,0,0,0,0,0,1037938,"2023-12-17T00:00:00.000Z",47738533,11,"Jeenathan Williams",0,0,0,0,0,0
"7926",945,0,0,0,0,0,0,0,0,0,0,0,0,0,0,0,0,1037938,"2023-12-17T00:00:00.000Z",3547281,11,"Nate Hinton",0,0,0,0,0,0
"7927",946,0,0,0,0,0,0,0,0,0,0,0,0,0,0,0,0,1037938,"2023-12-17T00:00:00.000Z",357,11,"Victor Oladipo",0,0,0,0,0,0
"7928",947,0,0,0,0,0,0,0,0,0,0,0,0,0,0,0,0,1037938,"2023-12-17T00:00:00.000Z",56677809,11,"Jermaine Samuels Jr.",0,0,0,0,0,0
"7929",948,0,0,0,0,0,0,0,0,0,0,0,0,0,0,0,0,1037938,"2023-12-17T00:00:00.000Z",56677825,11,"Amen Thompson",0,0,0,0,0,0
"7930",949,0,0,0,0,0,0,0,0,0,0,0,0,0,0,0,0,1037938,"2023-12-17T00:00:00.000Z",56677831,11,"Cam Whitmore",0,0,0,0,0,0
"7931",950,1,0,5,2,1,3,2,0,0,23,2,2,5,7,0,1,1037939,"2023-12-17T00:00:00.000Z",666729,24,"Nassir Little",0,12,13,6,8,13.9
"7932",951,0,0,1,1,1,4,3,2,2,19,1,0,9,2,0,0,1037613,"2023-10-27T00:00:00.000Z",56677833,21,"Cason Wallace",0,11,11,9,2,11.4
"7933",952,2,0,3,7,1,10,2,1,0,22,0,1,5,3,0,1,1037613,"2023-10-27T00:00:00.000Z",3547272,21,"Isaiah Joe",0,8,10,7,5,10.6
"7934",953,0,0,0,0,0,0,0,0,0,1,0,0,0,0,0,0,1037613,"2023-10-27T00:00:00.000Z",27924547,21,"Lindy Waters III",0,0,0,0,0,0
"7935",954,1,1,0,0,0,0,0,0,0,12,0,0,0,0,0,1,1037613,"2023-10-27T00:00:00.000Z",17896078,21,"Aaron Wiggins",1,0,1,1,1,3.5
"7936",955,1,0,0,1,1,1,1,0,0,6,0,0,3,0,0,2,1037613,"2023-10-27T00:00:00.000Z",4197029,21,"Vasilije Micic",0,3,4,4,1,2.5
"7937",956,0,0,0,0,0,0,0,0,0,0,0,0,0,0,0,0,1037613,"2023-10-27T00:00:00.000Z",17896036,21,"Tre Mann",0,0,0,0,0,0
"7938",957,0,0,0,0,0,0,0,0,0,0,0,0,0,0,0,0,1037613,"2023-10-27T00:00:00.000Z",3547271,21,"Aleksej Pokusevski",0,0,0,0,0,0
"7939",958,0,0,0,0,0,0,0,0,0,0,0,0,0,0,0,0,1037613,"2023-10-27T00:00:00.000Z",24572055,21,"Olivier Sarr",0,0,0,0,0,0
"7940",959,0,0,0,0,0,0,0,0,0,0,0,0,0,0,0,0,1037613,"2023-10-27T00:00:00.000Z",56677853,21,"Keyontae Johnson",0,0,0,0,0,0
"7941",960,0,0,0,0,0,0,0,0,0,0,0,0,0,0,0,0,1037613,"2023-10-27T00:00:00.000Z",38017706,21,"Jaylin Williams",0,0,0,0,0,0
"7942",961,0,0,0,0,0,0,0,0,0,0,0,0,0,0,0,0,1037613,"2023-10-27T00:00:00.000Z",480,21,"Kenrich Williams",0,0,0,0,0,0
"7943",962,1,1,2,0,0,2,1,4,4,20,0,4,6,2,2,0,1037611,"2023-10-27T00:00:00.000Z",3547244,1,"Onyeka Okongwu",3,8,9,7,3,18.9
"7944",963,2,2,4,0,0,24,10,9,7,35,3,1,27,7,1,3,1037612,"2023-10-27T00:00:00.000Z",4,16,"Bam Adebayo",3,34,36,29,9,44.4
"7945",964,6,0,5,12,5,19,10,3,3,40,1,2,28,6,1,3,1037612,"2023-10-27T00:00:00.000Z",666633,16,"Tyler Herro",1,34,40,34,12,44.2
"7946",965,5,1,7,4,3,7,5,0,0,32,1,3,13,8,0,1,1037612,"2023-10-27T00:00:00.000Z",286,16,"Kyle Lowry",1,21,26,18,13,32.1
"7947",966,0,0,0,0,0,0,0,0,0,0,0,0,0,0,0,0,1037610,"2023-10-27T00:00:00.000Z",17896067,15,"Santi Aldama",0,0,0,0,0,0
"7948",967,0,0,0,0,0,0,0,0,0,0,0,0,0,0,0,0,1037610,"2023-10-27T00:00:00.000Z",666505,15,"Brandon Clarke",0,0,0,0,0,0
"7949",968,0,0,0,0,0,0,0,0,0,0,0,0,0,0,0,0,1037610,"2023-10-27T00:00:00.000Z",254,15,"Luke Kennard",0,0,0,0,0,0
"7950",969,2,0,12,5,2,7,3,1,1,29,1,4,9,13,0,1,1037610,"2023-10-27T00:00:00.000Z",375,8,"Michael Porter Jr.",0,22,24,11,15,26.6
"7951",970,3,1,1,1,0,11,5,1,0,30,1,3,10,2,3,1,1037610,"2023-10-27T00:00:00.000Z",177,8,"Aaron Gordon",4,12,15,13,5,27.9
"7952",971,7,1,9,4,1,14,8,6,5,35,3,1,22,12,1,9,1037610,"2023-10-27T00:00:00.000Z",246,8,"Nikola Jokic",2,34,41,29,19,43.9
"7953",972,2,1,2,6,2,10,3,0,0,35,0,1,8,2,5,0,1037610,"2023-10-27T00:00:00.000Z",81,8,"Kentavious Caldwell-Pope",6,10,12,10,4,31.4
"7954",973,5,1,1,9,4,17,7,4,4,34,0,2,22,1,0,3,1037610,"2023-10-27T00:00:00.000Z",335,8,"Jamal Murray",1,23,28,27,6,30.7
"7955",974,2,0,3,4,1,6,2,2,0,19,1,1,5,4,1,1,1037610,"2023-10-27T00:00:00.000Z",38017709,8,"Christian Braun",1,9,11,7,6,14.8
"7956",975,6,0,2,5,2,13,7,0,0,22,0,0,16,2,0,0,1037610,"2023-10-27T00:00:00.000Z",236,8,"Reggie Jackson",0,18,24,22,8,27.4
"7957",976,2,1,4,3,2,12,5,2,1,32,0,2,13,4,2,2,3277531,"2023-11-28T00:00:00.000Z",62,4,"Miles Bridges",3,17,19,15,6,27.8
"7958",977,6,0,4,2,0,7,2,0,0,28,2,1,4,6,0,2,3277531,"2023-11-28T00:00:00.000Z",204,4,"Gordon Hayward",0,10,16,10,12,18.2
"7959",978,0,0,6,0,0,9,5,2,2,25,6,2,12,12,1,0,3277531,"2023-11-28T00:00:00.000Z",38017698,4,"Mark Williams",1,24,24,12,12,29.4
"7960",979,2,0,3,8,4,18,7,0,0,36,0,2,18,3,1,3,3277531,"2023-11-28T00:00:00.000Z",56677823,4,"Brandon Miller",1,21,23,20,5,24.6
"7961",980,5,0,2,3,0,16,5,1,1,32,0,0,11,2,1,3,3277531,"2023-11-28T00:00:00.000Z",403,4,"Terry Rozier",1,13,18,16,7,20.9
"7962",981,0,0,0,0,0,0,0,0,0,0,0,0,0,0,0,0,3277534,"2023-11-28T00:00:00.000Z",17895990,26,"Jordan Ford",0,0,0,0,0,0
"7963",982,0,0,0,0,0,0,0,0,0,0,0,0,0,0,0,0,3277534,"2023-11-28T00:00:00.000Z",56677845,26,"Colby Jones",0,0,0,0,0,0
"7964",983,5,0,6,7,4,14,8,2,1,33,3,5,21,9,0,1,3277534,"2023-11-28T00:00:00.000Z",221,26,"Kevin Huerter",0,30,35,26,14,38.3
"7965",984,1,1,4,5,2,8,5,0,0,26,0,1,12,4,1,1,3277534,"2023-11-28T00:00:00.000Z",30,26,"Harrison Barnes",2,16,17,13,5,23.3
"7966",985,10,0,6,1,0,7,2,6,5,37,2,3,9,8,1,1,3277534,"2023-11-28T00:00:00.000Z",406,26,"Domantas Sabonis",1,17,27,19,18,35.6
"7967",986,0,0,0,1,0,4,2,2,1,14,0,2,5,0,2,0,3277534,"2023-11-28T00:00:00.000Z",17896030,26,"Chris Duarte",2,5,5,5,0,11
"7968",987,7,0,9,8,2,20,9,17,9,40,1,4,29,10,2,2,3277534,"2023-11-28T00:00:00.000Z",161,26,"De'Aaron Fox",2,39,46,36,17,55.5
"7969",988,1,1,4,0,0,0,0,0,0,7,1,1,0,5,0,0,3277527,"2023-11-28T00:00:00.000Z",38017719,5,"Dalen Terry",1,5,6,1,6,10.5
"7970",989,0,0,0,0,0,0,0,0,0,0,0,0,0,0,0,0,3277527,"2023-11-28T00:00:00.000Z",27,5,"Lonzo Ball",0,0,0,0,0,0
"7971",990,0,0,0,0,0,0,0,0,0,0,0,0,0,0,0,0,3277527,"2023-11-28T00:00:00.000Z",56677874,5,"Onuralp Bitim",0,0,0,0,0,0
"7972",991,0,0,0,0,0,0,0,0,0,0,0,0,0,0,0,0,3277527,"2023-11-28T00:00:00.000Z",45969255,5,"Justin Lewis",0,0,0,0,0,0
"7973",992,0,0,0,0,0,0,0,0,0,0,0,0,0,0,0,0,3277527,"2023-11-28T00:00:00.000Z",56677860,5,"Adama Sanogo",0,0,0,0,0,0
"7974",993,2,0,1,1,0,2,1,3,3,11,1,2,5,2,1,0,3277533,"2023-11-28T00:00:00.000Z",3547301,11,"Jae'Sean Tate",1,7,9,7,4,13.4
"7975",994,0,0,0,0,0,0,0,0,0,0,0,0,0,0,0,0,3277533,"2023-11-28T00:00:00.000Z",296,11,"Boban Marjanovic",0,0,0,0,0,0
"7976",995,0,0,0,0,0,0,0,0,0,0,0,0,0,0,0,0,3277533,"2023-11-28T00:00:00.000Z",56677809,11,"Jermaine Samuels Jr.",0,0,0,0,0,0
"7977",996,0,0,0,0,0,0,0,0,0,0,0,0,0,0,0,0,3277533,"2023-11-28T00:00:00.000Z",56677831,11,"Cam Whitmore",0,0,0,0,0,0
"7978",997,0,0,0,0,0,0,0,0,0,0,0,0,0,0,0,0,3277533,"2023-11-28T00:00:00.000Z",357,11,"Victor Oladipo",0,0,0,0,0,0
"7979",998,0,0,0,0,0,0,0,0,0,0,0,0,0,0,0,0,3277533,"2023-11-28T00:00:00.000Z",56677825,11,"Amen Thompson",0,0,0,0,0,0
"7980",999,0,0,0,0,0,0,0,0,0,0,0,0,0,0,0,0,3277533,"2023-11-28T00:00:00.000Z",47738533,11,"Jeenathan Williams",0,0,0,0,0,0
"7981",1000,0,0,0,2,0,4,1,2,2,9,0,2,4,0,1,0,3277534,"2023-11-28T00:00:00.000Z",17553994,26,"Davion Mitchell",1,4,4,4,0,7
"7982",1001,3,0,10,3,0,17,8,5,3,33,3,3,19,13,0,1,1038042,"2023-12-31T00:00:00.000Z",349,24,"Jusuf Nurkic",0,32,35,22,16,38.1
"7983",1002,2,1,1,2,1,13,10,4,4,35,0,1,25,1,1,1,1038042,"2023-12-31T00:00:00.000Z",37,24,"Bradley Beal",2,26,28,27,3,34.2
"7984",1003,5,0,4,8,3,17,7,5,4,37,0,3,21,4,3,1,1038042,"2023-12-31T00:00:00.000Z",57,24,"Devin Booker",3,25,30,26,9,41.3
"7985",1004,0,0,1,2,0,3,0,0,0,30,0,3,0,1,2,0,1038042,"2023-12-31T00:00:00.000Z",178,24,"Eric Gordon",2,1,1,0,1,7.2
"7986",1005,0,0,4,2,0,7,3,0,0,17,2,2,6,6,0,1,1038042,"2023-12-31T00:00:00.000Z",314,24,"Chimezie Metu",0,12,12,6,6,12.2
"7987",1006,0,1,1,0,0,0,0,0,0,8,0,1,0,1,0,1,1038042,"2023-12-31T00:00:00.000Z",3547095,24,"Udoka Azubuike",1,1,1,0,1,3.2
"7988",1007,2,0,1,1,0,2,0,0,0,7,1,3,0,2,0,0,1038042,"2023-12-31T00:00:00.000Z",356,24,"Josh Okogie",0,2,4,2,4,5.4
"7989",1008,0,0,0,0,0,0,0,0,0,0,0,0,0,0,0,0,1038042,"2023-12-31T00:00:00.000Z",32,24,"Keita Bates-Diop",0,0,0,0,0,0
"7990",1009,0,0,0,0,0,0,0,0,0,0,0,0,0,0,0,0,1038042,"2023-12-31T00:00:00.000Z",666451,24,"Bol Bol",0,0,0,0,0,0
"7991",1010,0,0,0,0,0,0,0,0,0,0,0,0,0,0,0,0,1038042,"2023-12-31T00:00:00.000Z",147,24,"Drew Eubanks",0,0,0,0,0,0
"7992",1011,0,0,0,0,0,0,0,0,0,0,0,0,0,0,0,0,1038042,"2023-12-31T00:00:00.000Z",18678058,24,"Jordan Goodwin",0,0,0,0,0,0
"7993",1012,0,0,0,0,0,0,0,0,0,0,0,0,0,0,0,0,1038042,"2023-12-31T00:00:00.000Z",3547298,24,"Saben Lee",0,0,0,0,0,0
"7994",1013,0,0,0,0,0,0,0,0,0,0,0,0,0,0,0,0,1038042,"2023-12-31T00:00:00.000Z",17553983,22,"Trevelin Queen",0,0,0,0,0,0
"7995",1014,0,0,0,0,0,0,0,0,0,0,0,0,0,0,0,0,1038042,"2023-12-31T00:00:00.000Z",165,22,"Markelle Fultz",0,0,0,0,0,0
"7996",1015,0,0,0,0,0,0,0,0,0,0,0,0,0,0,0,0,1038042,"2023-12-31T00:00:00.000Z",38017607,22,"Kevon Harris",0,0,0,0,0,0
"7997",1016,0,0,0,0,0,0,0,0,0,0,0,0,0,0,0,0,1038042,"2023-12-31T00:00:00.000Z",56677839,22,"Jett Howard",0,0,0,0,0,0
"7998",1017,0,0,0,0,0,0,0,0,0,0,0,0,0,0,0,0,1038042,"2023-12-31T00:00:00.000Z",226,22,"Joe Ingles",0,0,0,0,0,0
"7999",1018,0,0,0,0,0,0,0,0,0,0,0,0,0,0,0,0,1038042,"2023-12-31T00:00:00.000Z",666885,22,"Admiral Schofield",0,0,0,0,0,0
"8000",1019,0,0,6,6,1,11,3,0,0,29,1,1,7,7,2,2,1038038,"2023-12-31T00:00:00.000Z",38017697,14,"Max Christie",2,14,14,7,7,19.4
"8001",1020,0,0,2,0,0,1,0,0,0,10,0,2,0,2,0,0,1038038,"2023-12-31T00:00:00.000Z",666626,14,"Jaxson Hayes",0,2,2,0,2,2.4
"8002",1021,0,0,0,0,0,1,1,0,0,5,0,0,2,0,1,0,1038038,"2023-12-31T00:00:00.000Z",56677835,14,"Jalen Hood-Schifino",1,2,2,2,0,5
"8003",1022,0,0,0,0,0,0,0,0,0,0,0,0,0,0,0,0,1038041,"2023-12-31T00:00:00.000Z",3,15,"Steven Adams",0,0,0,0,0,0
"8004",1023,0,0,0,0,0,0,0,0,0,0,0,0,0,0,0,0,1038041,"2023-12-31T00:00:00.000Z",666505,15,"Brandon Clarke",0,0,0,0,0,0
"8005",1024,0,0,0,0,0,0,0,0,0,0,0,0,0,0,0,0,1038041,"2023-12-31T00:00:00.000Z",48248287,15,"Jacob Gilyard",0,0,0,0,0,0
"8006",1025,0,0,0,0,0,0,0,0,0,0,0,0,0,0,0,0,1038041,"2023-12-31T00:00:00.000Z",56677830,15,"GG Jackson",0,0,0,0,0,0
"8007",1026,0,0,0,0,0,0,0,0,0,0,0,0,0,0,0,0,1037723,"2023-11-11T00:00:00.000Z",38017689,1,"AJ Griffin",0,0,0,0,0,0
"8008",1027,0,0,0,0,0,0,0,0,0,0,0,0,0,0,0,0,1037723,"2023-11-11T00:00:00.000Z",666754,1,"Garrison Mathews",0,0,0,0,0,0
"8009",1028,0,0,0,0,0,0,0,0,0,0,0,0,0,0,0,0,1037723,"2023-11-11T00:00:00.000Z",319,1,"Patty Mills",0,0,0,0,0,0
"8010",1029,0,0,0,0,0,0,0,0,0,0,0,0,0,0,0,0,1037723,"2023-11-11T00:00:00.000Z",56677838,1,"Kobe Bufkin",0,0,0,0,0,0
"8011",1030,4,0,6,3,1,5,3,0,0,24,1,2,7,7,0,0,1037722,"2023-11-11T00:00:00.000Z",219,2,"Al Horford",0,14,18,11,11,21.4
"8012",1031,4,0,3,3,1,5,2,2,2,24,3,1,7,6,0,1,1037722,"2023-11-11T00:00:00.000Z",3547276,2,"Payton Pritchard",0,13,17,11,10,19.2
"8013",1032,1,0,5,0,0,1,1,0,0,9,0,1,2,5,0,0,1037722,"2023-11-11T00:00:00.000Z",261,2,"Luke Kornet",0,7,8,3,6,9.5
"8014",1033,0,0,0,2,0,2,0,0,0,5,0,0,0,0,0,1,1037722,"2023-11-11T00:00:00.000Z",338,2,"Svi Mykhailiuk",0,0,0,0,0,-1
"8015",1034,0,0,0,0,0,0,0,0,0,0,0,0,0,0,0,0,1037722,"2023-11-11T00:00:00.000Z",3547279,2,"Lamar Stevens",0,0,0,0,0,0
"8016",1035,0,0,0,0,0,0,0,0,0,0,0,0,0,0,0,0,1037722,"2023-11-11T00:00:00.000Z",38017707,2,"JD Davison",0,0,0,0,0,0
"8017",1036,0,0,0,0,0,0,0,0,0,0,0,0,0,0,0,0,1037722,"2023-11-11T00:00:00.000Z",3547295,2,"Nathan Knight",0,0,0,0,0,0
"8018",1037,0,0,0,0,0,0,0,0,0,0,0,0,0,0,0,0,1037722,"2023-11-11T00:00:00.000Z",17553967,2,"Neemias Queta",0,0,0,0,0,0
"8019",1038,0,0,0,0,0,0,0,0,0,0,0,0,0,0,0,0,1037722,"2023-11-11T00:00:00.000Z",56677864,2,"Jordan Walsh",0,0,0,0,0,0
"8020",1039,2,0,2,8,2,13,3,0,0,28,1,0,8,3,1,0,1037722,"2023-11-11T00:00:00.000Z",18,28,"OG Anunoby",1,11,13,10,5,17.6
"8021",1040,3,0,5,4,0,17,6,6,5,28,2,0,17,7,3,3,1037722,"2023-11-11T00:00:00.000Z",416,28,"Pascal Siakam",3,24,27,20,10,35.9
"8022",1041,2,0,1,0,0,10,6,0,0,21,2,3,12,3,0,1,1037722,"2023-11-11T00:00:00.000Z",373,28,"Jakob Poeltl",0,15,17,14,5,17.6
"8023",1042,4,1,4,9,2,15,4,0,0,29,1,1,10,5,1,1,1037722,"2023-11-11T00:00:00.000Z",17896055,28,"Scottie Barnes",2,15,19,14,9,27
"8024",1043,4,0,1,3,1,7,3,7,7,25,0,3,14,1,1,1,1037722,"2023-11-11T00:00:00.000Z",409,28,"Dennis Schroder",1,15,19,18,5,23.2
"8025",1044,3,1,3,7,2,18,8,5,4,36,2,1,22,5,4,0,1037724,"2023-11-11T00:00:00.000Z",277,6,"Caris LeVert",5,27,30,25,8,47.5
"8026",1045,1,0,1,4,0,4,0,0,0,19,1,1,0,2,0,1,1037724,"2023-11-11T00:00:00.000Z",344,6,"Georges Niang",0,2,3,1,3,2.9
"8027",1046,0,0,7,4,2,4,2,2,2,17,0,6,8,7,0,0,1037724,"2023-11-11T00:00:00.000Z",666940,6,"Dean Wade",0,15,15,8,7,16.4
"8028",1047,0,0,0,0,0,0,0,6,1,1,0,0,1,0,0,0,1037724,"2023-11-11T00:00:00.000Z",56677872,6,"Craig Porter",0,1,1,1,0,1
"8029",1048,0,0,0,0,0,0,0,0,0,1,0,0,0,0,0,0,1037724,"2023-11-11T00:00:00.000Z",444,6,"Tristan Thompson",0,0,0,0,0,0
"8030",1049,0,0,0,0,0,0,0,0,0,1,0,0,0,0,0,0,1037724,"2023-11-11T00:00:00.000Z",56677847,6,"Emoni Bates",0,0,0,0,0,0
"8031",1050,0,0,0,0,0,0,0,0,0,1,0,0,0,0,0,0,1037724,"2023-11-11T00:00:00.000Z",248,6,"Damian Jones",0,0,0,0,0,0
"8032",1051,0,0,0,0,0,0,0,0,0,0,0,0,0,0,0,0,1037924,"2023-12-15T00:00:00.000Z",56677825,11,"Amen Thompson",0,0,0,0,0,0
"8033",1052,0,0,0,2,0,3,1,0,0,16,0,3,2,0,2,0,1037921,"2023-12-15T00:00:00.000Z",196,22,"Gary Harris",2,2,2,2,0,8
"8034",1053,4,0,0,3,2,8,5,6,5,20,0,3,17,0,1,1,1037921,"2023-12-15T00:00:00.000Z",3547251,22,"Cole Anthony",1,17,21,21,4,25
"8035",1054,2,0,0,1,0,3,1,0,0,13,1,3,2,1,0,3,1037921,"2023-12-15T00:00:00.000Z",462,22,"Moritz Wagner",0,3,5,4,3,3.2
"8036",1055,0,0,3,2,1,5,3,0,0,16,1,1,7,4,0,0,1037921,"2023-12-15T00:00:00.000Z",229,22,"Jonathan Isaac",0,11,11,7,4,11.8
"8037",1056,1,0,1,4,1,5,2,0,0,11,1,0,5,2,0,0,1037921,"2023-12-15T00:00:00.000Z",38017724,22,"Caleb Houstan",0,7,8,6,3,8.9
"8038",1057,0,0,0,0,0,1,0,0,0,4,0,0,0,0,0,0,1037921,"2023-12-15T00:00:00.000Z",666818,22,"Chuma Okeke",0,0,0,0,0,0
"8039",1058,0,0,1,1,0,1,0,0,0,3,0,0,0,1,0,0,1037921,"2023-12-15T00:00:00.000Z",56677839,22,"Jett Howard",0,1,1,0,1,1.2
"8040",1059,0,0,2,0,0,1,0,0,0,3,0,1,0,2,0,1,1037921,"2023-12-15T00:00:00.000Z",666885,22,"Admiral Schofield",0,2,2,0,2,1.4
"8041",1060,0,2,2,0,0,4,3,2,2,15,1,1,8,3,1,1,1037925,"2023-12-15T00:00:00.000Z",147,24,"Drew Eubanks",3,11,11,8,3,19.6
"8042",1061,0,0,0,0,0,0,0,0,0,7,0,0,0,0,0,0,1037925,"2023-12-15T00:00:00.000Z",470,24,"Yuta Watanabe",0,0,0,0,0,0
"8043",1062,0,0,3,1,0,5,2,0,0,14,0,0,4,3,0,0,1037925,"2023-12-15T00:00:00.000Z",32,24,"Keita Bates-Diop",0,7,7,4,3,7.6
"8044",1063,1,0,1,2,0,3,1,2,1,10,0,0,3,1,0,1,1037925,"2023-12-15T00:00:00.000Z",314,24,"Chimezie Metu",0,4,5,4,2,4.7
"8045",1064,0,0,0,0,0,1,1,0,0,2,0,0,2,0,0,0,1037925,"2023-12-15T00:00:00.000Z",666451,24,"Bol Bol",0,2,2,2,0,2
"8046",1065,0,0,0,0,0,0,0,0,0,0,0,0,0,0,0,0,1037925,"2023-12-15T00:00:00.000Z",3547095,24,"Udoka Azubuike",0,0,0,0,0,0
"8047",1066,0,0,0,0,0,0,0,0,0,0,0,0,0,0,0,0,1037925,"2023-12-15T00:00:00.000Z",178,24,"Eric Gordon",0,0,0,0,0,0
"8048",1067,0,0,0,0,0,0,0,0,0,0,0,0,0,0,0,0,1037925,"2023-12-15T00:00:00.000Z",272,24,"Damion Lee",0,0,0,0,0,0
"8049",1068,0,0,0,0,0,0,0,0,0,0,0,0,0,0,0,0,1037925,"2023-12-15T00:00:00.000Z",3547298,24,"Saben Lee",0,0,0,0,0,0
"8050",1069,0,0,0,0,0,0,0,0,0,0,0,0,0,0,0,0,1037925,"2023-12-15T00:00:00.000Z",356,24,"Josh Okogie",0,0,0,0,0,0
"8051",1070,3,1,1,2,1,10,6,8,8,29,1,2,21,2,0,1,1037925,"2023-12-15T00:00:00.000Z",666423,20,"RJ Barrett",1,23,26,24,5,29.9
"8052",1071,6,1,7,3,1,16,10,2,2,35,1,4,23,8,0,5,1037925,"2023-12-15T00:00:00.000Z",387,20,"Julius Randle",1,31,37,29,14,39.6
"8053",1072,0,0,2,0,0,4,2,1,1,18,1,3,5,3,0,0,1037925,"2023-12-15T00:00:00.000Z",17896063,20,"Jericho Sims",0,8,8,5,3,8.6
"8054",1073,1,0,1,2,1,3,2,0,0,19,0,4,5,1,1,0,1037925,"2023-12-15T00:00:00.000Z",131,20,"Donte DiVincenzo",1,6,7,6,2,10.7
"8055",1074,9,0,5,9,9,23,17,9,7,35,1,0,50,6,5,2,1037925,"2023-12-15T00:00:00.000Z",73,20,"Jalen Brunson",5,56,65,59,15,83.7
"8056",1075,2,0,0,3,0,8,3,0,0,29,2,0,6,2,0,0,1037925,"2023-12-15T00:00:00.000Z",202,20,"Josh Hart",0,8,10,8,4,11.4
"8057",1076,4,1,8,1,0,4,2,0,0,37,1,4,4,9,1,5,1037617,"2023-10-27T00:00:00.000Z",472,13,"Russell Westbrook",2,13,17,8,13,21.8
"8058",1077,1,0,2,5,2,10,5,0,0,22,0,2,12,2,1,3,1037617,"2023-10-27T00:00:00.000Z",17896031,13,"Nah'Shon Hyland",1,14,15,13,3,15.9
"8059",1078,1,0,3,4,2,10,7,4,4,25,0,2,20,3,1,1,1037617,"2023-10-27T00:00:00.000Z",380,13,"Norman Powell",1,23,24,21,4,27.1
"8060",1079,0,0,3,0,0,1,1,2,1,12,1,2,3,4,0,1,1037617,"2023-10-27T00:00:00.000Z",371,13,"Mason Plumlee",0,7,7,3,4,6.8
"8061",1080,3,3,2,3,2,4,3,0,0,30,0,4,8,2,1,0,1037617,"2023-10-27T00:00:00.000Z",33,13,"Nicolas Batum",4,10,13,11,5,26.9
"8062",1081,0,0,0,0,0,0,0,0,0,0,0,0,0,0,0,0,1037617,"2023-10-27T00:00:00.000Z",56677849,13,"Kobe Brown",0,0,0,0,0,0
"8063",1082,0,0,0,0,0,0,0,0,0,0,0,0,0,0,0,0,1037617,"2023-10-27T00:00:00.000Z",666511,13,"Amir Coffey",0,0,0,0,0,0
"8064",1083,0,0,0,0,0,0,0,0,0,0,0,0,0,0,0,0,1037617,"2023-10-27T00:00:00.000Z",38017725,13,"Moussa Diabate",0,0,0,0,0,0
"8065",1084,0,0,0,0,0,0,0,0,0,0,0,0,0,0,0,0,1037617,"2023-10-27T00:00:00.000Z",3547294,13,"Kenyon Martin Jr.",0,0,0,0,0,0
"8066",1085,0,0,0,0,0,0,0,0,0,0,0,0,0,0,0,0,1037617,"2023-10-27T00:00:00.000Z",56677856,13,"Jordan Miller",0,0,0,0,0,0
"8067",1086,0,0,0,0,0,0,0,0,0,0,0,0,0,0,0,0,1037617,"2023-10-27T00:00:00.000Z",17896022,13,"Brandon Boston Jr.",0,0,0,0,0,0
"8068",1087,0,0,0,0,0,0,0,0,0,0,0,0,0,0,0,0,1037617,"2023-10-27T00:00:00.000Z",666743,13,"Terance Mann",0,0,0,0,0,0
"8069",1088,0,0,0,0,0,0,0,0,0,0,0,0,0,0,0,0,1037617,"2023-10-27T00:00:00.000Z",328,13,"Marcus Morris",0,0,0,0,0,0
"8070",1089,0,0,0,0,0,0,0,0,0,0,0,0,0,0,0,0,1037617,"2023-10-27T00:00:00.000Z",17896051,13,"Joshua Primo",0,0,0,0,0,0
"8071",1090,1,0,3,2,1,5,4,4,1,30,1,1,10,4,1,0,1037619,"2023-10-27T00:00:00.000Z",30,26,"Harrison Barnes",1,14,15,11,5,19.3
"8072",1091,1,1,4,11,3,16,6,2,1,39,3,2,16,7,2,4,1037619,"2023-10-27T00:00:00.000Z",38017688,26,"Keegan Murray",3,23,24,17,8,30.9
"8073",1092,7,0,14,2,0,15,7,6,5,36,4,1,19,18,3,1,1037619,"2023-10-27T00:00:00.000Z",406,26,"Domantas Sabonis",3,37,44,26,25,59.1
"8074",1093,2,1,2,5,0,5,0,0,0,16,0,0,0,2,0,0,1037619,"2023-10-27T00:00:00.000Z",221,26,"Kevin Huerter",1,2,4,2,4,8.4
"8075",1094,4,0,4,9,5,28,14,7,6,39,0,3,39,4,2,2,1037619,"2023-10-27T00:00:00.000Z",161,26,"De'Aaron Fox",2,43,47,43,8,53.8
"8076",1095,6,1,0,2,1,4,2,4,4,18,0,2,9,0,0,2,1037619,"2023-10-27T00:00:00.000Z",324,26,"Malik Monk",1,9,15,15,6,19
"8077",1096,0,0,1,4,2,6,4,0,0,12,0,0,10,1,0,0,1037619,"2023-10-27T00:00:00.000Z",4197162,26,"Aleksandar Vezenkov",0,11,11,10,1,11.2
"8078",1097,0,0,0,1,0,2,0,0,0,11,0,1,0,0,1,2,1037619,"2023-10-27T00:00:00.000Z",17553994,26,"Davion Mitchell",1,0,0,0,0,1
"8079",1098,0,0,2,0,0,6,3,3,1,12,2,0,7,4,0,2,1037619,"2023-10-27T00:00:00.000Z",306,26,"JaVale McGee",0,11,11,7,4,9.8
"8080",1099,3,0,1,4,0,7,1,3,2,26,0,6,4,1,1,1,1037619,"2023-10-27T00:00:00.000Z",17896030,26,"Chris Duarte",1,5,8,7,4,11.7
"8081",1100,0,0,0,0,0,0,0,0,0,1,0,0,0,0,0,0,1037619,"2023-10-27T00:00:00.000Z",56677845,26,"Colby Jones",0,0,0,0,0,0
"8082",1101,1,0,0,1,1,2,1,0,0,10,0,1,3,0,1,2,1037869,"2023-12-01T00:00:00.000Z",17896027,15,"Ziaire Williams",1,3,4,4,1,5.5
"8083",1102,0,0,0,0,0,0,0,0,0,0,0,0,0,0,0,0,1037869,"2023-12-01T00:00:00.000Z",3,15,"Steven Adams",0,0,0,0,0,0
"8084",1103,0,0,0,0,0,0,0,0,0,0,0,0,0,0,0,0,1037869,"2023-12-01T00:00:00.000Z",666505,15,"Brandon Clarke",0,0,0,0,0,0
"8085",1104,0,0,0,0,0,0,0,0,0,0,0,0,0,0,0,0,1037869,"2023-12-01T00:00:00.000Z",56677830,15,"GG Jackson",0,0,0,0,0,0
"8086",1105,0,0,0,0,0,0,0,0,0,0,0,0,0,0,0,0,1037869,"2023-12-01T00:00:00.000Z",254,15,"Luke Kennard",0,0,0,0,0,0
"8087",1106,0,0,0,0,0,0,0,0,0,0,0,0,0,0,0,0,1037869,"2023-12-01T00:00:00.000Z",38017728,15,"Jake LaRavia",0,0,0,0,0,0
"8088",1107,0,0,0,0,0,0,0,0,0,0,0,0,0,0,0,0,1037869,"2023-12-01T00:00:00.000Z",666786,15,"Ja Morant",0,0,0,0,0,0
"8089",1108,0,0,0,0,0,0,0,0,0,0,0,0,0,0,0,0,1037869,"2023-12-01T00:00:00.000Z",420,15,"Marcus Smart",0,0,0,0,0,0
"8090",1109,3,0,1,6,4,11,4,4,3,23,0,2,15,1,0,0,1037866,"2023-12-01T00:00:00.000Z",17896045,30,"Corey Kispert",0,16,19,18,4,20.7
"8091",1110,2,0,0,3,3,8,5,3,0,18,0,4,13,0,0,2,1037866,"2023-12-01T00:00:00.000Z",414,30,"Landry Shamet",0,13,15,15,2,14
"8092",1111,0,0,0,0,0,0,0,0,0,0,0,0,0,0,0,0,1037866,"2023-12-01T00:00:00.000Z",3547302,30,"Anthony Gill",0,0,0,0,0,0
"8093",1112,0,0,0,0,0,0,0,0,0,0,0,0,0,0,0,0,1037866,"2023-12-01T00:00:00.000Z",337,30,"Mike Muscala",0,0,0,0,0,0
"8094",1113,0,0,0,0,0,0,0,0,0,0,0,0,0,0,0,0,1037866,"2023-12-01T00:00:00.000Z",17896106,30,"Eugene Omoruyi",0,0,0,0,0,0
"8095",1114,0,0,0,0,0,0,0,0,0,0,0,0,0,0,0,0,1037866,"2023-12-01T00:00:00.000Z",38124126,30,"John Butler Jr.",0,0,0,0,0,0
"8096",1115,0,0,0,0,0,0,0,0,0,0,0,0,0,0,0,0,1037866,"2023-12-01T00:00:00.000Z",38017712,30,"Ryan Rollins",0,0,0,0,0,0
"8097",1116,0,0,0,0,0,0,0,0,0,0,0,0,0,0,0,0,1037866,"2023-12-01T00:00:00.000Z",487,30,"Delon Wright",0,0,0,0,0,0
"8098",1117,5,1,6,3,2,16,6,6,6,34,1,5,20,7,0,1,1037874,"2023-12-02T00:00:00.000Z",17896026,22,"Franz Wagner",1,27,32,25,12,37.9
"8099",1118,8,0,9,2,0,15,6,9,7,34,1,3,19,10,1,1,1037874,"2023-12-02T00:00:00.000Z",38017683,22,"Paolo Banchero",1,29,37,27,18,45
"8100",1119,0,1,2,0,0,6,1,2,1,15,3,2,3,5,0,0,1037874,"2023-12-02T00:00:00.000Z",666442,22,"Goga Bitadze",1,8,8,3,5,12
"8101",1120,2,1,0,3,1,7,3,0,0,23,0,5,7,0,1,4,1037874,"2023-12-02T00:00:00.000Z",17896073,22,"Jalen Suggs",2,7,9,9,2,12
"8102",1121,1,0,3,0,0,1,1,0,0,19,0,3,2,3,0,0,1037874,"2023-12-02T00:00:00.000Z",56677827,22,"Anthony Black",0,5,6,3,4,7.1
"8103",1122,2,0,1,1,1,2,1,3,2,17,1,2,5,2,1,1,1037874,"2023-12-02T00:00:00.000Z",226,22,"Joe Ingles",1,7,9,7,4,12.4
"8104",1123,2,0,1,5,0,8,2,0,0,21,0,1,4,1,0,0,1037874,"2023-12-02T00:00:00.000Z",196,22,"Gary Harris",0,5,7,6,3,8.2
"8105",1124,2,1,1,2,2,9,6,5,4,22,1,2,18,2,0,2,1037874,"2023-12-02T00:00:00.000Z",462,22,"Moritz Wagner",1,20,22,20,4,24.4
"8106",1125,1,1,5,6,2,16,8,2,2,31,0,3,20,5,0,1,1037874,"2023-12-02T00:00:00.000Z",3547251,22,"Cole Anthony",1,25,26,21,6,29.5
"8107",1126,0,0,2,1,0,1,0,1,1,12,0,3,1,2,2,0,1038088,"2024-01-06T00:00:00.000Z",56677852,17,"Andre Jackson Jr.",2,3,3,1,2,9.4
"8108",1127,0,0,1,3,2,8,3,0,0,32,1,0,8,2,1,0,1038083,"2024-01-05T00:00:00.000Z",666860,14,"Cameron Reddish",1,10,10,8,2,13.4
"8109",1128,7,0,3,9,4,24,11,10,6,39,2,0,32,5,5,4,1038083,"2024-01-05T00:00:00.000Z",237,14,"LeBron James",5,37,44,39,12,59.5
"8110",1129,4,2,3,3,0,22,13,7,5,41,3,4,31,6,0,4,1038083,"2024-01-05T00:00:00.000Z",117,14,"Anthony Davis",2,37,41,35,10,46.2
"8111",1130,2,1,1,7,3,9,3,2,1,35,1,3,10,2,2,1,1038083,"2024-01-05T00:00:00.000Z",383,14,"Taurean Prince",3,12,14,12,4,23.4
"8112",1131,12,0,7,3,0,14,8,4,3,40,0,4,19,7,2,1,1038083,"2024-01-05T00:00:00.000Z",17553995,14,"Austin Reaves",2,26,38,31,19,50.4
"8113",1132,1,0,4,0,0,0,0,0,0,17,1,1,0,5,1,0,1038083,"2024-01-05T00:00:00.000Z",457,14,"Jarred Vanderbilt",1,5,6,1,6,10.5
"8114",1133,0,0,3,1,0,3,1,0,0,20,0,2,2,3,1,2,1038083,"2024-01-05T00:00:00.000Z",38017697,14,"Max Christie",1,5,5,2,3,6.6
"8115",1134,0,0,5,2,1,5,3,4,4,16,0,0,11,5,1,1,1038083,"2024-01-05T00:00:00.000Z",486,14,"Christian Wood",1,16,16,11,5,19
"8116",1135,0,0,0,0,0,0,0,0,0,0,0,0,0,0,0,0,1038083,"2024-01-05T00:00:00.000Z",56677867,14,"Alex Fudge",0,0,0,0,0,0
"8117",1136,0,0,0,0,0,0,0,0,0,0,0,0,0,0,0,0,1038083,"2024-01-05T00:00:00.000Z",666626,14,"Jaxson Hayes",0,0,0,0,0,0
"8118",1137,0,0,0,0,0,0,0,0,0,0,0,0,0,0,0,0,1038083,"2024-01-05T00:00:00.000Z",56677868,14,"D'Moi Hodge",0,0,0,0,0,0
"8119",1138,0,0,0,0,0,0,0,0,0,0,0,0,0,0,0,0,1038083,"2024-01-05T00:00:00.000Z",56677835,14,"Jalen Hood-Schifino",0,0,0,0,0,0
"8120",1139,0,0,0,0,0,0,0,0,0,0,0,0,0,0,0,0,1038083,"2024-01-05T00:00:00.000Z",56677836,14,"Maxwell Lewis",0,0,0,0,0,0
"8121",1140,0,0,0,0,0,0,0,0,0,0,0,0,0,0,0,0,1038083,"2024-01-05T00:00:00.000Z",56677738,14,"Colin Castleton",0,0,0,0,0,0
"8122",1141,0,0,0,0,0,0,0,0,0,0,0,0,0,0,0,0,1038083,"2024-01-05T00:00:00.000Z",666609,14,"Rui Hachimura",0,0,0,0,0,0
"8123",1142,0,0,0,0,0,0,0,0,0,0,0,0,0,0,0,0,1038083,"2024-01-05T00:00:00.000Z",405,14,"D'Angelo Russell",0,0,0,0,0,0
"8124",1143,0,0,0,0,0,0,0,0,0,0,0,0,0,0,0,0,1038083,"2024-01-05T00:00:00.000Z",1603383,14,"Gabe Vincent",0,0,0,0,0,0
"8125",1144,5,0,1,14,8,16,9,4,3,39,1,2,29,2,1,3,1038083,"2024-01-05T00:00:00.000Z",420,15,"Marcus Smart",1,31,36,34,7,38.9
"8126",1145,1,3,9,6,5,14,11,4,4,30,0,5,31,9,0,3,1038083,"2024-01-05T00:00:00.000Z",231,15,"Jaren Jackson Jr.",3,40,41,32,10,49.3
"8127",1146,1,0,9,0,0,3,3,0,0,31,1,2,6,10,0,2,1038083,"2024-01-05T00:00:00.000Z",48,15,"Bismack Biyombo",0,16,17,7,11,17.5
"8128",1147,13,0,5,8,5,14,8,4,3,37,0,2,24,5,1,3,1038083,"2024-01-05T00:00:00.000Z",3547287,15,"Desmond Bane",1,29,42,37,18,49.5
"8129",1148,7,1,5,7,3,17,7,5,4,35,2,3,21,7,1,2,1038083,"2024-01-05T00:00:00.000Z",666786,15,"Ja Morant",2,28,35,28,14,43.9
"8130",1149,0,0,0,0,0,0,0,0,0,9,0,0,0,0,1,1,1038083,"2024-01-05T00:00:00.000Z",17896067,15,"Santi Aldama",1,0,0,0,0,2
"8131",1150,4,0,2,3,0,4,0,0,0,20,1,0,0,3,1,0,1038083,"2024-01-05T00:00:00.000Z",254,15,"Luke Kennard",1,3,7,4,7,12.6
"8132",1151,2,0,4,2,1,5,3,0,0,28,1,1,7,5,0,0,3277454,"2023-11-17T00:00:00.000Z",666609,14,"Rui Hachimura",0,12,14,9,7,16
"8133",1152,0,0,0,0,0,0,0,0,0,0,0,0,0,0,0,0,3277453,"2023-11-17T00:00:00.000Z",666881,29,"Luka Samanic",0,0,0,0,0,0
"8134",1153,0,0,4,2,1,4,2,0,0,17,0,3,5,4,0,0,3277450,"2023-11-17T00:00:00.000Z",4197162,26,"Aleksandar Vezenkov",0,9,9,5,4,9.8
"8135",1154,2,0,0,0,0,1,1,0,0,10,0,0,2,0,1,1,3277450,"2023-11-17T00:00:00.000Z",38017714,26,"Keon Ellis",1,2,4,4,2,7
"8136",1155,0,0,0,0,0,0,0,0,0,0,0,0,0,0,0,0,3277453,"2023-11-17T00:00:00.000Z",56677842,29,"Brice Sensabaugh",0,0,0,0,0,0
"8137",1156,0,0,0,0,0,0,0,0,0,0,0,0,0,0,0,0,3277453,"2023-11-17T00:00:00.000Z",11891374,29,"Omer Yurtseven",0,0,0,0,0,0
"8138",1157,0,0,0,0,0,0,0,0,0,0,0,0,0,0,0,0,3277453,"2023-11-17T00:00:00.000Z",17896023,29,"Josh Christopher",0,0,0,0,0,0
"8139",1158,0,0,0,0,0,0,0,0,0,0,0,0,0,0,0,0,3277453,"2023-11-17T00:00:00.000Z",38017630,29,"Johnny Juzang",0,0,0,0,0,0
"8140",1159,0,0,0,0,0,0,0,0,0,0,0,0,0,0,0,0,3277453,"2023-11-17T00:00:00.000Z",38017705,29,"Walker Kessler",0,0,0,0,0,0
"8141",1160,0,0,0,0,0,0,0,0,0,0,0,0,0,0,0,0,3277453,"2023-11-17T00:00:00.000Z",19465584,29,"Micah Potter",0,0,0,0,0,0
"8142",1161,1,1,2,8,4,12,5,0,0,33,0,2,14,2,1,1,3277453,"2023-11-17T00:00:00.000Z",178,24,"Eric Gordon",2,16,17,15,3,22.9
"8143",1162,9,0,9,8,6,22,15,2,2,33,0,1,38,9,0,1,3277453,"2023-11-17T00:00:00.000Z",140,24,"Kevin Durant",0,47,56,47,18,61.3
"8144",1163,4,0,5,1,0,7,4,7,7,23,2,4,15,7,1,4,3277453,"2023-11-17T00:00:00.000Z",349,24,"Jusuf Nurkic",1,22,26,19,11,28.4
"8145",1164,1,0,1,4,2,8,3,2,2,30,0,1,10,1,0,0,3277453,"2023-11-17T00:00:00.000Z",8,24,"Grayson Allen",0,11,12,11,2,12.7
"8146",1165,15,0,4,3,2,15,7,10,8,32,0,3,24,4,0,1,3277453,"2023-11-17T00:00:00.000Z",57,24,"Devin Booker",0,28,43,39,19,50.3
"8147",1166,0,3,2,0,0,4,2,3,3,20,1,4,7,3,2,0,3277453,"2023-11-17T00:00:00.000Z",32,24,"Keita Bates-Diop",5,10,10,7,3,25.6
"8148",1167,0,0,0,0,0,0,0,0,0,0,0,0,0,0,0,0,3277453,"2023-11-17T00:00:00.000Z",3547095,24,"Udoka Azubuike",0,0,0,0,0,0
"8149",1168,2,0,3,6,2,9,2,4,2,17,0,1,8,3,0,2,3277455,"2023-11-17T00:00:00.000Z",472,13,"Russell Westbrook",0,11,13,10,5,12.6
"8150",1169,0,0,3,1,0,3,1,2,0,11,0,2,2,3,1,0,3277455,"2023-11-17T00:00:00.000Z",439,13,"Daniel Theis",1,5,5,2,3,8.6
"8151",1170,3,1,2,5,2,11,3,2,2,30,1,2,10,3,1,0,3277455,"2023-11-17T00:00:00.000Z",380,13,"Norman Powell",2,13,16,13,6,24.1
"8152",1171,0,0,0,0,0,0,0,0,0,15,0,3,0,0,0,0,3277455,"2023-11-17T00:00:00.000Z",450,13,"PJ Tucker",0,0,0,0,0,0
"8153",1172,0,0,0,0,0,0,0,0,0,0,0,0,0,0,0,0,3277455,"2023-11-17T00:00:00.000Z",17896031,13,"Nah'Shon Hyland",0,0,0,0,0,0
"8154",1173,0,0,0,0,0,0,0,0,0,0,0,0,0,0,0,0,3277455,"2023-11-17T00:00:00.000Z",17896022,13,"Brandon Boston Jr.",0,0,0,0,0,0
"8155",1174,0,0,0,0,0,0,0,0,0,0,0,0,0,0,0,0,3277455,"2023-11-17T00:00:00.000Z",56677849,13,"Kobe Brown",0,0,0,0,0,0
"8156",1175,0,0,0,0,0,0,0,0,0,0,0,0,0,0,0,0,3277455,"2023-11-17T00:00:00.000Z",56677856,13,"Jordan Miller",0,0,0,0,0,0
"8157",1176,1,0,5,3,1,15,11,8,8,40,5,3,31,10,2,0,1037996,"2023-12-25T00:00:00.000Z",56677785,16,"Jaime Jaquez Jr.",2,41,42,32,11,50.5
"8158",1177,1,0,4,0,0,0,0,2,1,9,1,1,1,5,0,2,1037996,"2023-12-25T00:00:00.000Z",666747,16,"Caleb Martin",0,6,7,2,6,6.5
"8159",1178,5,3,12,0,0,15,9,12,8,36,3,1,26,15,0,4,1037996,"2023-12-25T00:00:00.000Z",4,16,"Bam Adebayo",3,41,46,31,20,56.5
"8160",1179,5,1,4,11,4,25,8,3,2,38,2,1,22,6,1,4,1037996,"2023-12-25T00:00:00.000Z",666633,16,"Tyler Herro",2,28,33,27,11,38.7
"8161",1180,4,1,1,3,1,7,5,1,1,33,0,4,12,1,1,3,1037996,"2023-12-25T00:00:00.000Z",286,16,"Kyle Lowry",2,13,17,16,5,22.2
"8162",1181,0,1,4,0,0,2,0,4,3,17,1,4,3,5,0,0,1037996,"2023-12-25T00:00:00.000Z",38017734,16,"Jamal Cain",1,8,8,3,5,12
"8163",1182,4,0,0,3,0,4,0,0,0,17,0,0,0,0,0,0,1037996,"2023-12-25T00:00:00.000Z",3547257,16,"R.J. Hampton",0,0,4,4,4,6
"8164",1183,0,0,0,0,0,0,0,0,0,0,0,0,0,0,0,0,1037996,"2023-12-25T00:00:00.000Z",74,16,"Thomas Bryant",0,0,0,0,0,0
"8165",1184,0,0,0,0,0,0,0,0,0,0,0,0,0,0,0,0,1037996,"2023-12-25T00:00:00.000Z",38017696,16,"Nikola Jovic",0,0,0,0,0,0
"8166",1185,2,0,4,10,5,13,5,1,1,34,0,3,16,4,1,0,1037996,"2023-12-25T00:00:00.000Z",397,16,"Duncan Robinson",1,20,22,18,6,26.8
"8167",1186,5,0,9,2,1,3,2,4,3,16,1,0,8,10,0,1,1037996,"2023-12-25T00:00:00.000Z",285,16,"Kevin Love",0,18,23,13,15,26.5
"8168",1187,0,0,0,0,0,0,0,0,0,0,0,0,0,0,0,0,1037996,"2023-12-25T00:00:00.000Z",39398582,16,"Orlando Robinson",0,0,0,0,0,0
"8169",1188,0,0,0,0,0,0,0,0,0,0,0,0,0,0,0,0,1037996,"2023-12-25T00:00:00.000Z",38017736,16,"Cole Swider",0,0,0,0,0,0
"8170",1189,0,0,0,0,0,0,0,0,0,0,0,0,0,0,0,0,1037996,"2023-12-25T00:00:00.000Z",79,16,"Jimmy Butler",0,0,0,0,0,0
"8171",1190,0,0,0,0,0,0,0,0,0,0,0,0,0,0,0,0,1037996,"2023-12-25T00:00:00.000Z",3092,16,"Haywood Highsmith",0,0,0,0,0,0
"8172",1191,0,0,0,0,0,0,0,0,0,0,0,0,0,0,0,0,1037996,"2023-12-25T00:00:00.000Z",391,16,"Josh Richardson",0,0,0,0,0,0
"8173",1192,0,0,0,0,0,0,0,0,0,0,0,0,0,0,0,0,1037996,"2023-12-25T00:00:00.000Z",19465585,16,"Dru Smith",0,0,0,0,0,0
"8174",1193,3,1,6,9,6,16,9,3,1,40,1,3,25,7,1,1,1037996,"2023-12-25T00:00:00.000Z",360,23,"Kelly Oubre Jr.",2,32,35,28,10,42.9
"8175",1194,6,0,6,7,4,18,10,3,3,42,1,3,27,7,1,2,1037996,"2023-12-25T00:00:00.000Z",200,23,"Tobias Harris",1,34,40,33,13,45.4
"8176",1195,1,1,2,1,0,3,2,2,0,17,0,5,4,2,0,0,1037996,"2023-12-25T00:00:00.000Z",3547270,23,"Paul Reed",1,6,7,5,3,10.9
"8177",1196,5,1,5,9,2,17,5,3,3,36,2,2,15,7,4,0,1037996,"2023-12-25T00:00:00.000Z",313,23,"De'Anthony Melton",5,22,27,20,12,45.9
"8178",1197,5,1,3,8,1,20,4,6,3,43,0,4,12,3,1,0,1037996,"2023-12-25T00:00:00.000Z",3547254,23,"Tyrese Maxey",2,15,20,17,8,29.1
"8179",1198,0,0,1,3,0,4,0,0,0,11,0,1,0,1,0,0,1037996,"2023-12-25T00:00:00.000Z",328,23,"Marcus Morris",0,1,1,0,1,1.2
"8180",1199,2,0,5,3,3,8,7,2,1,25,1,2,18,6,2,1,1037996,"2023-12-25T00:00:00.000Z",28,23,"Mo Bamba",2,24,26,20,8,33.2
"8181",1200,0,0,3,3,1,4,2,4,4,13,0,2,9,3,0,2,1037996,"2023-12-25T00:00:00.000Z",45,23,"Patrick Beverley",0,12,12,9,3,10.6
"8182",1201,1,0,1,3,0,5,1,4,3,11,0,0,5,1,1,1,1037686,"2023-11-06T00:00:00.000Z",38017679,7,"Jaden Hardy",1,6,7,6,2,9.7
"8183",1202,0,0,0,0,0,0,0,0,0,0,0,0,0,0,0,0,1037686,"2023-11-06T00:00:00.000Z",114,7,"Seth Curry",0,0,0,0,0,0
"8184",1203,0,0,0,0,0,0,0,0,0,0,0,0,0,0,0,0,1037686,"2023-11-06T00:00:00.000Z",151,7,"Dante Exum",0,0,0,0,0,0
"8185",1204,0,0,0,0,0,0,0,0,0,0,0,0,0,0,0,0,1037686,"2023-11-06T00:00:00.000Z",217,7,"Richaun Holmes",0,0,0,0,0,0
"8186",1205,0,0,0,0,0,0,0,0,0,0,0,0,0,0,0,0,1037686,"2023-11-06T00:00:00.000Z",329,7,"Markieff Morris",0,0,0,0,0,0
"8187",1206,0,0,0,0,0,0,0,0,0,0,0,0,0,0,0,0,1037686,"2023-11-06T00:00:00.000Z",85,22,"Wendell Carter Jr.",0,0,0,0,0,0
"8188",1207,0,0,0,0,0,0,0,0,0,0,0,0,0,0,0,0,1037686,"2023-11-06T00:00:00.000Z",56677859,7,"Olivier-Maxence Prosper",0,0,0,0,0,0
"8189",1208,0,0,0,0,0,0,0,0,0,0,0,0,0,0,0,0,1037686,"2023-11-06T00:00:00.000Z",165,22,"Markelle Fultz",0,0,0,0,0,0
"8190",1209,0,0,0,0,0,0,0,0,0,0,0,0,0,0,0,0,1037686,"2023-11-06T00:00:00.000Z",196,22,"Gary Harris",0,0,0,0,0,0
"8191",1210,2,0,3,3,0,6,2,0,0,27,4,3,4,7,0,0,1037688,"2023-11-06T00:00:00.000Z",283,17,"Brook Lopez",0,11,13,6,9,15.4
"8192",1211,0,0,6,5,1,5,1,0,0,14,0,2,3,6,0,1,1037688,"2023-11-06T00:00:00.000Z",38,17,"Malik Beasley",0,9,9,3,6,9.2
"8193",1212,7,0,4,8,2,15,5,10,9,34,2,1,21,6,1,1,1037688,"2023-11-06T00:00:00.000Z",278,17,"Damian Lillard",1,27,34,28,13,40.7
"8194",1213,1,0,0,1,0,5,1,6,4,18,0,1,6,0,0,0,1037695,"2023-11-06T00:00:00.000Z",38017709,8,"Christian Braun",0,6,7,7,1,7.5
"8195",1214,0,0,0,1,1,2,2,0,0,7,1,0,5,1,0,0,1037694,"2023-11-06T00:00:00.000Z",17896078,21,"Aaron Wiggins",0,6,6,5,1,6.2
"8196",1215,2,1,2,2,0,5,2,2,2,13,0,3,6,2,1,0,1037694,"2023-11-06T00:00:00.000Z",38017706,21,"Jaylin Williams",2,8,10,8,4,17.4
"8197",1216,4,0,2,3,0,6,3,0,0,24,0,1,6,2,4,1,1037694,"2023-11-06T00:00:00.000Z",56677833,21,"Cason Wallace",4,8,12,10,6,25.4
"8198",1217,0,0,0,0,0,0,0,0,0,0,0,0,0,0,0,0,1037694,"2023-11-06T00:00:00.000Z",4197029,21,"Vasilije Micic",0,0,0,0,0,0
"8199",1218,0,0,0,0,0,0,0,0,0,0,0,0,0,0,0,0,1037694,"2023-11-06T00:00:00.000Z",3547271,21,"Aleksej Pokusevski",0,0,0,0,0,0
"8200",1219,0,0,0,0,0,0,0,0,0,0,0,0,0,0,0,0,1037689,"2023-11-06T00:00:00.000Z",19465585,16,"Dru Smith",0,0,0,0,0,0
"8201",1220,0,0,0,0,0,0,0,0,0,0,0,0,0,0,0,0,1037689,"2023-11-06T00:00:00.000Z",38017734,16,"Jamal Cain",0,0,0,0,0,0
"8202",1221,0,0,0,0,0,0,0,0,0,0,0,0,0,0,0,0,1037694,"2023-11-06T00:00:00.000Z",27924547,21,"Lindy Waters III",0,0,0,0,0,0
"8203",1222,0,0,0,0,0,0,0,0,0,0,0,0,0,0,0,0,1037694,"2023-11-06T00:00:00.000Z",56677853,21,"Keyontae Johnson",0,0,0,0,0,0
"8204",1223,0,0,0,0,0,0,0,0,0,0,0,0,0,0,0,0,1037694,"2023-11-06T00:00:00.000Z",24572055,21,"Olivier Sarr",0,0,0,0,0,0
"8205",1224,0,0,0,0,0,0,0,0,0,0,0,0,0,0,0,0,1037694,"2023-11-06T00:00:00.000Z",480,21,"Kenrich Williams",0,0,0,0,0,0
"8206",1225,0,0,2,7,1,13,2,4,3,33,0,2,8,2,0,0,1037694,"2023-11-06T00:00:00.000Z",666656,1,"De'Andre Hunter",0,10,10,8,2,10.4
"8207",1226,15,4,5,6,5,12,6,12,11,43,2,3,28,7,1,4,1037917,"2023-12-14T00:00:00.000Z",192,13,"James Harden",5,35,50,43,22,69.9
"8208",1227,1,0,0,2,0,6,1,0,0,27,0,1,2,0,1,2,1037909,"2023-12-13T00:00:00.000Z",18678058,24,"Jordan Goodwin",1,2,3,3,1,4.5
"8209",1228,0,0,0,0,0,1,0,0,0,4,0,0,0,0,0,0,1037909,"2023-12-13T00:00:00.000Z",147,24,"Drew Eubanks",0,0,0,0,0,0
"8210",1229,1,0,2,1,0,3,1,0,0,12,0,1,2,2,0,1,1037909,"2023-12-13T00:00:00.000Z",32,24,"Keita Bates-Diop",0,4,5,3,3,4.9
"8211",1230,0,0,0,0,0,0,0,0,0,0,0,0,0,0,0,0,1037909,"2023-12-13T00:00:00.000Z",666451,24,"Bol Bol",0,0,0,0,0,0
"8212",1231,0,0,0,0,0,0,0,0,0,0,0,0,0,0,0,0,1037909,"2023-12-13T00:00:00.000Z",3547298,24,"Saben Lee",0,0,0,0,0,0
"8213",1232,0,0,0,0,0,0,0,0,0,0,0,0,0,0,0,0,1037909,"2023-12-13T00:00:00.000Z",8,24,"Grayson Allen",0,0,0,0,0,0
"8214",1233,0,0,0,0,0,0,0,0,0,0,0,0,0,0,0,0,1037909,"2023-12-13T00:00:00.000Z",3547095,24,"Udoka Azubuike",0,0,0,0,0,0
"8215",1234,1,0,1,3,0,8,2,10,10,25,0,3,14,1,0,3,1037907,"2023-12-13T00:00:00.000Z",38017686,12,"Bennedict Mathurin",0,15,16,15,2,13.7
"8216",1235,2,0,5,7,0,16,3,4,3,24,1,2,9,6,0,0,1037910,"2023-12-13T00:00:00.000Z",666423,20,"RJ Barrett",0,15,17,11,8,19.2
"8217",1236,6,1,9,6,2,23,14,2,2,39,3,4,32,12,1,2,1037910,"2023-12-13T00:00:00.000Z",387,20,"Julius Randle",2,44,50,38,18,59.4
"8218",1237,0,1,1,0,0,2,2,0,0,18,1,2,4,2,0,1,1037910,"2023-12-13T00:00:00.000Z",17896063,20,"Jericho Sims",1,6,6,4,2,8.4
"8219",1238,1,0,4,9,4,13,6,7,5,27,3,2,21,7,4,0,1037910,"2023-12-13T00:00:00.000Z",131,20,"Donte DiVincenzo",4,28,29,22,8,42.9
"8220",1239,8,0,5,6,0,19,6,16,11,39,2,4,23,7,2,3,1037910,"2023-12-13T00:00:00.000Z",73,20,"Jalen Brunson",2,30,38,31,15,46.4
"8221",1240,2,0,2,4,0,5,0,0,0,29,0,2,0,2,1,0,1037910,"2023-12-13T00:00:00.000Z",202,20,"Josh Hart",1,2,4,2,4,8.4
"8222",1241,1,0,1,4,3,8,6,0,0,18,1,1,15,2,2,1,1037910,"2023-12-13T00:00:00.000Z",3547269,20,"Immanuel Quickley",2,17,18,16,3,23.9
"8223",1242,0,1,3,0,0,4,3,1,1,30,3,3,7,6,0,0,1037910,"2023-12-13T00:00:00.000Z",201,20,"Isaiah Hartenstein",1,13,13,7,6,17.2
"8224",1243,1,0,2,3,0,4,1,2,0,16,0,1,2,2,0,1,1037910,"2023-12-13T00:00:00.000Z",17895858,20,"Quentin Grimes",0,4,5,3,3,4.9
"8225",1244,0,0,0,0,0,0,0,0,0,0,0,0,0,0,0,0,1037910,"2023-12-13T00:00:00.000Z",19,20,"Ryan Arcidiacono",0,0,0,0,0,0
"8226",1245,5,0,1,12,8,15,9,4,4,32,0,1,30,1,2,0,1037917,"2023-12-14T00:00:00.000Z",443,10,"Klay Thompson",2,31,36,35,6,44.7
"8227",1246,4,0,4,13,3,17,5,4,4,34,0,3,17,4,0,1,1037917,"2023-12-14T00:00:00.000Z",115,10,"Stephen Curry",0,21,25,21,8,26.8
"8228",1247,0,0,0,0,0,0,0,0,0,0,0,0,0,0,0,0,1037915,"2023-12-14T00:00:00.000Z",297,29,"Lauri Markkanen",0,0,0,0,0,0
"8229",1248,0,0,0,0,0,0,0,0,0,0,0,0,0,0,0,0,1037915,"2023-12-14T00:00:00.000Z",56677842,29,"Brice Sensabaugh",0,0,0,0,0,0
"8230",1249,3,0,2,5,2,9,4,2,2,29,0,4,12,2,0,2,1037917,"2023-12-14T00:00:00.000Z",367,10,"Chris Paul",0,14,17,15,5,16.9
"8231",1250,1,0,6,4,1,5,2,0,0,17,0,2,5,6,0,1,1037917,"2023-12-14T00:00:00.000Z",407,10,"Dario Saric",0,11,12,6,7,12.7
"8232",1251,7,0,0,8,4,12,5,0,0,28,2,2,14,2,2,0,1037621,"2023-10-28T00:00:00.000Z",249,30,"Tyus Jones",2,16,23,21,9,32.9
"8233",1252,0,0,0,0,0,0,0,0,0,0,0,0,0,0,0,0,1037621,"2023-10-28T00:00:00.000Z",38017704,30,"Patrick Baldwin Jr.",0,0,0,0,0,0
"8234",1253,0,0,0,0,0,0,0,0,0,0,0,0,0,0,0,0,1037621,"2023-10-28T00:00:00.000Z",18677954,30,"Jared Butler",0,0,0,0,0,0
"8235",1254,1,0,3,10,5,14,8,1,1,32,0,2,22,3,1,2,1037621,"2023-10-28T00:00:00.000Z",17896045,30,"Corey Kispert",1,25,26,23,4,28.1
"8236",1255,0,1,1,1,0,2,0,0,0,14,0,1,0,1,0,1,1037621,"2023-10-28T00:00:00.000Z",56677844,30,"Bilal Coulibaly",1,1,1,0,1,3.2
"8237",1256,1,0,0,1,0,3,2,1,1,8,0,0,5,0,1,0,1037621,"2023-10-28T00:00:00.000Z",167,30,"Danilo Gallinari",1,5,6,6,1,9.5
"8238",1257,0,0,0,0,0,0,0,0,0,0,0,0,0,0,0,0,1037621,"2023-10-28T00:00:00.000Z",3547302,30,"Anthony Gill",0,0,0,0,0,0
"8239",1258,0,0,0,0,0,0,0,0,0,0,0,0,0,0,0,0,1037621,"2023-10-28T00:00:00.000Z",38124126,30,"John Butler Jr.",0,0,0,0,0,0
"8240",1259,0,0,0,0,0,0,0,0,0,0,0,0,0,0,0,0,1037621,"2023-10-28T00:00:00.000Z",38017687,30,"Johnny Davis",0,0,0,0,0,0
"8241",1260,0,0,0,0,0,0,0,0,0,0,0,0,0,0,0,0,1037621,"2023-10-28T00:00:00.000Z",414,30,"Landry Shamet",0,0,0,0,0,0
"8242",1261,1,0,10,12,4,14,6,0,0,34,0,2,16,10,0,1,1037621,"2023-10-28T00:00:00.000Z",17896027,15,"Ziaire Williams",0,26,27,17,11,28.5
"8243",1262,2,1,5,4,2,12,4,6,6,31,0,4,16,5,1,1,1037621,"2023-10-28T00:00:00.000Z",231,15,"Jaren Jackson Jr.",2,21,23,18,7,30
"8244",1263,3,0,6,2,2,7,3,0,0,24,1,4,8,7,0,1,1037621,"2023-10-28T00:00:00.000Z",3547285,15,"Xavier Tillman",0,15,18,11,10,19.9
"8245",1264,5,1,1,10,4,20,10,2,2,34,1,4,26,2,1,5,1037621,"2023-10-28T00:00:00.000Z",3547287,15,"Desmond Bane",2,28,33,31,7,36.9
"8246",1265,6,2,4,5,1,8,4,0,0,32,0,2,9,4,2,2,1037621,"2023-10-28T00:00:00.000Z",420,15,"Marcus Smart",4,13,19,15,10,32.8
"8247",1266,1,0,1,5,1,9,2,0,0,16,0,0,5,1,0,0,1037621,"2023-10-28T00:00:00.000Z",38017728,15,"Jake LaRavia",0,6,7,6,2,7.7
"8248",1267,1,2,6,3,1,4,2,0,0,22,3,0,5,9,2,1,1037621,"2023-10-28T00:00:00.000Z",666703,15,"John Konchar",4,14,15,6,10,28.3
"8249",1268,5,1,0,2,1,8,3,0,0,18,1,0,7,1,1,3,1037621,"2023-10-28T00:00:00.000Z",401,15,"Derrick Rose",2,8,13,12,6,18.7
"8250",1269,2,1,6,4,3,8,5,1,1,24,0,3,14,6,0,1,1037621,"2023-10-28T00:00:00.000Z",38017729,15,"David Roddy",1,20,22,16,8,26.2
"8251",1270,1,0,0,0,0,1,0,0,0,5,0,2,0,0,0,1,1037621,"2023-10-28T00:00:00.000Z",38017732,15,"Kenneth Lofton Jr.",0,0,1,1,1,0.5
"8252",1271,0,0,0,0,0,0,0,0,0,0,0,0,0,0,0,0,1037621,"2023-10-28T00:00:00.000Z",48248287,15,"Jacob Gilyard",0,0,0,0,0,0
"8253",1272,0,0,0,0,0,0,0,0,0,0,0,0,0,0,0,0,1037621,"2023-10-28T00:00:00.000Z",56677830,15,"GG Jackson",0,0,0,0,0,0
"8254",1273,0,0,0,0,0,0,0,0,0,0,0,0,0,0,0,0,1037621,"2023-10-28T00:00:00.000Z",666786,15,"Ja Morant",0,0,0,0,0,0
"8255",1274,3,0,0,2,1,6,3,0,0,22,0,0,7,0,1,2,1037620,"2023-10-28T00:00:00.000Z",38017682,9,"Jaden Ivey",1,7,10,10,3,12.5
"8256",1275,1,0,2,1,0,2,1,0,0,6,1,0,2,3,0,0,1037620,"2023-10-28T00:00:00.000Z",56677792,9,"Marcus Sasser",0,5,6,3,4,7.1
"8257",1276,0,0,0,0,0,0,0,0,0,0,0,0,0,0,0,0,1037872,"2023-12-02T00:00:00.000Z",2189,10,"Gary Payton II",0,0,0,0,0,0
"8258",1277,0,0,0,0,0,0,0,0,0,0,0,0,0,0,0,0,1037872,"2023-12-02T00:00:00.000Z",45658838,10,"Lester Quinones",0,0,0,0,0,0
"8259",1278,0,0,0,0,0,0,0,0,0,0,0,0,0,0,0,0,1037872,"2023-12-02T00:00:00.000Z",57875092,10,"Gui Santos",0,0,0,0,0,0
"8260",1279,0,0,0,0,0,0,0,0,0,0,0,0,0,0,0,0,1037872,"2023-12-02T00:00:00.000Z",475,10,"Andrew Wiggins",0,0,0,0,0,0
"8261",1280,1,0,2,6,3,7,3,0,0,32,1,4,9,3,1,1,1037873,"2023-12-02T00:00:00.000Z",68,18,"Troy Brown Jr.",1,12,13,10,4,16.1
"8262",1281,10,0,5,7,1,9,3,8,7,34,0,2,14,5,0,1,1037873,"2023-12-02T00:00:00.000Z",104,18,"Mike Conley",0,19,29,24,15,34
"8263",1282,4,0,4,0,0,6,2,7,7,26,2,3,11,6,2,2,1037873,"2023-12-02T00:00:00.000Z",12,18,"Kyle Anderson",2,17,21,15,10,28.2
"8264",1283,2,0,3,6,3,14,9,2,2,24,2,0,23,5,1,2,1037873,"2023-12-02T00:00:00.000Z",667378,18,"Naz Reid",1,28,30,25,7,33
"8265",1284,2,0,1,2,0,8,2,2,2,23,0,2,6,1,1,0,1037873,"2023-12-02T00:00:00.000Z",320,18,"Shake Milton",1,7,9,8,3,13.2
"8266",1285,0,0,0,0,0,0,0,0,0,0,0,0,0,0,0,0,1037873,"2023-12-02T00:00:00.000Z",17896056,18,"Luka Garza",0,0,0,0,0,0
"8267",1286,0,0,0,0,0,0,0,0,0,0,0,0,0,0,0,0,1037873,"2023-12-02T00:00:00.000Z",38017715,18,"Josh Minott",0,0,0,0,0,0
"8268",1287,3,3,4,6,3,20,12,18,15,35,1,3,42,5,1,3,1037874,"2023-12-02T00:00:00.000Z",61,3,"Mikal Bridges",4,47,50,45,8,61.5
"8269",1288,3,0,4,6,3,10,5,2,1,30,3,2,14,7,0,0,1037874,"2023-12-02T00:00:00.000Z",666679,3,"Cameron Johnson",0,21,24,17,10,26.9
"8270",1289,1,1,3,0,0,4,3,0,0,24,4,4,6,7,0,1,1037874,"2023-12-02T00:00:00.000Z",666508,3,"Nicolas Claxton",1,13,14,7,8,17.9
"8271",1290,5,0,7,9,4,23,7,2,2,38,0,3,20,7,0,2,1037874,"2023-12-02T00:00:00.000Z",17896048,3,"Cam Thomas",0,27,32,25,12,33.9
"8272",1291,3,0,4,7,3,15,8,4,3,35,0,2,22,4,0,2,1037874,"2023-12-02T00:00:00.000Z",130,3,"Spencer Dinwiddie",0,26,29,25,7,29.3
"8273",1292,7,0,5,3,1,3,1,0,0,26,1,3,3,6,1,0,1037874,"2023-12-02T00:00:00.000Z",351,3,"Royce O'Neale",1,9,16,10,13,23.7
"8274",1293,0,0,0,0,0,0,0,0,0,0,0,0,0,0,0,0,1037873,"2023-12-02T00:00:00.000Z",38017700,18,"Wendell Moore Jr.",0,0,0,0,0,0
"8275",1294,0,0,0,0,0,0,0,0,0,0,0,0,0,0,0,0,1037873,"2023-12-02T00:00:00.000Z",17895968,18,"Daishen Nix",0,0,0,0,0,0
"8276",1295,0,0,0,0,0,0,0,0,0,0,0,0,0,0,0,0,1037873,"2023-12-02T00:00:00.000Z",56677851,18,"Jaylen Clark",0,0,0,0,0,0
"8277",1296,0,0,0,0,0,0,0,0,0,0,0,0,0,0,0,0,1037873,"2023-12-02T00:00:00.000Z",3547238,18,"Anthony Edwards",0,0,0,0,0,0
"8278",1297,0,0,0,0,0,0,0,0,0,0,0,0,0,0,0,0,1037873,"2023-12-02T00:00:00.000Z",3547259,18,"Jaden McDaniels",0,0,0,0,0,0
"8279",1298,0,0,0,0,0,0,0,0,0,0,0,0,0,0,0,0,1037873,"2023-12-02T00:00:00.000Z",666767,18,"Jordan McLaughlin",0,0,0,0,0,0
"8280",1299,0,0,0,0,0,0,0,0,0,0,0,0,0,0,0,0,1037873,"2023-12-02T00:00:00.000Z",56677782,18,"Leonard Miller",0,0,0,0,0,0
"8281",1300,0,0,0,0,0,0,0,0,0,0,0,0,0,0,0,0,1037874,"2023-12-02T00:00:00.000Z",158,3,"Dorian Finney-Smith",0,0,0,0,0,0
"8282",1301,1,0,3,7,1,13,3,2,2,23,0,3,9,3,1,0,1038076,"2024-01-05T00:00:00.000Z",56677823,4,"Brandon Miller",1,12,13,10,4,17.1
"8283",1302,7,0,3,7,1,17,5,4,4,36,1,2,15,4,1,3,1038076,"2024-01-05T00:00:00.000Z",403,4,"Terry Rozier",1,19,26,22,11,30.3
"8284",1303,4,0,1,2,0,9,3,0,0,16,1,1,6,2,1,0,1038076,"2024-01-05T00:00:00.000Z",422,4,"Ish Smith",1,8,12,10,6,17.4
"8285",1304,2,0,2,1,0,2,0,0,0,6,1,0,0,3,0,0,1038076,"2024-01-05T00:00:00.000Z",666950,4,"P.J. Washington",0,3,5,2,5,6.6
"8286",1306,0,0,2,2,2,6,4,0,0,16,0,0,10,2,1,1,1038076,"2024-01-05T00:00:00.000Z",56677846,4,"Nick Smith Jr.",1,12,12,10,2,14.4
"8287",1307,1,0,2,0,0,2,1,0,0,16,0,1,2,2,0,0,1038076,"2024-01-05T00:00:00.000Z",18678001,4,"JT Thor",0,4,5,3,3,5.9
"8288",1308,0,0,0,1,0,4,0,0,0,5,2,0,0,2,0,1,1038076,"2024-01-05T00:00:00.000Z",38017708,4,"Bryce McGowens",0,2,2,0,2,1.4
"8289",1309,4,2,3,14,9,19,11,0,0,37,1,4,31,4,0,2,1038081,"2024-01-05T00:00:00.000Z",8,24,"Grayson Allen",2,35,39,35,8,45.8
"8290",1310,0,0,2,0,0,3,3,1,1,17,0,0,7,2,2,2,1038081,"2024-01-05T00:00:00.000Z",314,24,"Chimezie Metu",2,9,9,7,2,13.4
"8291",1311,2,0,8,1,0,6,3,0,0,26,1,2,6,9,1,0,1038081,"2024-01-05T00:00:00.000Z",349,24,"Jusuf Nurkic",1,15,17,8,11,22.8
"8292",1312,0,0,0,0,0,0,0,0,0,0,0,0,0,0,0,0,1038079,"2024-01-05T00:00:00.000Z",132,7,"Luka Doncic",0,0,0,0,0,0
"8293",1313,0,0,0,0,0,0,0,0,0,0,0,0,0,0,0,0,1038079,"2024-01-05T00:00:00.000Z",151,7,"Dante Exum",0,0,0,0,0,0
"8294",1314,0,0,0,0,0,0,0,0,0,0,0,0,0,0,0,0,1038079,"2024-01-05T00:00:00.000Z",217,7,"Richaun Holmes",0,0,0,0,0,0
"8295",1315,0,0,0,0,0,0,0,0,0,0,0,0,0,0,0,0,1038079,"2024-01-05T00:00:00.000Z",257,7,"Maxi Kleber",0,0,0,0,0,0
"8296",1316,0,0,0,0,0,0,0,0,0,0,0,0,0,0,0,0,1038079,"2024-01-05T00:00:00.000Z",56677840,7,"Dereck Lively II",0,0,0,0,0,0
"8297",1317,0,0,0,0,0,0,0,0,0,0,0,0,0,0,0,0,1038079,"2024-01-05T00:00:00.000Z",329,7,"Markieff Morris",0,0,0,0,0,0
"8298",1318,0,0,0,0,0,0,0,0,0,0,0,0,0,0,0,0,1038079,"2024-01-05T00:00:00.000Z",666965,7,"Grant Williams",0,0,0,0,0,0
"8299",1319,9,0,7,6,2,18,11,1,1,37,1,2,25,8,0,2,1038081,"2024-01-05T00:00:00.000Z",37,24,"Bradley Beal",0,33,42,34,17,46.1
"8300",1320,10,0,5,7,2,19,9,0,0,35,0,2,20,5,2,3,1038081,"2024-01-05T00:00:00.000Z",57,24,"Devin Booker",2,25,35,30,15,44
"8301",1321,4,2,1,1,0,2,0,8,7,24,1,5,7,2,3,0,1038081,"2024-01-05T00:00:00.000Z",356,24,"Josh Okogie",5,9,13,11,6,30.4
"8302",1322,0,0,0,0,0,0,0,0,0,2,0,0,0,0,0,0,1038075,"2024-01-05T00:00:00.000Z",17896063,20,"Jericho Sims",0,0,0,0,0,0
"8303",1323,0,0,0,0,0,0,0,0,0,0,0,0,0,0,0,0,1038075,"2024-01-05T00:00:00.000Z",160,20,"Evan Fournier",0,0,0,0,0,0
"8304",1324,0,0,0,0,0,0,0,0,0,0,0,0,0,0,0,0,1038075,"2024-01-05T00:00:00.000Z",173,20,"Taj Gibson",0,0,0,0,0,0
"8305",1325,13,0,3,6,1,7,2,3,3,29,0,2,8,3,0,1,1038078,"2024-01-05T00:00:00.000Z",192,13,"James Harden",0,11,24,21,16,30.1
"8306",1326,0,0,0,0,0,0,0,0,0,0,0,0,0,0,0,0,1037786,"2023-11-20T00:00:00.000Z",56677846,4,"Nick Smith Jr.",0,0,0,0,0,0
"8307",1327,2,1,3,1,0,5,3,2,1,32,1,3,7,4,0,0,1037788,"2023-11-20T00:00:00.000Z",3547242,30,"Deni Avdija",1,11,13,9,6,17.8
"8308",1328,13,1,3,5,2,15,10,0,0,31,0,2,22,3,2,2,1037788,"2023-11-20T00:00:00.000Z",265,30,"Kyle Kuzma",3,25,38,35,16,52.1
"8309",1329,0,0,0,0,0,0,0,0,0,0,0,0,0,0,0,0,1037787,"2023-11-20T00:00:00.000Z",259,9,"Kevin Knox",0,0,0,0,0,0
"8310",1330,0,0,0,0,0,0,0,0,0,0,0,0,0,0,0,0,1037787,"2023-11-20T00:00:00.000Z",54,9,"Bojan Bogdanovic",0,0,0,0,0,0
"8311",1331,0,0,0,0,0,0,0,0,0,0,0,0,0,0,0,0,1037787,"2023-11-20T00:00:00.000Z",56677729,9,"Malcolm Cazalon",0,0,0,0,0,0
"8312",1332,0,0,0,0,0,0,0,0,0,0,0,0,0,0,0,0,1037787,"2023-11-20T00:00:00.000Z",197,9,"Joe Harris",0,0,0,0,0,0
"8313",1333,0,0,0,0,0,0,0,0,0,0,0,0,0,0,0,0,1037787,"2023-11-20T00:00:00.000Z",330,9,"Monte Morris",0,0,0,0,0,0
"8314",1334,0,0,0,0,0,0,0,0,0,0,0,0,0,0,0,0,1037787,"2023-11-20T00:00:00.000Z",42097199,9,"Jared Rhoden",0,0,0,0,0,0
"8315",1335,2,1,9,9,4,15,5,1,0,38,2,3,14,11,0,4,1037787,"2023-11-20T00:00:00.000Z",375,8,"Michael Porter Jr.",1,25,27,16,13,29.2
"8316",1336,2,2,4,0,0,14,7,0,0,29,2,3,14,6,0,0,1037788,"2023-11-20T00:00:00.000Z",666577,30,"Daniel Gafford",2,20,22,16,8,30.2
"8317",1337,1,0,1,9,3,26,11,5,5,33,0,4,30,1,0,0,1037788,"2023-11-20T00:00:00.000Z",666848,30,"Jordan Poole",0,31,32,31,2,32.7
"8318",1338,3,0,2,1,0,13,9,0,0,26,0,0,18,2,0,0,1037788,"2023-11-20T00:00:00.000Z",249,30,"Tyus Jones",0,20,23,21,5,24.9
"8319",1339,0,0,0,0,0,0,0,0,0,1,0,0,0,0,0,0,1037788,"2023-11-20T00:00:00.000Z",18677954,30,"Jared Butler",0,0,0,0,0,0
"8320",1340,0,0,0,0,0,0,0,0,0,0,0,0,0,0,0,0,1037788,"2023-11-20T00:00:00.000Z",38017704,30,"Patrick Baldwin Jr.",0,0,0,0,0,0
"8321",1341,0,0,0,0,0,0,0,0,0,0,0,0,0,0,0,0,1037788,"2023-11-20T00:00:00.000Z",38124126,30,"John Butler Jr.",0,0,0,0,0,0
"8322",1342,7,0,4,1,0,10,4,4,3,37,4,1,11,8,1,2,1037787,"2023-11-20T00:00:00.000Z",177,8,"Aaron Gordon",1,19,26,18,15,32.1
"8323",1343,5,1,5,4,1,8,4,0,0,15,0,1,9,5,0,1,1037787,"2023-11-20T00:00:00.000Z",246,8,"Nikola Jokic",1,14,19,14,10,24.5
"8324",1344,3,2,2,5,2,17,8,2,2,36,1,2,20,3,2,3,1037787,"2023-11-20T00:00:00.000Z",81,8,"Kentavious Caldwell-Pope",4,23,26,23,6,37.1
"8325",1345,6,1,3,3,1,15,9,3,2,32,0,2,21,3,1,0,1037787,"2023-11-20T00:00:00.000Z",236,8,"Reggie Jackson",2,24,30,27,9,39.6
"8326",1346,2,1,5,2,2,10,5,4,3,32,1,2,15,6,1,2,1037787,"2023-11-20T00:00:00.000Z",38017709,8,"Christian Braun",2,21,23,17,8,29.2
"8327",1347,2,2,1,0,0,2,1,2,2,14,0,1,4,1,0,1,1037787,"2023-11-20T00:00:00.000Z",38017721,8,"Peyton Watson",2,5,7,6,3,13.2
"8328",1348,0,0,0,0,0,0,0,0,0,0,0,0,0,0,0,0,1037787,"2023-11-20T00:00:00.000Z",38017727,8,"Collin Gillespie",0,0,0,0,0,0
"8329",1349,0,0,0,0,0,0,0,0,0,0,0,0,0,0,0,0,1037787,"2023-11-20T00:00:00.000Z",215,8,"Justin Holiday",0,0,0,0,0,0
"8330",1350,0,0,0,0,0,0,0,0,0,0,0,0,0,0,0,0,1037787,"2023-11-20T00:00:00.000Z",250,8,"DeAndre Jordan",0,0,0,0,0,0
"8331",1351,0,0,0,0,0,0,0,0,0,0,0,0,0,0,0,0,1037989,"2023-12-23T00:00:00.000Z",56677868,14,"D'Moi Hodge",0,0,0,0,0,0
"8332",1352,0,0,0,0,0,0,0,0,0,0,0,0,0,0,0,0,1037985,"2023-12-23T00:00:00.000Z",38017728,15,"Jake LaRavia",0,0,0,0,0,0
"8333",1353,0,0,0,0,0,0,0,0,0,0,0,0,0,0,0,0,1037990,"2023-12-23T00:00:00.000Z",17895854,27,"Charles Bassey",0,0,0,0,0,0
"8334",1354,0,0,0,0,0,0,0,0,0,0,0,0,0,0,0,0,1037985,"2023-12-23T00:00:00.000Z",38017729,15,"David Roddy",0,0,0,0,0,0
"8335",1355,0,0,0,0,0,0,0,0,0,0,0,0,0,0,0,0,1037985,"2023-12-23T00:00:00.000Z",3,15,"Steven Adams",0,0,0,0,0,0
"8336",1356,0,0,0,0,0,0,0,0,0,0,0,0,0,0,0,0,1037985,"2023-12-23T00:00:00.000Z",666505,15,"Brandon Clarke",0,0,0,0,0,0
"8337",1357,0,0,0,0,0,0,0,0,0,0,0,0,0,0,0,0,1037990,"2023-12-23T00:00:00.000Z",56677865,27,"Charles Bediako",0,0,0,0,0,0
"8338",1358,0,0,0,0,0,0,0,0,0,0,0,0,0,0,0,0,1037990,"2023-12-23T00:00:00.000Z",17896049,27,"David Duke Jr.",0,0,0,0,0,0
"8339",1359,1,0,3,2,0,6,3,6,6,31,0,3,12,3,0,0,1037992,"2023-12-23T00:00:00.000Z",30,26,"Harrison Barnes",0,15,16,13,4,17.1
"8340",1360,0,1,6,7,3,16,8,2,1,40,1,4,20,7,3,1,1037992,"2023-12-23T00:00:00.000Z",38017688,26,"Keegan Murray",4,27,27,20,7,39.4
"8341",1361,10,0,9,1,0,12,7,5,3,39,1,3,17,10,1,3,1037992,"2023-12-23T00:00:00.000Z",406,26,"Domantas Sabonis",1,27,37,27,20,44
"8342",1362,1,0,1,2,0,7,1,0,0,15,0,3,2,1,0,1,1037992,"2023-12-23T00:00:00.000Z",221,26,"Kevin Huerter",0,3,4,3,2,3.7
"8343",1363,6,0,2,11,3,23,10,4,4,39,2,1,27,4,2,3,1037992,"2023-12-23T00:00:00.000Z",161,26,"De'Aaron Fox",2,31,37,33,10,43.8
"8344",1364,0,0,3,3,1,3,1,0,0,18,1,1,3,4,2,1,1037992,"2023-12-23T00:00:00.000Z",17896030,26,"Chris Duarte",2,7,7,3,4,12.8
"8345",1365,3,0,4,4,1,8,4,3,1,27,3,1,10,7,0,1,1037992,"2023-12-23T00:00:00.000Z",290,26,"Trey Lyles",0,17,20,13,10,21.9
"8346",1366,1,1,2,0,0,6,3,1,1,9,0,2,7,2,1,1,1037992,"2023-12-23T00:00:00.000Z",306,26,"JaVale McGee",2,9,10,8,3,15.9
"8347",1367,0,0,1,1,0,1,0,0,0,8,0,1,0,1,1,0,1037992,"2023-12-23T00:00:00.000Z",4197162,26,"Aleksandar Vezenkov",1,1,1,0,1,4.2
"8348",1368,0,0,0,0,0,0,0,0,0,0,0,0,0,0,0,0,1037985,"2023-12-23T00:00:00.000Z",3547297,1,"Trent Forrest",0,0,0,0,0,0
"8349",1369,0,0,0,0,0,0,0,0,0,0,0,0,0,0,0,0,1037985,"2023-12-23T00:00:00.000Z",4197387,1,"Vit Krejci",0,0,0,0,0,0
"8350",1370,0,0,0,0,0,0,0,0,0,0,0,0,0,0,0,0,1037985,"2023-12-23T00:00:00.000Z",301,1,"Wesley Matthews",0,0,0,0,0,0
"8351",1371,0,0,0,0,0,0,0,0,0,0,0,0,0,0,0,0,1037985,"2023-12-23T00:00:00.000Z",319,1,"Patty Mills",0,0,0,0,0,0
"8352",1372,0,0,0,0,0,0,0,0,0,0,0,0,0,0,0,0,1037985,"2023-12-23T00:00:00.000Z",38017689,1,"AJ Griffin",0,0,0,0,0,0
"8353",1373,0,0,0,0,0,0,0,0,0,0,0,0,0,0,0,0,1037985,"2023-12-23T00:00:00.000Z",56677806,1,"Mouhamed Gueye",0,0,0,0,0,0
"8354",1374,0,0,0,0,0,0,0,0,0,0,0,0,0,0,0,0,1037985,"2023-12-23T00:00:00.000Z",666656,1,"De'Andre Hunter",0,0,0,0,0,0
"8355",1375,0,2,1,0,0,7,3,0,0,16,2,0,6,3,1,0,1037985,"2023-12-23T00:00:00.000Z",3547285,15,"Xavier Tillman",3,9,9,6,3,18.6
"8356",1376,7,0,3,6,4,9,7,0,0,29,0,1,18,3,1,1,1037691,"2023-11-06T00:00:00.000Z",666956,5,"Coby White",1,21,28,25,10,34.1
"8357",1377,3,0,0,2,2,3,3,2,2,20,1,1,10,1,1,0,1037691,"2023-11-06T00:00:00.000Z",89,5,"Alex Caruso",1,11,14,13,4,18.7
"8358",1378,0,0,3,4,2,10,4,0,0,25,0,1,10,3,0,0,1037691,"2023-11-06T00:00:00.000Z",3547248,5,"Patrick Williams",0,13,13,10,3,13.6
"8359",1379,1,0,0,8,4,8,4,0,0,17,0,1,12,0,2,0,1037691,"2023-11-06T00:00:00.000Z",87,5,"Jevon Carter",2,12,13,13,1,19.5
"8360",1380,1,1,2,0,0,10,5,3,2,14,5,2,12,7,1,2,1037691,"2023-11-06T00:00:00.000Z",137,5,"Andre Drummond",2,19,20,13,8,25.9
"8361",1381,0,0,1,3,2,5,2,2,2,16,0,0,8,1,0,1,1037691,"2023-11-06T00:00:00.000Z",17895983,5,"Ayo Dosunmu",0,9,9,8,1,8.2
"8362",1382,1,0,1,1,0,3,1,0,0,3,0,0,2,1,0,1,1037691,"2023-11-06T00:00:00.000Z",38017719,5,"Dalen Terry",0,3,4,3,2,3.7
"8363",1383,0,0,1,1,0,1,0,0,0,2,0,0,0,1,0,0,1037691,"2023-11-06T00:00:00.000Z",56677857,5,"Julian Phillips",0,1,1,0,1,1.2
"8364",1384,0,0,1,0,0,0,0,0,0,2,0,0,0,1,0,0,1037691,"2023-11-06T00:00:00.000Z",17896116,5,"Terry Taylor",0,1,1,0,1,1.2
"8365",1385,0,0,0,0,0,0,0,0,0,0,0,0,0,0,0,0,1037691,"2023-11-06T00:00:00.000Z",27,5,"Lonzo Ball",0,0,0,0,0,0
"8366",1386,0,0,0,0,0,0,0,0,0,0,0,0,0,0,0,0,1037691,"2023-11-06T00:00:00.000Z",56677874,5,"Onuralp Bitim",0,0,0,0,0,0
"8367",1387,0,0,1,2,1,2,1,0,0,14,0,1,3,1,0,0,1037686,"2023-11-06T00:00:00.000Z",38017724,22,"Caleb Houstan",0,4,4,3,1,4.2
"8368",1388,0,0,0,0,0,0,0,0,0,0,0,0,0,0,0,0,1037686,"2023-11-06T00:00:00.000Z",56677839,22,"Jett Howard",0,0,0,0,0,0
"8369",1389,0,0,0,0,0,0,0,0,0,0,0,0,0,0,0,0,1037686,"2023-11-06T00:00:00.000Z",666818,22,"Chuma Okeke",0,0,0,0,0,0
"8370",1390,0,0,0,0,0,0,0,0,0,0,0,0,0,0,0,0,1037686,"2023-11-06T00:00:00.000Z",666885,22,"Admiral Schofield",0,0,0,0,0,0
"8371",1391,0,0,0,1,0,4,0,4,2,12,1,1,2,1,1,1,1037687,"2023-11-06T00:00:00.000Z",17896025,23,"Jaden Springer",1,3,3,2,1,5.2
"8372",1392,2,0,4,0,0,3,3,0,0,13,2,1,6,6,1,1,1037687,"2023-11-06T00:00:00.000Z",3547270,23,"Paul Reed",1,12,14,8,8,18.2
"8373",1393,0,1,1,0,0,2,1,1,1,6,0,0,3,1,0,0,1037687,"2023-11-06T00:00:00.000Z",328,23,"Marcus Morris",1,4,4,3,1,7.2
"8374",1394,1,0,1,0,0,1,0,0,0,4,0,0,0,1,0,0,1037687,"2023-11-06T00:00:00.000Z",3547294,23,"Kenyon Martin Jr.",0,1,2,1,2,2.7
"8375",1395,0,0,1,2,0,2,0,1,1,4,0,0,1,1,0,0,1037687,"2023-11-06T00:00:00.000Z",167,30,"Danilo Gallinari",0,2,2,1,1,2.2
"8376",1396,0,2,0,1,0,3,2,2,1,8,1,0,5,1,1,0,1037687,"2023-11-06T00:00:00.000Z",3547302,30,"Anthony Gill",3,6,6,5,1,15.2
"8377",1397,4,0,5,4,1,13,5,2,1,33,0,3,12,5,1,1,1037686,"2023-11-06T00:00:00.000Z",17896026,22,"Franz Wagner",1,17,21,16,9,26
"8378",1398,0,0,3,0,0,3,0,0,0,11,0,0,0,3,0,0,1037684,"2023-11-06T00:00:00.000Z",3547240,9,"James Wiseman",0,3,3,0,3,3.6
"8379",1399,0,0,3,5,4,8,5,1,1,16,0,3,15,3,0,1,1037684,"2023-11-06T00:00:00.000Z",44477024,9,"Stanley Umude",0,18,18,15,3,17.6
"8380",1400,0,0,0,0,0,0,0,0,0,0,0,0,0,0,0,0,1037684,"2023-11-06T00:00:00.000Z",54,9,"Bojan Bogdanovic",0,0,0,0,0,0
"8381",1401,0,0,0,0,0,0,0,0,0,0,0,0,0,0,0,0,1037913,"2023-12-14T00:00:00.000Z",228,7,"Kyrie Irving",0,0,0,0,0,0
"8382",1402,0,0,0,0,0,0,0,0,0,0,0,0,0,0,0,0,1037913,"2023-12-14T00:00:00.000Z",257,7,"Maxi Kleber",0,0,0,0,0,0
"8383",1403,1,1,1,2,0,9,5,1,1,24,1,3,11,2,0,0,1037913,"2023-12-14T00:00:00.000Z",3547259,18,"Jaden McDaniels",1,13,14,12,3,17.9
"8384",1404,2,0,8,0,0,9,5,0,0,17,1,5,10,9,0,2,1037914,"2023-12-14T00:00:00.000Z",666508,3,"Nicolas Claxton",0,19,21,12,11,21.8
"8385",1405,0,0,3,2,0,13,5,6,3,27,0,3,13,3,0,0,1037914,"2023-12-14T00:00:00.000Z",17896048,3,"Cam Thomas",0,16,16,13,3,16.6
"8386",1406,8,0,4,4,1,11,5,7,6,24,0,3,17,4,1,2,1037914,"2023-12-14T00:00:00.000Z",130,3,"Spencer Dinwiddie",1,21,29,25,12,34.8
"8387",1407,6,2,2,1,0,9,4,0,0,22,2,2,8,4,0,2,1037914,"2023-12-14T00:00:00.000Z",17896058,3,"Trendon Watford",2,12,18,14,10,25.8
"8388",1408,5,1,9,1,0,9,4,0,0,26,4,4,8,13,0,3,1037914,"2023-12-14T00:00:00.000Z",17896038,3,"Day'Ron Sharpe",1,21,26,13,18,31.1
"8389",1409,1,0,1,0,0,1,1,0,0,14,0,1,2,1,1,1,1037914,"2023-12-14T00:00:00.000Z",351,3,"Royce O'Neale",1,3,4,3,2,6.7
"8390",1410,0,0,0,1,0,3,0,0,0,16,4,2,0,4,1,1,1037914,"2023-12-14T00:00:00.000Z",158,3,"Dorian Finney-Smith",1,4,4,0,4,6.8
"8391",1411,2,0,3,1,1,4,2,2,2,17,1,0,7,4,0,0,1037914,"2023-12-14T00:00:00.000Z",56677722,3,"Jalen Wilson",0,11,13,9,6,14.8
"8392",1412,2,0,0,6,2,9,2,0,0,15,2,0,6,2,0,1,1037914,"2023-12-14T00:00:00.000Z",9051997,3,"Armoni Brooks",0,8,10,8,4,10.4
"8393",1413,1,0,3,1,0,9,4,3,3,15,3,1,11,6,1,0,1037914,"2023-12-14T00:00:00.000Z",174,3,"Harry Giles III",1,17,18,12,7,22.7
"8394",1414,2,0,7,2,1,4,2,0,0,17,0,0,5,7,0,0,1037908,"2023-12-13T00:00:00.000Z",359,27,"Cedi Osman",0,12,14,7,9,16.4
"8395",1415,1,0,1,3,1,5,1,0,0,15,0,0,3,1,1,0,1037908,"2023-12-13T00:00:00.000Z",305,27,"Doug McDermott",1,4,5,4,2,8.7
"8396",1416,0,0,0,0,0,0,0,0,0,0,0,0,0,0,0,0,1037908,"2023-12-13T00:00:00.000Z",17896059,27,"Sandro Mamukelashvili",0,0,0,0,0,0
"8397",1417,0,0,0,0,0,0,0,0,0,0,0,0,0,0,0,0,1037906,"2023-12-13T00:00:00.000Z",420,15,"Marcus Smart",0,0,0,0,0,0
"8398",1418,7,0,8,3,1,11,6,1,1,29,1,3,14,9,1,1,1037907,"2023-12-13T00:00:00.000Z",315,17,"Khris Middleton",1,23,30,21,16,37.3
"8399",1419,3,1,11,3,0,28,20,32,24,37,3,1,64,14,4,3,1037907,"2023-12-13T00:00:00.000Z",15,17,"Giannis Antetokounmpo",5,78,81,67,17,97.3
"8400",1420,1,6,1,2,0,6,1,4,4,33,2,5,6,3,0,1,1037907,"2023-12-13T00:00:00.000Z",283,17,"Brook Lopez",6,9,10,7,4,28.1
"8401",1421,2,1,2,4,1,7,3,0,0,36,4,3,7,6,2,0,1037907,"2023-12-13T00:00:00.000Z",38,17,"Malik Beasley",3,13,15,9,8,26.2
"8402",1422,6,0,4,8,2,14,6,9,7,36,0,2,21,4,1,5,1037907,"2023-12-13T00:00:00.000Z",278,17,"Damian Lillard",1,25,31,27,10,32.8
"8403",1423,0,0,3,0,0,4,3,0,0,15,0,2,6,3,0,3,1037907,"2023-12-13T00:00:00.000Z",38017676,17,"MarJon Beauchamp",0,9,9,6,3,6.6
"8404",1424,2,0,1,4,3,13,8,0,0,23,1,2,19,2,0,0,1037907,"2023-12-13T00:00:00.000Z",377,17,"Bobby Portis",0,21,23,21,4,24.4
"8405",1425,5,0,4,2,0,9,4,1,1,16,1,1,9,5,2,3,1037907,"2023-12-13T00:00:00.000Z",304,12,"T.J. McConnell",2,14,19,14,10,25.5
"8406",1426,2,0,1,4,1,4,1,0,0,16,0,0,3,1,0,0,1037602,"2023-10-25T00:00:00.000Z",87,5,"Jevon Carter",0,4,6,5,3,7.2
"8407",1427,3,0,2,4,1,5,2,2,1,19,0,1,6,2,2,1,1037602,"2023-10-25T00:00:00.000Z",89,5,"Alex Caruso",2,8,11,9,5,17.9
"8408",1428,1,0,3,4,3,6,4,0,0,22,4,2,11,7,0,1,1037602,"2023-10-25T00:00:00.000Z",110,5,"Torrey Craig",0,18,19,12,8,19.9
"8409",1429,1,0,2,0,0,4,3,0,0,16,3,1,6,5,1,1,1037602,"2023-10-25T00:00:00.000Z",137,5,"Andre Drummond",1,11,12,7,6,15.5
"8410",1430,0,0,4,3,1,7,4,0,0,29,0,2,9,4,0,1,1037603,"2023-10-25T00:00:00.000Z",17896027,15,"Ziaire Williams",0,13,13,9,4,12.8
"8411",1431,3,5,4,5,0,9,2,4,4,36,1,5,8,5,0,3,1037603,"2023-10-25T00:00:00.000Z",231,15,"Jaren Jackson Jr.",5,13,16,11,8,30.5
"8412",1432,4,1,8,5,1,16,7,2,2,34,4,2,17,12,3,0,1037603,"2023-10-25T00:00:00.000Z",3547285,15,"Xavier Tillman",4,29,33,21,16,49.4
"8413",1433,5,1,5,10,5,22,11,5,4,36,0,1,31,5,2,2,1037603,"2023-10-25T00:00:00.000Z",3547287,15,"Desmond Bane",3,36,41,36,10,51.5
"8414",1434,3,0,0,6,2,11,6,6,3,32,0,3,17,0,2,5,1037603,"2023-10-25T00:00:00.000Z",420,15,"Marcus Smart",2,17,20,20,3,22.5
"8415",1435,2,0,4,3,1,7,4,0,0,28,1,2,9,5,0,1,1037603,"2023-10-25T00:00:00.000Z",38017729,15,"David Roddy",0,14,16,11,7,17
"8416",1436,2,0,1,5,0,5,0,3,3,15,1,0,3,2,0,1,1037603,"2023-10-25T00:00:00.000Z",254,15,"Luke Kennard",0,5,7,5,4,7.4
"8417",1437,0,0,0,0,0,0,0,0,0,0,0,0,0,0,0,0,1037603,"2023-10-25T00:00:00.000Z",48248287,15,"Jacob Gilyard",0,0,0,0,0,0
"8418",1438,0,0,0,0,0,0,0,0,0,0,0,0,0,0,0,0,1037603,"2023-10-25T00:00:00.000Z",56677830,15,"GG Jackson",0,0,0,0,0,0
"8419",1439,0,0,0,0,0,0,0,0,0,0,0,0,0,0,0,0,1037603,"2023-10-25T00:00:00.000Z",666703,15,"John Konchar",0,0,0,0,0,0
"8420",1440,1,0,2,1,0,2,0,0,0,4,0,0,0,2,0,0,1037602,"2023-10-25T00:00:00.000Z",38017719,5,"Dalen Terry",0,2,3,1,3,3.9
"8421",1441,0,0,0,0,0,0,0,0,0,0,0,0,0,0,0,0,1037602,"2023-10-25T00:00:00.000Z",27,5,"Lonzo Ball",0,0,0,0,0,0
"8422",1442,0,0,0,0,0,0,0,0,0,0,0,0,0,0,0,0,1037602,"2023-10-25T00:00:00.000Z",56677874,5,"Onuralp Bitim",0,0,0,0,0,0
"8423",1443,0,0,0,0,0,0,0,0,0,0,0,0,0,0,0,0,1037602,"2023-10-25T00:00:00.000Z",45969255,5,"Justin Lewis",0,0,0,0,0,0
"8424",1444,0,0,0,0,0,0,0,0,0,0,0,0,0,0,0,0,1037602,"2023-10-25T00:00:00.000Z",56677860,5,"Adama Sanogo",0,0,0,0,0,0
"8425",1445,2,1,7,5,2,8,3,0,0,32,0,1,8,7,2,2,1037602,"2023-10-25T00:00:00.000Z",666541,21,"Luguentz Dort",3,15,17,10,9,26.4
"8426",1446,5,0,3,6,2,11,5,4,4,32,0,3,16,3,1,2,1037602,"2023-10-25T00:00:00.000Z",38017703,21,"Jalen Williams",1,19,24,21,8,28.1
"8427",1447,3,0,4,3,2,7,4,3,1,25,0,3,11,4,1,1,1037602,"2023-10-25T00:00:00.000Z",38017685,21,"Chet Holmgren",1,15,18,14,7,22.3
"8428",1448,6,0,5,3,2,14,7,0,0,32,1,1,16,6,0,3,1037602,"2023-10-25T00:00:00.000Z",17896065,21,"Josh Giddey",0,22,28,22,12,29.2
"8429",1449,0,0,0,0,0,0,0,0,0,0,0,0,0,0,0,0,1037595,"2023-10-25T00:00:00.000Z",62,4,"Miles Bridges",0,0,0,0,0,0
"8430",1450,0,0,0,0,0,0,0,0,0,0,0,0,0,0,0,0,1037595,"2023-10-25T00:00:00.000Z",666748,4,"Cody Martin",0,0,0,0,0,0
"8431",1451,10,0,2,5,2,13,6,2,2,32,1,3,16,3,1,2,1037863,"2023-11-30T00:00:00.000Z",405,14,"D'Angelo Russell",1,19,29,26,13,35.6
"8432",1452,1,0,1,2,1,10,5,0,0,18,1,1,11,2,3,0,1037861,"2023-11-30T00:00:00.000Z",87,5,"Jevon Carter",3,13,14,12,3,23.9
"8433",1453,0,0,0,0,0,0,0,0,0,0,0,0,0,0,0,0,1037861,"2023-11-30T00:00:00.000Z",56677874,5,"Onuralp Bitim",0,0,0,0,0,0
"8434",1454,0,0,0,0,0,0,0,0,0,0,0,0,0,0,0,0,1037860,"2023-11-30T00:00:00.000Z",330,9,"Monte Morris",0,0,0,0,0,0
"8435",1455,0,0,0,0,0,0,0,0,0,0,0,0,0,0,0,0,1037860,"2023-11-30T00:00:00.000Z",42097199,9,"Jared Rhoden",0,0,0,0,0,0
"8436",1456,4,0,4,10,4,14,8,5,5,27,0,1,25,4,0,2,1037864,"2023-11-30T00:00:00.000Z",3547246,27,"Devin Vassell",0,29,33,29,8,33.8
"8437",1457,3,0,2,2,0,7,2,2,1,20,0,0,5,2,2,0,1037862,"2023-11-30T00:00:00.000Z",320,18,"Shake Milton",2,7,10,8,5,17.9
"8438",1458,0,0,1,4,1,5,1,0,0,10,0,0,3,1,0,0,1037862,"2023-11-30T00:00:00.000Z",17895968,18,"Daishen Nix",0,4,4,3,1,4.2
"8439",1459,0,0,0,0,0,0,0,0,0,0,0,0,0,0,0,0,1037862,"2023-11-30T00:00:00.000Z",17896056,18,"Luka Garza",0,0,0,0,0,0
"8440",1460,0,0,0,0,0,0,0,0,0,0,0,0,0,0,0,0,1037862,"2023-11-30T00:00:00.000Z",38017715,18,"Josh Minott",0,0,0,0,0,0
"8441",1461,0,0,0,0,0,0,0,0,0,0,0,0,0,0,0,0,1037862,"2023-11-30T00:00:00.000Z",38017700,18,"Wendell Moore Jr.",0,0,0,0,0,0
"8442",1462,0,0,0,0,0,0,0,0,0,0,0,0,0,0,0,0,1037862,"2023-11-30T00:00:00.000Z",56677851,18,"Jaylen Clark",0,0,0,0,0,0
"8443",1463,0,0,0,0,0,0,0,0,0,0,0,0,0,0,0,0,1037862,"2023-11-30T00:00:00.000Z",3547238,18,"Anthony Edwards",0,0,0,0,0,0
"8444",1464,0,0,0,0,0,0,0,0,0,0,0,0,0,0,0,0,1037862,"2023-11-30T00:00:00.000Z",3547259,18,"Jaden McDaniels",0,0,0,0,0,0
"8445",1465,0,0,0,0,0,0,0,0,0,0,0,0,0,0,0,0,1037859,"2023-11-30T00:00:00.000Z",3547207,12,"Jordan Nwora",0,0,0,0,0,0
"8446",1466,3,0,3,4,1,10,3,5,2,27,0,3,9,3,2,3,1037861,"2023-11-30T00:00:00.000Z",315,17,"Khris Middleton",2,12,15,12,6,20.1
"8447",1467,5,5,8,1,0,17,11,4,4,39,6,5,26,14,2,5,1037861,"2023-11-30T00:00:00.000Z",15,17,"Giannis Antetokounmpo",7,40,45,31,19,66.3
"8448",1468,7,0,2,3,1,5,1,1,0,24,0,1,3,2,0,2,1037864,"2023-11-30T00:00:00.000Z",3547274,27,"Tre Jones",0,5,12,10,9,13.9
"8449",1469,2,0,1,5,1,7,1,0,0,16,0,3,3,1,0,1,1037864,"2023-11-30T00:00:00.000Z",359,27,"Cedi Osman",0,4,6,5,3,6.2
"8450",1470,0,0,2,8,5,8,5,0,0,20,1,2,15,3,0,1,1037864,"2023-11-30T00:00:00.000Z",38017649,27,"Julian Champagnie",0,18,18,15,3,17.6
"8451",1471,0,0,0,0,0,0,0,0,0,0,0,0,0,0,0,0,1037864,"2023-11-30T00:00:00.000Z",180,27,"Devonte' Graham",0,0,0,0,0,0
"8452",1472,0,0,0,0,0,0,0,0,0,0,0,0,0,0,0,0,1037864,"2023-11-30T00:00:00.000Z",17896059,27,"Sandro Mamukelashvili",0,0,0,0,0,0
"8453",1473,0,0,0,0,0,0,0,0,0,0,0,0,0,0,0,0,1037860,"2023-11-30T00:00:00.000Z",54,9,"Bojan Bogdanovic",0,0,0,0,0,0
"8454",1474,0,0,0,0,0,0,0,0,0,0,0,0,0,0,0,0,1037860,"2023-11-30T00:00:00.000Z",56677729,9,"Malcolm Cazalon",0,0,0,0,0,0
"8455",1475,0,0,0,0,0,0,0,0,0,0,0,0,0,0,0,0,1037860,"2023-11-30T00:00:00.000Z",197,9,"Joe Harris",0,0,0,0,0,0
"8456",1476,0,0,0,0,0,0,0,0,0,0,0,0,0,0,0,0,1038082,"2024-01-05T00:00:00.000Z",45658838,10,"Lester Quinones",0,0,0,0,0,0
"8457",1477,3,0,3,4,2,9,4,1,0,32,1,2,10,4,3,1,1038065,"2024-01-03T00:00:00.000Z",8,24,"Grayson Allen",3,14,17,13,7,27.3
"8458",1478,0,0,4,7,4,12,7,0,0,18,2,1,18,6,1,0,1038062,"2024-01-03T00:00:00.000Z",17896027,15,"Ziaire Williams",1,24,24,18,6,28.2
"8459",1479,0,0,0,0,0,0,0,0,0,0,0,0,0,0,0,0,1038062,"2024-01-03T00:00:00.000Z",3,15,"Steven Adams",0,0,0,0,0,0
"8460",1480,0,0,0,0,0,0,0,0,0,0,0,0,0,0,0,0,1038062,"2024-01-03T00:00:00.000Z",666505,15,"Brandon Clarke",0,0,0,0,0,0
"8461",1481,0,0,0,0,0,0,0,0,0,0,0,0,0,0,0,0,1038062,"2024-01-03T00:00:00.000Z",48248287,15,"Jacob Gilyard",0,0,0,0,0,0
"8462",1482,0,0,0,0,0,0,0,0,0,0,0,0,0,0,0,0,1038062,"2024-01-03T00:00:00.000Z",56677830,15,"GG Jackson",0,0,0,0,0,0
"8463",1483,0,0,0,0,0,0,0,0,0,0,0,0,0,0,0,0,1038062,"2024-01-03T00:00:00.000Z",38017728,15,"Jake LaRavia",0,0,0,0,0,0
"8464",1484,0,0,0,0,0,0,0,0,0,0,0,0,0,0,0,0,1038062,"2024-01-03T00:00:00.000Z",38017731,15,"Vince Williams Jr.",0,0,0,0,0,0
"8465",1485,3,0,7,5,2,12,5,3,2,33,0,3,14,7,1,3,1038062,"2024-01-03T00:00:00.000Z",666423,28,"RJ Barrett",1,21,24,17,10,26.9
"8466",1486,0,0,6,2,1,14,9,6,5,30,1,5,24,7,1,3,1038062,"2024-01-03T00:00:00.000Z",416,28,"Pascal Siakam",1,31,31,24,7,32.4
"8467",1487,2,5,5,0,0,7,2,4,3,33,3,3,7,8,1,1,1038062,"2024-01-03T00:00:00.000Z",373,28,"Jakob Poeltl",6,15,17,9,10,36.6
"8468",1488,8,0,2,5,2,14,7,4,4,40,0,2,20,2,1,1,1038062,"2024-01-03T00:00:00.000Z",17896055,28,"Scottie Barnes",1,22,30,28,10,36.4
"8469",1489,0,1,3,7,0,13,3,2,2,32,1,2,8,4,3,0,1038085,"2024-01-06T00:00:00.000Z",3547250,12,"Aaron Nesmith",4,12,12,8,4,24.8
"8470",1490,2,0,6,4,1,6,2,2,2,26,1,2,7,7,0,0,1038085,"2024-01-06T00:00:00.000Z",3547264,12,"Jalen Smith",0,14,16,9,9,18.4
"8471",1491,2,0,4,5,0,11,5,4,2,30,3,3,12,7,0,0,1038085,"2024-01-06T00:00:00.000Z",452,12,"Myles Turner",0,19,21,14,9,23.4
"8472",1492,3,0,2,10,3,16,6,0,0,31,0,3,15,2,0,0,1038085,"2024-01-06T00:00:00.000Z",210,12,"Buddy Hield",0,17,20,18,5,21.9
"8473",1493,7,0,5,9,2,17,5,5,5,35,1,1,17,6,5,4,1038085,"2024-01-06T00:00:00.000Z",3547245,12,"Tyrese Haliburton",5,23,30,24,13,45.7
"8474",1494,0,0,2,0,0,3,2,0,0,9,1,4,4,3,0,0,1038085,"2024-01-06T00:00:00.000Z",17896035,12,"Isaiah Jackson",0,7,7,4,3,7.6
"8475",1495,0,0,0,0,0,0,0,0,0,1,0,0,0,0,0,0,1038085,"2024-01-06T00:00:00.000Z",38017701,12,"Kendall Brown",0,0,0,0,0,0
"8476",1496,6,0,7,4,2,13,9,5,3,33,3,5,23,10,2,4,1038086,"2024-01-06T00:00:00.000Z",3547242,30,"Deni Avdija",2,33,39,29,16,46
"8477",1497,2,1,2,10,4,21,10,4,3,32,0,3,27,2,0,3,1038086,"2024-01-06T00:00:00.000Z",265,30,"Kyle Kuzma",1,29,31,29,4,32.4
"8478",1498,0,0,0,0,0,0,0,0,0,0,0,0,0,0,0,0,1038082,"2024-01-05T00:00:00.000Z",57875092,10,"Gui Santos",0,0,0,0,0,0
"8479",1499,3,0,3,8,2,19,5,0,0,36,2,0,12,5,2,1,1038082,"2024-01-05T00:00:00.000Z",54,9,"Bojan Bogdanovic",2,17,20,15,8,27.5
"8480",1500,1,0,1,2,1,3,2,0,0,22,0,2,5,1,1,0,1038082,"2024-01-05T00:00:00.000Z",17896071,9,"Isaiah Livers",1,6,7,6,2,10.7
"8481",1501,4,0,2,6,3,15,8,7,7,34,3,5,26,5,1,2,1037775,"2023-11-18T00:00:00.000Z",3547287,15,"Desmond Bane",1,31,35,30,9,39
"8482",1502,0,1,2,8,2,20,7,12,11,27,3,3,27,5,1,2,1037775,"2023-11-18T00:00:00.000Z",231,15,"Jaren Jackson Jr.",2,32,32,27,5,37
"8483",1503,5,0,6,8,2,19,7,11,9,38,3,4,25,9,0,3,1037736,"2023-11-13T00:00:00.000Z",387,20,"Julius Randle",0,34,39,30,14,40.3
"8484",1504,1,2,3,0,0,2,2,2,0,33,3,2,4,6,1,1,1037736,"2023-11-13T00:00:00.000Z",399,20,"Mitchell Robinson",3,10,11,5,7,20.7
"8485",1505,1,0,0,6,4,6,4,0,0,28,0,2,12,0,0,0,1037736,"2023-11-13T00:00:00.000Z",17895858,20,"Quentin Grimes",0,12,13,13,1,13.5
"8486",1506,4,0,3,7,3,21,10,5,3,39,0,0,26,3,1,2,1037736,"2023-11-13T00:00:00.000Z",73,20,"Jalen Brunson",1,29,33,30,7,36.6
"8487",1507,1,0,6,2,1,10,1,4,4,26,0,3,7,6,1,0,1037736,"2023-11-13T00:00:00.000Z",3547269,20,"Immanuel Quickley",1,13,14,8,7,18.7
"8488",1508,1,0,0,4,1,6,2,0,0,16,1,1,5,1,0,0,1037736,"2023-11-13T00:00:00.000Z",131,20,"Donte DiVincenzo",0,6,7,6,2,7.7
"8489",1509,1,0,0,1,1,2,1,0,0,15,3,0,3,3,1,0,1037736,"2023-11-13T00:00:00.000Z",201,20,"Isaiah Hartenstein",1,6,7,4,4,11.1
"8490",1510,0,0,0,0,0,0,0,0,0,0,0,0,0,0,0,0,1037736,"2023-11-13T00:00:00.000Z",19,20,"Ryan Arcidiacono",0,0,0,0,0,0
"8491",1511,2,1,8,6,3,10,7,2,2,25,2,3,19,10,0,0,1037738,"2023-11-13T00:00:00.000Z",377,17,"Bobby Portis",1,29,31,21,12,37
"8492",1512,0,0,0,0,0,0,0,0,0,0,0,0,0,0,0,0,1037738,"2023-11-13T00:00:00.000Z",38017691,17,"TyTy Washington Jr.",0,0,0,0,0,0
"8493",1513,0,0,0,0,0,0,0,0,0,0,0,0,0,0,0,0,1037738,"2023-11-13T00:00:00.000Z",666960,17,"Lindell Wigginton",0,0,0,0,0,0
"8494",1514,0,0,0,0,0,0,0,0,0,0,0,0,0,0,0,0,1037738,"2023-11-13T00:00:00.000Z",666453,17,"Marques Bolden",0,0,0,0,0,0
"8495",1515,0,0,0,0,0,0,0,0,0,0,0,0,0,0,0,0,1037738,"2023-11-13T00:00:00.000Z",112,17,"Jae Crowder",0,0,0,0,0,0
"8496",1516,0,0,0,0,0,0,0,0,0,0,0,0,0,0,0,0,1037738,"2023-11-13T00:00:00.000Z",56677854,17,"Chris Livingston",0,0,0,0,0,0
"8497",1517,7,1,2,3,0,14,3,5,5,37,2,3,11,4,0,1,1037738,"2023-11-13T00:00:00.000Z",125,5,"DeMar DeRozan",1,15,22,18,11,28.3
"8498",1518,2,0,5,4,1,8,3,1,1,23,7,2,8,12,0,0,1037738,"2023-11-13T00:00:00.000Z",110,5,"Torrey Craig",0,20,22,10,14,25.4
"8499",1519,0,1,4,1,0,2,1,4,3,18,2,1,5,6,3,2,3277451,"2023-11-17T00:00:00.000Z",137,5,"Andre Drummond",4,11,11,5,6,22.2
"8500",1520,1,0,2,1,0,3,0,0,0,13,0,1,0,2,0,0,3277451,"2023-11-17T00:00:00.000Z",17895983,5,"Ayo Dosunmu",0,2,3,1,3,3.9
"8501",1521,0,0,1,3,1,3,1,0,0,26,0,3,3,1,1,1,3277451,"2023-11-17T00:00:00.000Z",110,5,"Torrey Craig",1,4,4,3,1,6.2
"8502",1522,1,0,2,1,0,3,0,0,0,13,0,1,0,2,1,3,3277451,"2023-11-17T00:00:00.000Z",3547248,5,"Patrick Williams",1,2,3,1,3,3.9
"8503",1523,0,0,0,0,0,0,0,0,0,0,0,0,0,0,0,0,3277451,"2023-11-17T00:00:00.000Z",56677857,5,"Julian Phillips",0,0,0,0,0,0
"8504",1524,0,0,0,0,0,0,0,0,0,0,0,0,0,0,0,0,3277451,"2023-11-17T00:00:00.000Z",17896116,5,"Terry Taylor",0,0,0,0,0,0
"8505",1525,0,0,0,0,0,0,0,0,0,0,0,0,0,0,0,0,3277451,"2023-11-17T00:00:00.000Z",27,5,"Lonzo Ball",0,0,0,0,0,0
"8506",1526,1,0,2,1,1,3,3,3,2,13,0,2,9,2,1,0,1037987,"2023-12-23T00:00:00.000Z",58,28,"Chris Boucher",1,11,12,10,3,15.9
"8507",1527,0,0,0,0,0,0,0,0,0,0,0,0,0,0,0,0,1037978,"2023-12-22T00:00:00.000Z",38017687,30,"Johnny Davis",0,0,0,0,0,0
"8508",1528,0,0,0,0,0,0,0,0,0,0,0,0,0,0,0,0,1037978,"2023-12-22T00:00:00.000Z",167,30,"Danilo Gallinari",0,0,0,0,0,0
"8509",1529,0,0,0,0,0,0,0,0,0,0,0,0,0,0,0,0,1037978,"2023-12-22T00:00:00.000Z",487,30,"Delon Wright",0,0,0,0,0,0
"8510",1530,4,0,3,3,0,9,1,0,0,15,0,3,2,3,1,2,1037982,"2023-12-23T00:00:00.000Z",236,8,"Reggie Jackson",1,5,9,6,7,12.6
"8511",1531,1,0,0,5,2,10,4,0,0,16,1,0,10,1,1,1,1037982,"2023-12-23T00:00:00.000Z",56677776,8,"Julian Strawther",1,11,12,11,2,14.7
"8512",1532,1,2,0,0,0,1,0,0,0,12,2,4,0,2,0,1,1037982,"2023-12-23T00:00:00.000Z",3547268,8,"Zeke Nnaji",2,2,3,1,3,8.9
"8513",1533,0,0,0,0,0,0,0,0,0,0,0,0,0,0,0,0,1037982,"2023-12-23T00:00:00.000Z",17896103,8,"Jay Huff",0,0,0,0,0,0
"8514",1534,0,0,0,0,0,0,0,0,0,0,0,0,0,0,0,0,1037982,"2023-12-23T00:00:00.000Z",250,8,"DeAndre Jordan",0,0,0,0,0,0
"8515",1535,0,1,4,6,2,9,3,0,0,30,1,2,8,5,0,2,1037989,"2023-12-23T00:00:00.000Z",666541,21,"Luguentz Dort",1,13,13,8,5,15
"8516",1536,3,0,6,5,2,17,11,4,4,34,0,3,28,6,0,1,1037989,"2023-12-23T00:00:00.000Z",38017703,21,"Jalen Williams",0,34,37,31,9,38.7
"8517",1537,0,3,6,6,1,18,8,5,2,34,4,1,19,10,1,0,1037989,"2023-12-23T00:00:00.000Z",38017685,21,"Chet Holmgren",4,29,29,19,10,43
"8518",1538,4,0,2,4,1,6,2,0,0,24,1,2,5,3,1,0,1037989,"2023-12-23T00:00:00.000Z",56677833,21,"Cason Wallace",1,8,12,9,7,17.6
"8519",1539,7,0,4,5,1,21,12,10,9,38,1,2,34,5,2,3,1037989,"2023-12-23T00:00:00.000Z",175,21,"Shai Gilgeous-Alexander",2,39,46,41,12,53.5
"8520",1540,0,0,0,2,1,3,2,0,0,11,0,2,5,0,0,0,1037989,"2023-12-23T00:00:00.000Z",38017716,21,"Ousmane Dieng",0,5,5,5,0,5
"8521",1541,1,2,4,6,1,11,3,0,0,20,1,1,7,5,1,1,1037989,"2023-12-23T00:00:00.000Z",3547272,21,"Isaiah Joe",3,12,13,8,6,22.5
"8522",1542,1,0,9,4,3,14,9,2,2,27,2,4,23,11,2,2,1037980,"2023-12-23T00:00:00.000Z",377,17,"Bobby Portis",2,34,35,24,12,41.7
"8523",1543,1,0,1,1,1,2,2,4,3,14,0,0,8,1,0,0,1037980,"2023-12-23T00:00:00.000Z",368,17,"Cameron Payne",0,9,10,9,2,10.7
"8524",1544,0,0,0,0,0,0,0,0,0,0,0,0,0,0,0,0,1037980,"2023-12-23T00:00:00.000Z",284,17,"Robin Lopez",0,0,0,0,0,0
"8525",1545,0,0,0,0,0,0,0,0,0,0,0,0,0,0,0,0,1037980,"2023-12-23T00:00:00.000Z",666453,17,"Marques Bolden",0,0,0,0,0,0
"8526",1546,0,0,0,0,0,0,0,0,0,0,0,0,0,0,0,0,1037980,"2023-12-23T00:00:00.000Z",112,17,"Jae Crowder",0,0,0,0,0,0
"8527",1547,0,0,0,0,0,0,0,0,0,0,0,0,0,0,0,0,1037980,"2023-12-23T00:00:00.000Z",38017691,17,"TyTy Washington Jr.",0,0,0,0,0,0
"8528",1548,0,0,0,0,0,0,0,0,0,0,0,0,0,0,0,0,1037980,"2023-12-23T00:00:00.000Z",666960,17,"Lindell Wigginton",0,0,0,0,0,0
"8529",1549,1,0,1,2,1,2,1,0,0,11,0,0,3,1,0,0,1037989,"2023-12-23T00:00:00.000Z",44,21,"Davis Bertans",0,4,5,4,2,5.7
"8530",1550,0,0,0,0,0,0,0,0,0,0,0,0,0,0,0,0,1037989,"2023-12-23T00:00:00.000Z",17896036,21,"Tre Mann",0,0,0,0,0,0
"8531",1551,3,0,3,8,4,8,4,0,0,20,0,1,12,3,0,0,1037694,"2023-11-06T00:00:00.000Z",3547272,21,"Isaiah Joe",0,15,18,15,6,20.1
"8532",1552,0,0,5,4,1,13,8,2,2,26,0,3,19,5,1,2,1037686,"2023-11-06T00:00:00.000Z",462,22,"Moritz Wagner",1,24,24,19,5,26
"8533",1553,0,0,0,0,0,0,0,0,0,0,0,0,0,0,0,0,1037684,"2023-11-06T00:00:00.000Z",38017682,9,"Jaden Ivey",0,0,0,0,0,0
"8534",1554,1,0,2,2,1,3,2,2,1,20,0,3,6,2,1,1,1037686,"2023-11-06T00:00:00.000Z",3547258,7,"Josh Green",1,8,9,7,3,11.9
"8535",1555,0,0,6,11,4,16,8,1,1,31,0,0,21,6,0,0,1037686,"2023-11-06T00:00:00.000Z",191,7,"Tim Hardaway Jr.",0,27,27,21,6,28.2
"8536",1556,2,2,1,0,0,2,2,5,3,29,0,3,7,1,1,0,1037686,"2023-11-06T00:00:00.000Z",379,7,"Dwight Powell",3,8,10,9,3,20.2
"8537",1557,1,0,1,3,0,5,1,4,3,11,0,0,5,1,1,1,1037686,"2023-11-06T00:00:00.000Z",38017679,7,"Jaden Hardy",1,6,7,6,2,9.7
"8538",1558,0,0,0,0,0,0,0,0,0,0,0,0,0,0,0,0,1037686,"2023-11-06T00:00:00.000Z",114,7,"Seth Curry",0,0,0,0,0,0
"8539",1559,0,0,0,0,0,0,0,0,0,0,0,0,0,0,0,0,1037686,"2023-11-06T00:00:00.000Z",151,7,"Dante Exum",0,0,0,0,0,0
"8540",1560,0,0,0,0,0,0,0,0,0,0,0,0,0,0,0,0,1037686,"2023-11-06T00:00:00.000Z",217,7,"Richaun Holmes",0,0,0,0,0,0
"8541",1561,0,0,0,0,0,0,0,0,0,0,0,0,0,0,0,0,1037686,"2023-11-06T00:00:00.000Z",329,7,"Markieff Morris",0,0,0,0,0,0
"8542",1562,0,0,0,0,0,0,0,0,0,0,0,0,0,0,0,0,1037686,"2023-11-06T00:00:00.000Z",85,22,"Wendell Carter Jr.",0,0,0,0,0,0
"8543",1563,0,0,0,0,0,0,0,0,0,0,0,0,0,0,0,0,1037686,"2023-11-06T00:00:00.000Z",56677859,7,"Olivier-Maxence Prosper",0,0,0,0,0,0
"8544",1564,0,0,0,0,0,0,0,0,0,0,0,0,0,0,0,0,1037686,"2023-11-06T00:00:00.000Z",165,22,"Markelle Fultz",0,0,0,0,0,0
"8545",1565,0,0,0,0,0,0,0,0,0,0,0,0,0,0,0,0,1037686,"2023-11-06T00:00:00.000Z",196,22,"Gary Harris",0,0,0,0,0,0
"8546",1566,3,1,4,12,5,15,8,8,8,34,1,2,29,5,0,1,1037691,"2023-11-06T00:00:00.000Z",297,29,"Lauri Markkanen",1,34,37,32,8,41.5
"8547",1567,0,0,5,2,1,9,6,1,1,29,1,5,14,6,1,2,1037691,"2023-11-06T00:00:00.000Z",101,29,"John Collins",1,20,20,14,6,22.2
"8548",1568,0,4,4,2,1,12,5,6,4,31,11,3,15,15,0,1,1037691,"2023-11-06T00:00:00.000Z",38017705,29,"Walker Kessler",4,30,30,15,15,44
"8549",1569,6,0,0,8,1,14,3,0,0,29,1,1,7,1,0,5,1037691,"2023-11-06T00:00:00.000Z",100,29,"Jordan Clarkson",0,8,14,13,7,12.2
"8550",1570,4,0,6,3,1,5,2,0,0,23,0,0,5,6,0,5,1037691,"2023-11-06T00:00:00.000Z",666650,29,"Talen Horton-Tucker",0,11,15,9,10,13.2
"8551",1571,3,0,3,1,1,1,1,0,0,10,2,1,3,5,0,2,1037691,"2023-11-06T00:00:00.000Z",139,29,"Kris Dunn",0,8,11,6,8,11.5
"8552",1572,1,1,1,2,1,3,1,0,0,11,0,2,3,1,0,2,1037691,"2023-11-06T00:00:00.000Z",38017620,29,"Ochai Agbaji",1,4,5,4,2,6.7
"8553",1573,5,1,2,2,1,3,2,1,1,12,2,0,6,4,1,1,1037687,"2023-11-06T00:00:00.000Z",45,23,"Patrick Beverley",2,10,15,11,9,23.3
"8554",1574,2,0,2,2,0,2,0,2,1,14,1,1,1,3,0,1,1037687,"2023-11-06T00:00:00.000Z",260,23,"Furkan Korkmaz",0,4,6,3,5,6.6
"8555",1575,0,1,0,1,1,2,2,2,2,4,0,2,7,0,3,0,1037687,"2023-11-06T00:00:00.000Z",108,23,"Robert Covington",4,7,7,7,0,19
"8556",1576,0,0,0,0,0,0,0,0,0,0,0,0,0,0,0,0,1037893,"2023-12-11T00:00:00.000Z",17896021,19,"Jeremiah Robinson-Earl",0,0,0,0,0,0
"8557",1577,1,0,2,2,0,7,4,4,2,13,0,1,10,2,0,2,1037890,"2023-12-11T00:00:00.000Z",359,27,"Cedi Osman",0,12,13,11,3,11.9
"8558",1578,2,0,0,1,0,1,0,5,3,16,0,1,3,0,2,0,1037890,"2023-12-11T00:00:00.000Z",3547274,27,"Tre Jones",2,3,5,5,2,12
"8559",1579,1,0,0,5,2,5,2,0,0,15,0,0,6,0,1,0,1037890,"2023-12-11T00:00:00.000Z",305,27,"Doug McDermott",1,6,7,7,1,10.5
"8560",1580,0,0,1,0,0,0,0,0,0,4,0,1,0,1,0,0,1037890,"2023-12-11T00:00:00.000Z",17896059,27,"Sandro Mamukelashvili",0,1,1,0,1,1.2
"8561",1581,0,0,0,0,0,0,0,0,0,0,0,0,0,0,0,0,1037890,"2023-12-11T00:00:00.000Z",180,27,"Devonte' Graham",0,0,0,0,0,0
"8562",1582,0,0,0,0,0,0,0,0,0,0,0,0,0,0,0,0,1037890,"2023-12-11T00:00:00.000Z",38017693,27,"Blake Wesley",0,0,0,0,0,0
"8563",1583,0,0,0,0,0,0,0,0,0,0,0,0,0,0,0,0,1037890,"2023-12-11T00:00:00.000Z",38017730,27,"Dominick Barlow",0,0,0,0,0,0
"8564",1584,0,0,0,0,0,0,0,0,0,0,0,0,0,0,0,0,1037890,"2023-12-11T00:00:00.000Z",17895854,27,"Charles Bassey",0,0,0,0,0,0
"8565",1585,0,0,0,0,0,0,0,0,0,0,0,0,0,0,0,0,1037890,"2023-12-11T00:00:00.000Z",56677865,27,"Charles Bediako",0,0,0,0,0,0
"8566",1586,0,0,0,0,0,0,0,0,0,0,0,0,0,0,0,0,1037890,"2023-12-11T00:00:00.000Z",56677817,27,"Sidy Cissoko",0,0,0,0,0,0
"8567",1587,0,0,0,0,0,0,0,0,0,0,0,0,0,0,0,0,1037890,"2023-12-11T00:00:00.000Z",56677870,27,"Sir'Jabari Rice",0,0,0,0,0,0
"8568",1588,0,0,0,0,0,0,0,0,0,0,0,0,0,0,0,0,1037893,"2023-12-11T00:00:00.000Z",491,19,"Cody Zeller",0,0,0,0,0,0
"8569",1589,0,0,0,0,0,0,0,0,0,0,0,0,0,0,0,0,1037892,"2023-12-11T00:00:00.000Z",27,5,"Lonzo Ball",0,0,0,0,0,0
"8570",1590,0,0,0,0,0,0,0,0,0,0,0,0,0,0,0,0,1037892,"2023-12-11T00:00:00.000Z",56677874,5,"Onuralp Bitim",0,0,0,0,0,0
"8571",1591,0,0,0,0,0,0,0,0,0,0,0,0,0,0,0,0,1037892,"2023-12-11T00:00:00.000Z",268,5,"Zach LaVine",0,0,0,0,0,0
"8572",1592,0,0,0,0,0,0,0,0,0,0,0,0,0,0,0,0,1037892,"2023-12-11T00:00:00.000Z",45969255,5,"Justin Lewis",0,0,0,0,0,0
"8573",1593,0,0,0,0,0,0,0,0,0,0,0,0,0,0,0,0,1037892,"2023-12-11T00:00:00.000Z",56677860,5,"Adama Sanogo",0,0,0,0,0,0
"8574",1594,2,0,1,4,1,4,1,0,0,14,0,1,3,1,1,0,1037895,"2023-12-11T00:00:00.000Z",38017714,26,"Keon Ellis",1,4,6,5,3,10.2
"8575",1595,1,1,6,6,5,7,6,0,0,23,0,0,17,6,0,0,1037895,"2023-12-11T00:00:00.000Z",290,26,"Trey Lyles",1,23,24,18,7,28.7
"8576",1596,2,0,1,0,0,2,0,0,0,8,2,3,0,3,0,1,1037895,"2023-12-11T00:00:00.000Z",306,26,"JaVale McGee",0,3,5,2,5,5.6
"8577",1597,0,0,0,0,0,0,0,0,0,3,0,0,0,0,0,0,1037895,"2023-12-11T00:00:00.000Z",17896044,26,"Kessler Edwards",0,0,0,0,0,0
"8578",1598,1,0,0,1,0,1,0,0,0,3,0,0,0,0,0,0,1037895,"2023-12-11T00:00:00.000Z",17896030,26,"Chris Duarte",0,0,1,1,1,1.5
"8579",1599,0,0,0,0,0,0,0,0,0,1,0,1,0,0,0,0,1037895,"2023-12-11T00:00:00.000Z",56677845,26,"Colby Jones",0,0,0,0,0,0
"8580",1600,0,0,0,0,0,0,0,0,0,0,0,0,0,0,0,0,1037890,"2023-12-11T00:00:00.000Z",56677831,11,"Cam Whitmore",0,0,0,0,0,0
"8581",1601,6,0,7,5,3,17,5,2,2,34,0,2,15,7,1,2,1037601,"2023-10-25T00:00:00.000Z",416,28,"Pascal Siakam",1,22,28,21,13,33.4
"8582",1602,1,1,8,0,0,3,3,4,1,24,3,1,7,11,1,0,1037601,"2023-10-25T00:00:00.000Z",373,28,"Jakob Poeltl",2,18,19,8,12,27.7
"8583",1603,5,5,7,4,1,16,6,6,4,37,1,1,17,8,2,4,1037601,"2023-10-25T00:00:00.000Z",17896055,28,"Scottie Barnes",7,25,30,22,13,51.1
"8584",1604,7,0,2,8,4,17,8,2,2,32,1,1,22,3,0,2,1037601,"2023-10-25T00:00:00.000Z",409,28,"Dennis Schroder",0,25,32,29,10,34.1
"8585",1605,6,0,6,1,0,11,6,4,2,28,2,4,14,8,0,1,1037598,"2023-10-25T00:00:00.000Z",17896062,11,"Alperen Sengun",0,22,28,20,14,31.6
"8586",1606,0,1,1,1,0,10,2,7,6,30,0,2,10,1,1,4,1037598,"2023-10-25T00:00:00.000Z",17895966,11,"Jalen Green",2,11,11,10,1,13.2
"8587",1607,5,0,1,6,4,13,5,0,0,34,0,0,14,1,1,3,1037598,"2023-10-25T00:00:00.000Z",458,11,"Fred VanVleet",1,15,20,19,6,22.7
"8588",1608,2,0,4,7,1,10,3,2,1,21,1,2,8,5,0,4,1037598,"2023-10-25T00:00:00.000Z",56677825,11,"Amen Thompson",0,13,15,10,7,13
"8589",1609,2,0,0,2,1,2,1,0,0,9,0,1,3,0,0,1,1037598,"2023-10-25T00:00:00.000Z",19465326,11,"Jock Landale",0,3,5,5,2,5
"8590",1610,0,1,2,1,1,2,2,0,0,15,0,1,5,2,1,0,1037598,"2023-10-25T00:00:00.000Z",3547301,11,"Jae'Sean Tate",2,7,7,5,2,13.4
"8591",1611,4,0,4,2,0,12,6,9,8,35,2,4,20,6,3,3,1037599,"2023-10-25T00:00:00.000Z",61,3,"Mikal Bridges",3,26,30,24,10,39.2
"8592",1612,3,0,3,4,1,10,5,2,1,26,2,1,12,5,2,2,1037599,"2023-10-25T00:00:00.000Z",666679,3,"Cameron Johnson",2,17,20,15,8,26.5
"8593",1613,4,3,3,0,0,10,3,1,1,28,4,1,7,7,0,0,1037599,"2023-10-25T00:00:00.000Z",666508,3,"Nicolas Claxton",3,14,18,11,11,30.4
"8594",1614,3,0,1,3,1,3,1,2,2,24,0,2,5,1,0,1,1037599,"2023-10-25T00:00:00.000Z",130,3,"Spencer Dinwiddie",0,6,9,8,4,9.7
"8595",1615,9,1,9,0,0,6,2,0,0,23,1,2,4,10,0,2,1037599,"2023-10-25T00:00:00.000Z",417,3,"Ben Simmons",1,14,23,13,19,30.5
"8596",1616,2,0,3,5,2,21,13,11,8,25,0,0,36,3,1,1,1037599,"2023-10-25T00:00:00.000Z",17896048,3,"Cam Thomas",1,39,41,38,5,44.6
"8597",1617,0,2,1,0,0,3,2,0,0,12,1,2,4,2,0,3,1037599,"2023-10-25T00:00:00.000Z",17896038,3,"Day'Ron Sharpe",2,6,6,4,2,9.4
"8598",1618,9,0,1,9,1,19,4,15,14,36,0,3,23,1,1,5,1037595,"2023-10-25T00:00:00.000Z",490,1,"Trae Young",1,24,33,32,10,35.7
"8599",1619,0,0,0,0,0,0,0,0,0,0,0,0,0,0,0,0,1037595,"2023-10-25T00:00:00.000Z",56677855,1,"Seth Lundy",0,0,0,0,0,0
"8600",1620,0,0,0,0,0,0,0,0,0,0,0,0,0,0,0,0,1037595,"2023-10-25T00:00:00.000Z",301,1,"Wesley Matthews",0,0,0,0,0,0
"8601",1621,0,0,0,0,0,0,0,0,0,0,0,0,0,0,0,0,1037595,"2023-10-25T00:00:00.000Z",56677875,1,"Miles Norris",0,0,0,0,0,0
"8602",1622,6,0,5,1,1,8,3,1,1,25,1,1,8,6,3,0,1037596,"2023-10-25T00:00:00.000Z",487,30,"Delon Wright",3,14,20,14,12,33.2
"8603",1623,1,0,3,5,1,11,4,2,2,25,2,1,11,5,0,1,1037596,"2023-10-25T00:00:00.000Z",17896045,30,"Corey Kispert",0,16,17,12,6,17.5
"8604",1624,0,0,1,2,2,7,4,6,6,17,2,1,16,3,0,0,1037596,"2023-10-25T00:00:00.000Z",167,30,"Danilo Gallinari",0,19,19,16,3,19.6
"8605",1625,3,3,4,1,1,3,1,0,0,23,0,1,3,4,0,3,1037596,"2023-10-25T00:00:00.000Z",56677844,30,"Bilal Coulibaly",3,7,10,6,7,18.3
"8606",1626,0,3,1,0,0,3,2,0,0,19,2,3,4,3,0,1,3277527,"2023-11-28T00:00:00.000Z",261,2,"Luke Kornet",3,7,7,4,3,15.6
"8607",1627,0,0,0,0,0,0,0,0,0,2,0,0,0,0,0,0,3277527,"2023-11-28T00:00:00.000Z",338,2,"Svi Mykhailiuk",0,0,0,0,0,0
"8608",1628,0,0,0,0,0,0,0,0,0,0,0,0,0,0,0,0,3277527,"2023-11-28T00:00:00.000Z",666468,2,"Oshae Brissett",0,0,0,0,0,0
"8609",1629,2,0,4,7,3,10,4,0,0,23,1,0,11,5,1,0,3277527,"2023-11-28T00:00:00.000Z",3547276,2,"Payton Pritchard",1,16,18,13,7,23
"8610",1630,0,1,0,0,0,0,0,0,0,1,0,0,0,0,0,0,3277527,"2023-11-28T00:00:00.000Z",3547279,2,"Lamar Stevens",1,0,0,0,0,3
"8611",1631,0,0,0,0,0,0,0,0,0,0,0,0,0,0,0,0,3277527,"2023-11-28T00:00:00.000Z",17553967,2,"Neemias Queta",0,0,0,0,0,0
"8612",1632,0,0,0,0,0,0,0,0,0,0,0,0,0,0,0,0,3277527,"2023-11-28T00:00:00.000Z",38017707,2,"JD Davison",0,0,0,0,0,0
"8613",1633,0,0,0,0,0,0,0,0,0,0,0,0,0,0,0,0,3277527,"2023-11-28T00:00:00.000Z",3547295,2,"Nathan Knight",0,0,0,0,0,0
"8614",1634,2,0,3,4,1,13,3,9,9,28,0,1,16,3,1,1,3277531,"2023-11-28T00:00:00.000Z",666423,20,"RJ Barrett",1,19,21,18,5,24.6
"8615",1635,5,0,16,7,2,15,8,8,7,34,4,2,25,20,2,4,3277531,"2023-11-28T00:00:00.000Z",387,20,"Julius Randle",2,45,50,30,25,58.5
"8616",1636,0,6,5,0,0,6,3,0,0,33,5,1,6,10,2,4,3277531,"2023-11-28T00:00:00.000Z",399,20,"Mitchell Robinson",8,16,16,6,10,38
"8617",1637,7,0,2,5,2,9,5,1,0,33,1,3,12,3,3,2,3277531,"2023-11-28T00:00:00.000Z",73,20,"Jalen Brunson",3,15,22,19,10,33.1
"8618",1638,1,0,0,3,2,4,2,0,0,19,1,0,6,1,0,1,3277531,"2023-11-28T00:00:00.000Z",17895858,20,"Quentin Grimes",0,7,8,7,2,7.7
"8619",1639,2,1,5,3,2,10,7,1,1,30,1,2,17,6,1,1,3277531,"2023-11-28T00:00:00.000Z",202,20,"Josh Hart",2,23,25,19,8,32.2
"8620",1640,1,0,3,10,4,20,9,1,1,26,0,1,23,3,0,1,3277531,"2023-11-28T00:00:00.000Z",3547269,20,"Immanuel Quickley",0,26,27,24,4,27.1
"8621",1641,0,0,2,6,2,8,2,0,0,19,0,0,6,2,1,2,3277531,"2023-11-28T00:00:00.000Z",131,20,"Donte DiVincenzo",1,8,8,6,2,9.4
"8622",1642,2,0,3,0,0,3,2,0,0,14,3,2,4,6,0,0,3277531,"2023-11-28T00:00:00.000Z",201,20,"Isaiah Hartenstein",0,10,12,6,8,14.2
"8623",1643,0,0,0,0,0,0,0,0,0,0,0,0,0,0,0,0,3277531,"2023-11-28T00:00:00.000Z",19,20,"Ryan Arcidiacono",0,0,0,0,0,0
"8624",1644,0,0,0,0,0,0,0,0,0,0,0,0,0,0,0,0,3277531,"2023-11-28T00:00:00.000Z",160,20,"Evan Fournier",0,0,0,0,0,0
"8625",1645,0,0,0,0,0,0,0,0,0,5,0,0,0,0,1,0,3277531,"2023-11-28T00:00:00.000Z",56677866,4,"Leaky Black",1,0,0,0,0,3
"8626",1646,0,0,0,0,0,0,0,0,0,0,0,0,0,0,0,0,3277527,"2023-11-28T00:00:00.000Z",378,2,"Kristaps Porzingis",0,0,0,0,0,0
"8627",1647,0,0,0,0,0,0,0,0,0,0,0,0,0,0,0,0,3277527,"2023-11-28T00:00:00.000Z",56677864,2,"Jordan Walsh",0,0,0,0,0,0
"8628",1648,6,0,2,3,1,14,7,4,4,26,0,2,19,2,0,2,3277527,"2023-11-28T00:00:00.000Z",125,5,"DeMar DeRozan",0,21,27,25,8,28.4
"8629",1649,2,2,3,3,1,10,6,2,1,28,4,2,14,7,1,2,3277527,"2023-11-28T00:00:00.000Z",3547248,5,"Patrick Williams",3,21,23,16,9,32.4
"8630",1650,2,1,8,2,0,11,4,0,0,25,0,1,8,8,2,1,3277527,"2023-11-28T00:00:00.000Z",460,5,"Nikola Vucevic",3,16,18,10,10,28.6
"8631",1651,0,4,3,8,4,18,7,6,6,37,1,1,24,4,1,3,1038062,"2024-01-03T00:00:00.000Z",231,15,"Jaren Jackson Jr.",5,28,28,24,4,40.8
"8632",1652,2,0,3,0,0,3,2,0,0,23,2,3,4,5,0,0,1038062,"2024-01-03T00:00:00.000Z",3547285,15,"Xavier Tillman",0,9,11,6,7,13
"8633",1653,8,0,2,6,2,18,9,2,2,38,2,4,22,4,0,0,1038062,"2024-01-03T00:00:00.000Z",3547287,15,"Desmond Bane",0,26,34,30,12,38.8
"8634",1654,9,0,7,6,3,18,10,6,5,35,1,1,28,8,1,2,1038062,"2024-01-03T00:00:00.000Z",666786,15,"Ja Morant",1,36,45,37,17,52.1
"8635",1655,3,0,7,4,2,6,2,2,1,22,1,4,7,8,1,1,1038062,"2024-01-03T00:00:00.000Z",17896067,15,"Santi Aldama",1,15,18,10,11,23.1
"8636",1656,1,1,2,0,0,2,0,0,0,8,0,0,0,2,2,1,1038062,"2024-01-03T00:00:00.000Z",666703,15,"John Konchar",3,2,3,1,3,11.9
"8637",1657,0,0,1,4,0,5,1,0,0,19,0,1,2,1,0,0,1038062,"2024-01-03T00:00:00.000Z",254,15,"Luke Kennard",0,3,3,2,1,3.2
"8638",1658,0,0,0,0,0,0,0,0,0,0,0,0,0,0,0,0,1038062,"2024-01-03T00:00:00.000Z",48,15,"Bismack Biyombo",0,0,0,0,0,0
"8639",1659,2,0,5,0,0,2,2,0,0,13,3,0,4,8,0,1,1038062,"2024-01-03T00:00:00.000Z",58,28,"Chris Boucher",0,12,14,6,10,15.6
"8640",1660,4,0,1,4,0,6,1,2,1,17,2,0,3,3,1,0,1038063,"2024-01-03T00:00:00.000Z",666767,18,"Jordan McLaughlin",1,6,10,7,7,15.6
"8641",1661,0,1,0,0,0,0,0,2,2,3,0,0,2,0,0,0,1038063,"2024-01-03T00:00:00.000Z",38017715,18,"Josh Minott",1,2,2,2,0,5
"8642",1662,0,0,0,1,1,2,2,0,0,3,0,0,5,0,0,0,1038063,"2024-01-03T00:00:00.000Z",320,18,"Shake Milton",0,5,5,5,0,5
"8643",1663,1,0,4,2,0,5,3,2,2,27,0,4,8,4,2,0,1038064,"2024-01-03T00:00:00.000Z",3547258,7,"Josh Green",2,12,13,9,5,20.3
"8644",1664,2,0,2,5,2,9,5,0,0,21,2,0,12,4,0,0,1038057,"2024-01-03T00:00:00.000Z",337,30,"Mike Muscala",0,16,18,14,6,19.8
"8645",1665,0,0,1,5,0,9,4,6,4,20,0,0,12,1,0,0,1038057,"2024-01-03T00:00:00.000Z",17896045,30,"Corey Kispert",0,13,13,12,1,13.2
"8646",1666,2,0,3,3,2,6,3,2,1,15,0,0,9,3,1,0,1038057,"2024-01-03T00:00:00.000Z",414,30,"Landry Shamet",1,12,14,11,5,18.6
"8647",1667,0,0,0,1,0,3,1,0,0,7,1,2,2,1,0,0,1038057,"2024-01-03T00:00:00.000Z",17896106,30,"Eugene Omoruyi",0,3,3,2,1,3.2
"8648",1668,0,0,1,0,0,1,1,0,0,5,0,0,2,1,0,0,1038057,"2024-01-03T00:00:00.000Z",3547302,30,"Anthony Gill",0,3,3,2,1,3.2
"8649",1669,0,0,0,0,0,0,0,0,0,0,0,0,0,0,0,0,1038057,"2024-01-03T00:00:00.000Z",38017704,30,"Patrick Baldwin Jr.",0,0,0,0,0,0
"8650",1671,0,0,0,0,0,0,0,0,0,0,0,0,0,0,0,0,1038057,"2024-01-03T00:00:00.000Z",38017712,30,"Ryan Rollins",0,0,0,0,0,0
"8651",1672,0,0,0,0,0,0,0,0,0,0,0,0,0,0,0,0,1038063,"2024-01-03T00:00:00.000Z",17896021,19,"Jeremiah Robinson-Earl",0,0,0,0,0,0
"8652",1673,2,2,6,5,2,8,3,0,0,25,0,2,8,6,0,1,1038063,"2024-01-03T00:00:00.000Z",667378,18,"Naz Reid",2,14,16,10,8,23.2
"8653",1674,0,0,0,0,0,0,0,0,0,0,0,0,0,0,0,0,1038063,"2024-01-03T00:00:00.000Z",17895968,18,"Daishen Nix",0,0,0,0,0,0
"8654",1675,0,0,0,0,0,0,0,0,0,0,0,0,0,0,0,0,1038063,"2024-01-03T00:00:00.000Z",56677851,18,"Jaylen Clark",0,0,0,0,0,0
"8655",1676,2,0,1,2,0,3,1,1,1,28,0,3,3,1,0,0,1037776,"2023-11-18T00:00:00.000Z",56677833,21,"Cason Wallace",0,4,6,5,3,7.2
"8656",1677,0,0,0,0,0,0,0,0,0,0,0,0,0,0,0,0,1037773,"2023-11-18T00:00:00.000Z",38017736,16,"Cole Swider",0,0,0,0,0,0
"8657",1678,0,0,0,0,0,0,0,0,0,0,0,0,0,0,0,0,1037775,"2023-11-18T00:00:00.000Z",56677870,27,"Sir'Jabari Rice",0,0,0,0,0,0
"8658",1679,0,0,0,0,0,0,0,0,0,0,0,0,0,0,0,0,1037775,"2023-11-18T00:00:00.000Z",3547246,27,"Devin Vassell",0,0,0,0,0,0
"8659",1680,4,0,2,6,3,15,8,7,7,34,3,5,26,5,1,2,1037775,"2023-11-18T00:00:00.000Z",3547287,15,"Desmond Bane",1,31,35,30,9,39
"8660",1681,0,1,2,8,2,20,7,12,11,27,3,3,27,5,1,2,1037775,"2023-11-18T00:00:00.000Z",231,15,"Jaren Jackson Jr.",2,32,32,27,5,37
"8661",1682,4,0,2,9,3,13,5,3,3,36,0,4,16,2,0,4,1037776,"2023-11-18T00:00:00.000Z",443,10,"Klay Thompson",0,18,22,20,6,20.4
"8662",1683,3,1,1,8,5,19,12,4,2,35,0,4,31,1,0,0,1037776,"2023-11-18T00:00:00.000Z",475,10,"Andrew Wiggins",1,32,35,34,4,39.7
"8663",1684,5,1,9,0,0,5,3,0,0,35,5,0,6,14,1,1,1037776,"2023-11-18T00:00:00.000Z",282,10,"Kevon Looney",2,20,25,11,19,35.3
"8664",1685,11,1,3,7,4,9,4,0,0,38,1,3,12,4,3,0,1037776,"2023-11-18T00:00:00.000Z",367,10,"Chris Paul",4,16,27,23,15,45.3
"8665",1686,3,0,6,11,5,21,8,4,4,40,0,2,25,6,0,2,1037776,"2023-11-18T00:00:00.000Z",115,10,"Stephen Curry",0,31,34,28,9,34.7
"8666",1687,3,0,3,4,1,6,2,4,3,25,1,0,8,4,0,3,1037776,"2023-11-18T00:00:00.000Z",56677858,10,"Brandin Podziemski",0,12,15,11,7,14.3
"8667",1688,1,0,6,2,0,9,3,0,0,18,2,1,6,8,0,1,1037776,"2023-11-18T00:00:00.000Z",407,10,"Dario Saric",0,14,15,7,9,16.1
"8668",1689,2,1,3,2,0,10,6,2,1,20,2,2,13,5,1,3,1037776,"2023-11-18T00:00:00.000Z",17553979,10,"Jonathan Kuminga",2,18,20,15,7,25
"8669",1690,0,0,0,0,0,0,0,0,0,0,0,0,0,0,0,0,1037773,"2023-11-18T00:00:00.000Z",56677874,5,"Onuralp Bitim",0,0,0,0,0,0
"8670",1691,0,0,0,0,0,0,0,0,0,0,0,0,0,0,0,0,1037773,"2023-11-18T00:00:00.000Z",45969255,5,"Justin Lewis",0,0,0,0,0,0
"8671",1692,0,0,0,0,0,0,0,0,0,0,0,0,0,0,0,0,1037773,"2023-11-18T00:00:00.000Z",56677857,5,"Julian Phillips",0,0,0,0,0,0
"8672",1693,0,0,0,0,0,0,0,0,0,0,0,0,0,0,0,0,1037773,"2023-11-18T00:00:00.000Z",56677860,5,"Adama Sanogo",0,0,0,0,0,0
"8673",1694,2,0,3,6,2,16,8,7,7,33,0,2,25,3,1,2,1037773,"2023-11-18T00:00:00.000Z",79,16,"Jimmy Butler",1,28,30,27,5,32.6
"8674",1695,0,0,2,3,0,4,0,0,0,24,1,1,0,3,3,4,1037773,"2023-11-18T00:00:00.000Z",3092,16,"Haywood Highsmith",3,3,3,0,3,8.6
"8675",1696,5,0,9,0,0,12,8,8,8,36,1,3,24,10,0,3,1037773,"2023-11-18T00:00:00.000Z",4,16,"Bam Adebayo",0,34,39,29,15,40.5
"8676",1697,2,0,1,1,0,3,1,0,0,12,0,3,2,1,0,1,1037775,"2023-11-18T00:00:00.000Z",38017732,15,"Kenneth Lofton Jr.",0,3,5,4,3,5.2
"8677",1698,5,0,6,3,2,8,4,8,7,25,1,1,17,7,1,1,1037775,"2023-11-18T00:00:00.000Z",17896027,15,"Ziaire Williams",1,24,29,22,12,34.9
"8678",1699,0,0,0,0,0,0,0,0,0,0,0,0,0,0,0,0,1037775,"2023-11-18T00:00:00.000Z",38017728,15,"Jake LaRavia",0,0,0,0,0,0
"8679",1700,0,0,0,0,0,0,0,0,0,0,0,0,0,0,0,0,1037775,"2023-11-18T00:00:00.000Z",38017731,15,"Vince Williams Jr.",0,0,0,0,0,0
"8680",1701,0,0,0,0,0,0,0,0,0,0,0,0,0,0,0,0,1038004,"2023-12-26T00:00:00.000Z",56677865,27,"Charles Bediako",0,0,0,0,0,0
"8681",1702,0,0,0,0,0,0,0,0,0,0,0,0,0,0,0,0,1038004,"2023-12-26T00:00:00.000Z",17896049,27,"David Duke Jr.",0,0,0,0,0,0
"8682",1703,6,1,3,3,1,6,2,2,2,23,2,1,7,5,0,0,1038004,"2023-12-26T00:00:00.000Z",358,29,"Kelly Olynyk",1,12,18,13,11,25
"8683",1704,2,0,9,9,5,17,12,2,2,31,3,3,31,12,1,1,1038004,"2023-12-26T00:00:00.000Z",297,29,"Lauri Markkanen",1,43,45,33,14,50.4
"8684",1705,0,1,4,4,1,7,2,2,2,18,0,1,7,4,0,3,1038004,"2023-12-26T00:00:00.000Z",101,29,"John Collins",1,11,11,7,4,11.8
"8685",1706,0,0,0,0,0,2,2,0,0,8,1,2,4,1,0,0,1038000,"2023-12-26T00:00:00.000Z",17896116,5,"Terry Taylor",0,5,5,4,1,5.2
"8686",1707,0,0,0,1,0,1,0,0,0,7,0,1,0,0,0,1,1038000,"2023-12-26T00:00:00.000Z",38017719,5,"Dalen Terry",0,0,0,0,0,-1
"8687",1708,0,0,0,0,0,0,0,0,0,0,0,0,0,0,0,0,1038000,"2023-12-26T00:00:00.000Z",56677857,5,"Julian Phillips",0,0,0,0,0,0
"8688",1709,0,0,0,0,0,0,0,0,0,0,0,0,0,0,0,0,1038000,"2023-12-26T00:00:00.000Z",56677860,5,"Adama Sanogo",0,0,0,0,0,0
"8689",1710,0,0,0,0,0,0,0,0,0,0,0,0,0,0,0,0,1038000,"2023-12-26T00:00:00.000Z",27,5,"Lonzo Ball",0,0,0,0,0,0
"8690",1711,0,0,0,0,0,0,0,0,0,0,0,0,0,0,0,0,1038000,"2023-12-26T00:00:00.000Z",56677874,5,"Onuralp Bitim",0,0,0,0,0,0
"8691",1713,0,0,0,0,0,0,0,0,0,0,0,0,0,0,0,0,1038000,"2023-12-26T00:00:00.000Z",268,5,"Zach LaVine",0,0,0,0,0,0
"8692",1714,0,0,0,0,0,0,0,0,0,0,0,0,0,0,0,0,1038000,"2023-12-26T00:00:00.000Z",460,5,"Nikola Vucevic",0,0,0,0,0,0
"8693",1715,3,3,6,4,1,4,1,4,3,27,2,0,6,8,1,2,1038002,"2023-12-26T00:00:00.000Z",38017731,15,"Vince Williams Jr.",4,14,17,9,11,30.1
"8694",1716,1,1,1,2,0,2,0,2,2,12,0,1,2,1,1,2,1038002,"2023-12-26T00:00:00.000Z",17896027,15,"Ziaire Williams",2,3,4,3,2,8.7
"8695",1717,0,5,5,1,0,3,1,0,0,28,3,1,2,8,1,0,1038002,"2023-12-26T00:00:00.000Z",3547285,15,"Xavier Tillman",6,10,10,2,8,29.6
"8696",1718,1,0,3,5,2,7,3,0,0,16,1,0,8,4,0,0,1038002,"2023-12-26T00:00:00.000Z",38017729,15,"David Roddy",0,12,13,9,5,14.3
"8697",1719,0,0,0,0,0,0,0,0,0,0,0,0,0,0,0,0,1038002,"2023-12-26T00:00:00.000Z",666703,15,"John Konchar",0,0,0,0,0,0
"8698",1720,0,0,0,0,0,0,0,0,0,0,0,0,0,0,0,0,1038002,"2023-12-26T00:00:00.000Z",3,15,"Steven Adams",0,0,0,0,0,0
"8699",1721,0,0,0,0,0,0,0,0,0,0,0,0,0,0,0,0,1038002,"2023-12-26T00:00:00.000Z",666505,15,"Brandon Clarke",0,0,0,0,0,0
"8700",1722,0,0,2,0,0,5,3,1,1,12,2,1,7,4,2,1,1038001,"2023-12-26T00:00:00.000Z",56677825,11,"Amen Thompson",2,11,11,7,4,16.8
"8701",1723,0,0,1,0,0,3,2,2,1,14,0,1,5,1,1,0,1038001,"2023-12-26T00:00:00.000Z",3547301,11,"Jae'Sean Tate",1,6,6,5,1,9.2
"8702",1724,1,0,3,6,3,10,6,0,0,25,0,1,15,3,1,1,1038001,"2023-12-26T00:00:00.000Z",213,11,"Aaron Holiday",1,18,19,16,4,22.1
"8703",1725,0,0,0,0,0,0,0,0,0,0,0,0,0,0,0,0,1038001,"2023-12-26T00:00:00.000Z",19465326,11,"Jock Landale",0,0,0,0,0,0
"8704",1726,0,0,0,0,0,0,0,0,0,0,0,0,0,0,0,0,1037699,"2023-11-08T00:00:00.000Z",666679,3,"Cameron Johnson",0,0,0,0,0,0
"8705",1727,0,0,0,0,0,0,0,0,0,0,0,0,0,0,0,0,1037699,"2023-11-08T00:00:00.000Z",17896041,3,"Keon Johnson",0,0,0,0,0,0
"8706",1728,0,0,0,0,0,0,0,0,0,0,0,0,0,0,0,0,1037699,"2023-11-08T00:00:00.000Z",417,3,"Ben Simmons",0,0,0,0,0,0
"8707",1729,3,1,3,1,0,3,1,1,1,21,3,3,3,6,1,0,1037699,"2023-11-08T00:00:00.000Z",450,13,"PJ Tucker",2,9,12,6,9,20.7
"8708",1730,0,0,1,2,0,6,2,0,0,6,1,0,4,2,0,1,1037699,"2023-11-08T00:00:00.000Z",17896031,13,"Nah'Shon Hyland",0,6,6,4,2,5.4
"8709",1731,1,0,4,2,0,2,0,0,0,19,0,1,0,4,0,2,1037699,"2023-11-08T00:00:00.000Z",666743,13,"Terance Mann",0,4,5,1,5,4.3
"8710",1732,1,2,1,5,2,8,4,0,0,23,0,2,10,1,3,1,1037699,"2023-11-08T00:00:00.000Z",380,13,"Norman Powell",5,11,12,11,2,26.7
"8711",1733,0,0,0,0,0,0,0,0,0,0,0,0,0,0,0,0,1037699,"2023-11-08T00:00:00.000Z",17896022,13,"Brandon Boston Jr.",0,0,0,0,0,0
"8712",1734,0,0,0,0,0,0,0,0,0,0,0,0,0,0,0,0,1037699,"2023-11-08T00:00:00.000Z",56677856,13,"Jordan Miller",0,0,0,0,0,0
"8713",1735,0,0,0,0,0,0,0,0,0,0,0,0,0,0,0,0,1037699,"2023-11-08T00:00:00.000Z",371,13,"Mason Plumlee",0,0,0,0,0,0
"8714",1736,0,0,0,0,0,0,0,0,0,0,0,0,0,0,0,0,1037699,"2023-11-08T00:00:00.000Z",17896051,13,"Joshua Primo",0,0,0,0,0,0
"8715",1737,1,2,3,7,2,9,3,0,0,37,1,4,8,4,0,1,1037704,"2023-11-08T00:00:00.000Z",3547267,9,"Isaiah Stewart",2,12,13,9,5,19.3
"8716",1738,5,0,9,1,0,10,5,1,1,28,3,5,11,12,0,2,1037704,"2023-11-08T00:00:00.000Z",38017694,9,"Jalen Duren",0,23,28,16,17,30.9
"8717",1739,8,0,6,8,2,27,11,10,9,39,2,2,33,8,0,5,1037704,"2023-11-08T00:00:00.000Z",17896075,9,"Cade Cunningham",0,41,49,41,16,49.6
"8718",1740,4,0,5,3,0,15,6,2,2,29,0,1,14,5,1,1,1037704,"2023-11-08T00:00:00.000Z",3547241,9,"Killian Hayes",1,19,23,18,9,28
"8719",1741,2,1,0,0,0,6,5,2,2,20,2,4,12,2,0,1,1037704,"2023-11-08T00:00:00.000Z",24,9,"Marvin Bagley III",1,14,16,14,4,19.4
"8720",1742,0,0,0,0,0,0,0,0,0,0,0,0,0,0,0,0,1037704,"2023-11-08T00:00:00.000Z",56677729,9,"Malcolm Cazalon",0,0,0,0,0,0
"8721",1743,0,0,0,0,0,0,0,0,0,0,0,0,0,0,0,0,1037704,"2023-11-08T00:00:00.000Z",197,9,"Joe Harris",0,0,0,0,0,0
"8722",1744,0,0,0,0,0,0,0,0,0,0,0,0,0,0,0,0,1037704,"2023-11-08T00:00:00.000Z",38017682,9,"Jaden Ivey",0,0,0,0,0,0
"8723",1745,0,0,0,0,0,0,0,0,0,0,0,0,0,0,0,0,1037697,"2023-11-08T00:00:00.000Z",56677832,12,"Jarace Walker",0,0,0,0,0,0
"8724",1746,0,0,0,0,0,0,0,0,0,0,0,0,0,0,0,0,1037697,"2023-11-08T00:00:00.000Z",38017701,12,"Kendall Brown",0,0,0,0,0,0
"8725",1747,0,0,0,0,0,0,0,0,0,0,0,0,0,0,0,0,1037697,"2023-11-08T00:00:00.000Z",56677842,29,"Brice Sensabaugh",0,0,0,0,0,0
"8726",1748,0,0,0,0,0,0,0,0,0,0,0,0,0,0,0,0,1037707,"2023-11-08T00:00:00.000Z",489,28,"Thaddeus Young",0,0,0,0,0,0
"8727",1749,0,0,0,0,0,0,0,0,0,0,0,0,0,0,0,0,1037707,"2023-11-08T00:00:00.000Z",3547249,28,"Precious Achiuwa",0,0,0,0,0,0
"8728",1750,0,0,0,0,0,0,0,0,0,0,0,0,0,0,0,0,1037707,"2023-11-08T00:00:00.000Z",56677805,28,"Javon Freeman-Liberty",0,0,0,0,0,0
"8729",1751,0,0,0,0,0,0,0,0,0,0,0,0,0,0,0,0,1037939,"2023-12-17T00:00:00.000Z",38017704,30,"Patrick Baldwin Jr.",0,0,0,0,0,0
"8730",1752,4,2,4,3,0,8,5,1,0,31,0,5,10,4,1,2,1037943,"2023-12-18T00:00:00.000Z",89,5,"Alex Caruso",3,14,18,14,8,27.8
"8731",1753,0,1,5,0,0,3,2,2,1,14,3,0,5,8,1,0,1037943,"2023-12-18T00:00:00.000Z",137,5,"Andre Drummond",2,13,13,5,8,20.6
"8732",1754,1,0,2,0,0,1,1,0,0,10,1,2,2,3,0,0,1037943,"2023-12-18T00:00:00.000Z",38017719,5,"Dalen Terry",0,5,6,3,4,7.1
"8733",1755,0,0,0,0,0,0,0,0,0,0,0,0,0,0,0,0,1037943,"2023-12-18T00:00:00.000Z",110,5,"Torrey Craig",0,0,0,0,0,0
"8734",1756,0,0,0,0,0,0,0,0,0,0,0,0,0,0,0,0,1037943,"2023-12-18T00:00:00.000Z",56677857,5,"Julian Phillips",0,0,0,0,0,0
"8735",1757,0,0,0,0,0,0,0,0,0,0,0,0,0,0,0,0,1037943,"2023-12-18T00:00:00.000Z",17896116,5,"Terry Taylor",0,0,0,0,0,0
"8736",1758,0,0,0,0,0,0,0,0,0,0,0,0,0,0,0,0,1037943,"2023-12-18T00:00:00.000Z",27,5,"Lonzo Ball",0,0,0,0,0,0
"8737",1759,1,0,1,5,2,18,12,2,2,27,1,2,28,2,1,3,1037942,"2023-12-18T00:00:00.000Z",274,13,"Kawhi Leonard",1,30,31,29,3,31.9
"8738",1760,1,0,2,0,0,1,1,8,2,18,2,2,4,4,0,0,1037941,"2023-12-18T00:00:00.000Z",444,6,"Tristan Thompson",0,8,9,5,5,10.3
"8739",1761,3,3,12,0,0,10,7,5,4,26,4,2,18,16,0,0,1037942,"2023-12-18T00:00:00.000Z",493,13,"Ivica Zubac",3,34,37,21,19,50.7
"8740",1762,1,1,1,3,0,5,2,0,0,28,1,0,4,2,0,1,1037942,"2023-12-18T00:00:00.000Z",666743,13,"Terance Mann",1,6,7,5,3,9.9
"8741",1763,9,1,3,11,8,16,12,3,3,28,0,2,35,3,1,1,1037942,"2023-12-18T00:00:00.000Z",192,13,"James Harden",2,38,47,44,12,57.1
"8742",1764,2,0,3,1,0,1,0,0,0,18,0,2,0,3,0,0,1037942,"2023-12-18T00:00:00.000Z",666511,13,"Amir Coffey",0,3,5,2,5,6.6
"8743",1765,0,2,4,0,0,4,1,2,2,22,5,2,4,9,0,2,1037942,"2023-12-18T00:00:00.000Z",439,13,"Daniel Theis",2,13,13,4,9,18.8
"8744",1766,0,0,3,6,4,11,6,3,3,30,0,1,19,3,0,0,1037942,"2023-12-18T00:00:00.000Z",380,13,"Norman Powell",0,22,22,19,3,22.6
"8745",1767,0,0,0,0,0,0,0,0,0,0,0,0,0,0,0,0,1037941,"2023-12-18T00:00:00.000Z",666581,6,"Darius Garland",0,0,0,0,0,0
"8746",1768,0,0,0,0,0,0,0,0,0,0,0,0,0,0,0,0,1037941,"2023-12-18T00:00:00.000Z",666676,6,"Ty Jerome",0,0,0,0,0,0
"8747",1769,0,0,0,0,0,0,0,0,0,0,0,0,0,0,0,0,1037941,"2023-12-18T00:00:00.000Z",17896076,6,"Evan Mobley",0,0,0,0,0,0
"8748",1770,0,0,0,0,0,0,0,0,0,0,0,0,0,0,0,0,1037941,"2023-12-18T00:00:00.000Z",38017662,6,"Isaiah Mobley",0,0,0,0,0,0
"8749",1771,0,0,0,0,0,0,0,0,0,0,0,0,0,0,0,0,1037941,"2023-12-18T00:00:00.000Z",404,6,"Ricky Rubio",0,0,0,0,0,0
"8750",1772,2,0,2,7,3,12,6,2,1,38,1,3,16,3,0,0,1037941,"2023-12-18T00:00:00.000Z",66,11,"Dillon Brooks",0,19,21,18,5,22.6
"8751",1773,0,0,4,4,1,7,2,0,0,23,3,4,5,7,0,2,1037941,"2023-12-18T00:00:00.000Z",38017684,11,"Jabari Smith Jr.",0,12,12,5,7,11.4
"8752",1774,0,0,0,0,0,4,3,0,0,6,0,2,6,0,0,1,1037942,"2023-12-18T00:00:00.000Z",17896022,13,"Brandon Boston Jr.",0,6,6,6,0,5
"8753",1775,1,0,1,1,0,2,0,0,0,6,0,1,0,1,0,1,1037942,"2023-12-18T00:00:00.000Z",56677849,13,"Kobe Brown",0,1,2,1,2,1.7
"8754",1776,0,0,0,0,0,0,0,0,0,0,0,0,0,0,0,0,1037652,"2023-11-01T00:00:00.000Z",666423,20,"RJ Barrett",0,0,0,0,0,0
"8755",1777,1,0,0,1,1,2,2,0,0,5,0,0,5,0,0,0,1037648,"2023-11-01T00:00:00.000Z",56677854,17,"Chris Livingston",0,5,6,6,1,6.5
"8756",1778,1,0,1,0,0,1,1,0,0,5,0,1,2,1,0,0,1037648,"2023-11-01T00:00:00.000Z",38017733,17,"A.J. Green",0,3,4,3,2,4.7
"8757",1779,0,0,0,0,0,0,0,0,0,0,0,0,0,0,0,0,1037648,"2023-11-01T00:00:00.000Z",284,17,"Robin Lopez",0,0,0,0,0,0
"8758",1780,0,0,0,0,0,0,0,0,0,0,0,0,0,0,0,0,1037648,"2023-11-01T00:00:00.000Z",666453,17,"Marques Bolden",0,0,0,0,0,0
"8759",1781,0,0,0,0,0,0,0,0,0,0,0,0,0,0,0,0,1037648,"2023-11-01T00:00:00.000Z",38017691,17,"TyTy Washington Jr.",0,0,0,0,0,0
"8760",1782,1,0,0,6,2,13,5,1,1,20,0,1,13,0,1,1,1037649,"2023-11-01T00:00:00.000Z",666848,30,"Jordan Poole",1,13,14,14,1,16.5
"8761",1783,3,0,1,3,0,6,3,0,0,22,0,1,6,1,1,1,1037649,"2023-11-01T00:00:00.000Z",249,30,"Tyus Jones",1,7,10,9,4,13.7
"8762",1784,5,0,3,10,6,23,12,1,0,36,0,2,30,3,0,3,1037651,"2023-11-01T00:00:00.000Z",666633,16,"Tyler Herro",0,33,38,35,8,38.1
"8763",1785,3,1,3,5,2,5,2,0,0,30,0,3,6,3,2,2,1037651,"2023-11-01T00:00:00.000Z",286,16,"Kyle Lowry",3,9,12,9,6,21.1
"8764",1786,3,0,3,5,1,9,1,2,1,30,0,2,4,3,1,0,1037651,"2023-11-01T00:00:00.000Z",391,16,"Josh Richardson",1,7,10,7,6,15.1
"8765",1787,2,1,4,4,3,5,3,0,0,22,0,0,9,4,1,1,1037651,"2023-11-01T00:00:00.000Z",3092,16,"Haywood Highsmith",2,13,15,11,6,21.8
"8766",1788,2,0,3,6,1,8,2,0,0,21,0,4,5,3,0,1,1037651,"2023-11-01T00:00:00.000Z",397,16,"Duncan Robinson",0,8,10,7,5,10.6
"8767",1789,0,0,4,0,0,4,3,2,2,15,1,4,8,5,1,2,1037651,"2023-11-01T00:00:00.000Z",74,16,"Thomas Bryant",1,13,13,8,5,15
"8768",1790,0,0,0,0,0,0,0,0,0,0,0,0,0,0,0,0,1037651,"2023-11-01T00:00:00.000Z",38017696,16,"Nikola Jovic",0,0,0,0,0,0
"8769",1791,0,0,0,0,0,0,0,0,0,0,0,0,0,0,0,0,1037651,"2023-11-01T00:00:00.000Z",39398582,16,"Orlando Robinson",0,0,0,0,0,0
"8770",1792,0,0,0,0,0,0,0,0,0,0,0,0,0,0,0,0,1037651,"2023-11-01T00:00:00.000Z",19465585,16,"Dru Smith",0,0,0,0,0,0
"8771",1793,0,0,0,0,0,0,0,0,0,0,0,0,0,0,0,0,1037651,"2023-11-01T00:00:00.000Z",38017734,16,"Jamal Cain",0,0,0,0,0,0
"8772",1794,0,0,0,0,0,0,0,0,0,0,0,0,0,0,0,0,1037651,"2023-11-01T00:00:00.000Z",3547257,16,"R.J. Hampton",0,0,0,0,0,0
"8773",1795,0,0,0,0,0,0,0,0,0,0,0,0,0,0,0,0,1037651,"2023-11-01T00:00:00.000Z",285,16,"Kevin Love",0,0,0,0,0,0
"8774",1796,0,0,0,0,0,0,0,0,0,0,0,0,0,0,0,0,1037651,"2023-11-01T00:00:00.000Z",666747,16,"Caleb Martin",0,0,0,0,0,0
"8775",1797,0,2,3,3,1,9,4,0,0,18,2,3,9,5,0,0,1037655,"2023-11-01T00:00:00.000Z",3547268,8,"Zeke Nnaji",2,14,14,9,5,21
"8776",1798,1,0,2,1,0,3,2,0,0,16,0,2,4,2,0,2,1037655,"2023-11-01T00:00:00.000Z",38017721,8,"Peyton Watson",0,6,7,5,3,5.9
"8777",1799,0,2,0,6,1,7,2,1,0,16,0,0,5,0,1,0,1037655,"2023-11-01T00:00:00.000Z",56677776,8,"Julian Strawther",3,5,5,5,0,14
"8778",1800,3,0,0,0,0,2,0,0,0,5,0,2,0,0,0,0,1037655,"2023-11-01T00:00:00.000Z",17896007,8,"Braxton Key",0,0,3,3,3,4.5
"8779",1801,0,0,0,0,0,0,0,0,0,0,0,0,0,0,0,0,7050291,"2023-12-08T00:00:00.000Z",139,29,"Kris Dunn",0,0,0,0,0,0
"8780",1802,0,0,0,0,0,0,0,0,0,0,0,0,0,0,0,0,7050291,"2023-12-08T00:00:00.000Z",666881,29,"Luka Samanic",0,0,0,0,0,0
"8781",1803,0,0,0,0,0,0,0,0,0,0,0,0,0,0,0,0,7050291,"2023-12-08T00:00:00.000Z",11891374,29,"Omer Yurtseven",0,0,0,0,0,0
"8782",1804,0,0,0,0,0,0,0,0,0,0,0,0,0,0,0,0,7050291,"2023-12-08T00:00:00.000Z",17896023,29,"Josh Christopher",0,0,0,0,0,0
"8783",1805,0,0,0,0,0,0,0,0,0,0,0,0,0,0,0,0,7050291,"2023-12-08T00:00:00.000Z",38017630,29,"Johnny Juzang",0,0,0,0,0,0
"8784",1806,0,0,0,0,0,0,0,0,0,0,0,0,0,0,0,0,7050291,"2023-12-08T00:00:00.000Z",297,29,"Lauri Markkanen",0,0,0,0,0,0
"8785",1807,0,0,0,0,0,0,0,0,0,0,0,0,0,0,0,0,7050291,"2023-12-08T00:00:00.000Z",19465584,29,"Micah Potter",0,0,0,0,0,0
"8786",1808,0,0,0,0,0,0,0,0,0,0,0,0,0,0,0,0,7050291,"2023-12-08T00:00:00.000Z",56677842,29,"Brice Sensabaugh",0,0,0,0,0,0
"8787",1809,5,1,2,8,6,23,14,7,7,38,3,1,41,5,0,2,7050291,"2023-12-08T00:00:00.000Z",274,13,"Kawhi Leonard",1,46,51,46,10,55.5
"8788",1810,2,1,3,5,2,13,8,3,2,37,0,2,20,3,6,1,7050291,"2023-12-08T00:00:00.000Z",172,13,"Paul George",7,23,25,22,5,46.6
"8789",1811,3,2,7,0,0,15,9,0,0,42,5,5,18,12,0,1,7050291,"2023-12-08T00:00:00.000Z",493,13,"Ivica Zubac",2,30,33,21,15,41.9
"8790",1812,1,1,3,5,2,9,4,2,0,30,1,3,10,4,1,2,7050291,"2023-12-08T00:00:00.000Z",666743,13,"Terance Mann",2,14,15,11,5,20.3
"8791",1813,8,1,7,6,2,8,2,7,6,34,0,2,12,7,0,2,7050291,"2023-12-08T00:00:00.000Z",192,13,"James Harden",1,19,27,20,15,33.4
"8792",1814,1,1,1,0,0,2,0,2,1,14,2,3,1,3,0,0,7050291,"2023-12-08T00:00:00.000Z",56677849,13,"Kobe Brown",1,4,5,2,4,9.1
"8793",1815,1,0,1,8,2,11,4,0,0,28,0,0,10,1,0,1,7050291,"2023-12-08T00:00:00.000Z",380,13,"Norman Powell",0,11,12,11,2,11.7
"8794",1816,0,0,0,0,0,0,0,0,0,0,0,0,0,0,0,0,7050291,"2023-12-08T00:00:00.000Z",666511,13,"Amir Coffey",0,0,0,0,0,0
"8795",1817,0,0,0,0,0,0,0,0,0,0,0,0,0,0,0,0,7050291,"2023-12-08T00:00:00.000Z",17896031,13,"Nah'Shon Hyland",0,0,0,0,0,0
"8796",1818,2,0,2,3,1,10,3,3,3,27,1,2,10,3,0,0,7050292,"2023-12-08T00:00:00.000Z",38017711,25,"Jabari Walker",0,13,15,12,5,16.6
"8797",1819,0,0,4,3,1,6,2,0,0,18,1,0,5,5,1,0,7050292,"2023-12-08T00:00:00.000Z",56677791,25,"Kris Murray",1,10,10,5,5,14
"8798",1820,0,0,0,0,0,0,0,0,0,8,0,1,0,0,0,0,7050292,"2023-12-08T00:00:00.000Z",47957121,25,"Justin Minaya",0,0,0,0,0,0
"8799",1821,0,0,0,0,0,0,0,0,0,0,0,0,0,0,0,0,7050292,"2023-12-08T00:00:00.000Z",3547289,25,"Skylar Mays",0,0,0,0,0,0
"8800",1822,0,0,0,0,0,0,0,0,0,0,0,0,0,0,0,0,7050292,"2023-12-08T00:00:00.000Z",56677829,25,"Rayan Rupert",0,0,0,0,0,0
"8801",1823,0,0,0,0,0,0,0,0,0,0,0,0,0,0,0,0,7050292,"2023-12-08T00:00:00.000Z",22,25,"Deandre Ayton",0,0,0,0,0,0
"8802",1824,0,0,0,0,0,0,0,0,0,0,0,0,0,0,0,0,7050292,"2023-12-08T00:00:00.000Z",65,25,"Malcolm Brogdon",0,0,0,0,0,0
"8803",1825,0,0,0,0,0,0,0,0,0,0,0,0,0,0,0,0,7050292,"2023-12-08T00:00:00.000Z",182,25,"Jerami Grant",0,0,0,0,0,0
"8804",1826,3,2,6,7,3,14,6,1,0,35,2,2,15,8,1,2,1038124,"2024-01-12T00:00:00.000Z",38017688,26,"Keegan Murray",3,23,26,18,11,36.1
"8805",1827,5,0,7,0,0,10,6,2,2,33,5,3,14,12,0,4,1038124,"2024-01-12T00:00:00.000Z",406,26,"Domantas Sabonis",0,26,31,19,17,31.9
"8806",1828,0,0,2,1,0,2,0,2,1,10,1,1,1,3,0,1,1038124,"2024-01-12T00:00:00.000Z",17896030,26,"Chris Duarte",0,4,4,1,3,3.6
"8807",1829,4,0,4,7,2,15,5,11,9,38,1,2,21,5,1,2,1038124,"2024-01-12T00:00:00.000Z",161,26,"De'Aaron Fox",1,26,30,25,9,34
"8808",1830,0,0,0,0,0,0,0,0,0,0,0,0,0,0,0,0,1038125,"2024-01-12T00:00:00.000Z",242,12,"James Johnson",0,0,0,0,0,0
"8809",1831,0,0,0,0,0,0,0,0,0,0,0,0,0,0,0,0,1038125,"2024-01-12T00:00:00.000Z",56677832,12,"Jarace Walker",0,0,0,0,0,0
"8810",1832,0,0,0,0,0,0,0,0,0,0,0,0,0,0,0,0,1038125,"2024-01-12T00:00:00.000Z",56677794,12,"Isaiah Wong",0,0,0,0,0,0
"8811",1833,1,1,5,0,0,2,2,2,1,12,0,0,5,5,0,0,1038128,"2024-01-12T00:00:00.000Z",137,5,"Andre Drummond",1,10,11,6,6,15.5
"8812",1834,0,0,0,0,0,0,0,0,0,0,0,0,0,0,0,0,1038128,"2024-01-12T00:00:00.000Z",87,5,"Jevon Carter",0,0,0,0,0,0
"8813",1835,0,0,0,0,0,0,0,0,0,0,0,0,0,0,0,0,1038128,"2024-01-12T00:00:00.000Z",110,5,"Torrey Craig",0,0,0,0,0,0
"8814",1836,3,0,2,3,1,8,4,0,0,24,0,1,9,2,2,4,1038130,"2024-01-12T00:00:00.000Z",3547259,18,"Jaden McDaniels",2,11,14,12,5,17.9
"8815",1837,1,0,7,3,3,8,7,7,6,28,1,2,23,8,2,0,1038130,"2024-01-12T00:00:00.000Z",447,18,"Karl-Anthony Towns",2,31,32,24,9,40.1
"8816",1838,0,2,12,0,0,11,9,8,6,29,5,2,24,17,0,1,1038130,"2024-01-12T00:00:00.000Z",176,18,"Rudy Gobert",2,41,41,24,17,49.4
"8817",1839,6,1,3,3,0,9,4,2,1,27,0,2,9,3,1,0,1038130,"2024-01-12T00:00:00.000Z",3547238,18,"Anthony Edwards",2,12,18,15,9,27.6
"8818",1840,10,0,4,5,3,7,3,0,0,20,0,1,9,4,0,0,1038130,"2024-01-12T00:00:00.000Z",104,18,"Mike Conley",0,13,23,19,14,28.8
"8819",1841,1,0,2,0,0,2,1,0,0,15,0,2,2,2,0,2,1038130,"2024-01-12T00:00:00.000Z",12,18,"Kyle Anderson",0,4,5,3,3,3.9
"8820",1842,3,0,2,2,0,3,1,0,0,19,0,1,2,2,2,2,1038130,"2024-01-12T00:00:00.000Z",666400,18,"Nickeil Alexander-Walker",2,4,7,5,5,12.9
"8821",1843,5,0,0,2,0,3,1,0,0,13,0,2,2,0,1,2,1038130,"2024-01-12T00:00:00.000Z",666767,18,"Jordan McLaughlin",1,2,7,7,5,10.5
"8822",1844,2,0,0,0,0,5,3,0,0,10,0,1,6,0,0,0,1038130,"2024-01-12T00:00:00.000Z",320,18,"Shake Milton",0,6,8,8,2,9
"8823",1845,0,1,0,0,0,3,0,2,2,9,0,2,2,0,1,0,1038130,"2024-01-12T00:00:00.000Z",38017715,18,"Josh Minott",2,2,2,2,0,8
"8824",1846,3,0,1,5,2,5,2,0,0,9,1,1,6,2,0,3,1038130,"2024-01-12T00:00:00.000Z",68,18,"Troy Brown Jr.",0,8,11,9,5,9.9
"8825",1847,0,0,0,0,0,2,2,0,0,8,0,2,4,0,2,0,1038130,"2024-01-12T00:00:00.000Z",38017700,18,"Wendell Moore Jr.",2,4,4,4,0,10
"8826",1848,0,1,2,2,0,4,2,0,0,8,0,2,4,2,1,1,1038130,"2024-01-12T00:00:00.000Z",56677782,18,"Leonard Miller",2,6,6,4,2,11.4
"8827",1849,0,0,0,0,0,0,0,0,0,0,0,0,0,0,0,0,1038130,"2024-01-12T00:00:00.000Z",17895968,18,"Daishen Nix",0,0,0,0,0,0
"8828",1850,5,0,5,5,2,21,15,8,7,41,1,5,39,6,0,1,1038128,"2024-01-12T00:00:00.000Z",125,5,"DeMar DeRozan",0,45,50,44,11,52.7
"8829",1851,0,0,0,0,0,0,0,0,0,0,0,0,0,0,0,0,1037828,"2023-11-25T00:00:00.000Z",17896022,13,"Brandon Boston Jr.",0,0,0,0,0,0
"8830",1852,0,0,0,0,0,0,0,0,0,0,0,0,0,0,0,0,1037826,"2023-11-25T00:00:00.000Z",666860,14,"Cameron Reddish",0,0,0,0,0,0
"8831",1853,0,0,0,0,0,0,0,0,0,0,0,0,0,0,0,0,1037826,"2023-11-25T00:00:00.000Z",457,14,"Jarred Vanderbilt",0,0,0,0,0,0
"8832",1854,0,0,0,0,0,0,0,0,0,0,0,0,0,0,0,0,1037826,"2023-11-25T00:00:00.000Z",1603383,14,"Gabe Vincent",0,0,0,0,0,0
"8833",1855,3,0,6,7,3,22,11,1,1,32,0,3,26,6,1,1,1037828,"2023-11-25T00:00:00.000Z",228,7,"Kyrie Irving",1,32,35,29,9,39.7
"8834",1856,4,2,3,8,1,27,12,5,5,38,0,4,30,3,2,4,1037828,"2023-11-25T00:00:00.000Z",132,7,"Luka Doncic",4,33,37,34,7,47.6
"8835",1857,3,0,2,0,0,0,0,2,2,15,0,2,2,2,0,0,1037828,"2023-11-25T00:00:00.000Z",379,7,"Dwight Powell",0,4,7,5,5,8.9
"8836",1858,0,0,3,9,2,14,5,0,0,29,0,2,12,3,0,1,1037828,"2023-11-25T00:00:00.000Z",191,7,"Tim Hardaway Jr.",0,15,15,12,3,14.6
"8837",1859,1,0,1,1,0,2,0,0,0,9,0,2,0,1,0,0,1037828,"2023-11-25T00:00:00.000Z",3547258,7,"Josh Green",0,1,2,1,2,2.7
"8838",1860,2,0,5,1,0,4,1,0,0,18,3,1,2,8,1,1,1037828,"2023-11-25T00:00:00.000Z",151,7,"Dante Exum",1,10,12,4,10,16.6
"8839",1861,0,0,0,4,1,5,1,0,0,8,0,2,3,0,0,0,1037828,"2023-11-25T00:00:00.000Z",114,7,"Seth Curry",0,3,3,3,0,3
"8840",1862,1,0,2,1,0,3,1,2,2,8,2,0,4,4,0,1,1037828,"2023-11-25T00:00:00.000Z",38017679,7,"Jaden Hardy",0,8,9,5,5,9.3
"8841",1863,0,0,1,0,0,0,0,0,0,12,0,0,0,1,0,0,1037829,"2023-11-26T00:00:00.000Z",56677852,17,"Andre Jackson Jr.",0,1,1,0,1,1.2
"8842",1864,6,3,10,1,0,21,11,18,11,39,6,5,33,16,1,4,1037829,"2023-11-26T00:00:00.000Z",15,17,"Giannis Antetokounmpo",4,49,55,39,22,69.2
"8843",1865,3,4,5,6,2,11,4,0,0,31,1,3,10,6,3,0,1037829,"2023-11-26T00:00:00.000Z",283,17,"Brook Lopez",7,16,19,13,9,42.7
"8844",1866,0,0,5,11,4,14,5,0,0,36,1,1,14,6,3,2,1037829,"2023-11-26T00:00:00.000Z",38,17,"Malik Beasley",3,20,20,14,6,28.2
"8845",1867,4,0,4,12,4,21,7,14,13,37,1,2,31,5,2,3,1037829,"2023-11-26T00:00:00.000Z",278,17,"Damian Lillard",2,36,40,35,9,46
"8846",1868,1,0,2,2,1,4,2,0,0,20,2,1,5,4,1,2,1037829,"2023-11-26T00:00:00.000Z",105,17,"Pat Connaughton",1,9,10,6,5,12.3
"8847",1869,1,1,1,0,0,0,0,0,0,9,0,2,0,1,0,1,1037829,"2023-11-26T00:00:00.000Z",38017676,17,"MarJon Beauchamp",1,1,2,1,2,4.7
"8848",1870,3,0,2,3,1,4,1,0,0,17,0,2,3,2,1,3,1037829,"2023-11-26T00:00:00.000Z",368,17,"Cameron Payne",1,5,8,6,5,9.9
"8849",1871,0,0,0,2,0,2,0,0,0,4,1,1,0,1,0,0,1037829,"2023-11-26T00:00:00.000Z",38017733,17,"A.J. Green",0,1,1,0,1,1.2
"8850",1872,0,0,2,0,0,0,0,0,0,4,0,0,0,2,0,0,1037829,"2023-11-26T00:00:00.000Z",2148,17,"Thanasis Antetokounmpo",0,2,2,0,2,2.4
"8851",1873,0,0,0,0,0,0,0,0,0,0,0,0,0,0,0,0,1037829,"2023-11-26T00:00:00.000Z",666453,17,"Marques Bolden",0,0,0,0,0,0
"8852",1874,0,0,0,0,0,0,0,0,0,0,0,0,0,0,0,0,1037829,"2023-11-26T00:00:00.000Z",56677854,17,"Chris Livingston",0,0,0,0,0,0
"8853",1875,0,0,0,0,0,0,0,0,0,0,0,0,0,0,0,0,1037829,"2023-11-26T00:00:00.000Z",284,17,"Robin Lopez",0,0,0,0,0,0
"8854",1876,0,0,1,4,0,11,0,0,0,20,1,0,0,2,1,1,1038053,"2024-01-02T00:00:00.000Z",17896048,3,"Cam Thomas",1,2,2,0,2,4.4
"8855",1877,4,0,1,4,2,7,3,2,1,20,0,1,9,1,1,1,1038053,"2024-01-02T00:00:00.000Z",421,3,"Dennis Smith Jr.",1,10,14,13,5,18.2
"8856",1878,2,0,0,2,0,8,4,0,0,12,4,0,8,4,1,0,1038053,"2024-01-02T00:00:00.000Z",56677722,3,"Jalen Wilson",1,12,14,10,6,18.8
"8857",1879,0,0,0,4,1,5,2,0,0,8,1,1,5,1,0,0,1038053,"2024-01-02T00:00:00.000Z",9051997,3,"Armoni Brooks",0,6,6,5,1,6.2
"8858",1880,1,1,2,2,0,6,3,2,0,8,1,2,6,3,0,0,1038053,"2024-01-02T00:00:00.000Z",174,3,"Harry Giles III",1,9,10,7,4,14.1
"8859",1881,1,0,0,0,0,4,2,1,0,7,1,1,4,1,0,0,1038053,"2024-01-02T00:00:00.000Z",17896058,3,"Trendon Watford",0,5,6,5,2,6.7
"8860",1882,0,0,0,0,0,0,0,0,0,0,0,0,0,0,0,0,1038053,"2024-01-02T00:00:00.000Z",56677843,3,"Noah Clowney",0,0,0,0,0,0
"8861",1883,0,0,0,0,0,0,0,0,0,0,0,0,0,0,0,0,1038053,"2024-01-02T00:00:00.000Z",17896041,3,"Keon Johnson",0,0,0,0,0,0
"8862",1884,4,0,3,6,3,13,7,0,0,29,1,1,17,4,1,1,1038056,"2024-01-02T00:00:00.000Z",666950,4,"P.J. Washington",1,21,25,21,8,29.8
"8863",1885,0,0,0,0,0,0,0,0,0,0,0,0,0,0,0,0,1038056,"2024-01-02T00:00:00.000Z",56677848,4,"Amari Bailey",0,0,0,0,0,0
"8864",1886,0,0,0,0,0,0,0,0,0,0,0,0,0,0,0,0,1038056,"2024-01-02T00:00:00.000Z",3547239,4,"LaMelo Ball",0,0,0,0,0,0
"8865",1887,0,0,0,0,0,0,0,0,0,0,0,0,0,0,0,0,1038056,"2024-01-02T00:00:00.000Z",56677866,4,"Leaky Black",0,0,0,0,0,0
"8866",1888,0,0,0,0,0,0,0,0,0,0,0,0,0,0,0,0,1038056,"2024-01-02T00:00:00.000Z",204,4,"Gordon Hayward",0,0,0,0,0,0
"8867",1889,0,0,0,0,0,0,0,0,0,0,0,0,0,0,0,0,1038056,"2024-01-02T00:00:00.000Z",347,4,"Frank Ntilikina",0,0,0,0,0,0
"8868",1890,0,0,0,0,0,0,0,0,0,0,0,0,0,0,0,0,1038056,"2024-01-02T00:00:00.000Z",38017698,4,"Mark Williams",0,0,0,0,0,0
"8869",1891,0,0,3,3,0,5,1,0,0,11,1,0,2,4,0,1,1038055,"2024-01-02T00:00:00.000Z",2189,10,"Gary Payton II",0,6,6,2,4,5.8
"8870",1892,0,0,0,0,0,0,0,0,0,0,0,0,0,0,0,0,1038054,"2024-01-02T00:00:00.000Z",38017707,2,"JD Davison",0,0,0,0,0,0
"8871",1894,0,0,0,0,0,0,0,0,0,0,0,0,0,0,0,0,1038054,"2024-01-02T00:00:00.000Z",56677864,2,"Jordan Walsh",0,0,0,0,0,0
"8872",1895,2,0,3,3,1,7,4,4,1,29,1,2,10,4,1,0,1038055,"2024-01-02T00:00:00.000Z",56677858,10,"Brandin Podziemski",1,14,16,12,6,20.8
"8873",1896,0,0,3,3,1,7,4,3,1,21,0,1,10,3,2,1,1038055,"2024-01-02T00:00:00.000Z",475,10,"Andrew Wiggins",2,13,13,10,3,18.6
"8874",1897,1,0,2,1,0,3,1,0,0,14,1,0,2,3,0,2,1038055,"2024-01-02T00:00:00.000Z",407,10,"Dario Saric",0,5,6,3,4,5.1
"8875",1898,0,0,0,0,0,0,0,0,0,0,0,0,0,0,0,0,1038055,"2024-01-02T00:00:00.000Z",45658838,10,"Lester Quinones",0,0,0,0,0,0
"8876",1899,0,0,0,0,0,0,0,0,0,0,0,0,0,0,0,0,1038055,"2024-01-02T00:00:00.000Z",398,10,"Jerome Robinson",0,0,0,0,0,0
"8877",1900,0,0,0,0,0,0,0,0,0,0,0,0,0,0,0,0,1038055,"2024-01-02T00:00:00.000Z",17896070,10,"Usman Garuba",0,0,0,0,0,0
"8878",1901,0,0,0,0,0,0,0,0,0,0,0,0,0,0,0,0,3277451,"2023-11-17T00:00:00.000Z",56677874,5,"Onuralp Bitim",0,0,0,0,0,0
"8879",1902,2,1,7,6,3,16,8,8,7,37,1,3,26,8,5,3,3277455,"2023-11-17T00:00:00.000Z",274,13,"Kawhi Leonard",6,34,36,28,10,53.6
"8880",1903,3,1,7,10,4,22,8,3,3,40,1,2,23,8,2,3,3277455,"2023-11-17T00:00:00.000Z",172,13,"Paul George",3,31,34,26,11,43.1
"8881",1904,2,2,4,0,0,8,6,2,0,35,3,2,12,7,0,1,3277455,"2023-11-17T00:00:00.000Z",493,13,"Ivica Zubac",2,19,21,14,9,28.4
"8882",1905,3,1,5,2,0,3,0,2,1,21,1,3,1,6,1,0,3277455,"2023-11-17T00:00:00.000Z",666743,13,"Terance Mann",2,7,10,4,9,18.7
"8883",1906,7,1,8,4,2,11,8,7,6,34,1,1,24,9,0,3,3277455,"2023-11-17T00:00:00.000Z",192,13,"James Harden",1,33,40,31,16,45.3
"8884",1907,0,0,0,0,0,0,0,0,0,0,0,0,0,0,0,0,3277455,"2023-11-17T00:00:00.000Z",666511,13,"Amir Coffey",0,0,0,0,0,0
"8885",1908,0,0,0,0,0,0,0,0,0,0,0,0,0,0,0,0,3277455,"2023-11-17T00:00:00.000Z",38017725,13,"Moussa Diabate",0,0,0,0,0,0
"8886",1909,0,0,0,0,0,0,0,0,0,0,0,0,0,0,0,0,3277454,"2023-11-17T00:00:00.000Z",56677868,14,"D'Moi Hodge",0,0,0,0,0,0
"8887",1910,0,0,0,0,0,0,0,0,0,0,0,0,0,0,0,0,3277454,"2023-11-17T00:00:00.000Z",457,14,"Jarred Vanderbilt",0,0,0,0,0,0
"8888",1911,0,0,0,0,0,1,0,2,1,13,1,2,1,1,0,1,3277453,"2023-11-17T00:00:00.000Z",356,24,"Josh Okogie",0,2,2,1,1,1.2
"8889",1912,0,0,4,1,1,5,5,0,0,21,0,2,11,4,0,0,3277453,"2023-11-17T00:00:00.000Z",147,24,"Drew Eubanks",0,15,15,11,4,15.8
"8890",1913,0,0,1,2,1,3,1,0,0,10,1,1,3,2,0,0,3277453,"2023-11-17T00:00:00.000Z",470,24,"Yuta Watanabe",0,5,5,3,2,5.4
"8891",1914,4,0,2,4,1,6,1,0,0,14,0,2,3,2,1,0,3277453,"2023-11-17T00:00:00.000Z",18678058,24,"Jordan Goodwin",1,5,9,7,6,14.4
"8892",1915,1,0,1,2,1,3,2,0,0,11,0,0,5,1,0,0,3277453,"2023-11-17T00:00:00.000Z",666729,24,"Nassir Little",0,6,7,6,2,7.7
"8893",1916,0,0,0,0,0,0,0,0,0,0,0,0,0,0,0,0,3277453,"2023-11-17T00:00:00.000Z",666451,24,"Bol Bol",0,0,0,0,0,0
"8894",1917,0,0,0,0,0,0,0,0,0,0,0,0,0,0,0,0,3277453,"2023-11-17T00:00:00.000Z",3547298,24,"Saben Lee",0,0,0,0,0,0
"8895",1918,0,0,0,0,0,0,0,0,0,0,0,0,0,0,0,0,3277453,"2023-11-17T00:00:00.000Z",314,24,"Chimezie Metu",0,0,0,0,0,0
"8896",1919,18,1,14,8,1,20,10,5,5,36,2,2,26,16,0,4,3277452,"2023-11-17T00:00:00.000Z",246,8,"Nikola Jokic",1,42,60,44,34,71.2
"8897",1920,8,2,1,4,2,7,3,0,0,35,0,0,8,1,1,0,3277452,"2023-11-17T00:00:00.000Z",81,8,"Kentavious Caldwell-Pope",3,9,17,16,9,30.2
"8898",1921,3,0,1,7,2,12,6,0,0,33,1,2,14,2,0,4,3277452,"2023-11-17T00:00:00.000Z",236,8,"Reggie Jackson",0,16,19,17,5,16.9
"8899",1922,0,0,0,0,0,0,0,0,0,0,0,0,0,0,0,0,3277452,"2023-11-17T00:00:00.000Z",666489,8,"Vlatko Cancar",0,0,0,0,0,0
"8900",1923,0,0,0,0,0,0,0,0,0,0,0,0,0,0,0,0,3277452,"2023-11-17T00:00:00.000Z",17896103,8,"Jay Huff",0,0,0,0,0,0
"8901",1924,0,0,0,0,0,0,0,0,0,0,0,0,0,0,0,0,3277451,"2023-11-17T00:00:00.000Z",56677839,22,"Jett Howard",0,0,0,0,0,0
"8902",1925,0,0,0,0,0,0,0,0,0,0,0,0,0,0,0,0,3277451,"2023-11-17T00:00:00.000Z",17896073,22,"Jalen Suggs",0,0,0,0,0,0
"8903",1926,10,1,3,4,1,14,6,10,7,40,0,5,20,3,1,3,1037997,"2023-12-25T00:00:00.000Z",57,24,"Devin Booker",2,23,33,30,13,41.6
"8904",1927,0,0,0,0,0,0,0,0,0,0,0,0,0,0,0,0,1037997,"2023-12-25T00:00:00.000Z",3547253,24,"Theo Maledon",0,0,0,0,0,0
"8905",1928,0,0,0,0,0,0,0,0,0,0,0,0,0,0,0,0,1037997,"2023-12-25T00:00:00.000Z",349,24,"Jusuf Nurkic",0,0,0,0,0,0
"8906",1929,2,0,7,9,3,14,6,3,3,38,0,4,18,7,1,1,1037997,"2023-12-25T00:00:00.000Z",191,7,"Tim Hardaway Jr.",1,25,27,20,9,31.4
"8907",1930,1,0,1,8,3,18,9,4,2,35,2,3,23,3,1,0,1037997,"2023-12-25T00:00:00.000Z",247,7,"Derrick Jones Jr.",1,26,27,24,4,31.1
"8908",1931,1,0,7,0,0,9,8,9,4,32,3,3,20,10,0,1,1037997,"2023-12-25T00:00:00.000Z",56677840,7,"Dereck Lively II",0,30,31,21,11,32.5
"8909",1932,5,0,3,4,1,7,3,0,0,33,1,3,7,4,1,3,1037997,"2023-12-25T00:00:00.000Z",151,7,"Dante Exum",1,11,16,12,9,19.3
"8910",1933,14,3,5,16,8,25,15,12,12,43,1,2,50,6,4,4,1037997,"2023-12-25T00:00:00.000Z",132,7,"Luka Doncic",7,56,70,64,20,95.2
"8911",1934,1,3,3,2,0,3,1,2,1,27,0,4,3,3,0,2,1037997,"2023-12-25T00:00:00.000Z",666965,7,"Grant Williams",3,6,7,4,4,15.1
"8912",1935,1,0,2,3,1,4,1,0,0,13,0,0,3,2,0,0,1037997,"2023-12-25T00:00:00.000Z",38017679,7,"Jaden Hardy",0,5,6,4,3,6.9
"8913",1936,0,0,1,2,0,2,0,0,0,5,0,0,0,1,0,0,1037997,"2023-12-25T00:00:00.000Z",17554004,7,"AJ Lawson",0,1,1,0,1,1.2
"8914",1937,2,0,1,0,0,2,2,0,0,7,0,1,4,1,0,0,1037997,"2023-12-25T00:00:00.000Z",379,7,"Dwight Powell",0,5,7,6,3,8.2
"8915",1938,0,0,0,0,0,0,0,0,0,6,1,0,0,1,0,0,1037997,"2023-12-25T00:00:00.000Z",114,7,"Seth Curry",0,1,1,0,1,1.2
"8916",1939,0,0,0,0,0,0,0,0,0,1,0,0,0,0,0,0,1037997,"2023-12-25T00:00:00.000Z",56677859,7,"Olivier-Maxence Prosper",0,0,0,0,0,0
"8917",1940,0,0,0,0,0,0,0,0,0,0,0,0,0,0,0,0,1037997,"2023-12-25T00:00:00.000Z",217,7,"Richaun Holmes",0,0,0,0,0,0
"8918",1941,0,0,0,0,0,0,0,0,0,0,0,0,0,0,0,0,1037997,"2023-12-25T00:00:00.000Z",329,7,"Markieff Morris",0,0,0,0,0,0
"8919",1942,0,0,0,0,0,0,0,0,0,0,0,0,0,0,0,0,1037997,"2023-12-25T00:00:00.000Z",17896028,7,"Greg Brown III",0,0,0,0,0,0
"8920",1943,0,0,0,0,0,0,0,0,0,0,0,0,0,0,0,0,1037997,"2023-12-25T00:00:00.000Z",56677873,7,"Dexter Dennis",0,0,0,0,0,0
"8921",1944,0,0,0,0,0,0,0,0,0,0,0,0,0,0,0,0,1037997,"2023-12-25T00:00:00.000Z",3547258,7,"Josh Green",0,0,0,0,0,0
"8922",1945,0,0,0,0,0,0,0,0,0,0,0,0,0,0,0,0,1037997,"2023-12-25T00:00:00.000Z",228,7,"Kyrie Irving",0,0,0,0,0,0
"8923",1946,0,0,0,0,0,0,0,0,0,0,0,0,0,0,0,0,1037997,"2023-12-25T00:00:00.000Z",257,7,"Maxi Kleber",0,0,0,0,0,0
"8924",1947,2,0,3,9,3,19,9,3,2,39,0,6,23,3,0,4,1037998,"2023-12-26T00:00:00.000Z",54,9,"Bojan Bogdanovic",0,26,28,25,5,25.6
"8925",1948,4,0,7,2,1,7,2,4,2,36,4,2,7,11,0,0,1037998,"2023-12-26T00:00:00.000Z",3547267,9,"Isaiah Stewart",0,18,22,11,15,26.2
"8926",1949,4,1,10,0,0,11,6,0,0,33,5,3,12,15,1,1,1037998,"2023-12-26T00:00:00.000Z",38017694,9,"Jalen Duren",2,27,31,16,19,41
"8927",1950,4,1,1,2,0,12,3,6,3,28,2,5,9,3,3,1,1037998,"2023-12-26T00:00:00.000Z",38017682,9,"Jaden Ivey",4,12,16,13,7,29.6
"8928",1951,0,0,6,4,2,9,5,1,1,20,1,2,13,7,0,2,1037711,"2023-11-09T00:00:00.000Z",462,22,"Moritz Wagner",0,20,20,13,7,19.4
"8929",1952,0,0,0,0,0,0,0,0,0,0,0,0,0,0,0,0,1037710,"2023-11-09T00:00:00.000Z",38017691,17,"TyTy Washington Jr.",0,0,0,0,0,0
"8930",1953,3,0,4,1,0,12,5,2,2,29,2,2,12,6,0,4,1037711,"2023-11-09T00:00:00.000Z",17896026,22,"Franz Wagner",0,18,21,15,9,19.7
"8931",1954,4,0,4,3,1,14,7,4,2,34,4,4,17,8,1,5,1037711,"2023-11-09T00:00:00.000Z",38017683,22,"Paolo Banchero",1,25,29,21,12,30.6
"8932",1955,0,2,3,0,0,7,5,4,2,21,2,2,12,5,0,1,1037711,"2023-11-09T00:00:00.000Z",666442,22,"Goga Bitadze",2,17,17,12,5,23
"8933",1956,1,0,3,5,4,10,7,6,3,31,0,5,21,3,7,2,1037711,"2023-11-09T00:00:00.000Z",17896073,22,"Jalen Suggs",7,24,25,22,4,45.1
"8934",1957,3,0,0,0,0,12,5,3,3,28,1,1,13,1,0,0,1037711,"2023-11-09T00:00:00.000Z",165,22,"Markelle Fultz",0,14,17,16,4,18.7
"8935",1958,5,1,1,3,1,6,1,0,0,18,2,1,3,3,3,0,1037711,"2023-11-09T00:00:00.000Z",226,22,"Joe Ingles",4,6,11,8,8,26.1
"8936",1959,2,0,1,4,0,7,1,6,5,24,1,3,7,2,0,3,1037711,"2023-11-09T00:00:00.000Z",3547251,22,"Cole Anthony",0,9,11,9,4,9.4
"8937",1960,0,0,0,0,0,0,0,0,0,0,0,0,0,0,0,0,1037711,"2023-11-09T00:00:00.000Z",38017724,22,"Caleb Houstan",0,0,0,0,0,0
"8938",1961,0,0,0,0,0,0,0,0,0,0,0,0,0,0,0,0,1037711,"2023-11-09T00:00:00.000Z",56677839,22,"Jett Howard",0,0,0,0,0,0
"8939",1962,5,1,5,4,1,9,5,0,0,31,1,2,11,6,1,3,3277398,"2023-11-10T00:00:00.000Z",3547242,30,"Deni Avdija",2,17,22,16,11,28.7
"8940",1963,1,0,5,5,2,17,7,1,1,29,1,1,17,6,0,3,3277398,"2023-11-10T00:00:00.000Z",265,30,"Kyle Kuzma",0,23,24,18,7,22.7
"8941",1964,1,4,5,0,0,7,4,3,2,30,4,4,10,9,2,2,3277398,"2023-11-10T00:00:00.000Z",666577,30,"Daniel Gafford",6,19,20,11,10,38.3
"8942",1965,6,0,2,5,1,14,6,1,1,31,0,4,14,2,0,3,3277398,"2023-11-10T00:00:00.000Z",666848,30,"Jordan Poole",0,16,22,20,8,22.4
"8943",1966,4,1,4,4,2,12,6,3,2,34,0,2,16,4,0,0,3277398,"2023-11-10T00:00:00.000Z",249,30,"Tyus Jones",1,20,24,20,8,29.8
"8944",1967,0,0,4,3,3,6,5,2,2,16,0,2,15,4,0,0,3277398,"2023-11-10T00:00:00.000Z",17896045,30,"Corey Kispert",0,19,19,15,4,19.8
"8945",1968,4,0,0,4,1,6,3,2,2,18,1,1,9,1,0,1,3277398,"2023-11-10T00:00:00.000Z",167,30,"Danilo Gallinari",0,10,14,13,5,15.2
"8946",1969,6,0,2,2,0,3,1,3,2,14,0,3,4,2,1,0,3277398,"2023-11-10T00:00:00.000Z",487,30,"Delon Wright",1,6,12,10,8,18.4
"8947",1970,1,0,2,4,2,4,2,4,4,20,0,1,10,2,0,2,3277398,"2023-11-10T00:00:00.000Z",56677844,30,"Bilal Coulibaly",0,12,13,11,3,11.9
"8948",1971,0,0,0,7,2,10,4,1,1,17,0,3,11,0,0,1,3277398,"2023-11-10T00:00:00.000Z",414,30,"Landry Shamet",0,11,11,11,0,10
"8949",1972,0,0,0,0,0,0,0,0,0,0,0,0,0,0,0,0,3277398,"2023-11-10T00:00:00.000Z",38017704,30,"Patrick Baldwin Jr.",0,0,0,0,0,0
"8950",1973,0,0,0,0,0,0,0,0,0,0,0,0,0,0,0,0,3277398,"2023-11-10T00:00:00.000Z",38017687,30,"Johnny Davis",0,0,0,0,0,0
"8951",1974,1,1,1,2,1,4,3,2,2,17,2,3,9,3,1,1,1037711,"2023-11-09T00:00:00.000Z",56677827,22,"Anthony Black",2,12,13,10,4,19.1
"8952",1975,0,2,6,4,1,8,3,7,5,16,1,1,12,7,0,0,1037711,"2023-11-09T00:00:00.000Z",229,22,"Jonathan Isaac",2,19,19,12,7,26.4
"8953",1976,0,0,2,2,0,10,5,3,2,24,0,1,12,2,0,0,1037927,"2023-12-16T00:00:00.000Z",38017708,4,"Bryce McGowens",0,14,14,12,2,14.4
"8954",1977,0,0,10,7,1,14,3,2,2,31,0,1,9,10,0,1,1037927,"2023-12-16T00:00:00.000Z",62,4,"Miles Bridges",0,19,19,9,10,20
"8955",1978,1,2,2,0,0,6,4,0,0,20,2,3,8,4,1,1,1037927,"2023-12-16T00:00:00.000Z",3547282,4,"Nick Richards",3,12,13,9,5,22.3
"8956",1979,4,1,4,7,2,16,4,4,4,29,0,0,14,4,0,3,1037927,"2023-12-16T00:00:00.000Z",56677823,4,"Brandon Miller",1,18,22,18,8,24.8
"8957",1980,2,0,1,5,0,10,3,0,0,20,1,2,6,2,0,2,1037927,"2023-12-16T00:00:00.000Z",403,4,"Terry Rozier",0,8,10,8,4,9.4
"8958",1981,0,0,1,3,0,8,1,0,0,22,1,1,2,2,0,1,1037927,"2023-12-16T00:00:00.000Z",18678001,4,"JT Thor",0,4,4,2,2,3.4
"8959",1983,1,1,2,5,0,8,1,0,0,27,2,1,2,4,3,0,1037926,"2023-12-16T00:00:00.000Z",17896071,9,"Isaiah Livers",4,6,7,3,5,20.3
"8960",1984,5,0,3,0,0,9,7,3,3,26,3,4,17,6,1,0,1037926,"2023-12-16T00:00:00.000Z",3547240,9,"James Wiseman",1,23,28,22,11,34.7
"8961",1985,2,0,1,2,1,4,2,6,6,17,0,2,11,1,2,2,1037926,"2023-12-16T00:00:00.000Z",56677792,9,"Marcus Sasser",2,12,14,13,3,19.2
"8962",1986,0,0,0,0,0,0,0,0,0,0,0,0,0,0,0,0,1037926,"2023-12-16T00:00:00.000Z",3547267,9,"Isaiah Stewart",0,0,0,0,0,0
"8963",1987,0,0,0,0,0,0,0,0,0,0,0,0,0,0,0,0,1037926,"2023-12-16T00:00:00.000Z",56677729,9,"Malcolm Cazalon",0,0,0,0,0,0
"8964",1988,0,0,0,0,0,0,0,0,0,0,0,0,0,0,0,0,1037926,"2023-12-16T00:00:00.000Z",38017694,9,"Jalen Duren",0,0,0,0,0,0
"8965",1989,0,0,0,0,0,0,0,0,0,0,0,0,0,0,0,0,1037926,"2023-12-16T00:00:00.000Z",330,9,"Monte Morris",0,0,0,0,0,0
"8966",1990,0,0,0,0,0,0,0,0,0,0,0,0,0,0,0,0,1037926,"2023-12-16T00:00:00.000Z",42097199,9,"Jared Rhoden",0,0,0,0,0,0
"8967",1991,0,0,0,0,0,0,0,0,0,0,0,0,0,0,0,0,1037926,"2023-12-16T00:00:00.000Z",44477024,9,"Stanley Umude",0,0,0,0,0,0
"8968",1992,3,0,0,4,3,9,6,4,3,32,3,2,18,3,1,0,1037928,"2023-12-16T00:00:00.000Z",3547247,6,"Isaac Okoro",1,21,24,21,6,29.1
"8969",1993,3,0,4,7,4,8,5,2,2,22,1,5,16,5,1,0,1037928,"2023-12-16T00:00:00.000Z",666940,6,"Dean Wade",1,21,24,19,8,29.5
"8970",1994,1,1,10,0,0,14,12,1,1,35,4,1,25,14,2,4,1037928,"2023-12-16T00:00:00.000Z",9,6,"Jarrett Allen",3,39,40,26,15,48.3
"8971",1995,5,1,5,8,1,13,4,2,2,34,1,2,11,6,1,1,1037928,"2023-12-16T00:00:00.000Z",666908,6,"Max Strus",2,17,22,16,11,30.7
"8972",1996,13,0,2,9,4,21,7,4,4,41,3,4,22,5,2,1,1037928,"2023-12-16T00:00:00.000Z",322,6,"Donovan Mitchell",2,27,40,35,18,52.5
"8973",1997,1,1,3,4,1,15,6,2,1,25,2,1,14,5,1,3,1037928,"2023-12-16T00:00:00.000Z",277,6,"Caris LeVert",2,19,20,15,6,24.5
"8974",1998,3,0,1,1,0,8,3,0,0,15,1,1,6,2,0,1,1037928,"2023-12-16T00:00:00.000Z",56677872,6,"Craig Porter",0,8,11,9,5,11.9
"8975",1999,1,0,1,6,3,6,3,0,0,8,0,1,9,1,0,0,1037928,"2023-12-16T00:00:00.000Z",3547299,6,"Sam Merrill",0,10,11,10,2,11.7
"8976",2000,2,0,2,3,0,4,0,0,0,15,1,2,0,3,0,0,1037928,"2023-12-16T00:00:00.000Z",344,6,"Georges Niang",0,3,5,2,5,6.6
"8977",2001,0,0,0,0,0,0,0,0,0,1,0,0,0,0,0,0,1037636,"2023-10-30T00:00:00.000Z",56677806,1,"Mouhamed Gueye",0,0,0,0,0,0
"8978",2002,2,0,3,1,1,2,2,0,0,17,2,2,5,5,0,3,1037640,"2023-10-30T00:00:00.000Z",340,19,"Larry Nance Jr.",0,10,12,7,7,11
"8979",2003,2,0,2,7,3,9,4,1,1,27,1,2,12,3,0,2,1037640,"2023-10-30T00:00:00.000Z",17896017,19,"Matt Ryan",0,15,17,14,5,16.6
"8980",2004,0,0,1,0,0,2,0,2,0,5,1,0,0,2,0,0,1037640,"2023-10-30T00:00:00.000Z",491,19,"Cody Zeller",0,2,2,0,2,2.4
"8981",2005,0,0,0,0,0,0,0,0,0,0,0,0,0,0,0,0,1037640,"2023-10-30T00:00:00.000Z",38017663,19,"E.J. Liddell",0,0,0,0,0,0
"8982",2006,0,0,0,0,0,0,0,0,0,0,0,0,0,0,0,0,1037640,"2023-10-30T00:00:00.000Z",17896097,19,"Jose Alvarado",0,0,0,0,0,0
"8983",2007,0,0,0,0,0,0,0,0,0,0,0,0,0,0,0,0,1037640,"2023-10-30T00:00:00.000Z",3547293,19,"Naji Marshall",0,0,0,0,0,0
"8984",2008,0,0,0,0,0,0,0,0,0,0,0,0,0,0,0,0,1037640,"2023-10-30T00:00:00.000Z",18677986,19,"Trey Murphy III",0,0,0,0,0,0
"8985",2009,0,0,0,0,0,0,0,0,0,0,0,0,0,0,0,0,1037640,"2023-10-30T00:00:00.000Z",38017726,19,"Dereon Seabron",0,0,0,0,0,0
"8986",2010,0,0,2,2,1,8,4,2,0,20,1,2,9,3,0,3,1037640,"2023-10-30T00:00:00.000Z",475,10,"Andrew Wiggins",0,12,12,9,3,9.6
"8987",2011,7,1,5,2,0,8,3,0,0,21,1,2,6,6,0,1,1037640,"2023-10-30T00:00:00.000Z",185,10,"Draymond Green",1,12,19,13,13,25.7
"8988",2012,1,0,5,0,0,5,3,2,2,24,2,2,8,7,1,1,1037640,"2023-10-30T00:00:00.000Z",282,10,"Kevon Looney",1,15,16,9,8,19.9
"8989",2013,0,4,2,0,0,10,5,4,3,20,8,2,13,10,0,2,1037640,"2023-10-30T00:00:00.000Z",56677799,10,"Trayce Jackson-Davis",4,23,23,13,10,35
"8990",2014,1,0,1,1,0,1,0,0,0,5,0,2,0,1,0,0,1037640,"2023-10-30T00:00:00.000Z",251,10,"Cory Joseph",0,1,2,1,2,2.7
"8991",2015,0,0,0,0,0,0,0,0,0,0,0,0,0,0,0,0,1037637,"2023-10-30T00:00:00.000Z",3547249,28,"Precious Achiuwa",0,0,0,0,0,0
"8992",2016,0,0,0,0,0,0,0,0,0,0,0,0,0,0,0,0,1037637,"2023-10-30T00:00:00.000Z",56677805,28,"Javon Freeman-Liberty",0,0,0,0,0,0
"8993",2017,0,0,0,0,0,0,0,0,0,0,0,0,0,0,0,0,1037637,"2023-10-30T00:00:00.000Z",38017710,28,"Christian Koloko",0,0,0,0,0,0
"8994",2018,0,0,0,0,0,0,0,0,0,0,0,0,0,0,0,0,1037637,"2023-10-30T00:00:00.000Z",56677869,28,"Markquis Nowell",0,0,0,0,0,0
"8995",2019,2,0,0,4,3,4,3,0,0,19,0,1,9,0,0,0,1037637,"2023-10-30T00:00:00.000Z",666923,25,"Matisse Thybulle",0,9,11,11,2,12
"8996",2020,0,1,5,8,2,18,8,4,4,37,1,2,22,6,1,2,1037637,"2023-10-30T00:00:00.000Z",182,25,"Jerami Grant",2,28,28,22,6,33.2
"8997",2021,2,2,16,0,0,9,5,0,0,32,7,1,10,23,1,1,1037637,"2023-10-30T00:00:00.000Z",22,25,"Deandre Ayton",3,33,35,12,25,48.6
"8998",2022,0,0,0,0,0,0,0,0,0,0,0,0,0,0,0,0,1037641,"2023-10-30T00:00:00.000Z",38017706,21,"Jaylin Williams",0,0,0,0,0,0
"8999",2023,0,0,0,0,0,0,0,0,0,0,0,0,0,0,0,0,1037641,"2023-10-30T00:00:00.000Z",480,21,"Kenrich Williams",0,0,0,0,0,0
"9000",2024,3,3,3,2,0,14,6,4,3,31,7,4,15,10,1,3,1037641,"2023-10-30T00:00:00.000Z",56677826,9,"Ausar Thompson",4,25,28,18,13,40.5
"9001",2025,1,0,7,3,2,9,4,2,2,31,0,2,12,7,0,2,1037641,"2023-10-30T00:00:00.000Z",3547267,9,"Isaiah Stewart",0,19,20,13,8,19.9
"9002",2026,2,1,1,1,0,4,1,0,0,22,0,1,2,1,3,1,1037894,"2023-12-11T00:00:00.000Z",38017620,29,"Ochai Agbaji",4,3,5,4,3,17.2
"9003",2027,1,4,1,6,3,11,7,2,2,23,1,1,19,2,0,0,1037894,"2023-12-11T00:00:00.000Z",38017739,29,"Simone Fontecchio",4,21,22,20,3,34.9
"9004",2028,3,0,6,2,0,5,1,0,0,21,0,2,2,6,0,2,1037894,"2023-12-11T00:00:00.000Z",358,29,"Kelly Olynyk",0,8,11,5,9,11.7
"9005",2029,7,0,3,9,5,17,10,5,5,33,0,0,30,3,1,3,1037894,"2023-12-11T00:00:00.000Z",56677834,29,"Keyonte George",1,33,40,37,10,44.1
"9006",2030,5,1,2,4,0,13,3,2,2,22,2,1,8,4,1,2,1037894,"2023-12-11T00:00:00.000Z",100,29,"Jordan Clarkson",2,12,17,13,9,24.3
"9007",2031,1,0,5,0,0,10,7,5,4,29,7,2,18,12,0,2,1037888,"2023-12-11T00:00:00.000Z",177,8,"Aaron Gordon",0,30,31,19,13,31.9
"9008",2032,8,2,6,1,1,13,9,7,6,36,2,3,25,8,3,1,1037888,"2023-12-11T00:00:00.000Z",246,8,"Nikola Jokic",5,33,41,33,16,60.6
"9009",2033,2,1,3,2,0,6,1,8,6,30,0,2,8,3,0,2,1037888,"2023-12-11T00:00:00.000Z",81,8,"Kentavious Caldwell-Pope",1,11,13,10,5,15.6
"9010",2034,4,2,8,5,4,15,12,1,1,29,1,1,29,9,1,6,1037888,"2023-12-11T00:00:00.000Z",335,8,"Jamal Murray",3,38,42,33,13,48.8
"9011",2035,2,0,1,11,6,16,8,0,0,28,0,1,22,1,5,2,1037888,"2023-12-11T00:00:00.000Z",56677776,8,"Julian Strawther",5,23,25,24,3,39.2
"9012",2036,6,0,1,5,1,10,5,1,1,19,0,0,12,1,0,1,1037888,"2023-12-11T00:00:00.000Z",236,8,"Reggie Jackson",0,13,19,18,7,21.2
"9013",2037,1,0,2,0,0,3,2,2,2,11,0,2,6,2,0,0,1037888,"2023-12-11T00:00:00.000Z",38017709,8,"Christian Braun",0,8,9,7,3,9.9
"9014",2038,1,2,3,1,0,2,1,1,1,12,1,3,3,4,0,1,1037888,"2023-12-11T00:00:00.000Z",3547268,8,"Zeke Nnaji",2,7,8,4,5,14.3
"9015",2039,0,0,0,0,0,0,0,0,0,0,0,0,0,0,0,0,1037888,"2023-12-11T00:00:00.000Z",215,8,"Justin Holiday",0,0,0,0,0,0
"9016",2040,0,0,0,0,0,0,0,0,0,0,0,0,0,0,0,0,1037888,"2023-12-11T00:00:00.000Z",250,8,"DeAndre Jordan",0,0,0,0,0,0
"9017",2041,0,0,0,0,0,0,0,0,0,0,0,0,0,0,0,0,1037888,"2023-12-11T00:00:00.000Z",56677582,8,"Jalen Pickett",0,0,0,0,0,0
"9018",2042,0,0,0,0,0,0,0,0,0,0,0,0,0,0,0,0,1037888,"2023-12-11T00:00:00.000Z",56677875,1,"Miles Norris",0,0,0,0,0,0
"9019",2043,3,0,5,4,0,11,1,2,1,26,2,3,3,7,0,1,1037888,"2023-12-11T00:00:00.000Z",375,8,"Michael Porter Jr.",0,10,13,6,10,14.9
"9020",2044,8,0,4,3,3,8,6,2,1,31,3,4,16,7,1,1,1037889,"2023-12-11T00:00:00.000Z",202,20,"Josh Hart",1,23,31,24,15,38.4
"9021",2045,1,0,3,7,5,11,7,0,0,27,0,0,19,3,0,0,1037889,"2023-12-11T00:00:00.000Z",17895858,20,"Quentin Grimes",0,22,23,20,4,24.1
"9022",2046,2,1,3,0,0,7,4,4,3,27,5,4,11,8,2,2,1037889,"2023-12-11T00:00:00.000Z",201,20,"Isaiah Hartenstein",3,19,21,13,10,30.6
"9023",2047,3,0,0,1,1,2,1,0,0,10,0,1,3,0,0,0,1037889,"2023-12-11T00:00:00.000Z",17896033,20,"Miles McBride",0,3,6,6,3,7.5
"9024",2048,0,0,0,0,0,0,0,0,0,0,0,0,0,0,0,0,1037889,"2023-12-11T00:00:00.000Z",666675,20,"DaQuan Jeffries",0,0,0,0,0,0
"9025",2049,0,0,0,0,0,0,0,0,0,0,0,0,0,0,0,0,1037889,"2023-12-11T00:00:00.000Z",3547269,20,"Immanuel Quickley",0,0,0,0,0,0
"9026",2050,0,0,0,0,0,0,0,0,0,0,0,0,0,0,0,0,1037889,"2023-12-11T00:00:00.000Z",666971,20,"Dylan Windler",0,0,0,0,0,0
"9027",2051,2,1,2,3,0,3,0,0,0,16,0,2,0,2,1,0,1037601,"2023-10-25T00:00:00.000Z",666762,28,"Jalen McDaniels",2,2,4,2,4,11.4
"9028",2052,1,0,4,4,0,9,3,2,1,26,1,6,7,5,1,1,1037598,"2023-10-25T00:00:00.000Z",38017684,11,"Jabari Smith Jr.",1,12,13,8,6,16.5
"9029",2053,0,0,0,0,0,0,0,0,0,0,0,0,0,0,0,0,1037598,"2023-10-25T00:00:00.000Z",3547281,11,"Nate Hinton",0,0,0,0,0,0
"9030",2054,0,0,0,0,0,0,0,0,0,0,0,0,0,0,0,0,1037598,"2023-10-25T00:00:00.000Z",357,11,"Victor Oladipo",0,0,0,0,0,0
"9031",2055,0,0,0,0,0,0,0,0,0,0,0,0,0,0,0,0,1037601,"2023-10-25T00:00:00.000Z",376,28,"Otto Porter Jr.",0,0,0,0,0,0
"9032",2056,0,0,0,0,0,0,0,0,0,0,0,0,0,0,0,0,1037601,"2023-10-25T00:00:00.000Z",436,28,"Garrett Temple",0,0,0,0,0,0
"9033",2057,0,0,0,0,0,0,0,0,0,0,0,0,0,0,0,0,1037601,"2023-10-25T00:00:00.000Z",489,28,"Thaddeus Young",0,0,0,0,0,0
"9034",2058,0,0,0,0,0,0,0,0,0,0,0,0,0,0,0,0,1037601,"2023-10-25T00:00:00.000Z",56677805,28,"Javon Freeman-Liberty",0,0,0,0,0,0
"9035",2059,0,0,0,0,0,0,0,0,0,0,0,0,0,0,0,0,1037601,"2023-10-25T00:00:00.000Z",38017717,28,"Ron Harper Jr.",0,0,0,0,0,0
"9036",2060,0,0,0,0,0,0,0,0,0,0,0,0,0,0,0,0,1037601,"2023-10-25T00:00:00.000Z",38017710,28,"Christian Koloko",0,0,0,0,0,0
"9037",2061,0,0,0,0,0,0,0,0,0,0,0,0,0,0,0,0,1037601,"2023-10-25T00:00:00.000Z",56677869,28,"Markquis Nowell",0,0,0,0,0,0
"9038",2062,0,0,0,0,0,0,0,0,0,0,0,0,0,0,0,0,1037599,"2023-10-25T00:00:00.000Z",464,3,"Lonnie Walker IV",0,0,0,0,0,0
"9039",2063,0,0,0,0,0,0,0,0,0,0,0,0,0,0,0,0,1037599,"2023-10-25T00:00:00.000Z",17896058,3,"Trendon Watford",0,0,0,0,0,0
"9040",2064,0,0,0,0,0,0,0,0,0,0,0,0,0,0,0,0,1037599,"2023-10-25T00:00:00.000Z",9051997,3,"Armoni Brooks",0,0,0,0,0,0
"9041",2065,0,0,0,0,0,0,0,0,0,0,0,0,0,0,0,0,1037600,"2023-10-25T00:00:00.000Z",44477024,9,"Stanley Umude",0,0,0,0,0,0
"9042",2066,0,0,0,0,0,0,0,0,0,0,0,0,0,0,0,0,1037600,"2023-10-25T00:00:00.000Z",3547240,9,"James Wiseman",0,0,0,0,0,0
"9043",2067,0,0,0,0,0,0,0,0,0,0,0,0,0,0,0,0,1037600,"2023-10-25T00:00:00.000Z",54,9,"Bojan Bogdanovic",0,0,0,0,0,0
"9044",2068,0,0,0,0,0,0,0,0,0,0,0,0,0,0,0,0,1037600,"2023-10-25T00:00:00.000Z",17896071,9,"Isaiah Livers",0,0,0,0,0,0
"9045",2069,0,0,0,0,0,0,0,0,0,0,0,0,0,0,0,0,1037600,"2023-10-25T00:00:00.000Z",330,9,"Monte Morris",0,0,0,0,0,0
"9046",2070,0,0,0,0,0,0,0,0,0,0,0,0,0,0,0,0,1037599,"2023-10-25T00:00:00.000Z",56677841,3,"Dariq Whitehead",0,0,0,0,0,0
"9047",2071,0,0,0,0,0,0,0,0,0,0,0,0,0,0,0,0,1037599,"2023-10-25T00:00:00.000Z",56677722,3,"Jalen Wilson",0,0,0,0,0,0
"9048",2072,2,1,12,13,7,17,9,2,2,39,0,4,27,12,1,0,1037599,"2023-10-25T00:00:00.000Z",666908,6,"Max Strus",2,39,41,29,14,50.4
"9049",2073,4,1,3,4,2,10,6,5,4,32,3,5,18,6,2,2,1037599,"2023-10-25T00:00:00.000Z",3547247,6,"Isaac Okoro",3,24,28,22,10,38.2
"9050",2074,1,2,5,0,0,11,5,0,0,34,1,3,10,6,0,0,1037599,"2023-10-25T00:00:00.000Z",17896076,6,"Evan Mobley",2,16,17,11,7,24.7
"9051",2075,2,1,3,3,1,20,9,3,1,33,2,1,20,5,1,0,1037602,"2023-10-25T00:00:00.000Z",125,5,"DeMar DeRozan",2,25,27,22,7,35
"9052",2076,3,0,6,3,1,7,4,2,2,33,1,2,11,7,1,2,1037870,"2023-12-01T00:00:00.000Z",666682,27,"Keldon Johnson",1,18,21,14,10,24.9
"9053",2077,3,1,2,5,1,11,3,6,5,24,3,2,12,5,2,3,1037870,"2023-12-01T00:00:00.000Z",102,27,"Zach Collins",3,17,20,15,8,28.5
"9054",2078,0,0,2,3,2,7,4,0,0,22,0,1,10,2,0,3,1037870,"2023-12-01T00:00:00.000Z",38017692,27,"Malaki Branham",0,12,12,10,2,9.4
"9055",2079,4,0,3,4,2,13,4,4,3,31,0,2,13,3,0,2,1037870,"2023-12-01T00:00:00.000Z",38017699,27,"Jeremy Sochan",0,16,20,17,7,20.6
"9056",2080,5,1,2,5,2,9,4,2,1,27,0,3,11,2,0,0,1037870,"2023-12-01T00:00:00.000Z",359,27,"Cedi Osman",1,13,18,16,7,23.9
"9057",2081,1,0,0,7,2,12,5,2,2,27,0,2,14,0,2,3,1037870,"2023-12-01T00:00:00.000Z",3547246,27,"Devin Vassell",2,14,15,15,1,18.5
"9058",2082,3,3,10,0,0,4,4,0,0,19,1,4,8,11,0,1,1037870,"2023-12-01T00:00:00.000Z",17895854,27,"Charles Bassey",3,19,22,11,14,33.7
"9059",2083,3,0,2,4,2,9,4,0,0,23,1,1,10,3,0,2,1037870,"2023-12-01T00:00:00.000Z",3547274,27,"Tre Jones",0,13,16,13,6,16.1
"9060",2084,1,0,0,2,1,2,1,0,0,6,0,1,3,0,0,0,1037870,"2023-12-01T00:00:00.000Z",17896059,27,"Sandro Mamukelashvili",0,3,4,4,1,4.5
"9061",2085,2,0,0,0,0,0,0,0,0,3,0,0,0,0,0,0,1037870,"2023-12-01T00:00:00.000Z",38017693,27,"Blake Wesley",0,0,2,2,2,3
"9062",2086,0,0,0,0,0,1,1,0,0,3,0,0,2,0,0,0,1037870,"2023-12-01T00:00:00.000Z",38017730,27,"Dominick Barlow",0,2,2,2,0,2
"9063",2087,0,0,0,0,0,0,0,0,0,0,0,0,0,0,0,0,1037870,"2023-12-01T00:00:00.000Z",180,27,"Devonte' Graham",0,0,0,0,0,0
"9064",2088,0,0,0,0,0,0,0,0,0,0,0,0,0,0,0,0,1037870,"2023-12-01T00:00:00.000Z",56677865,27,"Charles Bediako",0,0,0,0,0,0
"9065",2089,0,0,0,0,0,0,0,0,0,0,0,0,0,0,0,0,1037870,"2023-12-01T00:00:00.000Z",56677817,27,"Sidy Cissoko",0,0,0,0,0,0
"9066",2090,0,0,0,0,0,0,0,0,0,0,0,0,0,0,0,0,1037870,"2023-12-01T00:00:00.000Z",305,27,"Doug McDermott",0,0,0,0,0,0
"9067",2091,0,0,0,0,0,0,0,0,0,0,0,0,0,0,0,0,1037870,"2023-12-01T00:00:00.000Z",56677870,27,"Sir'Jabari Rice",0,0,0,0,0,0
"9068",2092,0,0,0,0,0,0,0,0,0,0,0,0,0,0,0,0,1037870,"2023-12-01T00:00:00.000Z",56677822,27,"Victor Wembanyama",0,0,0,0,0,0
"9069",2093,0,0,0,6,1,9,3,2,1,22,0,0,8,0,0,1,1037866,"2023-12-01T00:00:00.000Z",196,22,"Gary Harris",0,8,8,8,0,7
"9070",2094,0,0,0,0,0,0,0,0,0,0,0,0,0,0,0,0,1037867,"2023-12-01T00:00:00.000Z",2175,23,"Danuel House Jr.",0,0,0,0,0,0
"9071",2095,11,3,4,3,1,25,8,13,13,36,0,2,30,4,1,1,1037871,"2023-12-01T00:00:00.000Z",140,24,"Kevin Durant",4,34,45,41,15,62.3
"9072",2096,1,0,1,0,0,1,0,4,4,17,0,0,4,1,0,0,1037871,"2023-12-01T00:00:00.000Z",32,24,"Keita Bates-Diop",0,5,6,5,2,6.7
"9073",2097,2,1,3,6,2,22,13,5,3,33,3,6,31,6,0,6,1037871,"2023-12-01T00:00:00.000Z",349,24,"Jusuf Nurkic",1,37,39,33,8,38.2
"9074",2098,3,1,3,7,4,11,6,0,0,33,1,1,16,4,1,3,1037871,"2023-12-01T00:00:00.000Z",178,24,"Eric Gordon",2,20,23,19,7,28.3
"9075",2099,3,0,9,4,1,9,5,2,2,37,0,2,13,9,1,0,1037871,"2023-12-01T00:00:00.000Z",8,24,"Grayson Allen",1,22,25,16,12,31.3
"9076",2100,0,0,4,1,0,3,1,0,0,20,2,1,2,6,0,0,1037871,"2023-12-01T00:00:00.000Z",18678058,24,"Jordan Goodwin",0,8,8,2,6,9.2
"9077",2101,0,0,0,0,0,0,0,0,0,0,0,0,0,0,0,0,1038095,"2024-01-07T00:00:00.000Z",18678058,24,"Jordan Goodwin",0,0,0,0,0,0
"9078",2102,0,0,0,0,0,0,0,0,0,0,0,0,0,0,0,0,1038095,"2024-01-07T00:00:00.000Z",470,24,"Yuta Watanabe",0,0,0,0,0,0
"9079",2103,6,1,9,8,3,20,11,4,3,32,1,5,28,10,0,2,1038095,"2024-01-07T00:00:00.000Z",231,15,"Jaren Jackson Jr.",1,38,44,34,16,50
"9080",2104,2,3,5,0,0,2,0,2,1,26,1,3,1,6,0,2,1038095,"2024-01-07T00:00:00.000Z",48,15,"Bismack Biyombo",3,7,9,3,8,18.2
"9081",2105,4,0,3,0,0,12,8,6,4,30,2,1,20,5,0,1,1038094,"2024-01-07T00:00:00.000Z",38017694,9,"Jalen Duren",0,25,29,24,9,31
"9082",2106,6,0,3,6,0,11,4,8,5,27,1,2,13,4,1,4,1038094,"2024-01-07T00:00:00.000Z",38017682,9,"Jaden Ivey",1,17,23,19,10,25.8
"9083",2107,3,0,3,2,1,6,1,0,0,11,0,2,3,3,0,0,1038094,"2024-01-07T00:00:00.000Z",17896075,9,"Cade Cunningham",0,6,9,6,6,11.1
"9084",2108,6,0,2,1,0,5,1,0,0,25,0,4,2,2,1,1,1038094,"2024-01-07T00:00:00.000Z",3547241,9,"Killian Hayes",1,4,10,8,8,15.4
"9085",2109,1,0,3,3,3,9,6,3,3,20,1,1,18,4,0,1,1038094,"2024-01-07T00:00:00.000Z",77,9,"Alec Burks",0,22,23,19,5,23.3
"9086",2110,0,0,0,0,0,0,0,0,0,0,0,0,0,0,0,0,1038093,"2024-01-07T00:00:00.000Z",320,18,"Shake Milton",0,0,0,0,0,0
"9087",2111,0,0,0,0,0,0,0,0,0,0,0,0,0,0,0,0,1038093,"2024-01-07T00:00:00.000Z",38017715,18,"Josh Minott",0,0,0,0,0,0
"9088",2112,0,0,0,0,0,0,0,0,0,0,0,0,0,0,0,0,1038093,"2024-01-07T00:00:00.000Z",56677851,18,"Jaylen Clark",0,0,0,0,0,0
"9089",2113,0,0,0,0,0,0,0,0,0,0,0,0,0,0,0,0,1038096,"2024-01-07T00:00:00.000Z",185,10,"Draymond Green",0,0,0,0,0,0
"9090",2114,0,0,0,1,0,3,0,0,0,3,3,1,0,3,0,0,1038095,"2024-01-07T00:00:00.000Z",3547285,15,"Xavier Tillman",0,3,3,0,3,3.6
"9091",2115,5,1,3,7,2,14,8,5,5,36,2,3,23,5,1,3,1038095,"2024-01-07T00:00:00.000Z",3547287,15,"Desmond Bane",2,28,33,28,10,39.5
"9092",2116,8,0,6,13,4,20,9,5,3,38,0,2,25,6,3,5,1038095,"2024-01-07T00:00:00.000Z",420,15,"Marcus Smart",3,31,39,33,14,48.2
"9093",2117,1,2,5,4,3,11,6,4,4,37,4,2,19,9,0,0,1038095,"2024-01-07T00:00:00.000Z",38017731,15,"Vince Williams Jr.",2,28,29,20,10,37.3
"9094",2118,3,0,2,5,1,10,4,1,0,27,2,4,9,4,2,1,1038095,"2024-01-07T00:00:00.000Z",17896027,15,"Ziaire Williams",2,13,16,12,7,23.3
"9095",2119,1,1,5,7,1,11,2,3,2,16,2,2,7,7,1,4,1038095,"2024-01-07T00:00:00.000Z",17896067,15,"Santi Aldama",2,14,15,8,8,18.9
"9096",2120,0,0,1,1,0,1,0,0,0,3,0,0,0,1,0,0,1038095,"2024-01-07T00:00:00.000Z",666703,15,"John Konchar",0,1,1,0,1,1.2
"9097",2121,0,0,0,0,0,0,0,0,0,0,0,0,0,0,0,0,1038095,"2024-01-07T00:00:00.000Z",38017729,15,"David Roddy",0,0,0,0,0,0
"9098",2122,0,0,0,0,0,0,0,0,0,0,0,0,0,0,0,0,1038093,"2024-01-07T00:00:00.000Z",17896056,18,"Luka Garza",0,0,0,0,0,0
"9099",2123,0,0,0,0,0,0,0,0,0,0,0,0,0,0,0,0,1038093,"2024-01-07T00:00:00.000Z",17895968,18,"Daishen Nix",0,0,0,0,0,0
"9100",2124,0,0,0,0,0,0,0,0,0,0,0,0,0,0,0,0,1038095,"2024-01-07T00:00:00.000Z",401,15,"Derrick Rose",0,0,0,0,0,0
"9101",2125,0,0,0,0,0,0,0,0,0,0,0,0,0,0,0,0,1038095,"2024-01-07T00:00:00.000Z",3,15,"Steven Adams",0,0,0,0,0,0
"9102",2126,0,0,0,0,0,0,0,0,0,0,0,0,0,0,0,0,3277504,"2023-11-24T00:00:00.000Z",2148,17,"Thanasis Antetokounmpo",0,0,0,0,0,0
"9103",2127,0,0,3,0,0,9,3,1,1,26,0,1,7,3,0,0,3277503,"2023-11-24T00:00:00.000Z",38017709,8,"Christian Braun",0,10,10,7,3,10.6
"9104",2128,0,0,0,0,0,0,0,0,0,6,0,1,0,0,0,0,3277503,"2023-11-24T00:00:00.000Z",56677776,8,"Julian Strawther",0,0,0,0,0,0
"9105",2129,0,0,0,0,0,1,0,0,0,4,0,0,0,0,0,1,3277503,"2023-11-24T00:00:00.000Z",3547268,8,"Zeke Nnaji",0,0,0,0,0,-1
"9106",2130,0,0,0,0,0,0,0,0,0,3,0,0,0,0,0,1,3277503,"2023-11-24T00:00:00.000Z",38017727,8,"Collin Gillespie",0,0,0,0,0,-1
"9107",2131,0,0,0,2,1,2,1,0,0,13,0,2,3,0,1,0,3277503,"2023-11-24T00:00:00.000Z",215,8,"Justin Holiday",1,3,3,3,0,6
"9108",2132,0,0,0,0,0,0,0,0,0,0,0,0,0,0,0,0,3277503,"2023-11-24T00:00:00.000Z",250,8,"DeAndre Jordan",0,0,0,0,0,0
"9109",2133,0,0,0,0,0,0,0,0,0,0,0,0,0,0,0,0,3277503,"2023-11-24T00:00:00.000Z",17896007,8,"Braxton Key",0,0,0,0,0,0
"9110",2134,0,0,0,0,0,0,0,0,0,0,0,0,0,0,0,0,3277503,"2023-11-24T00:00:00.000Z",56677582,8,"Jalen Pickett",0,0,0,0,0,0
"9111",2135,4,0,2,6,1,17,6,2,2,35,3,3,15,5,1,0,3277500,"2023-11-24T00:00:00.000Z",56677785,16,"Jaime Jaquez Jr.",1,20,24,19,9,30
"9112",2136,0,1,1,3,1,7,4,0,0,18,0,0,9,1,0,3,3277505,"2023-11-24T00:00:00.000Z",667378,18,"Naz Reid",1,10,10,9,1,10.2
"9113",2137,0,0,0,0,0,0,0,0,0,0,0,0,0,0,0,0,3277505,"2023-11-24T00:00:00.000Z",38017715,18,"Josh Minott",0,0,0,0,0,0
"9114",2138,0,0,0,0,0,0,0,0,0,0,0,0,0,0,0,0,3277505,"2023-11-24T00:00:00.000Z",17895968,18,"Daishen Nix",0,0,0,0,0,0
"9115",2139,0,0,0,0,0,0,0,0,0,0,0,0,0,0,0,0,3277505,"2023-11-24T00:00:00.000Z",56677851,18,"Jaylen Clark",0,0,0,0,0,0
"9116",2140,0,0,0,0,0,0,0,0,0,0,0,0,0,0,0,0,3277505,"2023-11-24T00:00:00.000Z",17896056,18,"Luka Garza",0,0,0,0,0,0
"9117",2141,0,0,0,0,0,0,0,0,0,0,0,0,0,0,0,0,3277505,"2023-11-24T00:00:00.000Z",3547259,18,"Jaden McDaniels",0,0,0,0,0,0
"9118",2142,0,0,0,0,0,0,0,0,0,0,0,0,0,0,0,0,3277505,"2023-11-24T00:00:00.000Z",666767,18,"Jordan McLaughlin",0,0,0,0,0,0
"9119",2143,0,0,0,0,0,0,0,0,0,0,0,0,0,0,0,0,3277505,"2023-11-24T00:00:00.000Z",38017700,18,"Wendell Moore Jr.",0,0,0,0,0,0
"9120",2144,0,1,0,1,0,3,0,0,0,6,1,1,0,1,0,0,3277503,"2023-11-24T00:00:00.000Z",38017721,8,"Peyton Watson",1,1,1,0,1,4.2
"9121",2145,0,0,0,0,0,0,0,0,0,0,0,0,0,0,0,0,3277503,"2023-11-24T00:00:00.000Z",56677871,8,"Hunter Tyson",0,0,0,0,0,0
"9122",2146,0,0,0,0,0,0,0,0,0,0,0,0,0,0,0,0,3277503,"2023-11-24T00:00:00.000Z",666489,8,"Vlatko Cancar",0,0,0,0,0,0
"9123",2147,0,0,0,0,0,0,0,0,0,0,0,0,0,0,0,0,3277503,"2023-11-24T00:00:00.000Z",17896103,8,"Jay Huff",0,0,0,0,0,0
"9124",2148,0,0,0,0,0,0,0,0,0,0,0,0,0,0,0,0,3277503,"2023-11-24T00:00:00.000Z",335,8,"Jamal Murray",0,0,0,0,0,0
"9125",2149,0,0,0,0,0,0,0,0,0,0,0,0,0,0,0,0,3277504,"2023-11-24T00:00:00.000Z",56677854,17,"Chris Livingston",0,0,0,0,0,0
"9126",2150,0,0,0,0,0,0,0,0,0,0,0,0,0,0,0,0,3277504,"2023-11-24T00:00:00.000Z",284,17,"Robin Lopez",0,0,0,0,0,0
"9127",2151,8,0,3,5,1,7,3,7,5,30,0,2,12,3,0,1,1038044,"2024-01-01T00:00:00.000Z",409,28,"Dennis Schroder",0,15,23,20,11,26.6
"9128",2152,0,0,0,0,0,0,0,0,0,0,0,0,0,0,0,0,1038044,"2024-01-01T00:00:00.000Z",666581,6,"Darius Garland",0,0,0,0,0,0
"9129",2153,0,0,0,0,0,0,0,0,0,0,0,0,0,0,0,0,1038044,"2024-01-01T00:00:00.000Z",17896076,6,"Evan Mobley",0,0,0,0,0,0
"9130",2154,0,0,0,0,0,0,0,0,0,0,0,0,0,0,0,0,1038044,"2024-01-01T00:00:00.000Z",38017662,6,"Isaiah Mobley",0,0,0,0,0,0
"9131",2155,0,0,0,0,0,0,0,0,0,0,0,0,0,0,0,0,1038044,"2024-01-01T00:00:00.000Z",404,6,"Ricky Rubio",0,0,0,0,0,0
"9132",2156,0,0,3,2,0,10,6,6,4,26,0,6,16,3,1,1,1038045,"2024-01-01T00:00:00.000Z",3547301,11,"Jae'Sean Tate",1,19,19,16,3,21.6
"9133",2157,1,1,6,5,3,7,3,0,0,27,0,1,9,6,0,1,1038045,"2024-01-01T00:00:00.000Z",38017684,11,"Jabari Smith Jr.",1,15,16,10,7,19.7
"9134",2158,9,0,3,2,0,13,9,9,8,27,1,3,26,4,3,2,1038045,"2024-01-01T00:00:00.000Z",17896062,11,"Alperen Sengun",3,30,39,35,13,51.3
"9135",2159,1,0,5,9,5,12,6,6,5,27,0,0,22,5,1,0,1038045,"2024-01-01T00:00:00.000Z",17895966,11,"Jalen Green",1,27,28,23,6,32.5
"9136",2160,7,0,1,6,3,11,6,0,0,26,0,1,15,1,1,1,1038045,"2024-01-01T00:00:00.000Z",458,11,"Fred VanVleet",1,16,23,22,8,28.7
"9137",2161,1,0,2,4,1,15,8,0,0,24,2,3,17,4,3,0,1038045,"2024-01-01T00:00:00.000Z",38017695,11,"Tari Eason",3,21,22,18,5,32.3
"9138",2162,4,0,2,1,0,3,0,0,0,11,1,1,0,3,0,0,1038045,"2024-01-01T00:00:00.000Z",213,11,"Aaron Holiday",0,3,7,4,7,9.6
"9139",2163,2,0,2,1,0,2,1,2,1,9,0,0,3,2,0,1,1038045,"2024-01-01T00:00:00.000Z",188,11,"Jeff Green",0,5,7,5,4,7.4
"9140",2164,2,0,2,2,1,5,3,0,0,14,0,0,7,2,0,1,1038045,"2024-01-01T00:00:00.000Z",75,11,"Reggie Bullock",0,9,11,9,4,11.4
"9141",2165,0,0,0,0,0,0,0,0,0,0,0,0,0,0,0,0,1038045,"2024-01-01T00:00:00.000Z",66,11,"Dillon Brooks",0,0,0,0,0,0
"9142",2166,1,0,3,8,4,11,6,0,0,17,0,2,16,3,0,1,1038044,"2024-01-01T00:00:00.000Z",3547299,6,"Sam Merrill",0,19,20,17,4,20.1
"9143",2167,0,0,1,1,0,2,0,0,0,6,0,1,0,1,0,0,1038044,"2024-01-01T00:00:00.000Z",56677872,6,"Craig Porter",0,1,1,0,1,1.2
"9144",2168,2,0,4,1,0,5,4,0,0,16,0,5,8,4,0,1,1038044,"2024-01-01T00:00:00.000Z",344,6,"Georges Niang",0,12,14,10,6,14.8
"9145",2169,1,0,1,0,0,0,0,0,0,14,2,3,0,3,0,0,1038044,"2024-01-01T00:00:00.000Z",444,6,"Tristan Thompson",0,3,4,1,4,5.1
"9146",2170,6,0,2,5,2,13,9,2,1,32,1,5,21,3,1,4,1038046,"2024-01-01T00:00:00.000Z",315,17,"Khris Middleton",1,24,30,27,9,32.6
"9147",2171,11,2,15,3,0,20,11,11,8,37,3,3,30,18,1,4,1038046,"2024-01-01T00:00:00.000Z",15,17,"Giannis Antetokounmpo",3,48,59,41,29,73.1
"9148",2172,1,4,4,6,2,17,8,4,3,38,1,3,21,5,0,0,1038046,"2024-01-01T00:00:00.000Z",283,17,"Brook Lopez",4,26,27,22,6,40.5
"9149",2173,0,0,4,8,4,8,4,0,0,37,0,5,12,4,0,0,1038046,"2024-01-01T00:00:00.000Z",38,17,"Malik Beasley",0,16,16,12,4,16.8
"9150",2174,5,0,6,9,1,16,3,6,6,38,1,3,13,7,0,1,1038046,"2024-01-01T00:00:00.000Z",278,17,"Damian Lillard",0,20,25,18,12,27.9
"9151",2175,2,1,2,3,1,3,1,0,0,23,0,1,3,2,1,0,1038046,"2024-01-01T00:00:00.000Z",105,17,"Pat Connaughton",2,5,7,5,4,14.4
"9152",2176,0,0,0,0,0,0,0,0,0,0,0,0,0,0,0,0,3277451,"2023-11-17T00:00:00.000Z",56677857,5,"Julian Phillips",0,0,0,0,0,0
"9153",2177,0,0,0,0,0,0,0,0,0,0,0,0,0,0,0,0,3277452,"2023-11-17T00:00:00.000Z",38017726,19,"Dereon Seabron",0,0,0,0,0,0
"9154",2178,0,0,8,6,2,14,8,1,0,33,3,3,18,11,0,0,3277452,"2023-11-17T00:00:00.000Z",375,8,"Michael Porter Jr.",0,29,29,18,11,31.2
"9155",2179,2,0,7,4,0,14,7,3,0,39,1,4,14,8,2,0,3277452,"2023-11-17T00:00:00.000Z",177,8,"Aaron Gordon",2,22,24,16,10,32.6
"9156",2180,3,0,4,1,1,20,10,4,2,36,0,1,23,4,1,3,3277451,"2023-11-17T00:00:00.000Z",125,5,"DeMar DeRozan",1,27,30,26,7,32.3
"9157",2181,0,2,1,5,4,6,5,4,4,23,0,4,18,1,2,1,3277451,"2023-11-17T00:00:00.000Z",89,5,"Alex Caruso",4,19,19,18,1,30.2
"9158",2182,6,0,7,3,0,16,4,2,2,30,3,4,10,10,0,1,3277451,"2023-11-17T00:00:00.000Z",460,5,"Nikola Vucevic",0,20,26,16,16,30
"9159",2183,3,0,6,11,4,20,12,7,6,41,0,4,34,6,2,3,3277451,"2023-11-17T00:00:00.000Z",268,5,"Zach LaVine",2,40,43,37,9,48.7
"9160",2184,4,0,1,3,0,6,2,1,0,30,0,2,4,1,0,2,3277451,"2023-11-17T00:00:00.000Z",666956,5,"Coby White",0,5,9,8,5,9.2
"9161",2185,1,0,1,0,0,0,0,0,0,10,0,0,0,1,0,0,3277451,"2023-11-17T00:00:00.000Z",87,5,"Jevon Carter",0,1,2,1,2,2.7
"9162",2186,2,1,7,6,3,16,8,8,7,37,1,3,26,8,5,3,3277455,"2023-11-17T00:00:00.000Z",274,13,"Kawhi Leonard",6,34,36,28,10,53.6
"9163",2187,3,1,7,10,4,22,8,3,3,40,1,2,23,8,2,3,3277455,"2023-11-17T00:00:00.000Z",172,13,"Paul George",3,31,34,26,11,43.1
"9164",2188,2,2,4,0,0,8,6,2,0,35,3,2,12,7,0,1,3277455,"2023-11-17T00:00:00.000Z",493,13,"Ivica Zubac",2,19,21,14,9,28.4
"9165",2189,3,1,5,2,0,3,0,2,1,21,1,3,1,6,1,0,3277455,"2023-11-17T00:00:00.000Z",666743,13,"Terance Mann",2,7,10,4,9,18.7
"9166",2190,7,1,8,4,2,11,8,7,6,34,1,1,24,9,0,3,3277455,"2023-11-17T00:00:00.000Z",192,13,"James Harden",1,33,40,31,16,45.3
"9167",2191,0,0,0,0,0,0,0,0,0,0,0,0,0,0,0,0,3277455,"2023-11-17T00:00:00.000Z",666511,13,"Amir Coffey",0,0,0,0,0,0
"9168",2192,0,0,0,0,0,0,0,0,0,0,0,0,0,0,0,0,3277455,"2023-11-17T00:00:00.000Z",38017725,13,"Moussa Diabate",0,0,0,0,0,0
"9169",2193,0,0,0,0,0,0,0,0,0,0,0,0,0,0,0,0,3277454,"2023-11-17T00:00:00.000Z",56677868,14,"D'Moi Hodge",0,0,0,0,0,0
"9170",2194,0,0,0,0,0,0,0,0,0,0,0,0,0,0,0,0,3277454,"2023-11-17T00:00:00.000Z",457,14,"Jarred Vanderbilt",0,0,0,0,0,0
"9171",2195,0,0,0,0,0,1,0,2,1,13,1,2,1,1,0,1,3277453,"2023-11-17T00:00:00.000Z",356,24,"Josh Okogie",0,2,2,1,1,1.2
"9172",2196,0,0,4,1,1,5,5,0,0,21,0,2,11,4,0,0,3277453,"2023-11-17T00:00:00.000Z",147,24,"Drew Eubanks",0,15,15,11,4,15.8
"9173",2197,0,0,1,2,1,3,1,0,0,10,1,1,3,2,0,0,3277453,"2023-11-17T00:00:00.000Z",470,24,"Yuta Watanabe",0,5,5,3,2,5.4
"9174",2198,4,0,2,4,1,6,1,0,0,14,0,2,3,2,1,0,3277453,"2023-11-17T00:00:00.000Z",18678058,24,"Jordan Goodwin",1,5,9,7,6,14.4
"9175",2199,1,0,1,2,1,3,2,0,0,11,0,0,5,1,0,0,3277453,"2023-11-17T00:00:00.000Z",666729,24,"Nassir Little",0,6,7,6,2,7.7
"9176",2200,0,0,0,0,0,0,0,0,0,0,0,0,0,0,0,0,3277453,"2023-11-17T00:00:00.000Z",666451,24,"Bol Bol",0,0,0,0,0,0
"9177",2201,0,0,0,0,0,0,0,0,0,0,0,0,0,0,0,0,1038015,"2023-12-28T00:00:00.000Z",17896056,18,"Luka Garza",0,0,0,0,0,0
"9178",2202,0,0,0,0,0,0,0,0,0,0,0,0,0,0,0,0,1038015,"2023-12-28T00:00:00.000Z",56677782,18,"Leonard Miller",0,0,0,0,0,0
"9179",2203,0,0,0,0,0,0,0,0,0,0,0,0,0,0,0,0,1038015,"2023-12-28T00:00:00.000Z",38017700,18,"Wendell Moore Jr.",0,0,0,0,0,0
"9180",2204,0,1,6,3,1,9,3,8,8,30,3,5,15,9,3,1,1038015,"2023-12-28T00:00:00.000Z",247,7,"Derrick Jones Jr.",4,24,24,15,9,36.8
"9181",2205,2,0,2,6,1,11,4,0,0,23,2,0,9,4,1,1,1038013,"2023-12-28T00:00:00.000Z",3547276,2,"Payton Pritchard",1,13,15,11,6,18.8
"9182",2206,1,0,2,4,1,6,2,0,0,18,1,0,5,3,0,1,1038013,"2023-12-28T00:00:00.000Z",17896060,2,"Sam Hauser",0,8,9,6,4,9.1
"9183",2207,0,0,2,0,0,2,2,2,1,20,0,4,5,2,1,0,1038013,"2023-12-28T00:00:00.000Z",17553967,2,"Neemias Queta",1,7,7,5,2,10.4
"9184",2208,0,0,0,0,0,0,0,0,0,0,0,0,0,0,0,0,1038013,"2023-12-28T00:00:00.000Z",261,2,"Luke Kornet",0,0,0,0,0,0
"9185",2209,0,0,0,0,0,0,0,0,0,0,0,0,0,0,0,0,1038013,"2023-12-28T00:00:00.000Z",338,2,"Svi Mykhailiuk",0,0,0,0,0,0
"9186",2210,0,0,0,0,0,0,0,0,0,0,0,0,0,0,0,0,1038013,"2023-12-28T00:00:00.000Z",3547279,2,"Lamar Stevens",0,0,0,0,0,0
"9187",2211,0,0,0,0,0,0,0,0,0,0,0,0,0,0,0,0,1038013,"2023-12-28T00:00:00.000Z",70,2,"Jaylen Brown",0,0,0,0,0,0
"9188",2212,0,0,0,0,0,0,0,0,0,0,0,0,0,0,0,0,1038013,"2023-12-28T00:00:00.000Z",38017707,2,"JD Davison",0,0,0,0,0,0
"9189",2214,0,0,0,0,0,0,0,0,0,0,0,0,0,0,0,0,1038013,"2023-12-28T00:00:00.000Z",56677864,2,"Jordan Walsh",0,0,0,0,0,0
"9190",2215,6,0,10,7,1,21,8,0,0,44,2,3,17,12,0,2,1038013,"2023-12-28T00:00:00.000Z",54,9,"Bojan Bogdanovic",0,29,35,23,18,38.4
"9191",2216,0,0,0,0,0,0,0,0,0,0,0,0,0,0,0,0,1038015,"2023-12-28T00:00:00.000Z",320,18,"Shake Milton",0,0,0,0,0,0
"9192",2217,0,0,0,0,0,0,0,0,0,0,0,0,0,0,0,0,1038015,"2023-12-28T00:00:00.000Z",38017715,18,"Josh Minott",0,0,0,0,0,0
"9193",2218,6,1,7,0,0,8,6,0,0,30,7,3,12,14,2,1,1038015,"2023-12-28T00:00:00.000Z",379,7,"Dwight Powell",3,26,32,18,20,45.8
"9194",2219,0,0,0,0,0,1,0,0,0,3,0,0,0,0,0,1,1038015,"2023-12-28T00:00:00.000Z",329,7,"Markieff Morris",0,0,0,0,0,-1
"9195",2220,0,0,0,0,0,0,0,0,0,0,0,0,0,0,0,0,1038015,"2023-12-28T00:00:00.000Z",56677859,7,"Olivier-Maxence Prosper",0,0,0,0,0,0
"9196",2221,0,0,0,0,0,0,0,0,0,0,0,0,0,0,0,0,1038015,"2023-12-28T00:00:00.000Z",24489167,7,"Brandon Williams",0,0,0,0,0,0
"9197",2222,0,0,0,0,0,0,0,0,0,0,0,0,0,0,0,0,1038015,"2023-12-28T00:00:00.000Z",17896028,7,"Greg Brown III",0,0,0,0,0,0
"9198",2223,0,0,0,0,0,0,0,0,0,0,0,0,0,0,0,0,1038015,"2023-12-28T00:00:00.000Z",132,7,"Luka Doncic",0,0,0,0,0,0
"9199",2224,0,0,0,0,0,0,0,0,0,0,0,0,0,0,0,0,1038015,"2023-12-28T00:00:00.000Z",228,7,"Kyrie Irving",0,0,0,0,0,0
"9200",2225,0,0,0,0,0,0,0,0,0,0,0,0,0,0,0,0,1038015,"2023-12-28T00:00:00.000Z",257,7,"Maxi Kleber",0,0,0,0,0,0
"9201",2226,0,0,0,0,0,0,0,0,0,0,0,0,0,0,0,0,1037729,"2023-11-12T00:00:00.000Z",54,9,"Bojan Bogdanovic",0,0,0,0,0,0
"9202",2227,0,0,0,0,0,0,0,0,0,0,0,0,0,0,0,0,1037729,"2023-11-12T00:00:00.000Z",56677729,9,"Malcolm Cazalon",0,0,0,0,0,0
"9203",2228,0,0,0,0,0,0,0,0,0,0,0,0,0,0,0,0,1037729,"2023-11-12T00:00:00.000Z",17896071,9,"Isaiah Livers",0,0,0,0,0,0
"9204",2229,0,0,0,0,0,0,0,0,0,0,0,0,0,0,0,0,1037729,"2023-11-12T00:00:00.000Z",330,9,"Monte Morris",0,0,0,0,0,0
"9205",2230,2,0,4,0,0,2,1,2,1,13,1,1,3,5,0,1,1037731,"2023-11-12T00:00:00.000Z",491,19,"Cody Zeller",0,8,10,5,7,11
"9206",2231,0,0,0,0,0,0,0,0,0,0,0,0,0,0,0,0,1037729,"2023-11-12T00:00:00.000Z",42097199,9,"Jared Rhoden",0,0,0,0,0,0
"9207",2232,2,1,3,0,0,1,1,2,1,8,0,2,3,3,0,0,1037731,"2023-11-12T00:00:00.000Z",38017726,19,"Dereon Seabron",1,6,8,5,5,12.6
"9208",2233,0,0,0,0,0,0,0,0,0,0,0,0,0,0,0,0,1037731,"2023-11-12T00:00:00.000Z",17896097,19,"Jose Alvarado",0,0,0,0,0,0
"9209",2234,0,0,0,0,0,0,0,0,0,0,0,0,0,0,0,0,1037731,"2023-11-12T00:00:00.000Z",17896024,19,"Herbert Jones",0,0,0,0,0,0
"9210",2235,0,0,0,0,0,0,0,0,0,0,0,0,0,0,0,0,1037731,"2023-11-12T00:00:00.000Z",38017663,19,"E.J. Liddell",0,0,0,0,0,0
"9211",2236,0,0,0,0,0,0,0,0,0,0,0,0,0,0,0,0,1037731,"2023-11-12T00:00:00.000Z",303,19,"CJ McCollum",0,0,0,0,0,0
"9212",2237,0,0,0,0,0,0,0,0,0,0,0,0,0,0,0,0,1037731,"2023-11-12T00:00:00.000Z",18677986,19,"Trey Murphy III",0,0,0,0,0,0
"9213",2238,2,0,1,6,2,6,2,2,1,22,0,0,7,1,0,1,1037731,"2023-11-12T00:00:00.000Z",247,7,"Derrick Jones Jr.",0,8,10,9,3,10.2
"9214",2239,1,0,0,2,0,2,0,0,0,8,0,2,0,0,0,0,1037730,"2023-11-12T00:00:00.000Z",56677776,8,"Julian Strawther",0,0,1,1,1,1.5
"9215",2240,0,0,0,0,0,0,0,0,0,0,0,0,0,0,0,0,1037730,"2023-11-12T00:00:00.000Z",215,8,"Justin Holiday",0,0,0,0,0,0
"9216",2241,6,0,3,3,1,6,2,0,0,20,0,1,5,3,1,2,1037729,"2023-11-12T00:00:00.000Z",56677792,9,"Marcus Sasser",1,8,14,11,9,18.6
"9217",2242,0,2,1,1,0,6,3,0,0,14,1,3,6,2,1,2,1037729,"2023-11-12T00:00:00.000Z",3547240,9,"James Wiseman",3,8,8,6,2,15.4
"9218",2243,2,0,0,2,0,4,2,2,2,12,0,1,6,0,1,1,1037729,"2023-11-12T00:00:00.000Z",38017682,9,"Jaden Ivey",1,6,8,8,2,11
"9219",2244,1,0,3,5,4,8,7,0,0,24,0,2,18,3,1,1,1037729,"2023-11-12T00:00:00.000Z",259,9,"Kevin Knox",1,21,22,19,4,25.1
"9220",2245,0,0,0,0,0,0,0,0,0,0,0,0,0,0,0,0,1037728,"2023-11-12T00:00:00.000Z",56677832,12,"Jarace Walker",0,0,0,0,0,0
"9221",2246,0,0,0,0,0,0,0,0,0,0,0,0,0,0,0,0,1037728,"2023-11-12T00:00:00.000Z",38017701,12,"Kendall Brown",0,0,0,0,0,0
"9222",2247,0,0,0,1,0,2,0,0,0,6,1,0,0,1,0,0,1037731,"2023-11-12T00:00:00.000Z",114,7,"Seth Curry",0,1,1,0,1,1.2
"9223",2248,0,0,1,0,0,1,1,0,0,4,0,1,2,1,0,0,1037731,"2023-11-12T00:00:00.000Z",217,7,"Richaun Holmes",0,3,3,2,1,3.2
"9224",2249,0,0,0,0,0,0,0,0,0,0,0,0,0,0,0,0,1037733,"2023-11-12T00:00:00.000Z",3547095,24,"Udoka Azubuike",0,0,0,0,0,0
"9225",2250,0,0,0,0,0,0,0,0,0,0,0,0,0,0,0,0,1037733,"2023-11-12T00:00:00.000Z",666451,24,"Bol Bol",0,0,0,0,0,0
"9226",2251,0,0,0,0,0,0,0,0,0,0,0,0,0,0,0,0,1037984,"2023-12-23T00:00:00.000Z",38017663,19,"E.J. Liddell",0,0,0,0,0,0
"9227",2252,0,0,0,0,0,0,0,0,0,0,0,0,0,0,0,0,1037984,"2023-12-23T00:00:00.000Z",340,19,"Larry Nance Jr.",0,0,0,0,0,0
"9228",2253,5,1,4,2,0,11,4,4,4,21,1,3,12,5,0,1,1037981,"2023-12-23T00:00:00.000Z",472,13,"Russell Westbrook",1,17,22,17,10,27.5
"9229",2254,0,0,0,0,0,0,0,0,0,0,0,0,0,0,0,0,1037981,"2023-12-23T00:00:00.000Z",450,13,"PJ Tucker",0,0,0,0,0,0
"9230",2255,0,0,0,0,0,0,0,0,0,0,0,0,0,0,0,0,1037981,"2023-12-23T00:00:00.000Z",38017725,13,"Moussa Diabate",0,0,0,0,0,0
"9231",2256,0,0,0,0,0,0,0,0,0,0,0,0,0,0,0,0,1037981,"2023-12-23T00:00:00.000Z",274,13,"Kawhi Leonard",0,0,0,0,0,0
"9232",2257,0,0,0,0,0,0,0,0,0,0,0,0,0,0,0,0,1037981,"2023-12-23T00:00:00.000Z",56677856,13,"Jordan Miller",0,0,0,0,0,0
"9233",2258,0,0,0,0,0,0,0,0,0,0,0,0,0,0,0,0,1037981,"2023-12-23T00:00:00.000Z",24417679,13,"Xavier Moon",0,0,0,0,0,0
"9234",2259,0,0,0,0,0,0,0,0,0,0,0,0,0,0,0,0,1037981,"2023-12-23T00:00:00.000Z",371,13,"Mason Plumlee",0,0,0,0,0,0
"9235",2260,0,0,0,0,0,0,0,0,0,0,0,0,0,0,0,0,1037981,"2023-12-23T00:00:00.000Z",17896051,13,"Joshua Primo",0,0,0,0,0,0
"9236",2261,2,0,5,10,5,16,9,9,7,30,0,0,30,5,1,2,1037981,"2023-12-23T00:00:00.000Z",434,2,"Jayson Tatum",1,35,37,32,7,40
"9237",2262,2,0,3,6,3,17,9,4,3,29,3,2,24,6,1,3,1037981,"2023-12-23T00:00:00.000Z",70,2,"Jaylen Brown",1,30,32,26,8,34.2
"9238",2263,5,2,7,5,2,6,2,0,0,27,0,2,6,7,1,0,1037981,"2023-12-23T00:00:00.000Z",219,2,"Al Horford",3,13,18,11,12,30.9
"9239",2264,3,3,3,10,3,12,5,5,5,29,0,2,18,3,0,2,1037981,"2023-12-23T00:00:00.000Z",473,2,"Derrick White",3,21,24,21,6,33.1
"9240",2265,7,0,3,6,4,12,8,0,0,28,3,1,20,6,1,1,1037981,"2023-12-23T00:00:00.000Z",214,2,"Jrue Holiday",1,26,33,27,13,39.7
"9241",2266,1,0,2,4,3,5,4,2,1,18,1,0,12,3,0,0,1037981,"2023-12-23T00:00:00.000Z",666468,2,"Oshae Brissett",0,15,16,13,4,17.1
"9242",2267,1,0,0,0,0,1,1,0,0,4,0,0,2,0,0,0,1037981,"2023-12-23T00:00:00.000Z",17896094,2,"Dalano Banton",0,2,3,3,1,3.5
"9243",2268,0,3,4,8,4,12,5,0,0,28,1,1,14,5,4,2,1037969,"2023-12-21T00:00:00.000Z",3547250,12,"Aaron Nesmith",7,19,19,14,5,39
"9244",2269,3,0,2,4,0,10,3,0,0,18,2,0,6,4,1,1,1037969,"2023-12-21T00:00:00.000Z",38017686,12,"Bennedict Mathurin",1,10,13,9,7,17.3
"9245",2270,0,0,0,0,0,0,0,0,0,0,0,0,0,0,0,0,1037969,"2023-12-21T00:00:00.000Z",56677778,12,"Oscar Tshiebwe",0,0,0,0,0,0
"9246",2271,0,0,0,0,0,0,0,0,0,0,0,0,0,0,0,0,1037969,"2023-12-21T00:00:00.000Z",56677832,12,"Jarace Walker",0,0,0,0,0,0
"9247",2272,0,0,0,0,0,0,0,0,0,0,0,0,0,0,0,0,1037969,"2023-12-21T00:00:00.000Z",56677794,12,"Isaiah Wong",0,0,0,0,0,0
"9248",2273,0,0,0,0,0,0,0,0,0,0,0,0,0,0,0,0,1037982,"2023-12-23T00:00:00.000Z",38017727,8,"Collin Gillespie",0,0,0,0,0,0
"9249",2274,0,0,0,0,0,0,0,0,0,0,0,0,0,0,0,0,1037982,"2023-12-23T00:00:00.000Z",215,8,"Justin Holiday",0,0,0,0,0,0
"9250",2275,1,1,6,5,2,17,5,2,1,29,1,1,13,7,0,1,1037980,"2023-12-23T00:00:00.000Z",666423,20,"RJ Barrett",1,20,21,14,8,24.9
"9251",2276,0,2,2,0,0,2,1,2,1,11,1,3,3,3,1,0,1037710,"2023-11-09T00:00:00.000Z",17896035,12,"Isaiah Jackson",3,6,6,3,3,15.6
"9252",2277,0,0,1,3,2,4,2,0,0,17,0,5,6,1,0,1,1037710,"2023-11-09T00:00:00.000Z",3547250,12,"Aaron Nesmith",0,7,7,6,1,6.2
"9253",2278,2,0,2,2,2,5,4,0,0,20,0,3,10,2,1,1,1037710,"2023-11-09T00:00:00.000Z",38017507,12,"Andrew Nembhard",1,12,14,12,4,17.4
"9254",2279,0,0,0,1,0,4,1,0,0,8,0,1,2,0,0,0,1037710,"2023-11-09T00:00:00.000Z",439,12,"Daniel Theis",0,2,2,2,0,2
"9255",2280,0,0,0,0,0,0,0,0,0,0,0,0,0,0,0,0,1037710,"2023-11-09T00:00:00.000Z",304,12,"T.J. McConnell",0,0,0,0,0,0
"9256",2281,0,0,0,0,0,0,0,0,0,0,0,0,0,0,0,0,1037710,"2023-11-09T00:00:00.000Z",3547207,12,"Jordan Nwora",0,0,0,0,0,0
"9257",2282,0,0,0,0,0,0,0,0,0,0,0,0,0,0,0,0,1037710,"2023-11-09T00:00:00.000Z",56677861,12,"Ben Sheppard",0,0,0,0,0,0
"9258",2283,0,0,0,0,0,0,0,0,0,0,0,0,0,0,0,0,1037710,"2023-11-09T00:00:00.000Z",3547264,12,"Jalen Smith",0,0,0,0,0,0
"9259",2284,0,0,0,0,0,0,0,0,0,0,0,0,0,0,0,0,1037710,"2023-11-09T00:00:00.000Z",56677832,12,"Jarace Walker",0,0,0,0,0,0
"9260",2285,0,0,0,0,0,0,0,0,0,0,0,0,0,0,0,0,1037710,"2023-11-09T00:00:00.000Z",38017701,12,"Kendall Brown",0,0,0,0,0,0
"9261",2286,0,0,0,0,0,0,0,0,0,0,0,0,0,0,0,0,1037710,"2023-11-09T00:00:00.000Z",56677778,12,"Oscar Tshiebwe",0,0,0,0,0,0
"9262",2287,0,0,1,0,0,0,0,0,0,8,1,1,0,2,0,1,1037709,"2023-11-08T00:00:00.000Z",47957121,25,"Justin Minaya",0,2,2,0,2,1.4
"9263",2288,0,0,0,0,0,0,0,0,0,0,0,0,0,0,0,0,1037709,"2023-11-08T00:00:00.000Z",56677829,25,"Rayan Rupert",0,0,0,0,0,0
"9264",2289,0,0,0,0,0,0,0,0,0,0,0,0,0,0,0,0,1037709,"2023-11-08T00:00:00.000Z",56677747,25,"Scoot Henderson",0,0,0,0,0,0
"9265",2290,0,0,0,0,0,0,0,0,0,0,0,0,0,0,0,0,1037709,"2023-11-08T00:00:00.000Z",56783340,25,"Duop Reath",0,0,0,0,0,0
"9266",2291,0,0,0,0,0,0,0,0,0,0,0,0,0,0,0,0,1037709,"2023-11-08T00:00:00.000Z",419,25,"Anfernee Simons",0,0,0,0,0,0
"9267",2292,0,0,0,0,0,0,0,0,0,0,0,0,0,0,0,0,1037709,"2023-11-08T00:00:00.000Z",17896120,25,"Ish Wainright",0,0,0,0,0,0
"9268",2293,0,0,0,0,0,0,0,0,0,0,0,0,0,0,0,0,1037709,"2023-11-08T00:00:00.000Z",476,25,"Robert Williams III",0,0,0,0,0,0
"9269",2294,0,0,0,0,0,0,0,0,0,0,0,0,0,0,0,0,1037710,"2023-11-09T00:00:00.000Z",56677794,12,"Isaiah Wong",0,0,0,0,0,0
"9270",2295,4,0,1,6,2,13,7,4,3,20,1,1,19,2,0,2,1037710,"2023-11-09T00:00:00.000Z",315,17,"Khris Middleton",0,21,25,23,6,25.4
"9271",2296,3,0,10,1,0,25,19,18,16,36,2,4,54,12,0,8,1037710,"2023-11-09T00:00:00.000Z",15,17,"Giannis Antetokounmpo",0,66,69,57,15,64.9
"9272",2297,0,3,1,4,0,7,1,0,0,29,0,2,2,1,2,0,1037710,"2023-11-09T00:00:00.000Z",283,17,"Brook Lopez",5,3,3,2,1,18.2
"9273",2298,2,0,3,6,3,10,4,2,2,29,1,2,13,4,1,0,1037710,"2023-11-09T00:00:00.000Z",38,17,"Malik Beasley",1,17,19,15,6,23.8
"9274",2299,5,1,4,2,1,9,3,0,0,30,0,4,7,4,0,1,1037710,"2023-11-09T00:00:00.000Z",368,17,"Cameron Payne",1,11,16,12,9,21.3
"9275",2300,1,0,4,1,1,2,2,0,0,29,0,2,5,4,1,0,1037710,"2023-11-09T00:00:00.000Z",112,17,"Jae Crowder",1,9,10,6,5,14.3
"9276",2301,0,0,0,0,0,0,0,0,0,0,0,0,0,0,0,0,1037962,"2023-12-20T00:00:00.000Z",56677835,14,"Jalen Hood-Schifino",0,0,0,0,0,0
"9277",2302,1,0,7,0,0,5,4,4,3,16,0,2,11,7,1,2,1037962,"2023-12-20T00:00:00.000Z",137,5,"Andre Drummond",1,18,19,12,8,21.9
"9278",2303,0,0,0,0,0,0,0,0,0,0,0,0,0,0,0,0,1037964,"2023-12-20T00:00:00.000Z",114,7,"Seth Curry",0,0,0,0,0,0
"9279",2304,0,0,0,0,0,0,0,0,0,0,0,0,0,0,0,0,1037964,"2023-12-20T00:00:00.000Z",217,7,"Richaun Holmes",0,0,0,0,0,0
"9280",2305,0,0,0,1,0,1,0,0,0,4,0,1,0,0,0,0,1037968,"2023-12-21T00:00:00.000Z",56677857,5,"Julian Phillips",0,0,0,0,0,0
"9281",2306,3,0,3,2,0,2,0,2,1,18,0,1,1,3,0,0,1037968,"2023-12-21T00:00:00.000Z",38017719,5,"Dalen Terry",0,4,7,4,6,9.1
"9282",2307,0,0,0,0,0,0,0,0,0,2,0,1,0,0,0,1,1037968,"2023-12-21T00:00:00.000Z",17896116,5,"Terry Taylor",0,0,0,0,0,-1
"9283",2308,0,0,0,0,0,0,0,0,0,0,0,0,0,0,0,0,1037968,"2023-12-21T00:00:00.000Z",27,5,"Lonzo Ball",0,0,0,0,0,0
"9284",2309,0,0,0,0,0,0,0,0,0,0,0,0,0,0,0,0,1037968,"2023-12-21T00:00:00.000Z",56677874,5,"Onuralp Bitim",0,0,0,0,0,0
"9285",2311,0,0,0,0,0,0,0,0,0,0,0,0,0,0,0,0,1037968,"2023-12-21T00:00:00.000Z",268,5,"Zach LaVine",0,0,0,0,0,0
"9286",2312,0,0,0,0,0,0,0,0,0,0,0,0,0,0,0,0,1037968,"2023-12-21T00:00:00.000Z",56677860,5,"Adama Sanogo",0,0,0,0,0,0
"9287",2313,2,0,4,2,0,13,5,3,1,32,2,3,11,6,0,3,1037968,"2023-12-21T00:00:00.000Z",666682,27,"Keldon Johnson",0,17,19,13,8,18.2
"9288",2314,5,3,5,1,0,8,3,3,1,22,0,0,7,5,2,2,1037968,"2023-12-21T00:00:00.000Z",56677822,27,"Victor Wembanyama",5,12,17,12,10,33.5
"9289",2315,2,0,3,8,3,15,7,4,4,31,1,0,21,4,1,1,1037968,"2023-12-21T00:00:00.000Z",3547246,27,"Devin Vassell",1,25,27,23,6,30.8
"9290",2316,3,0,1,8,6,16,9,6,5,27,2,4,29,3,3,3,1037965,"2023-12-20T00:00:00.000Z",161,26,"De'Aaron Fox",3,32,35,32,6,43.1
"9291",2317,5,0,2,4,0,10,3,4,4,25,0,1,10,2,0,1,1037965,"2023-12-20T00:00:00.000Z",324,26,"Malik Monk",0,12,17,15,7,18.9
"9292",2318,4,2,2,7,4,7,4,0,0,19,0,1,12,2,1,0,1037965,"2023-12-20T00:00:00.000Z",38017714,26,"Keon Ellis",3,14,18,16,6,29.4
"9293",2319,3,1,4,6,3,7,4,0,0,27,1,1,11,5,0,0,1037965,"2023-12-20T00:00:00.000Z",290,26,"Trey Lyles",1,16,19,14,8,24.5
"9294",2320,0,0,1,3,1,4,1,0,0,13,2,0,3,3,0,0,1037965,"2023-12-20T00:00:00.000Z",4197162,26,"Aleksandar Vezenkov",0,6,6,3,3,6.6
"9295",2321,0,0,2,2,1,5,3,0,0,6,0,0,7,2,0,0,1037965,"2023-12-20T00:00:00.000Z",17896044,26,"Kessler Edwards",0,9,9,7,2,9.4
"9296",2322,0,0,1,1,0,2,0,0,0,5,0,0,0,1,0,0,1037965,"2023-12-20T00:00:00.000Z",17896030,26,"Chris Duarte",0,1,1,0,1,1.2
"9297",2323,2,0,6,4,1,11,6,0,0,29,0,1,13,6,0,3,1037968,"2023-12-21T00:00:00.000Z",38017692,27,"Malaki Branham",0,19,21,15,8,20.2
"9298",2324,1,0,2,9,5,13,5,0,0,23,0,3,15,2,1,0,1037964,"2023-12-20T00:00:00.000Z",38017679,7,"Jaden Hardy",1,17,18,16,3,21.9
"9299",2325,0,0,0,0,0,0,0,0,0,0,0,0,0,0,0,0,1037964,"2023-12-20T00:00:00.000Z",56677840,7,"Dereck Lively II",0,0,0,0,0,0
"9300",2326,2,0,6,2,1,8,3,4,4,26,0,2,11,6,2,1,1037688,"2023-11-06T00:00:00.000Z",377,17,"Bobby Portis",2,17,19,13,8,26.2
"9301",2327,0,0,3,9,4,10,5,2,1,30,2,1,15,5,1,2,1037688,"2023-11-06T00:00:00.000Z",112,17,"Jae Crowder",1,20,20,15,5,22
"9302",2328,3,0,0,5,2,7,4,0,0,20,1,1,10,1,0,1,1037688,"2023-11-06T00:00:00.000Z",105,17,"Pat Connaughton",0,11,14,13,4,14.7
"9303",2329,3,0,1,4,3,6,4,0,0,17,0,1,11,1,0,0,1037688,"2023-11-06T00:00:00.000Z",368,17,"Cameron Payne",0,12,15,14,4,16.7
"9304",2330,2,0,0,1,1,2,1,0,0,16,1,0,3,1,1,1,1037688,"2023-11-06T00:00:00.000Z",38017676,17,"MarJon Beauchamp",1,4,6,5,3,9.2
"9305",2331,6,0,3,10,5,17,9,6,6,35,0,2,29,3,2,6,1037686,"2023-11-06T00:00:00.000Z",132,7,"Luka Doncic",2,32,38,35,9,41.6
"9306",2332,4,0,3,5,1,10,3,0,0,33,0,5,7,3,1,2,1037684,"2023-11-06T00:00:00.000Z",56677792,9,"Marcus Sasser",1,10,14,11,7,17.6
"9307",2333,0,0,1,1,0,2,0,2,2,5,1,1,2,2,0,1,1037684,"2023-11-06T00:00:00.000Z",42097199,9,"Jared Rhoden",0,4,4,2,2,3.4
"9308",2334,0,0,0,0,0,0,0,0,0,0,0,0,0,0,0,0,1037688,"2023-11-06T00:00:00.000Z",38017733,17,"A.J. Green",0,0,0,0,0,0
"9309",2335,0,0,0,0,0,0,0,0,0,0,0,0,0,0,0,0,1037688,"2023-11-06T00:00:00.000Z",56677852,17,"Andre Jackson Jr.",0,0,0,0,0,0
"9310",2336,0,0,0,0,0,0,0,0,0,0,0,0,0,0,0,0,1037688,"2023-11-06T00:00:00.000Z",56677854,17,"Chris Livingston",0,0,0,0,0,0
"9311",2337,0,0,0,0,0,0,0,0,0,0,0,0,0,0,0,0,1037688,"2023-11-06T00:00:00.000Z",284,17,"Robin Lopez",0,0,0,0,0,0
"9312",2338,0,0,0,0,0,0,0,0,0,0,0,0,0,0,0,0,1037688,"2023-11-06T00:00:00.000Z",666453,17,"Marques Bolden",0,0,0,0,0,0
"9313",2339,0,0,0,0,0,0,0,0,0,0,0,0,0,0,0,0,1037688,"2023-11-06T00:00:00.000Z",38017691,17,"TyTy Washington Jr.",0,0,0,0,0,0
"9314",2340,0,0,0,0,0,0,0,0,0,0,0,0,0,0,0,0,1037688,"2023-11-06T00:00:00.000Z",666960,17,"Lindell Wigginton",0,0,0,0,0,0
"9315",2341,0,0,5,4,1,13,8,2,2,26,0,3,19,5,1,2,1037686,"2023-11-06T00:00:00.000Z",462,22,"Moritz Wagner",1,24,24,19,5,26
"9316",2342,0,0,0,0,0,0,0,0,0,0,0,0,0,0,0,0,1037684,"2023-11-06T00:00:00.000Z",38017682,9,"Jaden Ivey",0,0,0,0,0,0
"9317",2343,1,0,2,2,1,3,2,2,1,20,0,3,6,2,1,1,1037686,"2023-11-06T00:00:00.000Z",3547258,7,"Josh Green",1,8,9,7,3,11.9
"9318",2344,0,0,6,11,4,16,8,1,1,31,0,0,21,6,0,0,1037686,"2023-11-06T00:00:00.000Z",191,7,"Tim Hardaway Jr.",0,27,27,21,6,28.2
"9319",2345,2,2,1,0,0,2,2,5,3,29,0,3,7,1,1,0,1037686,"2023-11-06T00:00:00.000Z",379,7,"Dwight Powell",3,8,10,9,3,20.2
"9320",2346,1,0,1,3,0,5,1,4,3,11,0,0,5,1,1,1,1037686,"2023-11-06T00:00:00.000Z",38017679,7,"Jaden Hardy",1,6,7,6,2,9.7
"9321",2347,0,0,0,0,0,0,0,0,0,0,0,0,0,0,0,0,1037686,"2023-11-06T00:00:00.000Z",114,7,"Seth Curry",0,0,0,0,0,0
"9322",2348,0,0,0,0,0,0,0,0,0,0,0,0,0,0,0,0,1037686,"2023-11-06T00:00:00.000Z",151,7,"Dante Exum",0,0,0,0,0,0
"9323",2349,0,0,0,0,0,0,0,0,0,0,0,0,0,0,0,0,1037686,"2023-11-06T00:00:00.000Z",217,7,"Richaun Holmes",0,0,0,0,0,0
"9324",2350,0,0,0,0,0,0,0,0,0,0,0,0,0,0,0,0,1037686,"2023-11-06T00:00:00.000Z",329,7,"Markieff Morris",0,0,0,0,0,0
"9325",2351,2,0,1,3,1,3,1,2,2,17,1,2,5,2,2,2,1037947,"2023-12-18T00:00:00.000Z",666703,15,"John Konchar",2,7,9,7,4,14.4
"9326",2352,1,0,4,3,1,5,2,3,3,22,0,1,8,4,1,3,1037947,"2023-12-18T00:00:00.000Z",38017729,15,"David Roddy",1,12,13,9,5,14.3
"9327",2353,5,0,7,7,2,12,6,5,5,22,0,3,19,7,0,4,1037947,"2023-12-18T00:00:00.000Z",17896027,15,"Ziaire Williams",0,26,31,24,12,30.9
"9328",2354,0,0,1,4,1,4,1,0,0,12,2,0,3,3,0,0,1037947,"2023-12-18T00:00:00.000Z",38017728,15,"Jake LaRavia",0,6,6,3,3,6.6
"9329",2355,0,1,0,3,2,6,3,0,0,12,0,2,8,0,0,0,1037947,"2023-12-18T00:00:00.000Z",56677830,15,"GG Jackson",1,8,8,8,0,11
"9330",2356,0,0,0,0,0,0,0,0,0,0,0,0,0,0,0,0,1037947,"2023-12-18T00:00:00.000Z",48,15,"Bismack Biyombo",0,0,0,0,0,0
"9331",2357,0,0,0,0,0,0,0,0,0,0,0,0,0,0,0,0,1037947,"2023-12-18T00:00:00.000Z",3,15,"Steven Adams",0,0,0,0,0,0
"9332",2358,0,0,0,0,0,0,0,0,0,0,0,0,0,0,0,0,1037947,"2023-12-18T00:00:00.000Z",666505,15,"Brandon Clarke",0,0,0,0,0,0
"9333",2359,0,0,0,0,0,0,0,0,0,0,0,0,0,0,0,0,1037947,"2023-12-18T00:00:00.000Z",254,15,"Luke Kennard",0,0,0,0,0,0
"9334",2360,0,0,0,0,0,0,0,0,0,0,0,0,0,0,0,0,1037947,"2023-12-18T00:00:00.000Z",38017732,15,"Kenneth Lofton Jr.",0,0,0,0,0,0
"9335",2361,0,0,0,0,0,0,0,0,0,0,0,0,0,0,0,0,1037947,"2023-12-18T00:00:00.000Z",666786,15,"Ja Morant",0,0,0,0,0,0
"9336",2362,0,0,0,0,0,0,0,0,0,0,0,0,0,0,0,0,1037947,"2023-12-18T00:00:00.000Z",401,15,"Derrick Rose",0,0,0,0,0,0
"9337",2363,0,0,0,0,0,0,0,0,0,0,0,0,0,0,0,0,1037947,"2023-12-18T00:00:00.000Z",420,15,"Marcus Smart",0,0,0,0,0,0
"9338",2364,1,0,2,3,2,8,3,0,0,23,2,1,8,4,0,2,1037948,"2023-12-18T00:00:00.000Z",375,8,"Michael Porter Jr.",0,12,13,9,5,12.3
"9339",2365,3,0,2,3,0,7,1,0,0,25,2,3,2,4,2,1,1037949,"2023-12-18T00:00:00.000Z",38017739,29,"Simone Fontecchio",2,6,9,5,7,16.3
"9340",2366,4,1,9,5,1,14,6,7,7,29,1,1,20,10,0,2,1037949,"2023-12-18T00:00:00.000Z",297,29,"Lauri Markkanen",1,30,34,24,14,39
"9341",2367,0,5,11,0,0,8,6,4,2,32,3,1,14,14,0,1,1037949,"2023-12-18T00:00:00.000Z",38017705,29,"Walker Kessler",5,28,28,14,14,44.8
"9342",2368,6,0,2,7,3,17,6,13,12,35,1,3,27,3,0,2,1037949,"2023-12-18T00:00:00.000Z",413,29,"Collin Sexton",0,30,36,33,9,37.6
"9343",2369,6,0,3,7,5,19,11,0,0,31,0,2,27,3,2,1,1037949,"2023-12-18T00:00:00.000Z",666650,29,"Talen Horton-Tucker",2,30,36,33,9,44.6
"9344",2370,3,0,4,1,0,2,1,0,0,20,1,4,2,5,1,0,1037949,"2023-12-18T00:00:00.000Z",358,29,"Kelly Olynyk",1,7,10,5,8,15.5
"9345",2371,5,0,1,0,0,2,2,0,0,16,2,1,4,3,0,0,1037949,"2023-12-18T00:00:00.000Z",139,29,"Kris Dunn",0,7,12,9,8,15.1
"9346",2372,2,1,2,5,1,10,6,0,0,23,1,1,13,3,1,2,1037949,"2023-12-18T00:00:00.000Z",38017620,29,"Ochai Agbaji",2,16,18,15,5,23.6
"9347",2373,1,0,1,6,2,6,2,0,0,23,0,2,6,1,1,1,1037949,"2023-12-18T00:00:00.000Z",351,3,"Royce O'Neale",1,7,8,7,2,10.7
"9348",2374,0,0,0,0,0,0,0,0,0,3,0,0,0,0,0,0,1037949,"2023-12-18T00:00:00.000Z",174,3,"Harry Giles III",0,0,0,0,0,0
"9349",2375,0,1,2,0,0,5,3,1,0,17,3,1,6,5,0,1,1037949,"2023-12-18T00:00:00.000Z",17896038,3,"Day'Ron Sharpe",1,11,11,6,5,14
"9350",2376,0,0,0,0,0,0,0,0,0,0,0,0,0,0,0,0,3277350,"2023-11-03T00:00:00.000Z",666423,20,"RJ Barrett",0,0,0,0,0,0
"9351",2377,4,1,4,7,4,15,7,12,12,36,0,0,30,4,1,4,3277350,"2023-11-03T00:00:00.000Z",278,17,"Damian Lillard",2,34,38,34,8,42.8
"9352",2378,2,0,0,2,0,4,1,0,0,24,2,2,2,2,1,1,3277350,"2023-11-03T00:00:00.000Z",105,17,"Pat Connaughton",1,4,6,4,4,9.4
"9353",2379,2,0,6,6,4,8,5,0,0,24,0,1,14,6,1,0,3277350,"2023-11-03T00:00:00.000Z",112,17,"Jae Crowder",1,20,22,16,8,27.2
"9354",2380,2,0,1,5,3,7,5,1,0,13,1,2,13,2,0,0,3277350,"2023-11-03T00:00:00.000Z",38017676,17,"MarJon Beauchamp",0,15,17,15,4,18.4
"9355",2381,0,0,0,0,0,0,0,0,0,0,0,0,0,0,0,0,3277350,"2023-11-03T00:00:00.000Z",2148,17,"Thanasis Antetokounmpo",0,0,0,0,0,0
"9356",2382,0,0,0,0,0,0,0,0,0,0,0,0,0,0,0,0,3277350,"2023-11-03T00:00:00.000Z",38017733,17,"A.J. Green",0,0,0,0,0,0
"9357",2383,0,0,0,0,0,0,0,0,0,0,0,0,0,0,0,0,3277350,"2023-11-03T00:00:00.000Z",56677852,17,"Andre Jackson Jr.",0,0,0,0,0,0
"9358",2384,1,0,9,0,0,4,0,0,0,29,6,4,0,15,0,0,3277350,"2023-11-03T00:00:00.000Z",399,20,"Mitchell Robinson",0,15,16,1,16,19.5
"9359",2385,2,0,4,10,5,11,6,0,0,34,0,3,17,4,0,1,3277350,"2023-11-03T00:00:00.000Z",17895858,20,"Quentin Grimes",0,21,23,19,6,23.8
"9360",2386,4,0,3,8,2,30,17,11,9,42,2,3,45,5,1,4,3277350,"2023-11-03T00:00:00.000Z",73,20,"Jalen Brunson",1,50,54,49,9,56
"9361",2387,1,0,3,3,1,10,5,3,3,22,0,1,14,3,0,1,3277350,"2023-11-03T00:00:00.000Z",3547269,20,"Immanuel Quickley",0,17,18,15,4,18.1
"9362",2388,0,0,2,0,0,3,2,0,0,18,1,3,4,3,0,2,3277350,"2023-11-03T00:00:00.000Z",201,20,"Isaiah Hartenstein",0,7,7,4,3,5.6
"9363",2389,0,0,3,4,1,8,1,0,0,18,1,0,3,4,0,1,3277350,"2023-11-03T00:00:00.000Z",131,20,"Donte DiVincenzo",0,7,7,3,4,6.8
"9364",2390,0,0,0,1,0,1,0,0,0,2,0,0,0,0,0,0,3277350,"2023-11-03T00:00:00.000Z",17896033,20,"Miles McBride",0,0,0,0,0,0
"9365",2391,0,0,0,0,0,0,0,0,0,0,0,0,0,0,0,0,3277350,"2023-11-03T00:00:00.000Z",666675,20,"DaQuan Jeffries",0,0,0,0,0,0
"9366",2392,6,0,1,8,4,11,7,0,0,29,0,0,18,1,1,2,3277351,"2023-11-03T00:00:00.000Z",397,16,"Duncan Robinson",1,19,25,24,7,29.2
"9367",2393,5,0,3,2,1,6,4,1,1,25,0,2,10,3,0,2,3277351,"2023-11-03T00:00:00.000Z",391,16,"Josh Richardson",0,13,18,15,8,19.1
"9368",2394,3,0,2,1,0,5,4,1,1,22,3,1,9,5,1,0,3277351,"2023-11-03T00:00:00.000Z",56677785,16,"Jaime Jaquez Jr.",1,14,17,12,8,22.5
"9369",2395,0,0,0,0,0,0,0,0,0,0,0,0,0,0,0,0,3277351,"2023-11-03T00:00:00.000Z",38017696,16,"Nikola Jovic",0,0,0,0,0,0
"9370",2396,0,0,0,0,0,0,0,0,0,0,0,0,0,0,0,0,3277351,"2023-11-03T00:00:00.000Z",285,16,"Kevin Love",0,0,0,0,0,0
"9371",2397,0,0,0,0,0,0,0,0,0,0,0,0,0,0,0,0,3277351,"2023-11-03T00:00:00.000Z",39398582,16,"Orlando Robinson",0,0,0,0,0,0
"9372",2398,0,0,0,0,0,0,0,0,0,0,0,0,0,0,0,0,3277351,"2023-11-03T00:00:00.000Z",19465585,16,"Dru Smith",0,0,0,0,0,0
"9373",2399,0,0,0,0,0,0,0,0,0,0,0,0,0,0,0,0,3277351,"2023-11-03T00:00:00.000Z",38017734,16,"Jamal Cain",0,0,0,0,0,0
"9374",2400,0,0,9,0,0,3,3,1,0,15,1,1,6,10,0,0,3277352,"2023-11-03T00:00:00.000Z",17896038,3,"Day'Ron Sharpe",0,16,16,6,10,18
"9375",2401,4,2,7,3,2,25,15,8,8,35,5,2,40,12,3,3,1037930,"2023-12-16T00:00:00.000Z",447,18,"Karl-Anthony Towns",5,52,56,44,16,72.4
"9376",2402,1,1,5,0,0,3,2,4,1,25,2,1,5,7,1,2,1037930,"2023-12-16T00:00:00.000Z",176,18,"Rudy Gobert",2,12,13,6,8,18.9
"9377",2403,4,0,2,10,7,23,14,2,2,34,0,3,37,2,3,4,1037930,"2023-12-16T00:00:00.000Z",3547238,18,"Anthony Edwards",3,39,43,41,6,50.4
"9378",2404,9,0,2,3,1,5,2,0,0,24,0,0,5,2,1,0,1037930,"2023-12-16T00:00:00.000Z",104,18,"Mike Conley",1,7,16,14,11,23.9
"9379",2405,10,0,3,0,0,4,2,0,0,23,1,4,4,4,0,2,1037930,"2023-12-16T00:00:00.000Z",12,18,"Kyle Anderson",0,8,18,14,14,21.8
"9380",2406,1,0,2,2,1,6,1,0,0,26,0,0,3,2,1,1,1037930,"2023-12-16T00:00:00.000Z",666400,18,"Nickeil Alexander-Walker",1,5,6,4,3,8.9
"9381",2407,0,0,0,0,0,0,0,0,0,0,0,0,0,0,0,0,1037929,"2023-12-16T00:00:00.000Z",56677874,5,"Onuralp Bitim",0,0,0,0,0,0
"9382",2409,0,0,0,0,0,0,0,0,0,0,0,0,0,0,0,0,1037929,"2023-12-16T00:00:00.000Z",268,5,"Zach LaVine",0,0,0,0,0,0
"9383",2410,0,1,3,0,0,0,0,0,0,14,0,2,0,3,0,1,1037927,"2023-12-16T00:00:00.000Z",108,23,"Robert Covington",1,3,3,0,3,5.6
"9384",2411,1,1,2,0,0,4,2,0,0,14,1,1,4,3,0,0,1037927,"2023-12-16T00:00:00.000Z",3547270,23,"Paul Reed",1,7,8,5,4,12.1
"9385",2412,1,0,1,0,0,5,2,2,2,12,1,0,6,2,1,2,1037927,"2023-12-16T00:00:00.000Z",17896025,23,"Jaden Springer",1,8,9,7,3,10.9
"9386",2413,2,0,1,2,2,3,3,2,2,7,0,0,10,1,0,0,1037927,"2023-12-16T00:00:00.000Z",2175,23,"Danuel House Jr.",0,11,13,12,3,14.2
"9387",2414,1,0,1,1,1,3,3,1,0,7,0,2,7,1,0,0,1037927,"2023-12-16T00:00:00.000Z",28,23,"Mo Bamba",0,8,9,8,2,9.7
"9388",2415,2,0,0,0,0,0,0,0,0,4,0,1,0,0,2,0,1037927,"2023-12-16T00:00:00.000Z",3547294,23,"Kenyon Martin Jr.",2,0,2,2,2,9
"9389",2416,0,0,0,0,0,0,0,0,0,4,0,0,0,0,0,0,1037927,"2023-12-16T00:00:00.000Z",260,23,"Furkan Korkmaz",0,0,0,0,0,0
"9390",2417,0,0,0,0,0,0,0,0,0,0,0,0,0,0,0,0,1037929,"2023-12-16T00:00:00.000Z",56677860,5,"Adama Sanogo",0,0,0,0,0,0
"9391",2418,0,0,2,5,2,10,5,0,0,21,2,2,12,4,0,1,1037927,"2023-12-16T00:00:00.000Z",360,23,"Kelly Oubre Jr.",0,16,16,12,4,15.8
"9392",2419,1,0,4,2,0,7,3,0,0,16,0,1,6,4,0,0,1037927,"2023-12-16T00:00:00.000Z",328,23,"Marcus Morris",0,10,11,7,5,12.3
"9393",2420,0,0,0,0,0,0,0,0,0,0,0,0,0,0,0,0,1037930,"2023-12-16T00:00:00.000Z",38017715,18,"Josh Minott",0,0,0,0,0,0
"9394",2421,0,0,0,0,0,0,0,0,0,0,0,0,0,0,0,0,1037930,"2023-12-16T00:00:00.000Z",17895968,18,"Daishen Nix",0,0,0,0,0,0
"9395",2422,2,0,1,3,0,4,0,0,0,18,0,1,0,1,0,3,1037930,"2023-12-16T00:00:00.000Z",210,12,"Buddy Hield",0,1,3,2,3,1.2
"9396",2423,1,0,2,2,1,4,3,0,0,17,2,2,7,4,0,1,1037930,"2023-12-16T00:00:00.000Z",3547243,12,"Obi Toppin",0,11,12,8,5,12.3
"9397",2424,0,0,0,0,0,0,0,0,0,0,0,0,0,0,0,0,1037928,"2023-12-16T00:00:00.000Z",17896040,1,"Jalen Johnson",0,0,0,0,0,0
"9398",2425,0,0,0,0,0,0,0,0,0,0,0,0,0,0,0,0,1037928,"2023-12-16T00:00:00.000Z",56677875,1,"Miles Norris",0,0,0,0,0,0
"9399",2426,0,0,0,0,0,0,0,0,0,0,0,0,0,0,0,0,1037652,"2023-11-01T00:00:00.000Z",38017662,6,"Isaiah Mobley",0,0,0,0,0,0
"9400",2427,0,0,0,0,0,0,0,0,0,0,0,0,0,0,0,0,1037621,"2023-10-28T00:00:00.000Z",56677830,15,"GG Jackson",0,0,0,0,0,0
"9401",2428,0,0,0,0,0,0,0,0,0,0,0,0,0,0,0,0,1037621,"2023-10-28T00:00:00.000Z",666786,15,"Ja Morant",0,0,0,0,0,0
"9402",2429,3,0,0,2,1,6,3,0,0,22,0,0,7,0,1,2,1037620,"2023-10-28T00:00:00.000Z",38017682,9,"Jaden Ivey",1,7,10,10,3,12.5
"9403",2430,1,0,2,1,0,2,1,0,0,6,1,0,2,3,0,0,1037620,"2023-10-28T00:00:00.000Z",56677792,9,"Marcus Sasser",0,5,6,3,4,7.1
"9404",2431,1,0,1,2,1,2,1,0,0,10,0,0,3,1,0,1,1037620,"2023-10-28T00:00:00.000Z",197,9,"Joe Harris",0,4,5,4,2,4.7
"9405",2432,0,0,0,0,0,0,0,0,0,1,0,0,0,0,0,0,1037620,"2023-10-28T00:00:00.000Z",44477024,9,"Stanley Umude",0,0,0,0,0,0
"9406",2433,0,0,0,0,0,0,0,0,0,0,0,0,0,0,0,0,1037620,"2023-10-28T00:00:00.000Z",42097199,9,"Jared Rhoden",0,0,0,0,0,0
"9407",2434,0,0,0,0,0,0,0,0,0,0,0,0,0,0,0,0,1037620,"2023-10-28T00:00:00.000Z",3547240,9,"James Wiseman",0,0,0,0,0,0
"9408",2435,0,0,0,0,0,0,0,0,0,0,0,0,0,0,0,0,1037620,"2023-10-28T00:00:00.000Z",54,9,"Bojan Bogdanovic",0,0,0,0,0,0
"9409",2436,0,0,0,0,0,0,0,0,0,0,0,0,0,0,0,0,1037620,"2023-10-28T00:00:00.000Z",17896071,9,"Isaiah Livers",0,0,0,0,0,0
"9410",2437,0,0,0,0,0,0,0,0,0,0,0,0,0,0,0,0,1037620,"2023-10-28T00:00:00.000Z",330,9,"Monte Morris",0,0,0,0,0,0
"9411",2438,4,2,1,1,0,13,7,7,6,32,1,3,20,2,1,1,1037620,"2023-10-28T00:00:00.000Z",125,5,"DeMar DeRozan",3,22,26,24,6,36.4
"9412",2439,1,0,2,1,0,3,0,0,0,21,1,3,0,3,1,1,1037620,"2023-10-28T00:00:00.000Z",3547248,5,"Patrick Williams",1,3,4,1,4,7.1
"9413",2440,1,0,4,2,1,12,5,1,1,32,0,5,12,4,0,1,1037620,"2023-10-28T00:00:00.000Z",460,5,"Nikola Vucevic",0,16,17,13,5,17.3
"9414",2441,2,1,2,0,0,6,1,0,0,15,3,0,2,5,3,0,1037620,"2023-10-28T00:00:00.000Z",137,5,"Andre Drummond",4,7,9,4,7,23
"9415",2442,0,0,0,0,0,0,0,0,0,1,0,0,0,0,0,0,1037620,"2023-10-28T00:00:00.000Z",56677857,5,"Julian Phillips",0,0,0,0,0,0
"9416",2443,0,0,0,1,1,1,1,0,0,1,0,0,3,0,0,0,1037620,"2023-10-28T00:00:00.000Z",38017719,5,"Dalen Terry",0,3,3,3,0,3
"9417",2444,0,0,0,0,0,0,0,0,0,1,0,0,0,0,0,0,1037620,"2023-10-28T00:00:00.000Z",17896116,5,"Terry Taylor",0,0,0,0,0,0
"9418",2445,0,0,0,0,0,0,0,0,0,0,0,0,0,0,0,0,1037620,"2023-10-28T00:00:00.000Z",27,5,"Lonzo Ball",0,0,0,0,0,0
"9419",2446,0,0,0,0,0,0,0,0,0,0,0,0,0,0,0,0,1037620,"2023-10-28T00:00:00.000Z",56677874,5,"Onuralp Bitim",0,0,0,0,0,0
"9420",2447,0,0,0,0,0,0,0,0,0,0,0,0,0,0,0,0,1037620,"2023-10-28T00:00:00.000Z",45969255,5,"Justin Lewis",0,0,0,0,0,0
"9421",2448,0,0,0,0,0,0,0,0,0,0,0,0,0,0,0,0,1037620,"2023-10-28T00:00:00.000Z",56677860,5,"Adama Sanogo",0,0,0,0,0,0
"9422",2449,0,2,3,3,1,9,4,0,0,18,2,3,9,5,0,0,1037655,"2023-11-01T00:00:00.000Z",3547268,8,"Zeke Nnaji",2,14,14,9,5,21
"9423",2450,1,0,2,1,0,3,2,0,0,16,0,2,4,2,0,2,1037655,"2023-11-01T00:00:00.000Z",38017721,8,"Peyton Watson",0,6,7,5,3,5.9
"9424",2451,0,0,0,0,0,0,0,0,0,0,0,0,0,0,0,0,1037909,"2023-12-13T00:00:00.000Z",272,24,"Damion Lee",0,0,0,0,0,0
"9425",2452,0,0,0,0,0,0,0,0,0,0,0,0,0,0,0,0,1037909,"2023-12-13T00:00:00.000Z",356,24,"Josh Okogie",0,0,0,0,0,0
"9426",2453,0,0,0,0,0,0,0,0,0,0,0,0,0,0,0,0,1037909,"2023-12-13T00:00:00.000Z",421,3,"Dennis Smith Jr.",0,0,0,0,0,0
"9427",2454,0,0,0,0,0,0,0,0,0,0,0,0,0,0,0,0,1037909,"2023-12-13T00:00:00.000Z",464,3,"Lonnie Walker IV",0,0,0,0,0,0
"9428",2455,0,0,0,0,0,0,0,0,0,0,0,0,0,0,0,0,1037909,"2023-12-13T00:00:00.000Z",56677841,3,"Dariq Whitehead",0,0,0,0,0,0
"9429",2456,1,0,0,2,0,6,1,0,0,27,0,1,2,0,1,2,1037909,"2023-12-13T00:00:00.000Z",18678058,24,"Jordan Goodwin",1,2,3,3,1,4.5
"9430",2457,0,0,0,0,0,1,0,0,0,4,0,0,0,0,0,0,1037909,"2023-12-13T00:00:00.000Z",147,24,"Drew Eubanks",0,0,0,0,0,0
"9431",2458,1,0,2,1,0,3,1,0,0,12,0,1,2,2,0,1,1037909,"2023-12-13T00:00:00.000Z",32,24,"Keita Bates-Diop",0,4,5,3,3,4.9
"9432",2459,0,0,0,0,0,0,0,0,0,0,0,0,0,0,0,0,1037909,"2023-12-13T00:00:00.000Z",666451,24,"Bol Bol",0,0,0,0,0,0
"9433",2460,0,0,0,0,0,0,0,0,0,0,0,0,0,0,0,0,1037909,"2023-12-13T00:00:00.000Z",3547298,24,"Saben Lee",0,0,0,0,0,0
"9434",2461,0,0,0,0,0,0,0,0,0,0,0,0,0,0,0,0,1037909,"2023-12-13T00:00:00.000Z",8,24,"Grayson Allen",0,0,0,0,0,0
"9435",2462,0,0,0,0,0,0,0,0,0,0,0,0,0,0,0,0,1037909,"2023-12-13T00:00:00.000Z",3547095,24,"Udoka Azubuike",0,0,0,0,0,0
"9436",2463,1,0,1,3,0,8,2,10,10,25,0,3,14,1,0,3,1037907,"2023-12-13T00:00:00.000Z",38017686,12,"Bennedict Mathurin",0,15,16,15,2,13.7
"9437",2464,2,0,5,7,0,16,3,4,3,24,1,2,9,6,0,0,1037910,"2023-12-13T00:00:00.000Z",666423,20,"RJ Barrett",0,15,17,11,8,19.2
"9438",2465,6,1,9,6,2,23,14,2,2,39,3,4,32,12,1,2,1037910,"2023-12-13T00:00:00.000Z",387,20,"Julius Randle",2,44,50,38,18,59.4
"9439",2466,0,1,1,0,0,2,2,0,0,18,1,2,4,2,0,1,1037910,"2023-12-13T00:00:00.000Z",17896063,20,"Jericho Sims",1,6,6,4,2,8.4
"9440",2467,1,0,4,9,4,13,6,7,5,27,3,2,21,7,4,0,1037910,"2023-12-13T00:00:00.000Z",131,20,"Donte DiVincenzo",4,28,29,22,8,42.9
"9441",2468,8,0,5,6,0,19,6,16,11,39,2,4,23,7,2,3,1037910,"2023-12-13T00:00:00.000Z",73,20,"Jalen Brunson",2,30,38,31,15,46.4
"9442",2469,2,0,2,4,0,5,0,0,0,29,0,2,0,2,1,0,1037910,"2023-12-13T00:00:00.000Z",202,20,"Josh Hart",1,2,4,2,4,8.4
"9443",2470,1,0,1,4,3,8,6,0,0,18,1,1,15,2,2,1,1037910,"2023-12-13T00:00:00.000Z",3547269,20,"Immanuel Quickley",2,17,18,16,3,23.9
"9444",2471,0,1,3,0,0,4,3,1,1,30,3,3,7,6,0,0,1037910,"2023-12-13T00:00:00.000Z",201,20,"Isaiah Hartenstein",1,13,13,7,6,17.2
"9445",2472,1,0,2,3,0,4,1,2,0,16,0,1,2,2,0,1,1037910,"2023-12-13T00:00:00.000Z",17895858,20,"Quentin Grimes",0,4,5,3,3,4.9
"9446",2473,0,0,0,0,0,0,0,0,0,0,0,0,0,0,0,0,1037910,"2023-12-13T00:00:00.000Z",19,20,"Ryan Arcidiacono",0,0,0,0,0,0
"9447",2474,0,0,0,0,0,0,0,0,0,0,0,0,0,0,0,0,1037910,"2023-12-13T00:00:00.000Z",160,20,"Evan Fournier",0,0,0,0,0,0
"9448",2475,0,0,0,0,0,0,0,0,0,0,0,0,0,0,0,0,1037910,"2023-12-13T00:00:00.000Z",666675,20,"DaQuan Jeffries",0,0,0,0,0,0
"9449",2476,1,0,5,2,2,3,3,3,3,14,0,0,11,5,0,0,1037632,"2023-10-29T00:00:00.000Z",486,14,"Christian Wood",0,16,17,12,6,18.5
"9450",2477,0,0,0,0,0,0,0,0,0,0,0,0,0,0,0,0,1037632,"2023-10-29T00:00:00.000Z",56677738,14,"Colin Castleton",0,0,0,0,0,0
"9451",2478,0,0,0,0,0,0,0,0,0,0,0,0,0,0,0,0,1037632,"2023-10-29T00:00:00.000Z",56677867,14,"Alex Fudge",0,0,0,0,0,0
"9452",2479,0,0,0,0,0,0,0,0,0,0,0,0,0,0,0,0,1037632,"2023-10-29T00:00:00.000Z",56677868,14,"D'Moi Hodge",0,0,0,0,0,0
"9453",2480,0,0,0,0,0,0,0,0,0,0,0,0,0,0,0,0,1037632,"2023-10-29T00:00:00.000Z",56677835,14,"Jalen Hood-Schifino",0,0,0,0,0,0
"9454",2481,0,0,0,0,0,0,0,0,0,0,0,0,0,0,0,0,1037632,"2023-10-29T00:00:00.000Z",457,14,"Jarred Vanderbilt",0,0,0,0,0,0
"9455",2482,3,1,2,1,0,1,0,0,0,26,1,1,0,3,1,0,1037631,"2023-10-29T00:00:00.000Z",108,13,"Robert Covington",2,3,6,3,6,14.1
"9456",2483,4,0,3,7,3,13,6,7,6,28,0,2,21,3,2,3,1037631,"2023-10-29T00:00:00.000Z",274,13,"Kawhi Leonard",2,24,28,25,7,33.6
"9457",2484,0,1,6,0,0,7,6,6,4,22,2,4,16,8,0,1,1037631,"2023-10-29T00:00:00.000Z",493,13,"Ivica Zubac",1,24,24,16,8,27.6
"9458",2485,5,0,3,7,2,17,8,1,1,28,1,1,19,4,5,1,1037631,"2023-10-29T00:00:00.000Z",172,13,"Paul George",5,23,28,24,9,45.3
"9459",2486,3,1,7,5,3,13,8,3,0,27,1,3,19,8,1,2,1037631,"2023-10-29T00:00:00.000Z",472,13,"Russell Westbrook",2,27,30,22,11,37.1
"9460",2487,1,0,3,8,4,14,7,0,0,21,0,1,18,3,1,4,1037631,"2023-10-29T00:00:00.000Z",17896031,13,"Nah'Shon Hyland",1,21,22,19,4,22.1
"9461",2488,1,0,4,0,0,3,2,0,0,21,2,0,4,6,0,0,1037631,"2023-10-29T00:00:00.000Z",371,13,"Mason Plumlee",0,10,11,5,7,12.7
"9462",2489,0,1,2,3,1,6,4,2,1,18,0,1,10,2,1,2,1037631,"2023-10-29T00:00:00.000Z",3547294,13,"Kenyon Martin Jr.",2,12,12,10,2,16.4
"9463",2490,1,0,2,4,0,4,0,0,0,15,0,1,0,2,1,1,1037631,"2023-10-29T00:00:00.000Z",33,13,"Nicolas Batum",1,2,3,1,3,5.9
"9464",2491,1,0,1,0,0,0,0,0,0,5,0,0,0,1,0,1,1037631,"2023-10-29T00:00:00.000Z",666511,13,"Amir Coffey",0,1,2,1,2,1.7
"9465",2492,1,0,4,2,1,2,1,0,0,5,0,1,3,4,1,0,1037631,"2023-10-29T00:00:00.000Z",56677849,13,"Kobe Brown",1,7,8,4,5,12.3
"9466",2493,2,0,0,0,0,0,0,0,0,5,1,0,0,1,0,1,1037631,"2023-10-29T00:00:00.000Z",38017725,13,"Moussa Diabate",0,1,3,2,3,3.2
"9467",2494,0,0,0,0,0,0,0,0,0,0,0,0,0,0,0,0,1037631,"2023-10-29T00:00:00.000Z",56677856,13,"Jordan Miller",0,0,0,0,0,0
"9468",2495,1,0,4,4,2,6,3,4,3,17,2,1,11,6,0,0,1037632,"2023-10-29T00:00:00.000Z",666609,14,"Rui Hachimura",0,17,18,12,7,19.7
"9469",2496,0,0,2,0,0,1,1,2,2,7,0,1,4,2,0,0,1037632,"2023-10-29T00:00:00.000Z",666626,14,"Jaxson Hayes",0,6,6,4,2,6.4
"9470",2497,0,0,0,0,0,0,0,0,0,0,0,0,0,0,0,0,1037632,"2023-10-29T00:00:00.000Z",38017697,14,"Max Christie",0,0,0,0,0,0
"9471",2498,0,0,0,0,0,0,0,0,0,0,0,0,0,0,0,0,1037632,"2023-10-29T00:00:00.000Z",56677836,14,"Maxwell Lewis",0,0,0,0,0,0
"9472",2499,1,1,2,5,2,11,5,2,1,19,1,1,13,3,2,0,1037631,"2023-10-29T00:00:00.000Z",380,13,"Norman Powell",3,16,17,14,4,27.1
"9473",2500,0,0,0,0,0,0,0,0,0,0,0,0,0,0,0,0,1037631,"2023-10-29T00:00:00.000Z",17896022,13,"Brandon Boston Jr.",0,0,0,0,0,0
"9474",2501,5,0,3,5,2,13,5,9,8,29,0,2,20,3,0,4,1037893,"2023-12-11T00:00:00.000Z",227,19,"Brandon Ingram",0,23,28,25,8,27.1
"9475",2502,2,1,3,0,0,17,13,12,10,33,2,1,36,5,1,1,1037893,"2023-12-11T00:00:00.000Z",666969,19,"Zion Williamson",2,41,43,38,7,50
"9476",2503,4,2,10,1,0,9,5,7,4,35,3,3,14,13,2,3,1037893,"2023-12-11T00:00:00.000Z",455,19,"Jonas Valanciunas",4,27,31,18,17,44.6
"9477",2504,5,0,7,3,1,7,2,3,2,32,3,4,7,10,0,0,1037893,"2023-12-11T00:00:00.000Z",17896024,19,"Herbert Jones",0,17,22,12,15,26.5
"9478",2505,4,1,4,7,4,15,8,3,3,29,0,2,23,4,1,1,1037893,"2023-12-11T00:00:00.000Z",303,19,"CJ McCollum",2,27,31,27,8,38.8
"9479",2506,1,0,3,5,1,8,4,2,1,24,0,0,10,3,0,2,1037893,"2023-12-11T00:00:00.000Z",18677986,19,"Trey Murphy III",0,13,14,11,4,13.1
"9480",2507,1,1,5,2,1,4,2,0,0,14,0,2,5,5,0,1,1037893,"2023-12-11T00:00:00.000Z",3547293,19,"Naji Marshall",1,10,11,6,6,14.5
"9481",2508,3,1,1,3,0,5,0,0,0,15,1,3,0,2,1,1,1037893,"2023-12-11T00:00:00.000Z",17896097,19,"Jose Alvarado",2,2,5,3,5,11.9
"9482",2509,2,1,1,1,1,3,1,4,3,28,1,3,6,2,2,0,1037893,"2023-12-11T00:00:00.000Z",38017677,19,"Dyson Daniels",3,8,10,8,4,20.4
"9483",2510,0,0,0,0,0,1,0,0,0,1,0,0,0,0,0,0,1037893,"2023-12-11T00:00:00.000Z",56677837,19,"Jordan Hawkins",0,0,0,0,0,0
"9484",2511,0,0,0,0,0,0,0,0,0,0,0,0,0,0,0,0,1037893,"2023-12-11T00:00:00.000Z",3547260,19,"Kira Lewis Jr.",0,0,0,0,0,0
"9485",2512,0,0,0,0,0,0,0,0,0,0,0,0,0,0,0,0,1037893,"2023-12-11T00:00:00.000Z",17896021,19,"Jeremiah Robinson-Earl",0,0,0,0,0,0
"9486",2513,1,0,2,2,0,7,4,4,2,13,0,1,10,2,0,2,1037890,"2023-12-11T00:00:00.000Z",359,27,"Cedi Osman",0,12,13,11,3,11.9
"9487",2514,2,0,0,1,0,1,0,5,3,16,0,1,3,0,2,0,1037890,"2023-12-11T00:00:00.000Z",3547274,27,"Tre Jones",2,3,5,5,2,12
"9488",2515,1,0,0,5,2,5,2,0,0,15,0,0,6,0,1,0,1037890,"2023-12-11T00:00:00.000Z",305,27,"Doug McDermott",1,6,7,7,1,10.5
"9489",2516,0,0,1,0,0,0,0,0,0,4,0,1,0,1,0,0,1037890,"2023-12-11T00:00:00.000Z",17896059,27,"Sandro Mamukelashvili",0,1,1,0,1,1.2
"9490",2517,0,0,0,0,0,0,0,0,0,0,0,0,0,0,0,0,1037890,"2023-12-11T00:00:00.000Z",180,27,"Devonte' Graham",0,0,0,0,0,0
"9491",2518,0,0,0,0,0,0,0,0,0,0,0,0,0,0,0,0,1037890,"2023-12-11T00:00:00.000Z",38017693,27,"Blake Wesley",0,0,0,0,0,0
"9492",2519,0,0,0,0,0,0,0,0,0,0,0,0,0,0,0,0,1037890,"2023-12-11T00:00:00.000Z",38017730,27,"Dominick Barlow",0,0,0,0,0,0
"9493",2520,0,0,0,0,0,0,0,0,0,0,0,0,0,0,0,0,1037890,"2023-12-11T00:00:00.000Z",17895854,27,"Charles Bassey",0,0,0,0,0,0
"9494",2521,0,0,0,0,0,0,0,0,0,0,0,0,0,0,0,0,1037890,"2023-12-11T00:00:00.000Z",56677865,27,"Charles Bediako",0,0,0,0,0,0
"9495",2522,0,0,0,0,0,0,0,0,0,0,0,0,0,0,0,0,1037890,"2023-12-11T00:00:00.000Z",56677817,27,"Sidy Cissoko",0,0,0,0,0,0
"9496",2523,0,0,0,0,0,0,0,0,0,0,0,0,0,0,0,0,1037890,"2023-12-11T00:00:00.000Z",56677870,27,"Sir'Jabari Rice",0,0,0,0,0,0
"9497",2524,0,0,0,0,0,0,0,0,0,0,0,0,0,0,0,0,1037893,"2023-12-11T00:00:00.000Z",491,19,"Cody Zeller",0,0,0,0,0,0
"9498",2525,0,0,0,0,0,0,0,0,0,0,0,0,0,0,0,0,1037893,"2023-12-11T00:00:00.000Z",56677782,18,"Leonard Miller",0,0,0,0,0,0
"9499",2526,0,0,0,0,0,0,0,0,0,0,0,0,0,0,0,0,1037643,"2023-10-30T00:00:00.000Z",56677868,14,"D'Moi Hodge",0,0,0,0,0,0
"9500",2527,0,0,0,0,0,0,0,0,0,0,0,0,0,0,0,0,1037643,"2023-10-30T00:00:00.000Z",56677836,14,"Maxwell Lewis",0,0,0,0,0,0
"9501",2528,0,4,3,0,0,0,0,0,0,12,2,1,0,5,0,1,1037638,"2023-10-30T00:00:00.000Z",379,7,"Dwight Powell",4,5,5,0,5,17
"9502",2529,0,0,0,2,0,2,0,0,0,2,0,2,0,0,0,1,1037641,"2023-10-30T00:00:00.000Z",3547271,21,"Aleksej Pokusevski",0,0,0,0,0,-1
"9503",2530,0,0,0,0,0,0,0,0,0,0,0,0,0,0,0,0,1037641,"2023-10-30T00:00:00.000Z",17896078,21,"Aaron Wiggins",0,0,0,0,0,0
"9504",2531,0,0,0,0,0,0,0,0,0,0,0,0,0,0,0,0,1037641,"2023-10-30T00:00:00.000Z",56677853,21,"Keyontae Johnson",0,0,0,0,0,0
"9505",2532,0,0,0,0,0,0,0,0,0,0,0,0,0,0,0,0,1037641,"2023-10-30T00:00:00.000Z",27924547,21,"Lindy Waters III",0,0,0,0,0,0
"9506",2533,0,0,1,0,0,0,0,0,0,2,0,0,0,1,0,0,1037641,"2023-10-30T00:00:00.000Z",42097199,9,"Jared Rhoden",0,1,1,0,1,1.2
"9507",2534,0,0,0,0,0,0,0,0,0,2,0,0,0,0,1,0,1037641,"2023-10-30T00:00:00.000Z",44477024,9,"Stanley Umude",1,0,0,0,0,3
"9508",2535,0,0,0,0,0,0,0,0,0,0,0,0,0,0,0,0,1037641,"2023-10-30T00:00:00.000Z",56677729,9,"Malcolm Cazalon",0,0,0,0,0,0
"9509",2536,0,0,0,0,0,0,0,0,0,0,0,0,0,0,0,0,1037641,"2023-10-30T00:00:00.000Z",3547240,9,"James Wiseman",0,0,0,0,0,0
"9510",2537,0,0,0,0,0,0,0,0,0,0,0,0,0,0,0,0,1037641,"2023-10-30T00:00:00.000Z",54,9,"Bojan Bogdanovic",0,0,0,0,0,0
"9511",2538,0,0,0,0,0,0,0,0,0,0,0,0,0,0,0,0,1037641,"2023-10-30T00:00:00.000Z",17896071,9,"Isaiah Livers",0,0,0,0,0,0
"9512",2539,0,0,0,0,0,0,0,0,0,0,0,0,0,0,0,0,1037641,"2023-10-30T00:00:00.000Z",330,9,"Monte Morris",0,0,0,0,0,0
"9513",2540,2,0,0,4,1,6,1,0,0,20,1,0,3,1,1,0,1037642,"2023-10-30T00:00:00.000Z",56677834,29,"Keyonte George",1,4,6,5,3,10.2
"9514",2541,2,0,1,2,0,5,0,0,0,15,1,0,0,2,0,0,1037642,"2023-10-30T00:00:00.000Z",38017620,29,"Ochai Agbaji",0,2,4,2,4,5.4
"9515",2542,1,0,2,1,0,2,0,0,0,6,0,1,0,2,0,0,1037642,"2023-10-30T00:00:00.000Z",139,29,"Kris Dunn",0,2,3,1,3,3.9
"9516",2543,0,0,0,0,0,0,0,0,0,0,0,0,0,0,0,0,1037642,"2023-10-30T00:00:00.000Z",38017739,29,"Simone Fontecchio",0,0,0,0,0,0
"9517",2544,0,0,0,0,0,0,0,0,0,0,0,0,0,0,0,0,1037642,"2023-10-30T00:00:00.000Z",666881,29,"Luka Samanic",0,0,0,0,0,0
"9518",2545,0,0,0,0,0,0,0,0,0,0,0,0,0,0,0,0,1037642,"2023-10-30T00:00:00.000Z",11891374,29,"Omer Yurtseven",0,0,0,0,0,0
"9519",2546,0,0,0,0,0,0,0,0,0,0,0,0,0,0,0,0,1037642,"2023-10-30T00:00:00.000Z",17896023,29,"Josh Christopher",0,0,0,0,0,0
"9520",2547,0,0,0,0,0,0,0,0,0,0,0,0,0,0,0,0,1037642,"2023-10-30T00:00:00.000Z",56677824,29,"Taylor Hendricks",0,0,0,0,0,0
"9521",2548,0,0,0,0,0,0,0,0,0,0,0,0,0,0,0,0,1037642,"2023-10-30T00:00:00.000Z",38017630,29,"Johnny Juzang",0,0,0,0,0,0
"9522",2549,0,0,0,0,0,0,0,0,0,0,0,0,0,0,0,0,1037642,"2023-10-30T00:00:00.000Z",19465584,29,"Micah Potter",0,0,0,0,0,0
"9523",2550,1,1,0,2,0,4,1,2,2,26,0,3,4,0,0,0,1037643,"2023-10-30T00:00:00.000Z",383,14,"Taurean Prince",1,4,5,5,1,8.5
"9524",2551,0,0,0,0,0,0,0,0,0,0,0,0,0,0,0,0,1037900,"2023-12-12T00:00:00.000Z",17896070,10,"Usman Garuba",0,0,0,0,0,0
"9525",2552,0,0,0,0,0,0,0,0,0,0,0,0,0,0,0,0,1037900,"2023-12-12T00:00:00.000Z",45658838,10,"Lester Quinones",0,0,0,0,0,0
"9526",2553,0,0,0,0,0,0,0,0,0,0,0,0,0,0,0,0,1037900,"2023-12-12T00:00:00.000Z",398,10,"Jerome Robinson",0,0,0,0,0,0
"9527",2554,0,0,0,0,0,0,0,0,0,0,0,0,0,0,0,0,1037900,"2023-12-12T00:00:00.000Z",57875092,10,"Gui Santos",0,0,0,0,0,0
"9528",2555,1,1,2,3,0,8,2,6,3,21,0,2,7,2,0,0,1037902,"2023-12-13T00:00:00.000Z",38017682,9,"Jaden Ivey",1,9,10,8,3,13.9
"9529",2556,0,0,2,3,1,7,1,0,0,13,1,1,3,3,1,0,1037902,"2023-12-13T00:00:00.000Z",77,9,"Alec Burks",1,6,6,3,3,9.6
"9530",2557,2,1,2,4,1,5,2,2,2,10,0,0,7,2,0,2,1037902,"2023-12-13T00:00:00.000Z",259,9,"Kevin Knox",1,9,11,9,4,13.4
"9531",2558,1,0,0,2,2,3,3,0,0,5,0,0,8,0,0,1,1037902,"2023-12-13T00:00:00.000Z",56677792,9,"Marcus Sasser",0,8,9,9,1,8.5
"9532",2559,0,0,0,0,0,0,0,0,0,0,0,0,0,0,0,0,1037902,"2023-12-13T00:00:00.000Z",24,9,"Marvin Bagley III",0,0,0,0,0,0
"9533",2560,0,0,0,0,0,0,0,0,0,0,0,0,0,0,0,0,1037902,"2023-12-13T00:00:00.000Z",197,9,"Joe Harris",0,0,0,0,0,0
"9534",2561,0,0,0,0,0,0,0,0,0,0,0,0,0,0,0,0,1037902,"2023-12-13T00:00:00.000Z",56677729,9,"Malcolm Cazalon",0,0,0,0,0,0
"9535",2562,0,0,0,0,0,0,0,0,0,0,0,0,0,0,0,0,1037902,"2023-12-13T00:00:00.000Z",38017694,9,"Jalen Duren",0,0,0,0,0,0
"9536",2563,0,2,5,0,0,6,5,4,3,24,1,3,13,6,1,1,1037903,"2023-12-13T00:00:00.000Z",666577,30,"Daniel Gafford",3,19,19,13,6,28.2
"9537",2564,4,1,1,5,1,12,5,0,0,31,0,2,11,1,2,5,1037903,"2023-12-13T00:00:00.000Z",666848,30,"Jordan Poole",3,12,16,15,5,22.2
"9538",2565,4,0,0,5,2,6,2,0,0,26,0,0,6,0,1,1,1037903,"2023-12-13T00:00:00.000Z",249,30,"Tyus Jones",1,6,10,10,4,14
"9539",2566,1,1,4,6,4,9,6,2,0,32,1,3,16,5,1,2,1037903,"2023-12-13T00:00:00.000Z",56677844,30,"Bilal Coulibaly",2,21,22,17,6,27.5
"9540",2567,0,1,3,6,3,7,4,2,1,21,0,2,12,3,0,1,1037903,"2023-12-13T00:00:00.000Z",17896045,30,"Corey Kispert",1,15,15,12,3,17.6
"9541",2568,1,0,1,3,1,6,2,4,4,16,0,0,9,1,0,1,1037903,"2023-12-13T00:00:00.000Z",167,30,"Danilo Gallinari",0,10,11,10,2,10.7
"9542",2569,4,0,1,4,2,4,2,2,2,13,0,1,8,1,1,1,1037903,"2023-12-13T00:00:00.000Z",18677954,30,"Jared Butler",1,9,13,12,5,17.2
"9543",2570,2,0,2,1,0,2,1,0,0,10,0,2,2,2,0,0,1037903,"2023-12-13T00:00:00.000Z",3547302,30,"Anthony Gill",0,4,6,4,4,7.4
"9544",2571,1,0,0,1,1,1,1,2,2,4,0,1,5,0,0,0,1037903,"2023-12-13T00:00:00.000Z",38017704,30,"Patrick Baldwin Jr.",0,5,6,6,1,6.5
"9545",2572,0,0,1,2,0,2,0,0,0,4,0,0,0,1,0,0,1037903,"2023-12-13T00:00:00.000Z",337,30,"Mike Muscala",0,1,1,0,1,1.2
"9546",2574,0,0,0,0,0,0,0,0,0,0,0,0,0,0,0,0,1037903,"2023-12-13T00:00:00.000Z",38017687,30,"Johnny Davis",0,0,0,0,0,0
"9547",2575,0,0,0,0,0,0,0,0,0,0,0,0,0,0,0,0,1037903,"2023-12-13T00:00:00.000Z",17896106,30,"Eugene Omoruyi",0,0,0,0,0,0
"9548",2576,7,0,3,4,1,9,5,0,0,27,0,0,11,3,1,2,1037635,"2023-10-30T00:00:00.000Z",249,30,"Tyus Jones",1,14,21,18,10,26.1
"9549",2577,0,0,2,6,3,6,3,2,0,24,0,1,9,2,0,2,1037635,"2023-10-30T00:00:00.000Z",17896045,30,"Corey Kispert",0,11,11,9,2,9.4
"9550",2578,2,0,2,2,0,5,1,2,1,16,0,0,3,2,1,1,1037635,"2023-10-30T00:00:00.000Z",167,30,"Danilo Gallinari",1,5,7,5,4,10.4
"9551",2579,2,0,2,0,0,2,0,2,1,11,0,0,1,2,0,0,1037635,"2023-10-30T00:00:00.000Z",487,30,"Delon Wright",0,3,5,3,4,6.4
"9552",2580,0,0,1,0,0,4,2,2,1,16,1,2,5,2,0,2,1037635,"2023-10-30T00:00:00.000Z",38017687,30,"Johnny Davis",0,7,7,5,2,5.4
"9553",2581,1,0,0,1,0,1,0,0,0,5,0,0,0,0,0,0,1037635,"2023-10-30T00:00:00.000Z",38017704,30,"Patrick Baldwin Jr.",0,0,1,1,1,1.5
"9554",2582,0,1,2,4,1,7,3,0,0,26,0,1,7,2,2,0,1037641,"2023-10-30T00:00:00.000Z",666541,21,"Luguentz Dort",3,9,9,7,2,18.4
"9555",2583,6,1,7,3,1,14,8,2,2,31,0,2,19,7,1,2,1037641,"2023-10-30T00:00:00.000Z",38017703,21,"Jalen Williams",2,26,32,25,13,40.4
"9556",2584,3,4,4,5,4,5,4,2,2,24,0,5,14,4,2,3,1037641,"2023-10-30T00:00:00.000Z",38017685,21,"Chet Holmgren",6,18,21,17,7,38.3
"9557",2585,3,1,4,2,0,18,9,5,3,28,3,1,21,7,1,1,1037641,"2023-10-30T00:00:00.000Z",17896065,21,"Josh Giddey",2,28,31,24,10,38.9
"9558",2586,0,0,0,0,0,0,0,0,0,0,0,0,0,0,0,0,1037633,"2023-10-30T00:00:00.000Z",56677843,3,"Noah Clowney",0,0,0,0,0,0
"9559",2587,0,0,0,0,0,0,0,0,0,0,0,0,0,0,0,0,1037633,"2023-10-30T00:00:00.000Z",666679,3,"Cameron Johnson",0,0,0,0,0,0
"9560",2588,0,0,0,0,0,0,0,0,0,0,0,0,0,0,0,0,1037633,"2023-10-30T00:00:00.000Z",56677841,3,"Dariq Whitehead",0,0,0,0,0,0
"9561",2589,0,0,0,0,0,0,0,0,0,0,0,0,0,0,0,0,1037633,"2023-10-30T00:00:00.000Z",56677722,3,"Jalen Wilson",0,0,0,0,0,0
"9562",2590,4,0,8,3,1,23,11,9,9,33,1,2,32,9,3,5,1037641,"2023-10-30T00:00:00.000Z",175,21,"Shai Gilgeous-Alexander",3,41,45,36,13,52.8
"9563",2591,1,3,8,0,0,0,0,4,2,21,1,2,2,9,0,0,1037641,"2023-10-30T00:00:00.000Z",24572055,21,"Olivier Sarr",3,11,12,3,10,23.3
"9564",2592,0,0,1,2,1,2,1,3,3,13,0,1,6,1,0,0,1037641,"2023-10-30T00:00:00.000Z",44,21,"Davis Bertans",0,7,7,6,1,7.2
"9565",2593,0,0,0,5,3,6,3,0,0,20,0,1,9,0,0,1,1037641,"2023-10-30T00:00:00.000Z",3547272,21,"Isaiah Joe",0,9,9,9,0,8
"9566",2594,2,0,4,1,0,2,1,2,2,22,0,2,4,4,0,1,1037641,"2023-10-30T00:00:00.000Z",56677833,21,"Cason Wallace",0,8,10,6,6,10.8
"9567",2595,2,0,0,2,2,4,4,1,0,18,1,0,10,1,0,1,1037641,"2023-10-30T00:00:00.000Z",38017716,21,"Ousmane Dieng",0,11,13,12,3,13.2
"9568",2596,0,0,0,0,0,0,0,0,0,2,0,0,0,0,0,0,1037641,"2023-10-30T00:00:00.000Z",17896036,21,"Tre Mann",0,0,0,0,0,0
"9569",2597,0,0,0,0,0,0,0,0,0,0,0,0,0,0,0,0,1037641,"2023-10-30T00:00:00.000Z",4197029,21,"Vasilije Micic",0,0,0,0,0,0
"9570",2598,5,0,2,7,3,15,5,5,4,36,0,1,17,2,0,7,1037641,"2023-10-30T00:00:00.000Z",17896075,9,"Cade Cunningham",0,19,24,22,7,19.9
"9571",2599,7,0,1,4,3,9,4,0,0,21,1,3,11,2,0,0,1037641,"2023-10-30T00:00:00.000Z",77,9,"Alec Burks",0,13,20,18,9,23.9
"9572",2600,1,0,3,0,0,4,3,8,7,24,1,1,13,4,0,0,1037641,"2023-10-30T00:00:00.000Z",24,9,"Marvin Bagley III",0,17,18,14,5,19.3
"9573",2601,1,2,5,4,2,9,4,0,0,21,1,4,10,6,1,0,1037902,"2023-12-13T00:00:00.000Z",313,23,"De'Anthony Melton",3,16,17,11,7,27.7
"9574",2602,9,0,3,6,0,13,2,6,5,33,1,1,9,4,0,1,1037902,"2023-12-13T00:00:00.000Z",3547254,23,"Tyrese Maxey",0,13,22,18,13,26.3
"9575",2603,1,0,3,4,2,9,7,2,1,23,0,2,17,3,2,2,1037902,"2023-12-13T00:00:00.000Z",360,23,"Kelly Oubre Jr.",2,20,21,18,4,26.1
"9576",2604,1,0,1,2,1,3,1,2,0,13,0,2,3,1,0,0,1037902,"2023-12-13T00:00:00.000Z",45,23,"Patrick Beverley",0,4,5,4,2,5.7
"9577",2605,2,1,7,0,0,2,2,0,0,16,1,2,4,8,0,0,1037902,"2023-12-13T00:00:00.000Z",328,23,"Marcus Morris",1,12,14,6,10,19.6
"9578",2606,2,0,6,2,0,4,2,1,1,17,0,2,5,6,0,1,1037902,"2023-12-13T00:00:00.000Z",108,23,"Robert Covington",0,11,13,7,8,14.2
"9579",2607,0,0,0,0,0,1,1,0,0,4,0,0,2,0,0,0,1037902,"2023-12-13T00:00:00.000Z",28,23,"Mo Bamba",0,2,2,2,0,2
"9580",2608,3,0,3,5,2,13,10,0,0,37,2,4,22,5,1,2,1037905,"2023-12-13T00:00:00.000Z",18,28,"OG Anunoby",1,27,30,25,8,33.5
"9581",2609,7,0,6,6,5,19,12,7,4,36,1,0,33,7,0,2,1037905,"2023-12-13T00:00:00.000Z",416,28,"Pascal Siakam",0,40,47,40,14,49.9
"9582",2610,6,3,9,0,0,8,5,8,5,32,4,4,15,13,0,1,1037905,"2023-12-13T00:00:00.000Z",373,28,"Jakob Poeltl",3,28,34,21,19,47.6
"9583",2611,10,0,4,0,0,8,4,7,7,29,2,1,15,6,1,4,1037904,"2023-12-13T00:00:00.000Z",79,16,"Jimmy Butler",1,21,31,25,16,36.2
"9584",2612,4,1,3,3,1,13,4,0,0,36,3,2,9,6,0,4,1037904,"2023-12-13T00:00:00.000Z",666747,16,"Caleb Martin",1,15,19,13,10,21.2
"9585",2613,1,0,2,0,0,5,3,0,0,12,2,2,6,4,0,3,1037904,"2023-12-13T00:00:00.000Z",39398582,16,"Orlando Robinson",0,10,11,7,5,9.3
"9586",2614,3,0,2,9,6,12,7,3,3,41,0,2,23,2,2,3,1037904,"2023-12-13T00:00:00.000Z",397,16,"Duncan Robinson",2,25,28,26,5,32.9
"9587",2615,1,0,2,4,4,5,5,3,3,24,0,2,17,2,2,2,1037904,"2023-12-13T00:00:00.000Z",286,16,"Kyle Lowry",2,19,20,18,3,24.9
"9588",2616,1,1,1,6,2,12,5,2,2,29,2,0,14,3,2,0,1037904,"2023-12-13T00:00:00.000Z",38017734,16,"Jamal Cain",3,17,18,15,4,28.1
"9589",2617,8,0,4,2,2,16,7,1,1,33,2,0,17,6,1,2,1037904,"2023-12-13T00:00:00.000Z",56677785,16,"Jaime Jaquez Jr.",1,23,31,25,14,37.2
"9590",2618,1,1,9,6,0,9,1,2,1,20,0,1,3,9,2,2,1037904,"2023-12-13T00:00:00.000Z",285,16,"Kevin Love",3,12,13,4,10,22.3
"9591",2619,0,0,3,0,0,7,5,1,1,16,6,2,11,9,0,1,1037904,"2023-12-13T00:00:00.000Z",74,16,"Thomas Bryant",0,20,20,11,9,20.8
"9592",2620,0,0,0,0,0,0,0,0,0,0,0,0,0,0,0,0,1037904,"2023-12-13T00:00:00.000Z",4,16,"Bam Adebayo",0,0,0,0,0,0
"9593",2621,0,0,0,0,0,0,0,0,0,0,0,0,0,0,0,0,1037904,"2023-12-13T00:00:00.000Z",3547257,16,"R.J. Hampton",0,0,0,0,0,0
"9594",2622,0,0,0,0,0,0,0,0,0,0,0,0,0,0,0,0,1037904,"2023-12-13T00:00:00.000Z",38017736,16,"Cole Swider",0,0,0,0,0,0
"9595",2623,0,0,0,0,0,0,0,0,0,0,0,0,0,0,0,0,1037904,"2023-12-13T00:00:00.000Z",666633,16,"Tyler Herro",0,0,0,0,0,0
"9596",2624,0,0,0,0,0,0,0,0,0,0,0,0,0,0,0,0,1037904,"2023-12-13T00:00:00.000Z",3092,16,"Haywood Highsmith",0,0,0,0,0,0
"9597",2625,0,0,0,0,0,0,0,0,0,0,0,0,0,0,0,0,1037904,"2023-12-13T00:00:00.000Z",38017696,16,"Nikola Jovic",0,0,0,0,0,0
"9598",2626,0,0,1,2,1,2,1,3,3,13,0,1,6,1,0,0,1037641,"2023-10-30T00:00:00.000Z",44,21,"Davis Bertans",0,7,7,6,1,7.2
"9599",2627,1,0,1,2,1,2,1,0,0,10,0,0,3,1,0,1,1037620,"2023-10-28T00:00:00.000Z",197,9,"Joe Harris",0,4,5,4,2,4.7
"9600",2628,0,0,0,0,0,0,0,0,0,1,0,0,0,0,0,0,1037620,"2023-10-28T00:00:00.000Z",44477024,9,"Stanley Umude",0,0,0,0,0,0
"9601",2629,0,0,0,0,0,0,0,0,0,0,0,0,0,0,0,0,1037620,"2023-10-28T00:00:00.000Z",42097199,9,"Jared Rhoden",0,0,0,0,0,0
"9602",2630,0,0,0,0,0,0,0,0,0,0,0,0,0,0,0,0,1037620,"2023-10-28T00:00:00.000Z",3547240,9,"James Wiseman",0,0,0,0,0,0
"9603",2631,0,0,0,0,0,0,0,0,0,0,0,0,0,0,0,0,1037620,"2023-10-28T00:00:00.000Z",54,9,"Bojan Bogdanovic",0,0,0,0,0,0
"9604",2632,0,0,0,0,0,0,0,0,0,0,0,0,0,0,0,0,1037620,"2023-10-28T00:00:00.000Z",17896071,9,"Isaiah Livers",0,0,0,0,0,0
"9605",2633,0,0,0,0,0,0,0,0,0,0,0,0,0,0,0,0,1037620,"2023-10-28T00:00:00.000Z",330,9,"Monte Morris",0,0,0,0,0,0
"9606",2634,4,2,1,1,0,13,7,7,6,32,1,3,20,2,1,1,1037620,"2023-10-28T00:00:00.000Z",125,5,"DeMar DeRozan",3,22,26,24,6,36.4
"9607",2635,1,0,2,1,0,3,0,0,0,21,1,3,0,3,1,1,1037620,"2023-10-28T00:00:00.000Z",3547248,5,"Patrick Williams",1,3,4,1,4,7.1
"9608",2636,1,0,4,2,1,12,5,1,1,32,0,5,12,4,0,1,1037620,"2023-10-28T00:00:00.000Z",460,5,"Nikola Vucevic",0,16,17,13,5,17.3
"9609",2637,2,1,2,0,0,6,1,0,0,15,3,0,2,5,3,0,1037620,"2023-10-28T00:00:00.000Z",137,5,"Andre Drummond",4,7,9,4,7,23
"9610",2638,0,0,0,0,0,0,0,0,0,1,0,0,0,0,0,0,1037620,"2023-10-28T00:00:00.000Z",56677857,5,"Julian Phillips",0,0,0,0,0,0
"9611",2639,0,0,0,1,1,1,1,0,0,1,0,0,3,0,0,0,1037620,"2023-10-28T00:00:00.000Z",38017719,5,"Dalen Terry",0,3,3,3,0,3
"9612",2640,0,0,0,0,0,0,0,0,0,1,0,0,0,0,0,0,1037620,"2023-10-28T00:00:00.000Z",17896116,5,"Terry Taylor",0,0,0,0,0,0
"9613",2641,0,0,0,0,0,0,0,0,0,0,0,0,0,0,0,0,1037620,"2023-10-28T00:00:00.000Z",27,5,"Lonzo Ball",0,0,0,0,0,0
"9614",2642,0,0,0,0,0,0,0,0,0,0,0,0,0,0,0,0,1037620,"2023-10-28T00:00:00.000Z",56677874,5,"Onuralp Bitim",0,0,0,0,0,0
"9615",2643,0,0,0,0,0,0,0,0,0,0,0,0,0,0,0,0,1037620,"2023-10-28T00:00:00.000Z",45969255,5,"Justin Lewis",0,0,0,0,0,0
"9616",2644,0,0,0,0,0,0,0,0,0,0,0,0,0,0,0,0,1037620,"2023-10-28T00:00:00.000Z",56677860,5,"Adama Sanogo",0,0,0,0,0,0
"9617",2645,5,0,2,7,3,15,5,5,4,36,0,1,17,2,0,7,1037641,"2023-10-30T00:00:00.000Z",17896075,9,"Cade Cunningham",0,19,24,22,7,19.9
"9618",2646,7,0,1,4,3,9,4,0,0,21,1,3,11,2,0,0,1037641,"2023-10-30T00:00:00.000Z",77,9,"Alec Burks",0,13,20,18,9,23.9
"9619",2647,1,0,3,0,0,4,3,8,7,24,1,1,13,4,0,0,1037641,"2023-10-30T00:00:00.000Z",24,9,"Marvin Bagley III",0,17,18,14,5,19.3
"9620",2648,3,1,1,6,4,13,7,2,2,19,1,5,20,2,1,1,1037641,"2023-10-30T00:00:00.000Z",38017682,9,"Jaden Ivey",2,22,25,23,5,31.9
"9621",2649,1,1,3,9,2,12,4,0,0,30,0,0,10,3,2,2,1037637,"2023-10-30T00:00:00.000Z",18,28,"OG Anunoby",3,13,14,11,4,22.1
"9622",2650,3,0,5,6,0,21,9,3,2,35,1,1,20,6,1,0,1037637,"2023-10-30T00:00:00.000Z",416,28,"Pascal Siakam",1,26,29,23,9,34.7
"9623",2651,3,1,4,0,0,2,2,1,0,13,2,3,4,6,0,0,1037887,"2023-12-11T00:00:00.000Z",3547270,23,"Paul Reed",1,10,13,7,9,18.7
"9624",2652,0,0,0,1,0,5,2,2,2,9,0,3,6,0,2,1,1037887,"2023-12-11T00:00:00.000Z",17896025,23,"Jaden Springer",2,6,6,6,0,11
"9625",2653,0,0,0,0,0,0,0,0,0,0,0,0,0,0,0,0,1037887,"2023-12-11T00:00:00.000Z",56913527,23,"Ricky Council IV",0,0,0,0,0,0
"9626",2654,0,0,0,0,0,0,0,0,0,0,0,0,0,0,0,0,1037887,"2023-12-11T00:00:00.000Z",17554001,23,"Javonte Smart",0,0,0,0,0,0
"9627",2655,0,0,0,0,0,0,0,0,0,0,0,0,0,0,0,0,1037887,"2023-12-11T00:00:00.000Z",56677788,23,"Terquavion Smith",0,0,0,0,0,0
"9628",2656,3,0,1,5,0,9,1,6,4,26,1,4,6,2,1,3,1037886,"2023-12-11T00:00:00.000Z",666908,6,"Max Strus",1,8,11,9,5,12.9
"9629",2657,0,0,2,4,2,5,3,2,1,29,4,2,9,6,3,2,1037886,"2023-12-11T00:00:00.000Z",666940,6,"Dean Wade",3,15,15,9,6,23.2
"9630",2658,1,0,5,0,0,3,2,0,0,15,2,6,4,7,1,1,1037886,"2023-12-11T00:00:00.000Z",9,6,"Jarrett Allen",1,11,12,5,8,15.9
"9631",2659,3,1,2,10,2,18,6,9,8,37,1,3,22,3,3,2,1037886,"2023-12-11T00:00:00.000Z",322,6,"Donovan Mitchell",4,25,28,25,6,40.1
"9632",2660,5,0,5,9,3,23,11,12,11,39,1,0,36,6,2,3,1037886,"2023-12-11T00:00:00.000Z",666581,6,"Darius Garland",2,42,47,41,11,53.7
"9633",2661,0,0,3,5,0,10,0,0,0,22,1,3,0,4,0,0,1037886,"2023-12-11T00:00:00.000Z",344,6,"Georges Niang",0,4,4,0,4,4.8
"9634",2662,0,0,1,4,0,4,0,4,1,26,3,2,1,4,0,1,1037886,"2023-12-11T00:00:00.000Z",3547247,6,"Isaac Okoro",0,5,5,1,4,4.8
"9635",2663,1,0,2,4,2,6,2,0,0,17,1,2,6,3,0,1,1037886,"2023-12-11T00:00:00.000Z",3547299,6,"Sam Merrill",0,9,10,7,4,10.1
"9636",2664,2,2,9,0,0,7,5,0,0,29,3,1,10,12,0,0,1037886,"2023-12-11T00:00:00.000Z",444,6,"Tristan Thompson",2,22,24,12,14,33.4
"9637",2665,0,0,0,0,0,0,0,0,0,0,0,0,0,0,0,0,1037886,"2023-12-11T00:00:00.000Z",248,6,"Damian Jones",0,0,0,0,0,0
"9638",2666,0,0,0,0,0,0,0,0,0,0,0,0,0,0,0,0,1037886,"2023-12-11T00:00:00.000Z",404,6,"Ricky Rubio",0,0,0,0,0,0
"9639",2667,7,0,6,3,1,12,7,4,2,32,0,4,17,6,1,0,1037884,"2023-12-11T00:00:00.000Z",204,4,"Gordon Hayward",1,23,30,24,13,37.7
"9640",2668,1,0,3,6,2,14,7,2,2,34,1,3,18,4,0,2,1037884,"2023-12-11T00:00:00.000Z",62,4,"Miles Bridges",0,22,23,19,5,22.3
"9641",2669,1,0,3,0,0,6,2,2,2,26,3,1,6,6,0,0,1037884,"2023-12-11T00:00:00.000Z",3547282,4,"Nick Richards",0,12,13,7,7,14.7
"9642",2670,2,0,4,8,3,14,6,1,1,30,0,5,16,4,0,2,1037884,"2023-12-11T00:00:00.000Z",56677823,4,"Brandon Miller",0,20,22,18,6,21.8
"9643",2671,13,0,1,13,8,17,10,7,6,39,1,4,34,2,0,3,1037884,"2023-12-11T00:00:00.000Z",403,4,"Terry Rozier",0,36,49,47,15,52.9
"9644",2672,1,0,0,5,1,5,1,0,0,17,0,1,3,0,1,0,1037888,"2023-12-11T00:00:00.000Z",666754,1,"Garrison Mathews",1,3,4,4,1,7.5
"9645",2673,2,1,3,4,1,11,6,4,3,40,1,2,16,4,1,0,1037888,"2023-12-11T00:00:00.000Z",3547256,1,"Saddiq Bey",2,20,22,18,6,29.8
"9646",2674,2,0,4,0,0,11,6,2,2,28,4,5,14,8,1,0,1037888,"2023-12-11T00:00:00.000Z",83,1,"Clint Capela",1,22,24,16,10,29.6
"9647",2675,3,0,2,8,3,23,8,2,2,38,4,2,21,6,1,2,1037888,"2023-12-11T00:00:00.000Z",334,1,"Dejounte Murray",1,27,30,24,9,33.7
"9648",2676,3,0,8,7,3,9,4,0,0,34,2,4,11,10,1,3,1037616,"2023-10-27T00:00:00.000Z",351,3,"Royce O'Neale",1,21,24,14,13,27.5
"9649",2677,0,0,0,0,0,0,0,0,0,0,0,0,0,0,0,0,1037616,"2023-10-27T00:00:00.000Z",9051997,3,"Armoni Brooks",0,0,0,0,0,0
"9650",2678,0,0,0,0,0,0,0,0,0,0,0,0,0,0,0,0,1037616,"2023-10-27T00:00:00.000Z",56677843,3,"Noah Clowney",0,0,0,0,0,0
"9651",2679,0,0,0,0,0,0,0,0,0,0,0,0,0,0,0,0,1037616,"2023-10-27T00:00:00.000Z",174,3,"Harry Giles III",0,0,0,0,0,0
"9652",2680,0,0,2,2,1,6,3,0,0,21,2,0,7,4,0,0,1037617,"2023-10-27T00:00:00.000Z",38017705,29,"Walker Kessler",0,11,11,7,4,11.8
"9653",2681,6,0,3,5,3,13,4,3,2,34,1,0,13,4,1,2,1037617,"2023-10-27T00:00:00.000Z",100,29,"Jordan Clarkson",1,17,23,19,10,27.8
"9654",2682,8,1,3,5,2,10,3,2,2,27,0,1,10,3,3,2,1037617,"2023-10-27T00:00:00.000Z",666650,29,"Talen Horton-Tucker",4,13,21,18,11,35.6
"9655",2683,0,0,1,2,0,12,5,4,3,20,0,3,13,1,0,0,1037617,"2023-10-27T00:00:00.000Z",413,29,"Collin Sexton",0,14,14,13,1,14.2
"9656",2684,2,1,1,2,0,3,1,0,0,12,0,3,2,1,1,0,1037617,"2023-10-27T00:00:00.000Z",38017620,29,"Ochai Agbaji",2,3,5,4,3,12.2
"9657",2685,3,1,1,2,2,6,5,3,3,27,3,3,15,4,1,3,1037617,"2023-10-27T00:00:00.000Z",358,29,"Kelly Olynyk",2,19,22,18,7,27.3
"9658",2686,4,1,10,2,2,26,15,2,2,36,1,2,34,11,5,5,1037613,"2023-10-27T00:00:00.000Z",175,21,"Shai Gilgeous-Alexander",6,45,49,38,15,66.2
"9659",2687,2,0,1,2,0,2,0,0,0,11,0,3,0,1,0,0,1037613,"2023-10-27T00:00:00.000Z",38017716,21,"Ousmane Dieng",0,1,3,2,3,4.2
"9660",2688,0,1,2,1,0,1,0,0,0,17,0,2,0,2,1,0,1037618,"2023-10-27T00:00:00.000Z",666923,25,"Matisse Thybulle",2,2,2,0,2,8.4
"9661",2689,3,0,4,5,1,14,4,7,6,36,0,5,15,4,2,3,1037618,"2023-10-27T00:00:00.000Z",182,25,"Jerami Grant",2,19,22,18,7,27.3
"9662",2690,1,0,11,0,0,9,7,0,0,30,4,4,14,15,0,2,1037618,"2023-10-27T00:00:00.000Z",22,25,"Deandre Ayton",0,29,30,15,16,31.5
"9663",2691,2,0,1,11,4,23,9,2,2,41,4,1,24,5,2,3,1037618,"2023-10-27T00:00:00.000Z",38017690,25,"Shaedon Sharpe",2,29,31,26,7,36
"9664",2692,2,0,1,5,1,12,3,0,0,25,2,5,7,3,1,5,1037618,"2023-10-27T00:00:00.000Z",56677747,25,"Scoot Henderson",1,10,12,9,5,11.6
"9665",2693,1,0,5,6,2,15,6,6,4,31,2,2,18,7,0,2,1037618,"2023-10-27T00:00:00.000Z",65,25,"Malcolm Brogdon",0,25,26,19,8,25.9
"9666",2694,2,0,2,0,0,5,3,0,0,20,1,2,6,3,0,1,1037618,"2023-10-27T00:00:00.000Z",476,25,"Robert Williams III",0,9,11,8,5,11.6
"9667",2695,3,0,3,2,0,4,0,2,2,23,1,0,2,4,0,0,1037618,"2023-10-27T00:00:00.000Z",56677850,25,"Toumani Camara",0,6,9,5,7,11.3
"9668",2696,0,0,3,2,1,3,2,4,4,9,1,3,9,4,0,0,1037618,"2023-10-27T00:00:00.000Z",38017711,25,"Jabari Walker",0,13,13,9,4,13.8
"9669",2697,1,0,0,0,0,2,1,0,0,8,0,0,2,0,0,0,1037618,"2023-10-27T00:00:00.000Z",3547289,25,"Skylar Mays",0,2,3,3,1,3.5
"9670",2698,0,0,0,0,0,0,0,0,0,0,0,0,0,0,0,0,1037618,"2023-10-27T00:00:00.000Z",666476,25,"Moses Brown",0,0,0,0,0,0
"9671",2699,0,0,0,0,0,0,0,0,0,0,0,0,0,0,0,0,1037618,"2023-10-27T00:00:00.000Z",56677791,25,"Kris Murray",0,0,0,0,0,0
"9672",2700,0,0,0,0,0,0,0,0,0,0,0,0,0,0,0,0,1037618,"2023-10-27T00:00:00.000Z",56677829,25,"Rayan Rupert",0,0,0,0,0,0
"9673",2701,4,0,1,5,0,17,8,9,7,34,0,3,23,1,1,1,7981426,"2023-12-08T00:00:00.000Z",73,20,"Jalen Brunson",1,24,28,27,5,32.2
"9674",2702,0,0,0,0,0,0,0,0,0,0,0,0,0,0,0,0,7981426,"2023-12-08T00:00:00.000Z",19,20,"Ryan Arcidiacono",0,0,0,0,0,0
"9675",2703,0,0,0,0,0,0,0,0,0,0,0,0,0,0,0,0,7981426,"2023-12-08T00:00:00.000Z",17896063,20,"Jericho Sims",0,0,0,0,0,0
"9676",2704,0,0,0,0,0,0,0,0,0,0,0,0,0,0,0,0,7981426,"2023-12-08T00:00:00.000Z",666474,20,"Charles Brown",0,0,0,0,0,0
"9677",2705,0,0,0,0,0,0,0,0,0,0,0,0,0,0,0,0,7981426,"2023-12-08T00:00:00.000Z",59421201,20,"Jaylen Martin",0,0,0,0,0,0
"9678",2706,0,0,0,0,0,0,0,0,0,0,0,0,0,0,0,0,7981426,"2023-12-08T00:00:00.000Z",56677795,20,"Jacob Toppin",0,0,0,0,0,0
"9679",2707,0,0,0,0,0,0,0,0,0,0,0,0,0,0,0,0,7981426,"2023-12-08T00:00:00.000Z",666971,20,"Dylan Windler",0,0,0,0,0,0
"9680",2708,0,0,0,0,0,3,2,0,0,4,0,0,4,0,0,0,7050287,"2023-12-08T00:00:00.000Z",17896027,15,"Ziaire Williams",0,4,4,4,0,4
"9681",2709,0,0,0,0,0,0,0,0,0,0,0,0,0,0,0,0,7050287,"2023-12-08T00:00:00.000Z",3,15,"Steven Adams",0,0,0,0,0,0
"9682",2710,0,0,0,0,0,0,0,0,0,0,0,0,0,0,0,0,7050287,"2023-12-08T00:00:00.000Z",666505,15,"Brandon Clarke",0,0,0,0,0,0
"9683",2711,0,0,0,0,0,0,0,0,0,0,0,0,0,0,0,0,7050287,"2023-12-08T00:00:00.000Z",56677830,15,"GG Jackson",0,0,0,0,0,0
"9684",2712,0,0,0,0,0,0,0,0,0,0,0,0,0,0,0,0,7050287,"2023-12-08T00:00:00.000Z",254,15,"Luke Kennard",0,0,0,0,0,0
"9685",2713,0,0,0,0,0,0,0,0,0,0,0,0,0,0,0,0,7050287,"2023-12-08T00:00:00.000Z",38017728,15,"Jake LaRavia",0,0,0,0,0,0
"9686",2714,0,0,0,0,0,0,0,0,0,0,0,0,0,0,0,0,7050287,"2023-12-08T00:00:00.000Z",666786,15,"Ja Morant",0,0,0,0,0,0
"9687",2715,0,0,0,0,0,0,0,0,0,0,0,0,0,0,0,0,7050287,"2023-12-08T00:00:00.000Z",420,15,"Marcus Smart",0,0,0,0,0,0
"9688",2716,2,1,0,8,4,9,4,2,2,34,2,2,14,2,0,2,7050287,"2023-12-08T00:00:00.000Z",666400,18,"Nickeil Alexander-Walker",1,16,18,16,4,20.4
"9689",2717,2,0,8,6,3,8,5,1,1,27,2,1,14,10,0,2,7981426,"2023-12-08T00:00:00.000Z",219,2,"Al Horford",0,24,26,16,12,27
"9690",2718,2,0,1,3,1,4,2,0,0,18,1,2,5,2,0,0,7981426,"2023-12-08T00:00:00.000Z",3547276,2,"Payton Pritchard",0,7,9,7,4,10.4
"9691",2719,1,0,0,0,0,3,2,0,0,11,1,0,4,1,0,0,7981426,"2023-12-08T00:00:00.000Z",261,2,"Luke Kornet",0,5,6,5,2,6.7
"9692",2720,0,0,0,0,0,0,0,0,0,0,0,0,0,0,0,0,7981426,"2023-12-08T00:00:00.000Z",338,2,"Svi Mykhailiuk",0,0,0,0,0,0
"9693",2721,0,0,0,0,0,0,0,0,0,0,0,0,0,0,0,0,7981426,"2023-12-08T00:00:00.000Z",17553967,2,"Neemias Queta",0,0,0,0,0,0
"9694",2722,0,0,0,0,0,0,0,0,0,0,0,0,0,0,0,0,7981426,"2023-12-08T00:00:00.000Z",3547279,2,"Lamar Stevens",0,0,0,0,0,0
"9695",2723,0,0,0,0,0,0,0,0,0,0,0,0,0,0,0,0,7981426,"2023-12-08T00:00:00.000Z",38017707,2,"JD Davison",0,0,0,0,0,0
"9696",2724,0,0,0,0,0,0,0,0,0,0,0,0,0,0,0,0,7981426,"2023-12-08T00:00:00.000Z",3547295,2,"Nathan Knight",0,0,0,0,0,0
"9697",2725,0,0,0,0,0,0,0,0,0,0,0,0,0,0,0,0,7050286,"2023-12-08T00:00:00.000Z",38017736,16,"Cole Swider",0,0,0,0,0,0
"9698",2726,2,0,2,2,0,4,0,0,0,15,0,3,0,2,1,2,1037610,"2023-10-27T00:00:00.000Z",38017729,15,"David Roddy",1,2,4,2,4,6.4
"9699",2727,0,0,1,8,2,16,6,1,1,30,1,2,15,2,0,2,1037608,"2023-10-26T00:00:00.000Z",178,24,"Eric Gordon",0,17,17,15,2,15.4
"9700",2728,2,0,6,5,1,15,6,3,1,30,0,2,14,6,2,1,1037608,"2023-10-26T00:00:00.000Z",18678058,24,"Jordan Goodwin",2,20,22,16,8,29.2
"9701",2729,2,0,3,0,0,2,1,0,0,17,1,3,2,4,0,2,1037608,"2023-10-26T00:00:00.000Z",147,24,"Drew Eubanks",0,6,8,4,6,7.8
"9702",2730,0,0,1,1,1,2,1,0,0,15,0,2,3,1,0,1,1037608,"2023-10-26T00:00:00.000Z",470,24,"Yuta Watanabe",0,4,4,3,1,3.2
"9703",2731,0,1,2,2,0,2,0,2,2,13,0,0,2,2,1,1,1037608,"2023-10-26T00:00:00.000Z",666729,24,"Nassir Little",2,4,4,2,2,9.4
"9704",2732,0,0,0,0,0,0,0,0,0,0,0,0,0,0,0,0,1037608,"2023-10-26T00:00:00.000Z",3547095,24,"Udoka Azubuike",0,0,0,0,0,0
"9705",2733,0,0,0,0,0,0,0,0,0,0,0,0,0,0,0,0,1037608,"2023-10-26T00:00:00.000Z",32,24,"Keita Bates-Diop",0,0,0,0,0,0
"9706",2734,0,0,0,0,0,0,0,0,0,0,0,0,0,0,0,0,1037608,"2023-10-26T00:00:00.000Z",666451,24,"Bol Bol",0,0,0,0,0,0
"9707",2735,0,0,0,0,0,0,0,0,0,0,0,0,0,0,0,0,1037608,"2023-10-26T00:00:00.000Z",3547298,24,"Saben Lee",0,0,0,0,0,0
"9708",2736,0,0,0,0,0,0,0,0,0,0,0,0,0,0,0,0,1037608,"2023-10-26T00:00:00.000Z",314,24,"Chimezie Metu",0,0,0,0,0,0
"9709",2737,0,0,0,0,0,0,0,0,0,0,0,0,0,0,0,0,1037608,"2023-10-26T00:00:00.000Z",37,24,"Bradley Beal",0,0,0,0,0,0
"9710",2738,0,0,0,0,0,0,0,0,0,0,0,0,0,0,0,0,1037608,"2023-10-26T00:00:00.000Z",57,24,"Devin Booker",0,0,0,0,0,0
"9711",2739,0,0,0,0,0,0,0,0,0,0,0,0,0,0,0,0,1037608,"2023-10-26T00:00:00.000Z",272,24,"Damion Lee",0,0,0,0,0,0
"9712",2740,4,0,8,4,2,15,6,6,5,34,1,2,19,9,3,3,1037609,"2023-10-27T00:00:00.000Z",204,4,"Gordon Hayward",3,28,32,23,13,41.8
"9713",2741,3,1,3,5,1,13,6,1,0,29,0,6,13,3,2,2,1037609,"2023-10-27T00:00:00.000Z",666950,4,"P.J. Washington",3,16,19,16,6,28.1
"9714",2742,1,1,1,0,0,4,1,0,0,21,2,5,2,3,0,1,1037609,"2023-10-27T00:00:00.000Z",38017698,4,"Mark Williams",1,5,6,3,4,9.1
"9715",2743,1,0,2,7,0,20,8,4,4,35,1,0,20,3,1,2,1037609,"2023-10-27T00:00:00.000Z",403,4,"Terry Rozier",1,23,24,21,4,26.1
"9716",2744,9,1,6,7,2,17,4,12,10,33,3,1,20,9,2,4,1037609,"2023-10-27T00:00:00.000Z",3547239,4,"LaMelo Ball",3,29,38,29,18,49.3
"9717",2745,2,1,4,4,2,13,6,4,3,33,2,4,17,6,1,3,1037609,"2023-10-27T00:00:00.000Z",56677823,4,"Brandon Miller",2,23,25,19,8,30.2
"9718",2746,0,1,3,1,0,3,1,0,0,25,1,1,2,4,1,0,1037609,"2023-10-27T00:00:00.000Z",18678001,4,"JT Thor",2,6,6,2,4,12.8
"9719",2747,0,2,1,0,0,1,0,2,0,16,1,4,0,2,1,2,1037609,"2023-10-27T00:00:00.000Z",3547282,4,"Nick Richards",3,2,2,0,2,9.4
"9720",2748,0,0,2,0,0,2,1,5,4,14,0,0,6,2,2,1,1037609,"2023-10-27T00:00:00.000Z",3547253,4,"Theo Maledon",2,8,8,6,2,13.4
"9721",2749,0,0,0,0,0,0,0,0,0,0,0,0,0,0,0,0,1037609,"2023-10-27T00:00:00.000Z",56677848,4,"Amari Bailey",0,0,0,0,0,0
"9722",2750,0,0,0,0,0,0,0,0,0,0,0,0,0,0,0,0,1037609,"2023-10-27T00:00:00.000Z",56677866,4,"Leaky Black",0,0,0,0,0,0
"9723",2751,2,2,3,3,2,4,3,2,1,18,0,1,9,3,2,1,7045522,"2023-12-04T00:00:00.000Z",17896097,19,"Jose Alvarado",4,12,14,11,5,26.6
"9724",2752,1,1,2,8,3,13,6,2,1,30,0,1,16,2,0,0,7045522,"2023-12-04T00:00:00.000Z",18677986,19,"Trey Murphy III",1,18,19,17,3,22.9
"9725",2753,0,0,0,0,0,0,0,0,0,5,0,0,0,0,1,0,7045522,"2023-12-04T00:00:00.000Z",491,19,"Cody Zeller",1,0,0,0,0,3
"9726",2754,0,0,0,0,0,1,0,0,0,6,1,1,0,1,2,0,7045522,"2023-12-04T00:00:00.000Z",38017677,19,"Dyson Daniels",2,1,1,0,1,7.2
"9727",2755,0,0,0,0,0,0,0,0,0,0,0,0,0,0,0,0,7045522,"2023-12-04T00:00:00.000Z",56677837,19,"Jordan Hawkins",0,0,0,0,0,0
"9728",2756,0,0,0,0,0,0,0,0,0,0,0,0,0,0,0,0,7045522,"2023-12-04T00:00:00.000Z",3547260,19,"Kira Lewis Jr.",0,0,0,0,0,0
"9729",2757,0,0,0,0,0,0,0,0,0,0,0,0,0,0,0,0,7045522,"2023-12-04T00:00:00.000Z",17896021,19,"Jeremiah Robinson-Earl",0,0,0,0,0,0
"9730",2758,0,0,0,0,0,0,0,0,0,0,0,0,0,0,0,0,7045522,"2023-12-04T00:00:00.000Z",38017663,19,"E.J. Liddell",0,0,0,0,0,0
"9731",2759,0,0,0,0,0,0,0,0,0,0,0,0,0,0,0,0,7045522,"2023-12-04T00:00:00.000Z",340,19,"Larry Nance Jr.",0,0,0,0,0,0
"9732",2760,0,0,0,0,0,0,0,0,0,0,0,0,0,0,0,0,7045522,"2023-12-04T00:00:00.000Z",17896017,19,"Matt Ryan",0,0,0,0,0,0
"9733",2761,0,0,0,0,0,0,0,0,0,0,0,0,0,0,0,0,7045522,"2023-12-04T00:00:00.000Z",38017726,19,"Dereon Seabron",0,0,0,0,0,0
"9734",2762,7,0,2,3,2,12,6,0,0,26,2,1,14,4,1,2,7045523,"2023-12-05T00:00:00.000Z",315,17,"Khris Middleton",1,18,25,21,11,30.3
"9735",2763,10,0,5,1,1,22,15,9,4,34,3,3,35,8,3,4,7045523,"2023-12-05T00:00:00.000Z",15,17,"Giannis Antetokounmpo",3,43,53,45,18,64.6
"9736",2764,3,3,6,4,1,8,4,0,0,34,2,4,9,8,3,0,7045523,"2023-12-05T00:00:00.000Z",283,17,"Brook Lopez",6,17,20,12,11,41.1
"9737",2765,0,0,3,10,6,11,6,0,0,33,0,4,18,3,0,0,7045523,"2023-12-05T00:00:00.000Z",38,17,"Malik Beasley",0,21,21,18,3,21.6
"9738",2766,7,1,2,7,5,13,8,8,7,34,1,4,28,3,1,3,7045523,"2023-12-05T00:00:00.000Z",278,17,"Damian Lillard",2,31,38,35,10,45.1
"9739",2767,1,2,2,3,1,9,5,2,2,24,2,4,13,4,0,1,7045523,"2023-12-05T00:00:00.000Z",377,17,"Bobby Portis",2,17,18,14,5,24.3
"9740",2768,1,0,2,2,2,3,2,0,0,19,0,1,6,2,1,0,7045523,"2023-12-05T00:00:00.000Z",38017676,17,"MarJon Beauchamp",1,8,9,7,3,12.9
"9741",2769,1,0,0,4,3,4,3,0,0,15,0,0,9,0,0,0,7045523,"2023-12-05T00:00:00.000Z",38017733,17,"A.J. Green",0,9,10,10,1,10.5
"9742",2770,0,0,0,0,0,0,0,0,0,1,0,0,0,0,0,0,7045523,"2023-12-05T00:00:00.000Z",56677852,17,"Andre Jackson Jr.",0,0,0,0,0,0
"9743",2771,2,0,2,3,2,6,5,0,0,14,0,2,12,2,1,1,7045523,"2023-12-05T00:00:00.000Z",368,17,"Cameron Payne",1,14,16,14,4,19.4
"9744",2772,0,0,1,0,0,1,0,0,0,2,1,0,0,2,1,1,7045523,"2023-12-05T00:00:00.000Z",56677854,17,"Chris Livingston",1,2,2,0,2,4.4
"9745",2773,0,0,0,1,0,1,0,0,0,2,0,0,0,0,0,0,7045523,"2023-12-05T00:00:00.000Z",284,17,"Robin Lopez",0,0,0,0,0,0
"9746",2774,0,0,0,0,0,1,1,0,0,2,1,0,2,1,1,0,7045523,"2023-12-05T00:00:00.000Z",2148,17,"Thanasis Antetokounmpo",1,3,3,2,1,6.2
"9747",2775,0,0,0,0,0,0,0,0,0,0,0,0,0,0,0,0,7045523,"2023-12-05T00:00:00.000Z",666453,17,"Marques Bolden",0,0,0,0,0,0
"9748",2776,0,0,5,4,1,4,1,2,1,17,1,2,4,6,0,3,1038131,"2024-01-12T00:00:00.000Z",38017709,8,"Christian Braun",0,10,10,4,6,8.2
"9749",2777,0,0,0,0,0,0,0,0,0,2,0,0,0,0,0,1,1038131,"2024-01-12T00:00:00.000Z",215,8,"Justin Holiday",0,0,0,0,0,-1
"9750",2778,0,0,0,0,0,1,1,0,0,2,0,1,2,0,0,0,1038131,"2024-01-12T00:00:00.000Z",38017727,8,"Collin Gillespie",0,2,2,2,0,2
"9751",2779,0,0,2,5,2,10,5,0,0,24,0,1,12,2,1,3,1038131,"2024-01-12T00:00:00.000Z",236,8,"Reggie Jackson",1,14,14,12,2,14.4
"9752",2780,0,1,2,4,2,7,3,0,0,15,1,1,8,3,1,0,1038131,"2024-01-12T00:00:00.000Z",38017721,8,"Peyton Watson",2,11,11,8,3,17.6
"9753",2781,1,1,6,0,0,2,2,2,2,14,1,1,6,7,0,0,1038131,"2024-01-12T00:00:00.000Z",250,8,"DeAndre Jordan",1,13,14,7,8,18.9
"9754",2782,0,0,0,0,0,0,0,0,0,1,0,0,0,0,0,1,1038131,"2024-01-12T00:00:00.000Z",17896007,8,"Braxton Key",0,0,0,0,0,-1
"9755",2783,0,0,0,0,0,1,0,0,0,2,0,0,0,0,0,0,1038131,"2024-01-12T00:00:00.000Z",3547268,8,"Zeke Nnaji",0,0,0,0,0,0
"9756",2784,0,0,0,0,0,0,0,0,0,0,0,0,0,0,0,0,1038131,"2024-01-12T00:00:00.000Z",666489,8,"Vlatko Cancar",0,0,0,0,0,0
"9757",2785,0,0,0,0,0,0,0,0,0,0,0,0,0,0,0,0,1038131,"2024-01-12T00:00:00.000Z",56677582,8,"Jalen Pickett",0,0,0,0,0,0
"9758",2786,0,0,0,0,0,0,0,0,0,0,0,0,0,0,0,0,1038131,"2024-01-12T00:00:00.000Z",56677776,8,"Julian Strawther",0,0,0,0,0,0
"9759",2787,0,0,0,0,0,0,0,0,0,0,0,0,0,0,0,0,1038131,"2024-01-12T00:00:00.000Z",56677871,8,"Hunter Tyson",0,0,0,0,0,0
"9760",2788,6,0,4,1,0,11,4,2,1,34,0,2,9,4,0,2,1038131,"2024-01-12T00:00:00.000Z",227,19,"Brandon Ingram",0,13,19,15,10,20.8
"9761",2789,5,1,4,0,0,22,13,6,4,35,2,1,30,6,0,1,1038131,"2024-01-12T00:00:00.000Z",666969,19,"Zion Williamson",1,36,41,35,11,46.7
"9762",2790,1,0,4,3,1,11,5,6,6,26,2,3,17,6,0,0,1038131,"2024-01-12T00:00:00.000Z",455,19,"Jonas Valanciunas",0,23,24,18,7,25.7
"9763",2791,1,1,1,2,2,4,3,0,0,19,0,1,8,1,0,1,1038131,"2024-01-12T00:00:00.000Z",17896024,19,"Herbert Jones",1,9,10,9,2,12.7
"9764",2792,7,0,5,8,3,10,4,2,1,30,0,2,12,5,1,2,1038131,"2024-01-12T00:00:00.000Z",303,19,"CJ McCollum",1,17,24,19,12,29.5
"9765",2793,0,0,1,2,0,5,2,2,2,12,1,0,6,2,0,0,1038131,"2024-01-12T00:00:00.000Z",3547293,19,"Naji Marshall",0,8,8,6,2,8.4
"9766",2794,1,0,0,3,2,7,3,2,2,17,1,0,10,1,1,1,1038131,"2024-01-12T00:00:00.000Z",17896097,19,"Jose Alvarado",1,11,12,11,2,14.7
"9767",2795,3,0,2,2,0,4,1,2,0,15,2,0,2,4,3,0,1038131,"2024-01-12T00:00:00.000Z",38017677,19,"Dyson Daniels",3,6,9,5,7,20.3
"9768",2796,0,0,0,0,0,0,0,0,0,2,0,0,0,0,0,0,1038131,"2024-01-12T00:00:00.000Z",56677837,19,"Jordan Hawkins",0,0,0,0,0,0
"9769",2797,1,0,1,0,0,0,0,0,0,2,0,0,0,1,0,0,1038131,"2024-01-12T00:00:00.000Z",38017663,19,"E.J. Liddell",0,1,2,1,2,2.7
"9770",2798,1,1,2,4,3,6,5,0,0,20,0,1,13,2,2,1,1038131,"2024-01-12T00:00:00.000Z",340,19,"Larry Nance Jr.",3,15,16,14,3,24.9
"9771",2799,4,0,3,8,2,9,2,0,0,28,0,0,6,3,2,0,1038131,"2024-01-12T00:00:00.000Z",18677986,19,"Trey Murphy III",2,9,13,10,7,21.6
"9772",2800,0,0,0,0,0,0,0,0,0,0,0,0,0,0,0,0,1038131,"2024-01-12T00:00:00.000Z",491,19,"Cody Zeller",0,0,0,0,0,0
"9773",2801,0,0,0,0,0,0,0,0,0,0,0,0,0,0,0,0,1037871,"2023-12-01T00:00:00.000Z",37,24,"Bradley Beal",0,0,0,0,0,0
"9774",2802,0,0,0,0,0,0,0,0,0,0,0,0,0,0,0,0,1037871,"2023-12-01T00:00:00.000Z",57,24,"Devin Booker",0,0,0,0,0,0
"9775",2803,0,0,0,0,0,0,0,0,0,0,0,0,0,0,0,0,1037871,"2023-12-01T00:00:00.000Z",272,24,"Damion Lee",0,0,0,0,0,0
"9776",2804,5,0,1,5,3,8,6,0,0,26,1,2,15,2,1,0,1037871,"2023-12-01T00:00:00.000Z",215,8,"Justin Holiday",1,17,22,20,7,27.9
"9777",2805,4,1,9,4,0,16,8,3,3,37,1,1,19,10,2,2,1037871,"2023-12-01T00:00:00.000Z",375,8,"Michael Porter Jr.",3,29,33,23,14,44
"9778",2806,16,2,4,3,0,18,9,6,3,35,1,4,21,5,1,3,1037871,"2023-12-01T00:00:00.000Z",246,8,"Nikola Jokic",3,26,42,37,21,57
"9779",2807,0,0,0,0,0,0,0,0,0,0,0,0,0,0,0,0,1037871,"2023-12-01T00:00:00.000Z",177,8,"Aaron Gordon",0,0,0,0,0,0
"9780",2808,0,0,0,0,0,0,0,0,0,0,0,0,0,0,0,0,1037871,"2023-12-01T00:00:00.000Z",17896103,8,"Jay Huff",0,0,0,0,0,0
"9781",2809,0,0,0,0,0,0,0,0,0,0,0,0,0,0,0,0,1037871,"2023-12-01T00:00:00.000Z",335,8,"Jamal Murray",0,0,0,0,0,0
"9782",2810,0,0,0,0,0,0,0,0,0,0,0,0,0,0,0,0,1037871,"2023-12-01T00:00:00.000Z",56677582,8,"Jalen Pickett",0,0,0,0,0,0
"9783",2811,0,0,0,0,0,0,0,0,0,0,0,0,0,0,0,0,1037871,"2023-12-01T00:00:00.000Z",56677871,8,"Hunter Tyson",0,0,0,0,0,0
"9784",2812,7,0,8,5,2,16,9,0,0,39,0,2,20,8,1,3,1037872,"2023-12-02T00:00:00.000Z",274,13,"Kawhi Leonard",1,28,35,27,15,40.1
"9785",2813,6,0,6,8,4,17,8,5,5,38,0,5,25,6,1,1,1037872,"2023-12-02T00:00:00.000Z",172,13,"Paul George",1,31,37,31,12,43.2
"9786",2814,1,3,6,0,0,6,6,0,0,23,1,4,12,7,0,3,1037872,"2023-12-02T00:00:00.000Z",493,13,"Ivica Zubac",3,19,20,13,8,27.9
"9787",2815,2,0,1,5,1,6,1,0,0,24,1,1,3,2,1,0,1037872,"2023-12-02T00:00:00.000Z",666743,13,"Terance Mann",1,5,7,5,4,11.4
"9788",2816,9,0,5,7,2,14,7,5,5,35,0,4,21,5,1,1,1037872,"2023-12-02T00:00:00.000Z",192,13,"James Harden",1,26,35,30,14,42.5
"9789",2817,2,1,6,4,2,5,2,4,2,19,0,0,8,6,0,0,1037872,"2023-12-02T00:00:00.000Z",472,13,"Russell Westbrook",1,14,16,10,8,21.2
"9790",2818,3,0,1,3,0,3,0,0,0,11,0,1,0,1,0,0,1037872,"2023-12-02T00:00:00.000Z",56677849,13,"Kobe Brown",0,1,4,3,4,5.7
"9791",2819,1,2,2,2,0,11,6,0,0,22,2,3,12,4,1,1,1037872,"2023-12-02T00:00:00.000Z",439,13,"Daniel Theis",3,16,17,13,5,26.3
"9792",2820,0,0,0,5,2,12,5,0,0,29,1,1,12,1,0,2,1037872,"2023-12-02T00:00:00.000Z",380,13,"Norman Powell",0,13,13,12,1,11.2
"9793",2821,0,0,0,0,0,0,0,0,0,0,0,0,0,0,0,0,1037872,"2023-12-02T00:00:00.000Z",666511,13,"Amir Coffey",0,0,0,0,0,0
"9794",2822,0,0,0,0,0,0,0,0,0,0,0,0,0,0,0,0,1037872,"2023-12-02T00:00:00.000Z",38017725,13,"Moussa Diabate",0,0,0,0,0,0
"9795",2823,0,0,0,0,0,0,0,0,0,0,0,0,0,0,0,0,1037872,"2023-12-02T00:00:00.000Z",17896031,13,"Nah'Shon Hyland",0,0,0,0,0,0
"9796",2824,0,0,0,0,0,0,0,0,0,0,0,0,0,0,0,0,1037872,"2023-12-02T00:00:00.000Z",24417679,13,"Xavier Moon",0,0,0,0,0,0
"9797",2825,0,0,0,0,0,0,0,0,0,0,0,0,0,0,0,0,1037872,"2023-12-02T00:00:00.000Z",450,13,"PJ Tucker",0,0,0,0,0,0
"9798",2826,1,1,1,3,2,12,8,2,2,36,1,5,20,2,3,3,1037593,"2023-10-24T00:00:00.000Z",81,8,"Kentavious Caldwell-Pope",4,22,23,21,3,32.9
"9799",2827,6,1,2,5,3,13,8,2,2,34,0,3,21,2,0,1,1037593,"2023-10-24T00:00:00.000Z",335,8,"Jamal Murray",1,23,29,27,8,34.4
"9800",2828,1,0,3,5,2,8,3,0,0,24,0,0,8,3,1,2,1037593,"2023-10-24T00:00:00.000Z",236,8,"Reggie Jackson",1,11,12,9,4,14.1
"9801",2829,2,1,2,1,0,5,2,2,1,19,1,1,5,3,0,1,1037593,"2023-10-24T00:00:00.000Z",38017709,8,"Christian Braun",1,8,10,7,5,13.6
"9802",2830,0,0,0,0,0,0,0,0,0,1,0,0,0,0,0,0,1037593,"2023-10-24T00:00:00.000Z",38017727,8,"Collin Gillespie",0,0,0,0,0,0
"9803",2831,0,0,0,0,0,0,0,0,0,0,0,0,0,0,0,0,1037593,"2023-10-24T00:00:00.000Z",215,8,"Justin Holiday",0,0,0,0,0,0
"9804",2832,0,0,0,0,0,0,0,0,0,0,0,0,0,0,0,0,1037593,"2023-10-24T00:00:00.000Z",250,8,"DeAndre Jordan",0,0,0,0,0,0
"9805",2833,3,1,6,11,3,18,6,0,0,36,1,3,15,7,0,3,1037594,"2023-10-24T00:00:00.000Z",443,10,"Klay Thompson",1,22,25,18,10,27.9
"9806",2834,0,1,0,3,0,12,4,3,2,27,1,3,10,1,0,0,1037594,"2023-10-24T00:00:00.000Z",475,10,"Andrew Wiggins",1,11,11,10,1,14.2
"9807",2835,1,0,6,0,0,6,3,1,1,28,5,2,7,11,0,2,1037594,"2023-10-24T00:00:00.000Z",282,10,"Kevon Looney",0,18,19,8,12,19.7
"9808",2836,9,0,5,6,0,15,4,7,6,34,1,0,14,6,2,1,1037594,"2023-10-24T00:00:00.000Z",367,10,"Chris Paul",2,20,29,23,15,39.7
"9809",2837,1,0,4,14,4,20,8,7,7,31,1,5,27,5,1,2,1037594,"2023-10-24T00:00:00.000Z",115,10,"Stephen Curry",1,32,33,28,6,35.5
"9810",2838,1,0,0,0,0,0,0,0,0,4,1,0,0,1,0,0,1037594,"2023-10-24T00:00:00.000Z",251,10,"Cory Joseph",0,1,2,1,2,2.7
"9811",2839,4,0,4,2,1,11,4,7,5,31,4,2,14,8,2,2,1037593,"2023-10-24T00:00:00.000Z",17553995,14,"Austin Reaves",2,22,26,18,12,33.6
"9812",2840,7,0,4,5,2,12,4,2,1,36,0,3,11,4,1,3,1037593,"2023-10-24T00:00:00.000Z",405,14,"D'Angelo Russell",1,15,22,18,11,26.3
"9813",2841,2,0,0,4,0,8,3,0,0,22,1,3,6,1,1,2,1037593,"2023-10-24T00:00:00.000Z",1603383,14,"Gabe Vincent",1,7,9,8,3,11.2
"9814",2842,0,0,3,1,0,4,3,2,1,16,1,1,7,4,0,1,1037593,"2023-10-24T00:00:00.000Z",486,14,"Christian Wood",0,11,11,7,4,10.8
"9815",2843,0,0,0,0,0,0,0,0,0,0,0,0,0,0,0,0,1037594,"2023-10-24T00:00:00.000Z",56677799,10,"Trayce Jackson-Davis",0,0,0,0,0,0
"9816",2844,0,0,0,0,0,0,0,0,0,0,0,0,0,0,0,0,1037593,"2023-10-24T00:00:00.000Z",56677738,14,"Colin Castleton",0,0,0,0,0,0
"9817",2845,0,0,0,0,0,0,0,0,0,0,0,0,0,0,0,0,1037593,"2023-10-24T00:00:00.000Z",56677867,14,"Alex Fudge",0,0,0,0,0,0
"9818",2846,0,0,0,0,0,0,0,0,0,0,0,0,0,0,0,0,1037593,"2023-10-24T00:00:00.000Z",56677868,14,"D'Moi Hodge",0,0,0,0,0,0
"9819",2847,0,0,0,0,0,0,0,0,0,0,0,0,0,0,0,0,1037593,"2023-10-24T00:00:00.000Z",56677835,14,"Jalen Hood-Schifino",0,0,0,0,0,0
"9820",2848,0,0,0,0,0,0,0,0,0,0,0,0,0,0,0,0,1037593,"2023-10-24T00:00:00.000Z",457,14,"Jarred Vanderbilt",0,0,0,0,0,0
"9821",2849,0,0,0,0,0,0,0,0,0,0,0,0,0,0,0,0,1037594,"2023-10-24T00:00:00.000Z",3547095,24,"Udoka Azubuike",0,0,0,0,0,0
"9822",2850,0,0,0,0,0,0,0,0,0,0,0,0,0,0,0,0,1037594,"2023-10-24T00:00:00.000Z",32,24,"Keita Bates-Diop",0,0,0,0,0,0
"9823",2851,3,0,2,4,2,20,12,1,1,31,0,0,27,2,0,0,7050283,"2023-12-08T00:00:00.000Z",17896026,22,"Franz Wagner",0,29,32,30,5,33.9
"9824",2852,2,0,4,3,0,17,9,7,6,30,0,3,24,4,2,0,7050283,"2023-12-08T00:00:00.000Z",38017683,22,"Paolo Banchero",2,28,30,26,6,37.8
"9825",2853,2,4,4,0,0,7,6,1,1,28,4,1,13,8,0,1,7050283,"2023-12-08T00:00:00.000Z",666442,22,"Goga Bitadze",4,21,23,15,10,36.6
"9826",2854,1,0,3,5,2,8,4,1,1,23,0,3,11,3,2,1,7050283,"2023-12-08T00:00:00.000Z",196,22,"Gary Harris",2,14,15,12,4,21.1
"9827",2855,3,0,4,1,0,4,2,4,2,25,1,2,6,5,0,1,7050283,"2023-12-08T00:00:00.000Z",56677827,22,"Anthony Black",0,11,14,9,8,15.5
"9828",2856,5,0,4,3,2,6,2,0,0,16,0,1,6,4,0,0,7050283,"2023-12-08T00:00:00.000Z",226,22,"Joe Ingles",0,10,15,11,9,18.3
"9829",2857,6,0,3,3,1,12,6,3,3,24,0,4,16,3,0,1,7050283,"2023-12-08T00:00:00.000Z",3547251,22,"Cole Anthony",0,19,25,22,9,27.6
"9830",2858,1,0,4,6,2,6,2,0,0,25,0,1,6,4,0,0,7050283,"2023-12-08T00:00:00.000Z",38017724,22,"Caleb Houstan",0,10,11,7,5,12.3
"9831",2859,1,0,1,1,1,2,2,2,1,5,0,1,6,1,0,0,7050283,"2023-12-08T00:00:00.000Z",56677839,22,"Jett Howard",0,7,8,7,2,8.7
"9832",2860,0,0,0,0,0,0,0,0,0,0,0,0,0,0,0,0,7050284,"2023-12-08T00:00:00.000Z",56913527,23,"Ricky Council IV",0,0,0,0,0,0
"9833",2861,0,0,0,0,0,0,0,0,0,0,0,0,0,0,0,0,7050284,"2023-12-08T00:00:00.000Z",17554001,23,"Javonte Smart",0,0,0,0,0,0
"9834",2862,0,0,0,0,0,0,0,0,0,0,0,0,0,0,0,0,7050284,"2023-12-08T00:00:00.000Z",56677788,23,"Terquavion Smith",0,0,0,0,0,0
"9835",2863,1,0,6,7,4,18,9,2,2,37,1,2,24,7,0,3,7050284,"2023-12-08T00:00:00.000Z",666656,1,"De'Andre Hunter",0,31,32,25,8,30.9
"9836",2864,1,0,3,9,3,20,6,1,1,38,5,1,16,8,0,0,7050284,"2023-12-08T00:00:00.000Z",3547256,1,"Saddiq Bey",0,24,25,17,9,27.1
"9837",2865,2,1,6,0,0,12,6,4,3,30,10,5,15,16,0,2,7050284,"2023-12-08T00:00:00.000Z",83,1,"Clint Capela",1,31,33,17,18,38.2
"9838",2866,2,0,8,11,3,17,7,3,3,39,1,5,20,9,1,2,7050284,"2023-12-08T00:00:00.000Z",53,1,"Bogdan Bogdanovic",1,29,31,22,11,34.8
"9839",2867,9,0,3,5,2,17,7,4,4,36,1,1,20,4,1,4,7050284,"2023-12-08T00:00:00.000Z",334,1,"Dejounte Murray",1,24,33,29,13,37.3
"9840",2868,0,0,0,0,0,0,0,0,0,0,0,0,0,0,0,0,7050284,"2023-12-08T00:00:00.000Z",666564,1,"Bruno Fernando",0,0,0,0,0,0
"9841",2869,4,0,1,2,1,15,10,4,3,35,3,1,24,4,1,3,7050282,"2023-12-08T00:00:00.000Z",204,4,"Gordon Hayward",1,28,32,28,8,34.8
"9842",2870,3,0,8,6,3,15,8,3,3,38,0,0,22,8,2,1,7050282,"2023-12-08T00:00:00.000Z",62,4,"Miles Bridges",2,30,33,25,11,41.1
"9843",2871,1,2,1,0,0,4,2,0,0,20,2,2,4,3,1,1,7050282,"2023-12-08T00:00:00.000Z",38017698,4,"Mark Williams",3,7,8,5,4,17.1
"9844",2872,3,2,5,7,4,15,7,2,2,35,0,1,20,5,0,4,7050282,"2023-12-08T00:00:00.000Z",56677823,4,"Brandon Miller",2,25,28,23,8,32.5
"9845",2873,13,0,2,5,2,15,7,5,5,40,0,5,21,2,0,2,7050282,"2023-12-08T00:00:00.000Z",403,4,"Terry Rozier",0,23,36,34,15,40.9
"9846",2874,4,0,0,0,0,1,1,0,0,14,0,0,2,0,0,1,7050282,"2023-12-08T00:00:00.000Z",422,4,"Ish Smith",0,2,6,6,4,7
"9847",2875,0,0,6,0,0,7,5,6,5,26,2,2,15,8,1,1,7050282,"2023-12-08T00:00:00.000Z",3547282,4,"Nick Richards",1,23,23,15,8,26.6
"9848",2876,1,0,2,6,4,7,5,0,0,23,0,1,14,2,0,3,1037615,"2023-10-27T00:00:00.000Z",359,27,"Cedi Osman",0,16,17,15,3,14.9
"9849",2877,0,0,0,0,0,0,0,0,0,0,0,0,0,0,0,0,1037615,"2023-10-27T00:00:00.000Z",38017693,27,"Blake Wesley",0,0,0,0,0,0
"9850",2878,0,0,0,0,0,0,0,0,0,0,0,0,0,0,0,0,1037615,"2023-10-27T00:00:00.000Z",56677865,27,"Charles Bediako",0,0,0,0,0,0
"9851",2879,0,0,0,0,0,0,0,0,0,0,0,0,0,0,0,0,1037615,"2023-10-27T00:00:00.000Z",56677817,27,"Sidy Cissoko",0,0,0,0,0,0
"9852",2880,0,0,0,0,0,0,0,0,0,0,0,0,0,0,0,0,1037615,"2023-10-27T00:00:00.000Z",56677870,27,"Sir'Jabari Rice",0,0,0,0,0,0
"9853",2881,2,0,2,2,1,13,7,2,2,39,0,4,17,2,1,2,1037615,"2023-10-27T00:00:00.000Z",66,11,"Dillon Brooks",1,19,21,19,4,23.4
"9854",2882,0,0,3,1,0,4,2,0,0,22,0,3,4,3,1,0,1037611,"2023-10-27T00:00:00.000Z",202,20,"Josh Hart",1,7,7,4,3,10.6
"9855",2883,6,0,6,9,1,14,4,2,2,24,0,2,11,6,1,4,1037611,"2023-10-27T00:00:00.000Z",3547269,20,"Immanuel Quickley",1,17,23,17,12,26.2
"9856",2884,1,1,1,0,0,4,3,4,2,10,1,4,8,2,1,1,1037611,"2023-10-27T00:00:00.000Z",201,20,"Isaiah Hartenstein",2,10,11,9,3,16.9
"9857",2885,0,0,5,8,2,16,5,4,1,37,4,4,13,9,1,2,1037615,"2023-10-27T00:00:00.000Z",38017684,11,"Jabari Smith Jr.",1,22,22,13,9,24.8
"9858",2886,1,1,1,5,3,10,6,2,1,20,1,2,16,2,1,2,1037611,"2023-10-27T00:00:00.000Z",131,20,"Donte DiVincenzo",2,18,19,17,3,23.9
"9859",2887,0,0,0,0,0,0,0,0,0,0,0,0,0,0,0,0,1037611,"2023-10-27T00:00:00.000Z",19,20,"Ryan Arcidiacono",0,0,0,0,0,0
"9860",2888,0,0,0,0,0,0,0,0,0,0,0,0,0,0,0,0,1037611,"2023-10-27T00:00:00.000Z",160,20,"Evan Fournier",0,0,0,0,0,0
"9861",2889,0,0,0,0,0,0,0,0,0,0,0,0,0,0,0,0,1037611,"2023-10-27T00:00:00.000Z",666675,20,"DaQuan Jeffries",0,0,0,0,0,0
"9862",2890,0,0,0,0,0,0,0,0,0,0,0,0,0,0,0,0,1037611,"2023-10-27T00:00:00.000Z",17896033,20,"Miles McBride",0,0,0,0,0,0
"9863",2891,7,1,8,3,1,18,11,6,2,41,6,6,25,14,2,6,1037615,"2023-10-27T00:00:00.000Z",17896062,11,"Alperen Sengun",3,39,46,32,21,55.3
"9864",2892,2,1,1,6,4,9,5,0,0,21,0,3,14,1,0,2,1037616,"2023-10-27T00:00:00.000Z",464,3,"Lonnie Walker IV",1,15,17,16,3,19.2
"9865",2893,0,0,2,0,0,2,1,0,0,3,2,1,2,4,1,2,1037616,"2023-10-27T00:00:00.000Z",17896038,3,"Day'Ron Sharpe",1,6,6,2,4,7.8
"9866",2894,1,0,1,0,0,3,0,0,0,8,0,4,0,1,0,1,1037616,"2023-10-27T00:00:00.000Z",421,3,"Dennis Smith Jr.",0,1,2,1,2,1.7
"9867",2895,0,0,0,0,0,0,0,0,0,0,0,0,0,0,0,0,1037616,"2023-10-27T00:00:00.000Z",17896058,3,"Trendon Watford",0,0,0,0,0,0
"9868",2896,0,0,0,0,0,0,0,0,0,0,0,0,0,0,0,0,1037616,"2023-10-27T00:00:00.000Z",56677722,3,"Jalen Wilson",0,0,0,0,0,0
"9869",2897,0,0,0,0,0,0,0,0,0,0,0,0,0,0,0,0,1037616,"2023-10-27T00:00:00.000Z",666508,3,"Nicolas Claxton",0,0,0,0,0,0
"9870",2898,0,0,0,0,0,0,0,0,0,0,0,0,0,0,0,0,1037616,"2023-10-27T00:00:00.000Z",666679,3,"Cameron Johnson",0,0,0,0,0,0
"9871",2899,0,0,0,0,0,0,0,0,0,0,0,0,0,0,0,0,1037616,"2023-10-27T00:00:00.000Z",56677841,3,"Dariq Whitehead",0,0,0,0,0,0
"9872",2900,3,0,1,2,0,7,2,0,0,18,0,6,4,1,1,3,1037617,"2023-10-27T00:00:00.000Z",139,29,"Kris Dunn",1,5,8,7,4,9.7
"9873",1,8,0,5,4,4,12,9,8,8,23,0,1,30,5,0,0,7996352,"2023-12-07T00:00:00.000Z",237,14,"LeBron James",0,35,43,38,13,48
"9874",2,5,2,10,2,0,10,5,8,6,31,5,1,16,15,2,2,7996352,"2023-12-07T00:00:00.000Z",117,14,"Anthony Davis",4,31,36,21,20,51.5
"9875",3,1,0,3,8,5,9,5,0,0,23,0,3,15,3,1,0,7996352,"2023-12-07T00:00:00.000Z",383,14,"Taurean Prince",1,18,19,16,4,23.1
"9876",4,1,0,3,5,2,10,6,0,0,22,0,1,14,3,1,4,7996352,"2023-12-07T00:00:00.000Z",405,14,"D'Angelo Russell",1,17,18,15,4,18.1
"9877",5,1,1,5,0,0,2,1,0,0,15,0,0,2,5,0,0,7996352,"2023-12-07T00:00:00.000Z",457,14,"Jarred Vanderbilt",1,7,8,3,6,12.5
"9878",6,0,0,2,1,0,5,3,2,0,17,0,1,6,2,1,0,7996352,"2023-12-07T00:00:00.000Z",38017697,14,"Max Christie",1,8,8,6,2,11.4
"9879",7,2,0,1,3,1,9,5,2,1,21,0,3,12,1,0,0,7996352,"2023-12-07T00:00:00.000Z",666609,14,"Rui Hachimura",0,13,15,14,3,16.2
"9880",8,0,0,4,1,0,3,2,1,0,17,0,4,4,4,0,1,7996352,"2023-12-07T00:00:00.000Z",666626,14,"Jaxson Hayes",0,8,8,4,4,7.8
"9881",9,1,1,3,0,0,3,0,2,1,8,1,1,1,4,0,1,7996352,"2023-12-07T00:00:00.000Z",56677835,14,"Jalen Hood-Schifino",1,5,6,2,5,9.3
"9882",10,1,0,1,2,1,4,1,0,0,8,0,0,3,1,0,1,7996352,"2023-12-07T00:00:00.000Z",56677836,14,"Maxwell Lewis",0,4,5,4,2,4.7
"9883",11,3,0,2,4,2,20,12,1,1,31,0,0,27,2,0,0,7050283,"2023-12-08T00:00:00.000Z",17896026,22,"Franz Wagner",0,29,32,30,5,33.9
"9884",12,2,0,4,3,0,17,9,7,6,30,0,3,24,4,2,0,7050283,"2023-12-08T00:00:00.000Z",38017683,22,"Paolo Banchero",2,28,30,26,6,37.8
"9885",13,2,4,4,0,0,7,6,1,1,28,4,1,13,8,0,1,7050283,"2023-12-08T00:00:00.000Z",666442,22,"Goga Bitadze",4,21,23,15,10,36.6
"9886",14,1,0,3,5,2,8,4,1,1,23,0,3,11,3,2,1,7050283,"2023-12-08T00:00:00.000Z",196,22,"Gary Harris",2,14,15,12,4,21.1
"9887",15,3,0,4,1,0,4,2,4,2,25,1,2,6,5,0,1,7050283,"2023-12-08T00:00:00.000Z",56677827,22,"Anthony Black",0,11,14,9,8,15.5
"9888",16,5,0,4,3,2,6,2,0,0,16,0,1,6,4,0,0,7050283,"2023-12-08T00:00:00.000Z",226,22,"Joe Ingles",0,10,15,11,9,18.3
"9889",17,6,0,3,3,1,12,6,3,3,24,0,4,16,3,0,1,7050283,"2023-12-08T00:00:00.000Z",3547251,22,"Cole Anthony",0,19,25,22,9,27.6
"9890",18,1,0,4,6,2,6,2,0,0,25,0,1,6,4,0,0,7050283,"2023-12-08T00:00:00.000Z",38017724,22,"Caleb Houstan",0,10,11,7,5,12.3
"9891",19,1,0,1,1,1,2,2,2,1,5,0,1,6,1,0,0,7050283,"2023-12-08T00:00:00.000Z",56677839,22,"Jett Howard",0,7,8,7,2,8.7
"9892",20,0,0,0,0,0,0,0,0,0,0,0,0,0,0,0,0,7050284,"2023-12-08T00:00:00.000Z",56913527,23,"Ricky Council IV",0,0,0,0,0,0
"9893",21,0,0,0,0,0,0,0,0,0,0,0,0,0,0,0,0,7050284,"2023-12-08T00:00:00.000Z",17554001,23,"Javonte Smart",0,0,0,0,0,0
"9894",22,0,0,0,0,0,0,0,0,0,0,0,0,0,0,0,0,7050284,"2023-12-08T00:00:00.000Z",56677788,23,"Terquavion Smith",0,0,0,0,0,0
"9895",23,1,0,6,7,4,18,9,2,2,37,1,2,24,7,0,3,7050284,"2023-12-08T00:00:00.000Z",666656,1,"De'Andre Hunter",0,31,32,25,8,30.9
"9896",24,1,0,3,9,3,20,6,1,1,38,5,1,16,8,0,0,7050284,"2023-12-08T00:00:00.000Z",3547256,1,"Saddiq Bey",0,24,25,17,9,27.1
"9897",25,2,1,6,0,0,12,6,4,3,30,10,5,15,16,0,2,7050284,"2023-12-08T00:00:00.000Z",83,1,"Clint Capela",1,31,33,17,18,38.2
"9898",26,0,0,0,0,0,0,0,0,0,0,0,0,0,0,0,0,1037622,"2023-10-28T00:00:00.000Z",666474,20,"Charles Brown",0,0,0,0,0,0
"9899",27,0,0,0,0,0,0,0,0,0,0,0,0,0,0,0,0,1037622,"2023-10-28T00:00:00.000Z",56677795,20,"Jacob Toppin",0,0,0,0,0,0
"9900",28,0,0,0,0,0,0,0,0,0,0,0,0,0,0,0,0,1037622,"2023-10-28T00:00:00.000Z",17896089,20,"Duane Washington Jr.",0,0,0,0,0,0
"9901",29,2,0,0,2,2,4,2,1,1,13,0,1,7,0,1,3,1037624,"2023-10-28T00:00:00.000Z",3547275,28,"Malachi Flynn",1,7,9,9,2,10
"9902",30,0,0,0,0,0,0,0,0,0,0,0,0,0,0,0,0,1037622,"2023-10-28T00:00:00.000Z",18677986,19,"Trey Murphy III",0,0,0,0,0,0
"9903",31,0,0,0,0,0,0,0,0,0,0,0,0,0,0,0,0,1037622,"2023-10-28T00:00:00.000Z",38017726,19,"Dereon Seabron",0,0,0,0,0,0
"9904",32,2,1,3,6,1,16,7,4,3,30,0,0,18,3,1,3,1037622,"2023-10-28T00:00:00.000Z",666423,20,"RJ Barrett",2,21,23,20,5,27.6
"9905",33,4,0,12,5,0,15,4,2,2,34,0,4,10,12,0,8,1037622,"2023-10-28T00:00:00.000Z",387,20,"Julius Randle",0,22,26,14,16,22.4
"9906",34,0,2,5,0,0,8,4,0,0,29,10,1,8,15,0,0,1037622,"2023-10-28T00:00:00.000Z",399,20,"Mitchell Robinson",2,23,23,8,15,32
"9907",35,1,0,2,6,1,9,2,0,0,26,0,1,5,2,2,0,1037622,"2023-10-28T00:00:00.000Z",17895858,20,"Quentin Grimes",2,7,8,6,3,14.9
"9908",36,0,0,3,2,0,6,1,3,3,12,1,2,5,4,1,1,1037624,"2023-10-28T00:00:00.000Z",58,28,"Chris Boucher",1,9,9,5,4,11.8
"9909",37,0,0,0,0,0,0,0,0,0,0,0,0,0,0,0,0,1037624,"2023-10-28T00:00:00.000Z",56677805,28,"Javon Freeman-Liberty",0,0,0,0,0,0
"9910",38,0,0,0,0,0,0,0,0,0,0,0,0,0,0,0,0,1037624,"2023-10-28T00:00:00.000Z",28,23,"Mo Bamba",0,0,0,0,0,0
"9911",39,0,0,0,0,0,0,0,0,0,0,0,0,0,0,0,0,1037624,"2023-10-28T00:00:00.000Z",260,23,"Furkan Korkmaz",0,0,0,0,0,0
"9912",40,0,0,0,0,0,0,0,0,0,0,0,0,0,0,0,0,1037624,"2023-10-28T00:00:00.000Z",17895941,23,"Filip Petrusev",0,0,0,0,0,0
"9913",41,2,2,3,0,0,7,6,0,0,19,2,3,12,5,0,0,1037626,"2023-10-28T00:00:00.000Z",147,24,"Drew Eubanks",2,17,19,14,7,27
"9914",42,5,0,3,5,2,9,2,6,6,25,2,2,12,5,1,2,1037626,"2023-10-28T00:00:00.000Z",18678058,24,"Jordan Goodwin",1,17,22,17,10,26.5
"9915",43,0,1,3,4,1,7,2,2,2,20,1,2,7,4,2,0,1037626,"2023-10-28T00:00:00.000Z",470,24,"Yuta Watanabe",3,11,11,7,4,20.8
"9916",44,0,0,1,5,0,8,3,0,0,21,0,2,6,1,1,0,1037626,"2023-10-28T00:00:00.000Z",666729,24,"Nassir Little",1,7,7,6,1,10.2
"9917",45,0,2,1,0,0,0,0,0,0,4,0,0,0,1,0,2,1037626,"2023-10-28T00:00:00.000Z",666451,24,"Bol Bol",2,1,1,0,1,5.2
"9918",46,2,1,0,1,0,2,1,0,0,4,0,0,2,0,0,0,1037626,"2023-10-28T00:00:00.000Z",3547298,24,"Saben Lee",1,2,4,4,2,8
"9919",47,1,0,1,0,0,2,1,0,0,3,0,0,2,1,0,0,1037626,"2023-10-28T00:00:00.000Z",314,24,"Chimezie Metu",0,3,4,3,2,4.7
"9920",48,0,0,0,0,0,0,0,0,0,0,0,0,0,0,0,0,1037626,"2023-10-28T00:00:00.000Z",37,24,"Bradley Beal",0,0,0,0,0,0
"9921",49,0,0,0,0,0,0,0,0,0,0,0,0,0,0,0,0,1037626,"2023-10-28T00:00:00.000Z",57,24,"Devin Booker",0,0,0,0,0,0
"9922",50,0,0,0,0,0,0,0,0,0,0,0,0,0,0,0,0,1037626,"2023-10-28T00:00:00.000Z",272,24,"Damion Lee",0,0,0,0,0,0
"9923",51,1,0,2,2,1,5,4,0,0,22,1,2,9,3,2,1,7050288,"2023-12-08T00:00:00.000Z",17896078,21,"Aaron Wiggins",2,12,13,10,4,19.1
"9924",52,0,0,2,3,0,4,1,0,0,9,0,1,2,2,0,0,7050288,"2023-12-08T00:00:00.000Z",480,21,"Kenrich Williams",0,4,4,2,2,4.4
"9925",53,0,0,0,0,0,0,0,0,0,1,0,0,0,0,0,0,7050288,"2023-12-08T00:00:00.000Z",44,21,"Davis Bertans",0,0,0,0,0,0
"9926",54,0,0,0,0,0,0,0,0,0,0,0,0,0,0,0,0,7050288,"2023-12-08T00:00:00.000Z",38017716,21,"Ousmane Dieng",0,0,0,0,0,0
"9927",55,0,0,0,0,0,0,0,0,0,0,0,0,0,0,0,0,7050288,"2023-12-08T00:00:00.000Z",17896036,21,"Tre Mann",0,0,0,0,0,0
"9928",56,0,0,0,0,0,0,0,0,0,0,0,0,0,0,0,0,7050288,"2023-12-08T00:00:00.000Z",4197029,21,"Vasilije Micic",0,0,0,0,0,0
"9929",57,0,0,0,0,0,0,0,0,0,0,0,0,0,0,0,0,7050288,"2023-12-08T00:00:00.000Z",3547271,21,"Aleksej Pokusevski",0,0,0,0,0,0
"9930",58,0,0,0,0,0,0,0,0,0,0,0,0,0,0,0,0,7050288,"2023-12-08T00:00:00.000Z",56677853,21,"Keyontae Johnson",0,0,0,0,0,0
"9931",59,0,0,0,0,0,0,0,0,0,0,0,0,0,0,0,0,7050288,"2023-12-08T00:00:00.000Z",24572055,21,"Olivier Sarr",0,0,0,0,0,0
"9932",60,0,0,0,0,0,0,0,0,0,0,0,0,0,0,0,0,7050288,"2023-12-08T00:00:00.000Z",27924547,21,"Lindy Waters III",0,0,0,0,0,0
"9933",61,1,0,4,4,2,11,4,2,2,32,2,3,12,6,0,6,7050288,"2023-12-08T00:00:00.000Z",475,10,"Andrew Wiggins",0,18,19,13,7,14.7
"9934",62,13,1,4,2,1,7,5,2,1,35,1,6,12,5,0,4,7050288,"2023-12-08T00:00:00.000Z",185,10,"Draymond Green",1,17,30,25,18,36.5
"9935",63,2,0,3,0,0,2,2,3,1,16,1,1,5,4,0,2,7050288,"2023-12-08T00:00:00.000Z",282,10,"Kevon Looney",0,9,11,7,6,10.8
"9936",64,0,1,3,9,4,15,8,2,2,39,1,4,22,4,0,4,7050288,"2023-12-08T00:00:00.000Z",443,10,"Klay Thompson",1,26,26,22,4,25.8
"9937",65,3,0,6,12,6,20,10,8,8,40,0,0,34,6,1,3,7050288,"2023-12-08T00:00:00.000Z",115,10,"Stephen Curry",1,40,43,37,9,45.7
"9938",66,0,0,2,3,0,5,1,0,0,16,2,4,2,4,0,2,7050288,"2023-12-08T00:00:00.000Z",17553992,10,"Moses Moody",0,6,6,2,4,4.8
"9939",67,0,0,6,6,3,21,10,1,1,29,6,6,24,12,0,3,7050288,"2023-12-08T00:00:00.000Z",17553979,10,"Jonathan Kuminga",0,36,36,24,12,35.4
"9940",68,4,0,1,4,1,11,5,1,1,23,5,2,12,6,1,1,7050288,"2023-12-08T00:00:00.000Z",56677858,10,"Brandin Podziemski",1,18,22,16,10,27.2
"9941",69,3,0,1,1,0,3,1,0,0,13,0,0,2,1,0,0,7050288,"2023-12-08T00:00:00.000Z",251,10,"Cory Joseph",0,3,6,5,4,7.7
"9942",70,0,0,0,0,0,0,0,0,0,0,0,0,0,0,0,0,7050288,"2023-12-08T00:00:00.000Z",56677799,10,"Trayce Jackson-Davis",0,0,0,0,0,0
"9943",71,0,0,0,0,0,0,0,0,0,0,0,0,0,0,0,0,7050288,"2023-12-08T00:00:00.000Z",367,10,"Chris Paul",0,0,0,0,0,0
"9944",72,0,0,0,0,0,0,0,0,0,0,0,0,0,0,0,0,7050288,"2023-12-08T00:00:00.000Z",2189,10,"Gary Payton II",0,0,0,0,0,0
"9945",73,0,0,0,0,0,0,0,0,0,0,0,0,0,0,0,0,7050285,"2023-12-08T00:00:00.000Z",9051997,3,"Armoni Brooks",0,0,0,0,0,0
"9946",74,0,0,0,0,0,0,0,0,0,0,0,0,0,0,0,0,7050285,"2023-12-08T00:00:00.000Z",56677843,3,"Noah Clowney",0,0,0,0,0,0
"9947",75,0,0,0,0,0,0,0,0,0,1,0,0,0,0,0,0,7981426,"2023-12-08T00:00:00.000Z",666468,2,"Oshae Brissett",0,0,0,0,0,0
"9948",76,2,0,7,5,1,15,7,5,3,41,1,4,18,8,0,3,1037614,"2023-10-27T00:00:00.000Z",416,28,"Pascal Siakam",0,26,28,20,10,27.6
"9949",77,0,0,6,0,0,5,4,0,0,19,0,6,8,6,0,3,1037614,"2023-10-27T00:00:00.000Z",373,28,"Jakob Poeltl",0,14,14,8,6,12.2
"9950",78,0,0,3,4,1,8,5,1,0,28,0,2,11,3,2,1,1037614,"2023-10-27T00:00:00.000Z",18,28,"OG Anunoby",2,14,14,11,3,19.6
"9951",79,0,0,0,1,1,4,4,2,2,13,2,0,11,2,1,0,1037616,"2023-10-27T00:00:00.000Z",379,7,"Dwight Powell",1,13,13,11,2,16.4
"9952",80,0,0,0,0,0,0,0,0,0,0,0,0,0,0,0,0,1037616,"2023-10-27T00:00:00.000Z",329,7,"Markieff Morris",0,0,0,0,0,0
"9953",81,0,0,0,0,0,0,0,0,0,0,0,0,0,0,0,0,1037616,"2023-10-27T00:00:00.000Z",56677859,7,"Olivier-Maxence Prosper",0,0,0,0,0,0
"9954",82,0,0,0,0,0,0,0,0,0,0,0,0,0,0,0,0,1037616,"2023-10-27T00:00:00.000Z",17896028,7,"Greg Brown III",0,0,0,0,0,0
"9955",83,0,0,0,0,0,0,0,0,0,0,0,0,0,0,0,0,1037616,"2023-10-27T00:00:00.000Z",56677873,7,"Dexter Dennis",0,0,0,0,0,0
"9956",84,0,0,0,0,0,0,0,0,0,0,0,0,0,0,0,0,1037616,"2023-10-27T00:00:00.000Z",17554004,7,"AJ Lawson",0,0,0,0,0,0
"9957",85,2,1,7,4,1,19,12,5,5,33,0,2,30,7,1,0,1037616,"2023-10-27T00:00:00.000Z",17896048,3,"Cam Thomas",2,37,39,32,9,47.4
"9958",86,3,0,3,7,3,17,6,3,3,36,1,2,18,4,0,1,1037616,"2023-10-27T00:00:00.000Z",61,3,"Mikal Bridges",0,22,25,21,7,26.3
"9959",87,3,0,6,7,4,8,4,0,0,32,1,5,12,7,0,2,1037616,"2023-10-27T00:00:00.000Z",158,3,"Dorian Finney-Smith",0,19,22,15,10,22.9
"9960",88,8,0,3,12,6,17,8,2,1,40,0,4,23,3,0,2,1037616,"2023-10-27T00:00:00.000Z",130,3,"Spencer Dinwiddie",0,26,34,31,11,36.6
"9961",89,2,0,1,2,0,2,0,0,0,13,0,1,0,1,0,1,1037614,"2023-10-27T00:00:00.000Z",87,5,"Jevon Carter",0,1,3,2,3,3.2
"9962",90,1,0,2,4,0,4,0,0,0,18,1,1,0,3,1,0,1037614,"2023-10-27T00:00:00.000Z",666762,28,"Jalen McDaniels",1,3,4,1,4,8.1
"9963",91,0,0,0,1,0,1,0,0,0,4,0,0,0,0,0,0,1037614,"2023-10-27T00:00:00.000Z",3547275,28,"Malachi Flynn",0,0,0,0,0,0
"9964",92,1,0,7,3,1,5,2,3,3,23,2,6,8,9,0,3,1037614,"2023-10-27T00:00:00.000Z",3547249,28,"Precious Achiuwa",0,17,18,9,10,17.3
"9965",93,0,0,0,0,0,0,0,0,0,0,0,0,0,0,0,0,1037611,"2023-10-27T00:00:00.000Z",666474,20,"Charles Brown",0,0,0,0,0,0
"9966",94,0,0,0,0,0,0,0,0,0,0,0,0,0,0,0,0,1037611,"2023-10-27T00:00:00.000Z",56677795,20,"Jacob Toppin",0,0,0,0,0,0
"9967",95,0,0,0,0,0,0,0,0,0,0,0,0,0,0,0,0,1037611,"2023-10-27T00:00:00.000Z",17896089,20,"Duane Washington Jr.",0,0,0,0,0,0
"9968",96,0,0,1,2,0,2,0,0,0,6,0,0,0,1,0,0,1037614,"2023-10-27T00:00:00.000Z",56677828,28,"Gradey Dick",0,1,1,0,1,1.2
"9969",97,0,0,5,0,0,4,3,5,4,17,1,3,10,6,0,1,1037614,"2023-10-27T00:00:00.000Z",58,28,"Chris Boucher",0,16,16,10,6,16.2
"9970",98,0,0,0,0,0,0,0,0,0,0,0,0,0,0,0,0,1037614,"2023-10-27T00:00:00.000Z",376,28,"Otto Porter Jr.",0,0,0,0,0,0
"9971",99,0,0,0,0,0,0,0,0,0,0,0,0,0,0,0,0,1037614,"2023-10-27T00:00:00.000Z",436,28,"Garrett Temple",0,0,0,0,0,0
"9972",100,0,0,0,0,0,0,0,0,0,0,0,0,0,0,0,0,1037614,"2023-10-27T00:00:00.000Z",489,28,"Thaddeus Young",0,0,0,0,0,0
"9973",101,7,0,1,1,0,7,2,2,2,22,0,1,6,1,0,1,7050287,"2023-12-08T00:00:00.000Z",401,15,"Derrick Rose",0,7,14,13,8,16.7
"9974",102,0,0,0,0,0,0,0,0,0,0,0,0,0,0,0,0,7050285,"2023-12-08T00:00:00.000Z",56677722,3,"Jalen Wilson",0,0,0,0,0,0
"9975",103,4,2,7,4,1,9,6,3,2,27,0,1,15,7,1,0,7050285,"2023-12-08T00:00:00.000Z",3547242,30,"Deni Avdija",3,22,26,19,11,38.4
"9976",104,2,0,4,0,0,4,2,0,0,16,1,1,4,5,0,2,7050283,"2023-12-08T00:00:00.000Z",462,22,"Moritz Wagner",0,9,11,6,7,11
"9977",105,0,0,2,0,0,2,1,0,0,4,0,3,2,2,0,2,7050283,"2023-12-08T00:00:00.000Z",666885,22,"Admiral Schofield",0,4,4,2,2,2.4
"9978",106,0,0,0,0,0,0,0,0,0,0,0,0,0,0,0,0,7050283,"2023-12-08T00:00:00.000Z",85,22,"Wendell Carter Jr.",0,0,0,0,0,0
"9979",107,0,0,0,0,0,0,0,0,0,0,0,0,0,0,0,0,7050283,"2023-12-08T00:00:00.000Z",165,22,"Markelle Fultz",0,0,0,0,0,0
"9980",108,0,0,0,0,0,0,0,0,0,0,0,0,0,0,0,0,7050283,"2023-12-08T00:00:00.000Z",38017607,22,"Kevon Harris",0,0,0,0,0,0
"9981",109,0,0,0,0,0,0,0,0,0,0,0,0,0,0,0,0,7050283,"2023-12-08T00:00:00.000Z",229,22,"Jonathan Isaac",0,0,0,0,0,0
"9982",110,0,0,0,0,0,0,0,0,0,0,0,0,0,0,0,0,7050283,"2023-12-08T00:00:00.000Z",17553983,22,"Trevelin Queen",0,0,0,0,0,0
"9983",111,2,0,1,5,0,12,2,2,1,20,1,3,5,2,1,0,7050283,"2023-12-08T00:00:00.000Z",56677826,9,"Ausar Thompson",1,7,9,7,4,13.4
"9984",112,0,0,3,0,0,0,0,4,2,16,2,2,2,5,0,1,7050283,"2023-12-08T00:00:00.000Z",3547240,9,"James Wiseman",0,7,7,2,5,7
"9985",113,4,1,0,5,2,13,7,1,1,27,0,5,17,0,1,2,7981426,"2023-12-08T00:00:00.000Z",70,2,"Jaylen Brown",2,17,21,21,4,27
"9986",114,5,0,6,9,3,18,8,8,6,38,0,3,25,6,1,0,7981426,"2023-12-08T00:00:00.000Z",434,2,"Jayson Tatum",1,31,36,30,11,42.7
"9987",115,1,0,2,6,3,13,7,4,4,29,1,2,21,3,2,2,7981426,"2023-12-08T00:00:00.000Z",378,2,"Kristaps Porzingis",2,24,25,22,4,30.1
"9988",116,3,2,1,10,6,16,10,4,4,32,2,4,30,3,2,0,7981426,"2023-12-08T00:00:00.000Z",473,2,"Derrick White",4,33,36,33,6,50.1
"9989",117,5,1,6,3,1,11,7,1,1,35,0,1,16,6,2,1,7981426,"2023-12-08T00:00:00.000Z",214,2,"Jrue Holiday",3,22,27,21,11,38.7
"9990",118,1,1,2,5,0,5,0,2,1,21,1,1,1,3,0,0,7981426,"2023-12-08T00:00:00.000Z",17896060,2,"Sam Hauser",1,4,5,2,4,9.1
"9991",119,1,0,1,3,0,5,0,0,0,12,0,2,0,1,0,0,7050283,"2023-12-08T00:00:00.000Z",17896071,9,"Isaiah Livers",0,1,2,1,2,2.7
"9992",120,1,0,0,1,0,3,2,0,0,5,0,0,4,0,0,0,7050283,"2023-12-08T00:00:00.000Z",56677792,9,"Marcus Sasser",0,4,5,5,1,5.5
"9993",121,0,0,0,0,0,0,0,0,0,0,0,0,0,0,0,0,7050283,"2023-12-08T00:00:00.000Z",56677729,9,"Malcolm Cazalon",0,0,0,0,0,0
"9994",122,0,0,0,0,0,0,0,0,0,0,0,0,0,0,0,0,7050283,"2023-12-08T00:00:00.000Z",38017694,9,"Jalen Duren",0,0,0,0,0,0
"9995",123,0,0,0,0,0,0,0,0,0,0,0,0,0,0,0,0,7050283,"2023-12-08T00:00:00.000Z",330,9,"Monte Morris",0,0,0,0,0,0
"9996",124,0,0,0,0,0,0,0,0,0,0,0,0,0,0,0,0,7050283,"2023-12-08T00:00:00.000Z",42097199,9,"Jared Rhoden",0,0,0,0,0,0
"9997",125,0,0,0,0,0,0,0,0,0,0,0,0,0,0,0,0,7050283,"2023-12-08T00:00:00.000Z",44477024,9,"Stanley Umude",0,0,0,0,0,0
"9998",126,0,0,0,0,0,0,0,0,0,0,0,0,0,0,0,0,1037627,"2023-10-29T00:00:00.000Z",480,21,"Kenrich Williams",0,0,0,0,0,0
"9999",127,2,0,4,0,0,17,12,2,0,28,1,0,24,5,0,0,1037622,"2023-10-28T00:00:00.000Z",666969,19,"Zion Williamson",0,29,31,26,7,33
"10000",128,0,0,4,1,0,7,3,2,2,21,0,4,8,4,1,4,1037622,"2023-10-28T00:00:00.000Z",455,19,"Jonas Valanciunas",1,12,12,8,4,11.8
"10001",129,1,3,2,2,2,6,4,0,0,27,0,5,10,2,0,1,1037622,"2023-10-28T00:00:00.000Z",17896024,19,"Herbert Jones",3,12,13,11,3,21.9
"10002",130,7,0,3,7,2,11,4,4,2,30,0,2,12,3,4,1,1037622,"2023-10-28T00:00:00.000Z",303,19,"CJ McCollum",4,15,22,19,10,37.1
"10003",131,3,0,4,3,0,7,1,4,0,22,0,2,2,4,1,1,1037622,"2023-10-28T00:00:00.000Z",38017677,19,"Dyson Daniels",1,6,9,5,7,13.3
"10004",132,5,0,12,2,1,16,12,3,3,30,2,3,28,14,0,4,1037627,"2023-10-29T00:00:00.000Z",246,8,"Nikola Jokic",0,42,47,33,19,48.3
"10005",133,1,0,3,4,1,5,2,2,2,30,0,2,7,3,2,1,1037627,"2023-10-29T00:00:00.000Z",81,8,"Kentavious Caldwell-Pope",2,10,11,8,4,17.1
"10006",134,8,0,1,1,1,14,9,0,0,30,1,1,19,2,0,4,1037627,"2023-10-29T00:00:00.000Z",335,8,"Jamal Murray",0,21,29,27,10,29.4
"10007",135,6,0,0,2,1,3,2,0,0,22,0,4,5,0,2,2,1037627,"2023-10-29T00:00:00.000Z",236,8,"Reggie Jackson",2,5,11,11,6,18
"10008",136,7,1,6,2,0,9,4,5,5,21,1,2,13,7,1,0,1037627,"2023-10-29T00:00:00.000Z",38017709,8,"Christian Braun",2,20,27,20,14,37.9
"10009",137,1,1,3,3,1,11,8,0,0,22,1,1,17,4,1,0,1037627,"2023-10-29T00:00:00.000Z",38017721,8,"Peyton Watson",2,21,22,18,5,29.3
"10010",138,1,0,2,0,0,1,0,0,0,15,1,2,0,3,0,0,1037627,"2023-10-29T00:00:00.000Z",3547268,8,"Zeke Nnaji",0,3,4,1,4,5.1
"10011",139,1,0,1,3,2,5,3,0,0,8,0,0,8,1,0,0,1037627,"2023-10-29T00:00:00.000Z",56677776,8,"Julian Strawther",0,9,10,9,2,10.7
"10012",140,0,0,0,1,0,1,0,0,0,5,0,1,0,0,1,0,1037627,"2023-10-29T00:00:00.000Z",38017727,8,"Collin Gillespie",1,0,0,0,0,3
"10013",141,0,0,1,0,0,0,0,0,0,3,0,1,0,1,0,0,1037627,"2023-10-29T00:00:00.000Z",56677871,8,"Hunter Tyson",0,1,1,0,1,1.2
"10014",142,0,0,0,0,0,0,0,0,0,3,0,0,0,0,0,0,1037627,"2023-10-29T00:00:00.000Z",215,8,"Justin Holiday",0,0,0,0,0,0
"10015",143,0,0,1,1,0,2,1,0,0,3,0,0,2,1,0,0,1037627,"2023-10-29T00:00:00.000Z",17896007,8,"Braxton Key",0,3,3,2,1,3.2
"10016",144,0,0,0,0,0,0,0,0,0,0,0,0,0,0,0,0,1037627,"2023-10-29T00:00:00.000Z",250,8,"DeAndre Jordan",0,0,0,0,0,0
"10017",145,0,0,0,0,0,0,0,0,0,0,0,0,0,0,0,0,1037627,"2023-10-29T00:00:00.000Z",666489,8,"Vlatko Cancar",0,0,0,0,0,0
"10018",146,0,0,0,0,0,0,0,0,0,0,0,0,0,0,0,0,1037627,"2023-10-29T00:00:00.000Z",17896103,8,"Jay Huff",0,0,0,0,0,0
"10019",147,0,0,0,0,0,0,0,0,0,0,0,0,0,0,0,0,1037627,"2023-10-29T00:00:00.000Z",56677582,8,"Jalen Pickett",0,0,0,0,0,0
"10020",148,2,0,4,5,2,10,4,2,2,34,0,5,12,4,0,0,1037628,"2023-10-29T00:00:00.000Z",66,11,"Dillon Brooks",0,16,18,14,6,19.8
"10021",149,5,0,6,6,2,12,6,0,0,34,2,3,14,8,2,1,1037628,"2023-10-29T00:00:00.000Z",38017684,11,"Jabari Smith Jr.",2,22,27,19,13,36.1
"10022",150,7,0,1,2,1,15,7,4,4,33,4,3,19,5,0,0,1037628,"2023-10-29T00:00:00.000Z",17896062,11,"Alperen Sengun",0,24,31,26,12,35.5
"10023",151,0,0,0,0,0,0,0,0,0,0,0,0,0,0,0,0,1037908,"2023-12-13T00:00:00.000Z",1603383,14,"Gabe Vincent",0,0,0,0,0,0
"10024",152,0,0,0,0,0,0,0,0,0,1,0,1,0,0,0,0,1037907,"2023-12-13T00:00:00.000Z",284,17,"Robin Lopez",0,0,0,0,0,0
"10025",153,0,0,0,0,0,0,0,0,0,1,0,0,0,0,0,1,1037907,"2023-12-13T00:00:00.000Z",2148,17,"Thanasis Antetokounmpo",0,0,0,0,0,-1
"10026",154,0,0,0,0,0,0,0,0,0,0,0,0,0,0,0,0,1037907,"2023-12-13T00:00:00.000Z",666453,17,"Marques Bolden",0,0,0,0,0,0
"10027",155,0,0,7,8,4,13,7,7,5,25,1,2,23,8,0,0,1037910,"2023-12-13T00:00:00.000Z",297,29,"Lauri Markkanen",0,31,31,23,8,32.6
"10028",156,2,0,3,10,3,12,4,4,4,31,3,4,15,6,2,2,1037910,"2023-12-13T00:00:00.000Z",38017739,29,"Simone Fontecchio",2,21,23,17,8,29.2
"10029",157,8,0,9,2,1,9,3,2,2,30,1,3,9,10,0,4,1037910,"2023-12-13T00:00:00.000Z",358,29,"Kelly Olynyk",0,19,27,17,18,29
"10030",158,7,0,3,8,3,18,10,3,3,30,1,4,26,4,0,2,1037910,"2023-12-13T00:00:00.000Z",413,29,"Collin Sexton",0,30,37,33,11,39.3
"10031",159,4,2,5,5,1,18,9,10,8,38,1,3,27,6,1,2,1037909,"2023-12-13T00:00:00.000Z",140,24,"Kevin Durant",3,33,37,31,10,47.2
"10032",160,0,0,1,3,2,8,3,0,0,20,3,2,8,4,2,1,1037909,"2023-12-13T00:00:00.000Z",314,24,"Chimezie Metu",2,12,12,8,4,17.8
"10033",161,3,2,16,2,0,15,7,2,1,31,6,3,15,22,0,0,1037909,"2023-12-13T00:00:00.000Z",349,24,"Jusuf Nurkic",2,37,40,18,25,51.9
"10034",162,4,0,1,2,2,9,6,0,0,34,0,1,14,1,1,2,1037909,"2023-12-13T00:00:00.000Z",37,24,"Bradley Beal",1,15,19,18,5,22.2
"10035",163,12,0,5,6,2,15,9,15,14,40,1,5,34,6,0,2,1037909,"2023-12-13T00:00:00.000Z",57,24,"Devin Booker",0,40,52,46,18,57.2
"10036",164,3,0,5,5,2,7,4,0,0,27,2,2,10,7,0,2,1037909,"2023-12-13T00:00:00.000Z",666729,24,"Nassir Little",0,17,20,13,10,20.9
"10037",165,0,0,0,2,0,2,0,0,0,7,1,2,0,1,0,0,1037909,"2023-12-13T00:00:00.000Z",470,24,"Yuta Watanabe",0,1,1,0,1,1.2
"10038",166,0,0,0,0,0,0,0,0,0,0,0,0,0,0,0,0,1037907,"2023-12-13T00:00:00.000Z",105,17,"Pat Connaughton",0,0,0,0,0,0
"10039",167,0,0,0,0,0,0,0,0,0,0,0,0,0,0,0,0,1037907,"2023-12-13T00:00:00.000Z",112,17,"Jae Crowder",0,0,0,0,0,0
"10040",168,0,0,0,0,0,0,0,0,0,0,0,0,0,0,0,0,1037907,"2023-12-13T00:00:00.000Z",56677854,17,"Chris Livingston",0,0,0,0,0,0
"10041",169,0,0,0,0,0,0,0,0,0,0,0,0,0,0,0,0,1037907,"2023-12-13T00:00:00.000Z",38017691,17,"TyTy Washington Jr.",0,0,0,0,0,0
"10042",170,0,0,0,0,0,0,0,0,0,0,0,0,0,0,0,0,1037907,"2023-12-13T00:00:00.000Z",666960,17,"Lindell Wigginton",0,0,0,0,0,0
"10043",171,9,0,5,3,0,10,4,4,1,27,3,2,9,8,2,1,1037907,"2023-12-13T00:00:00.000Z",69,12,"Bruce Brown",2,17,26,18,17,37.1
"10044",172,1,1,4,3,1,7,2,0,0,19,3,6,5,7,0,0,1037907,"2023-12-13T00:00:00.000Z",3547243,12,"Obi Toppin",1,12,13,6,8,17.9
"10045",173,0,1,5,2,2,14,8,4,4,33,4,4,22,9,0,2,1037907,"2023-12-13T00:00:00.000Z",452,12,"Myles Turner",1,31,31,22,9,33.8
"10046",174,2,0,1,6,1,9,3,0,0,27,2,1,7,3,0,1,1037907,"2023-12-13T00:00:00.000Z",210,12,"Buddy Hield",0,10,12,9,5,12.6
"10047",175,7,0,4,4,1,16,8,7,5,31,1,0,22,5,0,3,1037907,"2023-12-13T00:00:00.000Z",3547245,12,"Tyrese Haliburton",0,27,34,29,12,35.5
"10048",176,0,0,0,0,0,0,0,0,0,0,0,0,0,0,0,0,1037658,"2023-11-01T00:00:00.000Z",290,26,"Trey Lyles",0,0,0,0,0,0
"10049",177,0,0,0,0,0,0,0,0,0,0,0,0,0,0,0,0,1037654,"2023-11-01T00:00:00.000Z",56677831,11,"Cam Whitmore",0,0,0,0,0,0
"10050",178,0,0,0,0,0,0,0,0,0,0,0,0,0,0,0,0,1037654,"2023-11-01T00:00:00.000Z",38017695,11,"Tari Eason",0,0,0,0,0,0
"10051",179,0,0,0,0,0,0,0,0,0,0,0,0,0,0,0,0,1037654,"2023-11-01T00:00:00.000Z",357,11,"Victor Oladipo",0,0,0,0,0,0
"10052",180,0,0,0,0,0,0,0,0,0,0,0,0,0,0,0,0,1037654,"2023-11-01T00:00:00.000Z",47738533,11,"Jeenathan Williams",0,0,0,0,0,0
"10053",181,5,1,5,1,0,11,6,7,5,31,2,1,17,7,1,1,1037654,"2023-11-01T00:00:00.000Z",204,4,"Gordon Hayward",2,24,29,22,12,37.9
"10054",182,0,0,2,6,5,13,8,2,2,35,1,2,23,3,0,1,1037654,"2023-11-01T00:00:00.000Z",666950,4,"P.J. Washington",0,26,26,23,3,25.6
"10055",183,1,2,3,0,0,4,3,6,3,25,3,0,9,6,2,1,1037654,"2023-11-01T00:00:00.000Z",38017698,4,"Mark Williams",4,15,16,10,7,28.7
"10056",184,6,0,1,6,1,21,10,0,0,39,2,0,21,3,1,4,1037654,"2023-11-01T00:00:00.000Z",403,4,"Terry Rozier",1,24,30,27,9,32.6
"10057",185,5,0,0,6,2,15,7,4,3,33,1,4,19,1,1,3,1037654,"2023-11-01T00:00:00.000Z",3547239,4,"LaMelo Ball",1,20,25,24,6,27.7
"10058",186,2,0,3,1,1,7,4,9,3,19,2,5,12,5,2,1,1037657,"2023-11-01T00:00:00.000Z",38017732,15,"Kenneth Lofton Jr.",2,17,19,14,7,26
"10059",187,3,3,2,4,1,5,2,8,7,16,0,3,12,2,1,1,1037657,"2023-11-01T00:00:00.000Z",38017731,15,"Vince Williams Jr.",4,14,17,15,5,29.9
"10060",188,0,0,0,2,0,4,2,0,0,8,0,0,4,0,0,0,1037657,"2023-11-01T00:00:00.000Z",38017728,15,"Jake LaRavia",0,4,4,4,0,4
"10061",189,0,0,0,0,0,0,0,0,0,0,0,0,0,0,0,0,1037657,"2023-11-01T00:00:00.000Z",666786,15,"Ja Morant",0,0,0,0,0,0
"10062",190,0,0,0,0,0,0,0,0,0,0,0,0,0,0,0,0,1037657,"2023-11-01T00:00:00.000Z",3,15,"Steven Adams",0,0,0,0,0,0
"10063",191,1,0,1,7,2,7,2,3,3,14,0,0,9,1,0,0,1037653,"2023-11-01T00:00:00.000Z",3547272,21,"Isaiah Joe",0,10,11,10,2,11.7
"10064",192,0,2,4,0,0,0,0,0,0,7,1,1,0,5,0,1,1037653,"2023-11-01T00:00:00.000Z",24572055,21,"Olivier Sarr",2,5,5,0,5,11
"10065",193,1,0,2,0,0,2,1,2,2,18,0,4,4,2,0,0,1037653,"2023-11-01T00:00:00.000Z",56677833,21,"Cason Wallace",0,6,7,5,3,7.9
"10066",194,0,0,0,0,0,0,0,0,0,1,0,0,0,0,0,0,1037653,"2023-11-01T00:00:00.000Z",27924547,21,"Lindy Waters III",0,0,0,0,0,0
"10067",195,1,0,2,3,0,4,1,0,0,12,0,0,2,2,0,0,1037653,"2023-11-01T00:00:00.000Z",38017716,21,"Ousmane Dieng",0,4,5,3,3,5.9
"10068",196,0,0,0,0,0,0,0,0,0,0,0,0,0,0,0,0,1037653,"2023-11-01T00:00:00.000Z",44,21,"Davis Bertans",0,0,0,0,0,0
"10069",197,0,0,0,0,0,0,0,0,0,0,0,0,0,0,0,0,1037653,"2023-11-01T00:00:00.000Z",17896036,21,"Tre Mann",0,0,0,0,0,0
"10070",198,0,0,0,0,0,0,0,0,0,0,0,0,0,0,0,0,1037657,"2023-11-01T00:00:00.000Z",17896067,15,"Santi Aldama",0,0,0,0,0,0
"10071",199,0,0,0,0,0,0,0,0,0,0,0,0,0,0,0,0,1037657,"2023-11-01T00:00:00.000Z",666505,15,"Brandon Clarke",0,0,0,0,0,0
"10072",200,0,0,0,0,0,0,0,0,0,0,0,0,0,0,0,0,1037655,"2023-11-01T00:00:00.000Z",17895968,18,"Daishen Nix",0,0,0,0,0,0
"10073",201,0,0,0,0,0,0,0,0,0,0,0,0,0,0,0,0,1037906,"2023-12-13T00:00:00.000Z",56677809,11,"Jermaine Samuels Jr.",0,0,0,0,0,0
"10074",202,0,0,0,0,0,0,0,0,0,0,0,0,0,0,0,0,1037906,"2023-12-13T00:00:00.000Z",56677825,11,"Amen Thompson",0,0,0,0,0,0
"10075",203,0,0,0,0,0,0,0,0,0,0,0,0,0,0,0,0,1037906,"2023-12-13T00:00:00.000Z",56677831,11,"Cam Whitmore",0,0,0,0,0,0
"10076",204,4,0,5,7,2,14,3,2,1,32,1,1,9,6,1,1,1037906,"2023-12-13T00:00:00.000Z",38017729,15,"David Roddy",1,15,19,13,10,24.2
"10077",205,2,1,6,8,3,24,15,13,11,40,1,4,44,7,4,3,1037906,"2023-12-13T00:00:00.000Z",231,15,"Jaren Jackson Jr.",5,51,53,46,9,67.4
"10078",206,1,0,5,0,0,2,1,6,1,24,1,5,3,6,0,2,1037906,"2023-12-13T00:00:00.000Z",48,15,"Bismack Biyombo",0,9,10,4,7,9.7
"10079",207,1,0,6,4,2,5,2,6,4,28,1,6,10,7,1,0,1037906,"2023-12-13T00:00:00.000Z",38017731,15,"Vince Williams Jr.",1,17,18,11,8,22.9
"10080",208,6,1,3,4,1,14,7,4,4,31,1,4,19,4,0,1,1037906,"2023-12-13T00:00:00.000Z",401,15,"Derrick Rose",1,23,29,25,10,34.8
"10081",209,3,0,4,6,0,8,1,3,3,26,0,2,5,4,0,1,1037906,"2023-12-13T00:00:00.000Z",17896027,15,"Ziaire Williams",0,9,12,8,7,13.3
"10082",210,1,0,0,2,0,3,0,0,0,8,0,1,0,0,0,1,1037906,"2023-12-13T00:00:00.000Z",666809,15,"Jaylen Nowell",0,0,1,1,1,0.5
"10083",211,1,2,5,2,1,4,3,0,0,16,0,4,7,5,0,1,1037906,"2023-12-13T00:00:00.000Z",17896067,15,"Santi Aldama",2,12,13,8,6,19.5
"10084",212,1,0,0,1,0,1,0,0,0,7,0,0,0,0,1,0,1037906,"2023-12-13T00:00:00.000Z",666703,15,"John Konchar",1,0,1,1,1,4.5
"10085",213,2,0,0,3,0,6,2,0,0,15,0,3,4,0,0,1,1037906,"2023-12-13T00:00:00.000Z",38017728,15,"Jake LaRavia",0,4,6,6,2,6
"10086",214,3,0,0,1,1,1,1,0,0,13,0,0,3,0,0,0,1037906,"2023-12-13T00:00:00.000Z",48248287,15,"Jacob Gilyard",0,3,6,6,3,7.5
"10087",215,0,0,0,0,0,0,0,0,0,0,0,0,0,0,0,0,1037906,"2023-12-13T00:00:00.000Z",38017732,15,"Kenneth Lofton Jr.",0,0,0,0,0,0
"10088",216,0,0,0,0,0,0,0,0,0,0,0,0,0,0,0,0,1037906,"2023-12-13T00:00:00.000Z",3547285,15,"Xavier Tillman",0,0,0,0,0,0
"10089",217,0,0,0,0,0,0,0,0,0,0,0,0,0,0,0,0,1037906,"2023-12-13T00:00:00.000Z",3,15,"Steven Adams",0,0,0,0,0,0
"10090",218,0,0,0,0,0,0,0,0,0,0,0,0,0,0,0,0,1037906,"2023-12-13T00:00:00.000Z",3547287,15,"Desmond Bane",0,0,0,0,0,0
"10091",219,0,0,0,0,0,0,0,0,0,0,0,0,0,0,0,0,1037906,"2023-12-13T00:00:00.000Z",666505,15,"Brandon Clarke",0,0,0,0,0,0
"10092",220,0,0,0,0,0,0,0,0,0,0,0,0,0,0,0,0,1037906,"2023-12-13T00:00:00.000Z",56677830,15,"GG Jackson",0,0,0,0,0,0
"10093",221,2,0,7,2,1,4,2,0,0,17,0,0,5,7,0,0,1037908,"2023-12-13T00:00:00.000Z",359,27,"Cedi Osman",0,12,14,7,9,16.4
"10094",222,1,0,1,3,1,5,1,0,0,15,0,0,3,1,1,0,1037908,"2023-12-13T00:00:00.000Z",305,27,"Doug McDermott",1,4,5,4,2,8.7
"10095",223,0,0,0,0,0,0,0,0,0,0,0,0,0,0,0,0,1037908,"2023-12-13T00:00:00.000Z",17896059,27,"Sandro Mamukelashvili",0,0,0,0,0,0
"10096",224,0,0,0,0,0,0,0,0,0,0,0,0,0,0,0,0,1037906,"2023-12-13T00:00:00.000Z",420,15,"Marcus Smart",0,0,0,0,0,0
"10097",225,7,0,8,3,1,11,6,1,1,29,1,3,14,9,1,1,1037907,"2023-12-13T00:00:00.000Z",315,17,"Khris Middleton",1,23,30,21,16,37.3
"10098",226,3,2,10,0,0,12,8,5,5,33,4,0,21,14,2,4,1037651,"2023-11-01T00:00:00.000Z",4,16,"Bam Adebayo",4,35,38,24,17,50.3
"10099",227,0,0,0,0,0,2,0,0,0,2,2,0,0,2,0,0,1037653,"2023-11-01T00:00:00.000Z",491,19,"Cody Zeller",0,2,2,0,2,2.4
"10100",228,0,0,0,0,0,0,0,0,0,0,0,0,0,0,0,0,1037653,"2023-11-01T00:00:00.000Z",17896097,19,"Jose Alvarado",0,0,0,0,0,0
"10101",229,0,0,0,0,0,0,0,0,0,0,0,0,0,0,0,0,1037653,"2023-11-01T00:00:00.000Z",666584,19,"Kaiser Gates",0,0,0,0,0,0
"10102",230,0,0,0,0,0,0,0,0,0,0,0,0,0,0,0,0,1037653,"2023-11-01T00:00:00.000Z",227,19,"Brandon Ingram",0,0,0,0,0,0
"10103",231,3,1,0,3,2,5,3,3,1,25,1,2,9,1,0,0,1037648,"2023-11-01T00:00:00.000Z",112,17,"Jae Crowder",1,10,13,12,4,17.7
"10104",232,1,0,5,1,0,6,2,9,6,19,1,1,10,6,2,1,1037648,"2023-11-01T00:00:00.000Z",377,17,"Bobby Portis",2,16,17,11,7,23.7
"10105",233,1,0,2,2,0,5,2,0,0,19,0,2,4,2,0,1,1037648,"2023-11-01T00:00:00.000Z",368,17,"Cameron Payne",0,6,7,5,3,6.9
"10106",234,0,0,2,5,2,5,2,2,2,16,0,0,8,2,0,0,1037648,"2023-11-01T00:00:00.000Z",38017676,17,"MarJon Beauchamp",0,10,10,8,2,10.4
"10107",235,3,0,1,0,0,1,1,0,0,6,0,2,2,1,1,0,1037648,"2023-11-01T00:00:00.000Z",56677852,17,"Andre Jackson Jr.",1,3,6,5,4,10.7
"10108",236,1,0,0,1,1,2,2,0,0,5,0,0,5,0,0,0,1037648,"2023-11-01T00:00:00.000Z",56677854,17,"Chris Livingston",0,5,6,6,1,6.5
"10109",237,1,0,1,0,0,1,1,0,0,5,0,1,2,1,0,0,1037648,"2023-11-01T00:00:00.000Z",38017733,17,"A.J. Green",0,3,4,3,2,4.7
"10110",238,0,0,0,0,0,0,0,0,0,0,0,0,0,0,0,0,1037648,"2023-11-01T00:00:00.000Z",284,17,"Robin Lopez",0,0,0,0,0,0
"10111",239,0,0,0,0,0,0,0,0,0,0,0,0,0,0,0,0,1037648,"2023-11-01T00:00:00.000Z",666453,17,"Marques Bolden",0,0,0,0,0,0
"10112",240,0,0,0,0,0,0,0,0,0,0,0,0,0,0,0,0,1037648,"2023-11-01T00:00:00.000Z",38017691,17,"TyTy Washington Jr.",0,0,0,0,0,0
"10113",241,1,0,0,6,2,13,5,1,1,20,0,1,13,0,1,1,1037649,"2023-11-01T00:00:00.000Z",666848,30,"Jordan Poole",1,13,14,14,1,16.5
"10114",242,3,0,1,3,0,6,3,0,0,22,0,1,6,1,1,1,1037649,"2023-11-01T00:00:00.000Z",249,30,"Tyus Jones",1,7,10,9,4,13.7
"10115",243,5,0,3,10,6,23,12,1,0,36,0,2,30,3,0,3,1037651,"2023-11-01T00:00:00.000Z",666633,16,"Tyler Herro",0,33,38,35,8,38.1
"10116",244,3,1,3,5,2,5,2,0,0,30,0,3,6,3,2,2,1037651,"2023-11-01T00:00:00.000Z",286,16,"Kyle Lowry",3,9,12,9,6,21.1
"10117",245,3,0,3,5,1,9,1,2,1,30,0,2,4,3,1,0,1037651,"2023-11-01T00:00:00.000Z",391,16,"Josh Richardson",1,7,10,7,6,15.1
"10118",246,2,1,4,4,3,5,3,0,0,22,0,0,9,4,1,1,1037651,"2023-11-01T00:00:00.000Z",3092,16,"Haywood Highsmith",2,13,15,11,6,21.8
"10119",247,2,0,3,6,1,8,2,0,0,21,0,4,5,3,0,1,1037651,"2023-11-01T00:00:00.000Z",397,16,"Duncan Robinson",0,8,10,7,5,10.6
"10120",248,0,0,4,0,0,4,3,2,2,15,1,4,8,5,1,2,1037651,"2023-11-01T00:00:00.000Z",74,16,"Thomas Bryant",1,13,13,8,5,15
"10121",249,0,0,0,0,0,0,0,0,0,0,0,0,0,0,0,0,1037651,"2023-11-01T00:00:00.000Z",38017696,16,"Nikola Jovic",0,0,0,0,0,0
"10122",250,0,0,0,0,0,0,0,0,0,0,0,0,0,0,0,0,1037651,"2023-11-01T00:00:00.000Z",39398582,16,"Orlando Robinson",0,0,0,0,0,0
"10123",251,0,0,0,0,0,0,0,0,0,0,0,0,0,0,0,0,1037907,"2023-12-13T00:00:00.000Z",38017691,17,"TyTy Washington Jr.",0,0,0,0,0,0
"10124",252,0,0,0,0,0,0,0,0,0,0,0,0,0,0,0,0,1037907,"2023-12-13T00:00:00.000Z",666960,17,"Lindell Wigginton",0,0,0,0,0,0
"10125",253,9,0,5,3,0,10,4,4,1,27,3,2,9,8,2,1,1037907,"2023-12-13T00:00:00.000Z",69,12,"Bruce Brown",2,17,26,18,17,37.1
"10126",254,1,1,4,3,1,7,2,0,0,19,3,6,5,7,0,0,1037907,"2023-12-13T00:00:00.000Z",3547243,12,"Obi Toppin",1,12,13,6,8,17.9
"10127",255,0,1,5,2,2,14,8,4,4,33,4,4,22,9,0,2,1037907,"2023-12-13T00:00:00.000Z",452,12,"Myles Turner",1,31,31,22,9,33.8
"10128",256,2,0,1,6,1,9,3,0,0,27,2,1,7,3,0,1,1037907,"2023-12-13T00:00:00.000Z",210,12,"Buddy Hield",0,10,12,9,5,12.6
"10129",257,7,0,4,4,1,16,8,7,5,31,1,0,22,5,0,3,1037907,"2023-12-13T00:00:00.000Z",3547245,12,"Tyrese Haliburton",0,27,34,29,12,35.5
"10130",258,0,0,0,1,0,1,0,0,0,4,0,1,0,0,0,2,1037910,"2023-12-13T00:00:00.000Z",56677834,29,"Keyonte George",0,0,0,0,0,-2
"10131",259,2,0,1,5,1,12,2,0,0,30,3,2,5,4,0,0,1037910,"2023-12-13T00:00:00.000Z",38017620,29,"Ochai Agbaji",0,9,11,7,6,12.8
"10132",260,7,0,2,2,2,4,4,0,0,18,0,3,10,2,1,1,1037910,"2023-12-13T00:00:00.000Z",139,29,"Kris Dunn",1,12,19,17,9,24.9
"10133",261,1,1,2,3,1,7,2,0,0,20,2,3,5,4,2,1,1037910,"2023-12-13T00:00:00.000Z",56677824,29,"Taylor Hendricks",3,9,10,6,5,19.3
"10134",262,2,0,3,9,3,19,7,5,4,39,0,3,21,3,1,0,1037909,"2023-12-13T00:00:00.000Z",61,3,"Mikal Bridges",1,24,26,23,5,30.6
"10135",263,4,2,4,7,3,10,5,2,2,34,1,1,15,5,2,1,1037909,"2023-12-13T00:00:00.000Z",666679,3,"Cameron Johnson",4,20,24,19,9,38
"10136",264,1,1,7,1,1,10,6,2,1,33,0,4,14,7,0,0,1037909,"2023-12-13T00:00:00.000Z",666508,3,"Nicolas Claxton",1,21,22,15,8,26.9
"10137",265,4,1,1,8,4,17,6,8,8,28,1,0,24,2,1,2,1037909,"2023-12-13T00:00:00.000Z",17896048,3,"Cam Thomas",2,26,30,28,6,36.4
"10138",266,7,0,6,5,2,11,6,4,2,35,2,4,16,8,2,2,1037909,"2023-12-13T00:00:00.000Z",130,3,"Spencer Dinwiddie",2,24,31,23,15,40.1
"10139",267,0,0,0,1,0,3,1,2,1,8,3,0,3,3,0,0,1037909,"2023-12-13T00:00:00.000Z",17896038,3,"Day'Ron Sharpe",0,6,6,3,3,6.6
"10140",268,1,0,3,4,0,9,4,0,0,26,3,3,8,6,2,2,1037909,"2023-12-13T00:00:00.000Z",158,3,"Dorian Finney-Smith",2,14,15,9,7,20.7
"10141",269,3,0,4,3,1,14,7,2,0,24,0,2,15,4,0,1,1037910,"2023-12-13T00:00:00.000Z",666650,29,"Talen Horton-Tucker",0,19,22,18,7,23.3
"10142",270,1,3,5,0,0,7,4,3,1,23,3,3,9,8,0,2,1037910,"2023-12-13T00:00:00.000Z",38017705,29,"Walker Kessler",3,17,18,10,9,27.1
"10143",271,0,0,2,0,0,1,0,0,0,5,1,0,0,3,0,0,1037910,"2023-12-13T00:00:00.000Z",11891374,29,"Omer Yurtseven",0,3,3,0,3,3.6
"10144",272,0,0,0,0,0,0,0,0,0,0,0,0,0,0,0,0,1037910,"2023-12-13T00:00:00.000Z",19465584,29,"Micah Potter",0,0,0,0,0,0
"10145",273,0,0,0,0,0,0,0,0,0,0,0,0,0,0,0,0,1037910,"2023-12-13T00:00:00.000Z",56677842,29,"Brice Sensabaugh",0,0,0,0,0,0
"10146",274,0,0,0,0,0,0,0,0,0,0,0,0,0,0,0,0,1037910,"2023-12-13T00:00:00.000Z",17896023,29,"Josh Christopher",0,0,0,0,0,0
"10147",275,0,0,0,0,0,0,0,0,0,0,0,0,0,0,0,0,1037910,"2023-12-13T00:00:00.000Z",100,29,"Jordan Clarkson",0,0,0,0,0,0
"10148",276,0,0,0,0,0,0,0,0,0,0,0,0,0,0,0,0,1037655,"2023-11-01T00:00:00.000Z",17896103,8,"Jay Huff",0,0,0,0,0,0
"10149",277,0,0,0,0,0,0,0,0,0,0,0,0,0,0,0,0,1037653,"2023-11-01T00:00:00.000Z",3547293,19,"Naji Marshall",0,0,0,0,0,0
"10150",278,0,0,0,0,0,0,0,0,0,0,0,0,0,0,0,0,1037653,"2023-11-01T00:00:00.000Z",18677986,19,"Trey Murphy III",0,0,0,0,0,0
"10151",279,0,0,0,0,0,0,0,0,0,0,0,0,0,0,0,0,1037653,"2023-11-01T00:00:00.000Z",38017726,19,"Dereon Seabron",0,0,0,0,0,0
"10152",280,1,0,10,6,4,11,6,3,3,28,1,5,19,11,1,0,1037657,"2023-11-01T00:00:00.000Z",297,29,"Lauri Markkanen",1,30,31,20,12,36.7
"10153",281,2,0,2,5,2,12,5,6,4,28,2,2,16,4,2,1,1037657,"2023-11-01T00:00:00.000Z",101,29,"John Collins",2,20,22,18,6,28.8
"10154",282,4,0,2,4,1,9,4,11,8,25,1,1,17,3,3,3,1037651,"2023-11-01T00:00:00.000Z",464,3,"Lonnie Walker IV",3,20,24,21,7,32.6
"10155",283,4,0,3,2,1,6,4,2,2,14,1,2,11,4,1,1,1037651,"2023-11-01T00:00:00.000Z",17896058,3,"Trendon Watford",1,15,19,15,8,23.8
"10156",284,1,0,6,0,0,3,2,2,1,13,1,0,5,7,1,0,1037651,"2023-11-01T00:00:00.000Z",17896038,3,"Day'Ron Sharpe",1,12,13,6,8,17.9
"10157",285,0,1,1,0,0,1,0,0,0,5,0,0,0,1,0,0,1037651,"2023-11-01T00:00:00.000Z",56677722,3,"Jalen Wilson",1,1,1,0,1,4.2
"10158",286,0,0,0,0,0,0,0,0,0,0,0,0,0,0,0,0,1037651,"2023-11-01T00:00:00.000Z",56677843,3,"Noah Clowney",0,0,0,0,0,0
"10159",287,0,0,0,0,0,0,0,0,0,0,0,0,0,0,0,0,1037651,"2023-11-01T00:00:00.000Z",130,3,"Spencer Dinwiddie",0,0,0,0,0,0
"10160",288,0,0,0,0,0,0,0,0,0,0,0,0,0,0,0,0,1037651,"2023-11-01T00:00:00.000Z",666679,3,"Cameron Johnson",0,0,0,0,0,0
"10161",289,0,0,0,0,0,0,0,0,0,0,0,0,0,0,0,0,1037651,"2023-11-01T00:00:00.000Z",17896041,3,"Keon Johnson",0,0,0,0,0,0
"10162",290,0,0,0,0,0,0,0,0,0,0,0,0,0,0,0,0,1037651,"2023-11-01T00:00:00.000Z",421,3,"Dennis Smith Jr.",0,0,0,0,0,0
"10163",291,0,0,0,0,0,0,0,0,0,0,0,0,0,0,0,0,1037647,"2023-11-01T00:00:00.000Z",38017694,9,"Jalen Duren",0,0,0,0,0,0
"10164",292,0,0,0,0,0,0,0,0,0,0,0,0,0,0,0,0,1037651,"2023-11-01T00:00:00.000Z",56677841,3,"Dariq Whitehead",0,0,0,0,0,0
"10165",293,0,1,5,3,1,4,2,0,0,13,0,2,5,5,3,1,1037654,"2023-11-01T00:00:00.000Z",18678001,4,"JT Thor",4,10,10,5,5,22
"10166",294,0,0,0,0,0,0,0,0,0,0,0,0,0,0,0,0,1037647,"2023-11-01T00:00:00.000Z",17896071,9,"Isaiah Livers",0,0,0,0,0,0
"10167",295,0,0,0,0,0,0,0,0,0,0,0,0,0,0,0,0,1037647,"2023-11-01T00:00:00.000Z",330,9,"Monte Morris",0,0,0,0,0,0
"10168",296,1,0,1,3,0,3,0,0,0,17,0,1,0,1,1,0,1037647,"2023-11-01T00:00:00.000Z",666923,25,"Matisse Thybulle",1,1,2,1,2,5.7
"10169",297,0,0,0,0,0,0,0,0,0,0,0,0,0,0,0,0,1037647,"2023-11-01T00:00:00.000Z",56783340,25,"Duop Reath",0,0,0,0,0,0
"10170",298,0,0,0,0,0,0,0,0,0,0,0,0,0,0,0,0,1037654,"2023-11-01T00:00:00.000Z",56677846,4,"Nick Smith Jr.",0,0,0,0,0,0
"10171",299,0,0,0,0,0,0,0,0,0,0,0,0,0,0,0,0,1037654,"2023-11-01T00:00:00.000Z",17896037,4,"James Bouknight",0,0,0,0,0,0
"10172",300,0,0,0,0,0,0,0,0,0,0,0,0,0,0,0,0,1037654,"2023-11-01T00:00:00.000Z",666748,4,"Cody Martin",0,0,0,0,0,0
"10173",301,1,0,2,3,0,4,1,2,0,16,0,1,2,2,0,1,1037910,"2023-12-13T00:00:00.000Z",17895858,20,"Quentin Grimes",0,4,5,3,3,4.9
"10174",302,0,0,0,0,0,0,0,0,0,0,0,0,0,0,0,0,1037910,"2023-12-13T00:00:00.000Z",19,20,"Ryan Arcidiacono",0,0,0,0,0,0
"10175",303,0,0,0,0,0,0,0,0,0,0,0,0,0,0,0,0,1037910,"2023-12-13T00:00:00.000Z",160,20,"Evan Fournier",0,0,0,0,0,0
"10176",304,0,0,0,0,0,0,0,0,0,0,0,0,0,0,0,0,1037910,"2023-12-13T00:00:00.000Z",666675,20,"DaQuan Jeffries",0,0,0,0,0,0
"10177",305,0,0,0,0,0,0,0,0,0,0,0,0,0,0,0,0,1037910,"2023-12-13T00:00:00.000Z",17896033,20,"Miles McBride",0,0,0,0,0,0
"10178",306,0,0,0,0,0,0,0,0,0,0,0,0,0,0,0,0,1037910,"2023-12-13T00:00:00.000Z",666474,20,"Charles Brown",0,0,0,0,0,0
"10179",307,0,0,0,0,0,0,0,0,0,0,0,0,0,0,0,0,1037910,"2023-12-13T00:00:00.000Z",59421201,20,"Jaylen Martin",0,0,0,0,0,0
"10180",308,0,0,0,0,0,0,0,0,0,0,0,0,0,0,0,0,1037910,"2023-12-13T00:00:00.000Z",399,20,"Mitchell Robinson",0,0,0,0,0,0
"10181",309,0,0,0,0,0,0,0,0,0,0,0,0,0,0,0,0,1037910,"2023-12-13T00:00:00.000Z",56677795,20,"Jacob Toppin",0,0,0,0,0,0
"10182",310,4,0,1,4,2,5,3,0,0,19,0,1,8,1,0,0,1037909,"2023-12-13T00:00:00.000Z",351,3,"Royce O'Neale",0,9,13,12,5,15.2
"10183",311,1,0,1,2,0,5,3,1,1,18,0,1,7,1,1,0,1037909,"2023-12-13T00:00:00.000Z",17896058,3,"Trendon Watford",1,8,9,8,2,12.7
"10184",312,0,0,0,0,0,0,0,0,0,0,0,0,0,0,0,0,1037909,"2023-12-13T00:00:00.000Z",9051997,3,"Armoni Brooks",0,0,0,0,0,0
"10185",313,0,0,0,0,0,0,0,0,0,0,0,0,0,0,0,0,1037909,"2023-12-13T00:00:00.000Z",174,3,"Harry Giles III",0,0,0,0,0,0
"10186",314,0,0,0,0,0,0,0,0,0,0,0,0,0,0,0,0,1037909,"2023-12-13T00:00:00.000Z",56677722,3,"Jalen Wilson",0,0,0,0,0,0
"10187",315,0,0,0,0,0,0,0,0,0,0,0,0,0,0,0,0,1037909,"2023-12-13T00:00:00.000Z",56677843,3,"Noah Clowney",0,0,0,0,0,0
"10188",316,0,0,0,0,0,0,0,0,0,0,0,0,0,0,0,0,1037909,"2023-12-13T00:00:00.000Z",17896041,3,"Keon Johnson",0,0,0,0,0,0
"10189",317,0,0,0,0,0,0,0,0,0,0,0,0,0,0,0,0,1037909,"2023-12-13T00:00:00.000Z",417,3,"Ben Simmons",0,0,0,0,0,0
"10190",318,7,0,5,1,0,15,6,10,8,36,2,0,20,7,0,1,1037912,"2023-12-14T00:00:00.000Z",79,16,"Jimmy Butler",0,27,34,27,14,37.9
"10191",319,4,0,9,4,3,13,7,0,0,39,2,3,17,11,0,1,1037912,"2023-12-14T00:00:00.000Z",666747,16,"Caleb Martin",0,28,32,21,15,35.2
"10192",320,0,0,0,1,0,2,0,2,1,14,2,2,1,2,0,1,1037912,"2023-12-14T00:00:00.000Z",39398582,16,"Orlando Robinson",0,3,3,1,2,2.4
"10193",321,3,0,2,6,3,9,4,2,0,27,0,2,11,2,0,2,1037912,"2023-12-14T00:00:00.000Z",397,16,"Duncan Robinson",0,13,16,14,5,15.9
"10194",322,3,0,2,9,4,12,6,1,1,39,1,5,17,3,1,1,1037912,"2023-12-14T00:00:00.000Z",286,16,"Kyle Lowry",1,20,23,20,6,27.1
"10195",323,4,0,8,8,3,12,5,4,3,22,1,1,16,9,1,2,1037912,"2023-12-14T00:00:00.000Z",285,16,"Kevin Love",1,25,29,20,13,33.8
"10196",324,4,0,4,4,1,14,6,10,9,34,0,4,22,4,0,2,1037912,"2023-12-14T00:00:00.000Z",56677785,16,"Jaime Jaquez Jr.",0,26,30,26,8,30.8
"10197",325,0,1,0,0,0,0,0,4,3,8,0,1,3,0,0,0,1037912,"2023-12-14T00:00:00.000Z",38017734,16,"Jamal Cain",1,3,3,3,0,6
"10198",326,2,2,6,1,0,5,3,0,0,21,3,5,6,9,0,4,1037655,"2023-11-01T00:00:00.000Z",3547259,18,"Jaden McDaniels",2,15,17,8,11,21.8
"10199",327,4,0,6,4,1,19,7,6,6,31,2,2,21,8,2,1,1037655,"2023-11-01T00:00:00.000Z",447,18,"Karl-Anthony Towns",2,29,33,25,12,41.6
"10200",328,1,2,10,0,0,7,0,4,4,33,2,3,4,12,1,1,1037655,"2023-11-01T00:00:00.000Z",176,18,"Rudy Gobert",3,16,17,5,13,27.9
"10201",329,1,0,2,4,1,16,8,8,7,32,0,1,24,2,2,4,1037655,"2023-11-01T00:00:00.000Z",3547238,18,"Anthony Edwards",2,26,27,25,3,29.9
"10202",330,6,0,3,4,3,9,7,0,0,27,0,1,17,3,1,0,1037655,"2023-11-01T00:00:00.000Z",104,18,"Mike Conley",1,20,26,23,9,32.6
"10203",331,2,0,3,1,1,6,4,0,0,25,0,0,9,3,0,0,1037655,"2023-11-01T00:00:00.000Z",12,18,"Kyle Anderson",0,12,14,11,5,15.6
"10204",332,1,1,0,2,1,6,2,0,0,21,0,2,5,0,0,0,1037655,"2023-11-01T00:00:00.000Z",666400,18,"Nickeil Alexander-Walker",1,5,6,6,1,9.5
"10205",333,1,0,4,3,1,9,6,3,3,19,1,0,16,5,1,1,1037655,"2023-11-01T00:00:00.000Z",667378,18,"Naz Reid",1,21,22,17,6,25.5
"10206",334,9,0,3,3,2,10,6,1,1,26,1,2,15,4,0,0,1037650,"2023-11-01T00:00:00.000Z",3547276,2,"Payton Pritchard",0,19,28,24,13,33.3
"10207",335,0,0,1,1,0,4,1,2,2,20,0,0,4,1,2,0,1037650,"2023-11-01T00:00:00.000Z",666468,2,"Oshae Brissett",2,5,5,4,1,11.2
"10208",336,5,0,3,4,1,8,3,0,0,24,1,3,7,4,1,1,1037650,"2023-11-01T00:00:00.000Z",210,12,"Buddy Hield",1,11,16,12,9,21.3
"10209",337,1,0,0,6,1,9,4,1,0,18,1,4,9,1,0,0,1037650,"2023-11-01T00:00:00.000Z",3547250,12,"Aaron Nesmith",0,10,11,10,2,11.7
"10210",338,5,0,5,1,0,13,8,2,2,28,2,2,18,7,1,1,1037650,"2023-11-01T00:00:00.000Z",304,12,"T.J. McConnell",1,25,30,23,12,35.9
"10211",339,1,4,3,0,0,5,3,2,1,19,0,1,7,3,0,1,1037650,"2023-11-01T00:00:00.000Z",17896035,12,"Isaiah Jackson",4,10,11,8,4,23.1
"10212",340,1,0,1,0,0,3,0,2,2,18,0,1,2,1,2,1,1037655,"2023-11-01T00:00:00.000Z",320,18,"Shake Milton",2,3,4,3,2,9.7
"10213",341,1,0,4,1,0,1,0,4,4,5,0,0,4,4,0,1,1037655,"2023-11-01T00:00:00.000Z",68,18,"Troy Brown Jr.",0,8,9,5,5,9.3
"10214",342,0,0,0,1,0,1,0,0,0,4,0,0,0,0,0,0,1037655,"2023-11-01T00:00:00.000Z",666767,18,"Jordan McLaughlin",0,0,0,0,0,0
"10215",343,0,0,2,1,0,10,6,2,2,25,0,2,14,2,0,1,1037658,"2023-11-01T00:00:00.000Z",475,10,"Andrew Wiggins",0,16,16,14,2,15.4
"10216",344,9,2,0,4,2,7,4,4,3,28,2,1,13,2,2,2,1037658,"2023-11-01T00:00:00.000Z",185,10,"Draymond Green",4,15,24,22,11,38.9
"10217",345,6,0,7,0,0,4,3,0,0,23,2,2,6,9,0,0,1037658,"2023-11-01T00:00:00.000Z",282,10,"Kevon Looney",0,15,21,12,15,25.8
"10218",346,2,3,1,4,1,15,6,1,1,29,1,3,14,2,0,2,1037658,"2023-11-01T00:00:00.000Z",443,10,"Klay Thompson",3,16,18,16,4,26.4
"10219",347,3,0,4,10,4,15,7,3,3,32,1,3,21,5,0,7,1037658,"2023-11-01T00:00:00.000Z",115,10,"Stephen Curry",0,26,29,24,8,24.5
"10220",348,0,0,0,0,0,0,0,0,0,1,0,0,0,0,0,0,1037658,"2023-11-01T00:00:00.000Z",56677799,10,"Trayce Jackson-Davis",0,0,0,0,0,0
"10221",349,1,0,4,9,3,13,7,0,0,31,1,2,17,5,0,0,1037656,"2023-11-01T00:00:00.000Z",247,7,"Derrick Jones Jr.",0,22,23,18,6,24.5
"10222",350,1,0,3,9,7,10,7,6,4,30,2,1,25,5,1,0,1037656,"2023-11-01T00:00:00.000Z",666965,7,"Grant Williams",1,30,31,26,6,35.5
"10223",351,0,0,0,0,0,0,0,0,0,0,0,0,0,0,0,0,1037924,"2023-12-15T00:00:00.000Z",666786,15,"Ja Morant",0,0,0,0,0,0
"10224",352,0,0,0,0,0,0,0,0,0,0,0,0,0,0,0,0,1037921,"2023-12-15T00:00:00.000Z",219,2,"Al Horford",0,0,0,0,0,0
"10225",353,0,0,0,0,0,0,0,0,0,0,0,0,0,0,0,0,1037922,"2023-12-15T00:00:00.000Z",2309958,28,"Jontay Porter",0,0,0,0,0,0
"10226",354,4,0,7,8,2,12,4,0,0,38,3,3,10,10,0,1,1037922,"2023-12-15T00:00:00.000Z",3547256,1,"Saddiq Bey",0,20,24,14,14,27
"10227",355,0,0,0,0,0,0,0,0,0,0,0,0,0,0,0,0,1037921,"2023-12-15T00:00:00.000Z",261,2,"Luke Kornet",0,0,0,0,0,0
"10228",357,0,0,0,0,0,0,0,0,0,0,0,0,0,0,0,0,1037923,"2023-12-15T00:00:00.000Z",56677817,27,"Sidy Cissoko",0,0,0,0,0,0
"10229",358,0,0,0,0,0,0,0,0,0,0,0,0,0,0,0,0,1037923,"2023-12-15T00:00:00.000Z",17896049,27,"David Duke Jr.",0,0,0,0,0,0
"10230",359,1,1,3,6,2,10,5,0,0,36,0,2,12,3,1,1,1037923,"2023-12-15T00:00:00.000Z",383,14,"Taurean Prince",2,15,16,13,4,22.1
"10231",360,0,0,0,0,0,0,0,0,0,0,0,0,0,0,0,0,1037920,"2023-12-15T00:00:00.000Z",56677794,12,"Isaiah Wong",0,0,0,0,0,0
"10232",361,1,1,10,0,0,12,9,2,2,28,3,2,20,13,0,2,1037919,"2023-12-15T00:00:00.000Z",3547240,9,"James Wiseman",1,33,34,21,14,38.1
"10233",362,0,0,0,0,0,0,0,0,0,0,0,0,0,0,0,0,1037919,"2023-12-15T00:00:00.000Z",56677729,9,"Malcolm Cazalon",0,0,0,0,0,0
"10234",363,0,0,0,0,0,0,0,0,0,0,0,0,0,0,0,0,1037919,"2023-12-15T00:00:00.000Z",38017694,9,"Jalen Duren",0,0,0,0,0,0
"10235",364,0,0,0,0,0,0,0,0,0,0,0,0,0,0,0,0,1037919,"2023-12-15T00:00:00.000Z",330,9,"Monte Morris",0,0,0,0,0,0
"10236",365,0,0,0,0,0,0,0,0,0,0,0,0,0,0,0,0,1037919,"2023-12-15T00:00:00.000Z",42097199,9,"Jared Rhoden",0,0,0,0,0,0
"10237",366,0,0,0,0,0,0,0,0,0,0,0,0,0,0,0,0,1037919,"2023-12-15T00:00:00.000Z",44477024,9,"Stanley Umude",0,0,0,0,0,0
"10238",367,0,1,7,2,1,7,6,1,1,33,4,3,14,11,0,1,1037922,"2023-12-15T00:00:00.000Z",3547244,1,"Onyeka Okongwu",1,25,25,14,11,29.2
"10239",368,0,3,9,0,0,12,9,0,0,35,6,2,18,15,0,1,1037922,"2023-12-15T00:00:00.000Z",83,1,"Clint Capela",3,33,33,18,15,44
"10240",369,9,0,6,6,1,18,8,0,0,33,1,3,17,7,1,1,1037922,"2023-12-15T00:00:00.000Z",334,1,"Dejounte Murray",1,24,33,26,16,40.9
"10241",370,11,0,4,15,7,29,15,2,1,36,1,2,38,5,1,8,1037922,"2023-12-15T00:00:00.000Z",490,1,"Trae Young",1,43,54,49,16,55.5
"10242",371,4,0,2,1,0,4,0,0,0,11,1,1,0,3,1,0,1037922,"2023-12-15T00:00:00.000Z",3547297,1,"Trent Forrest",1,3,7,4,7,12.6
"10243",372,6,0,3,7,3,16,7,3,3,33,0,2,20,3,0,0,1037922,"2023-12-15T00:00:00.000Z",53,1,"Bogdan Bogdanovic",0,23,29,26,9,32.6
"10244",373,0,0,1,2,2,2,2,0,0,18,0,2,6,1,1,0,1037922,"2023-12-15T00:00:00.000Z",666754,1,"Garrison Mathews",1,7,7,6,1,10.2
"10245",374,0,0,0,0,0,1,1,0,0,1,0,1,2,0,0,0,1037922,"2023-12-15T00:00:00.000Z",56677855,1,"Seth Lundy",0,2,2,2,0,2
"10246",375,0,0,1,4,2,4,2,0,0,17,0,1,6,1,0,1,1037923,"2023-12-15T00:00:00.000Z",305,27,"Doug McDermott",0,7,7,6,1,6.2
"10247",376,1,0,6,4,2,14,9,6,6,38,3,0,26,9,1,1,1037676,"2023-11-04T00:00:00.000Z",66,11,"Dillon Brooks",1,35,36,27,10,40.3
"10248",377,0,1,8,6,3,15,9,0,0,35,3,4,21,11,0,0,1037676,"2023-11-04T00:00:00.000Z",38017684,11,"Jabari Smith Jr.",1,32,32,21,11,37.2
"10249",378,6,0,9,3,1,13,7,0,0,34,0,2,15,9,2,2,1037676,"2023-11-04T00:00:00.000Z",17896062,11,"Alperen Sengun",2,24,30,21,15,38.8
"10250",379,5,0,2,2,0,10,4,7,2,36,0,1,10,2,0,3,1037676,"2023-11-04T00:00:00.000Z",17895966,11,"Jalen Green",0,12,17,15,7,16.9
"10251",380,12,2,6,14,4,22,7,3,3,36,0,4,21,6,0,2,1037676,"2023-11-04T00:00:00.000Z",458,11,"Fred VanVleet",2,27,39,33,18,50.2
"10252",381,1,0,4,3,3,6,4,0,0,21,0,4,11,4,0,0,1037676,"2023-11-04T00:00:00.000Z",3547301,11,"Jae'Sean Tate",0,15,16,12,5,17.3
"10253",382,0,0,2,2,0,4,0,0,0,19,1,1,0,3,0,1,1037676,"2023-11-04T00:00:00.000Z",213,11,"Aaron Holiday",0,3,3,0,3,2.6
"10254",383,2,2,5,10,5,16,9,5,4,31,1,4,27,6,1,2,1037678,"2023-11-04T00:00:00.000Z",375,8,"Michael Porter Jr.",3,33,35,29,8,44.2
"10255",384,5,1,9,3,1,9,4,8,6,35,3,2,15,12,2,3,1037678,"2023-11-04T00:00:00.000Z",177,8,"Aaron Gordon",3,27,32,20,17,42.9
"10256",385,0,0,0,0,0,0,0,0,0,0,0,0,0,0,0,0,1037673,"2023-11-04T00:00:00.000Z",1603383,14,"Gabe Vincent",0,0,0,0,0,0
"10257",386,1,0,2,2,0,5,2,2,2,15,1,1,6,3,0,0,1037674,"2023-11-04T00:00:00.000Z",340,19,"Larry Nance Jr.",0,9,10,7,4,11.1
"10258",387,3,0,5,2,1,17,8,2,2,30,2,3,19,7,0,2,1037678,"2023-11-04T00:00:00.000Z",460,5,"Nikola Vucevic",0,26,29,22,10,29.9
"10259",388,4,0,4,5,1,12,4,4,3,31,0,2,12,4,1,3,1037678,"2023-11-04T00:00:00.000Z",268,5,"Zach LaVine",1,16,20,16,8,22.8
"10260",389,0,0,4,1,0,9,5,2,2,15,2,0,12,6,0,0,1037676,"2023-11-04T00:00:00.000Z",306,26,"JaVale McGee",0,18,18,12,6,19.2
"10261",390,5,1,2,4,1,10,4,2,2,31,0,2,11,2,2,2,1037678,"2023-11-04T00:00:00.000Z",666956,5,"Coby White",3,13,18,16,7,27.9
"10262",391,1,0,0,5,4,9,6,1,0,18,0,2,16,0,0,1,1037678,"2023-11-04T00:00:00.000Z",87,5,"Jevon Carter",0,16,17,17,1,16.5
"10263",392,2,0,0,2,0,3,1,1,1,14,0,3,3,0,1,2,1037678,"2023-11-04T00:00:00.000Z",89,5,"Alex Caruso",1,3,5,5,2,7
"10264",393,3,2,2,5,0,7,2,4,3,28,1,0,7,3,1,1,1037678,"2023-11-04T00:00:00.000Z",3547248,5,"Patrick Williams",3,10,13,10,6,23.1
"10265",394,0,0,7,0,0,3,2,2,1,15,4,1,5,11,1,0,1037678,"2023-11-04T00:00:00.000Z",137,5,"Andre Drummond",1,16,16,5,11,21.2
"10266",395,0,0,0,0,0,0,0,0,0,3,0,0,0,0,0,0,1037678,"2023-11-04T00:00:00.000Z",56677857,5,"Julian Phillips",0,0,0,0,0,0
"10267",396,0,0,0,0,0,0,0,0,0,3,0,0,0,0,0,0,1037678,"2023-11-04T00:00:00.000Z",56677874,5,"Onuralp Bitim",0,0,0,0,0,0
"10268",397,0,0,0,0,0,0,0,0,0,0,0,0,0,0,0,0,1037675,"2023-11-04T00:00:00.000Z",3547295,2,"Nathan Knight",0,0,0,0,0,0
"10269",398,0,0,0,0,0,0,0,0,0,0,0,0,0,0,0,0,1037675,"2023-11-04T00:00:00.000Z",17553967,2,"Neemias Queta",0,0,0,0,0,0
"10270",399,3,0,2,1,0,1,0,0,0,12,1,1,0,3,1,0,1037676,"2023-11-04T00:00:00.000Z",19465326,11,"Jock Landale",1,3,6,3,6,11.1
"10271",400,0,0,3,0,0,1,0,2,1,6,2,0,1,5,0,1,1037676,"2023-11-04T00:00:00.000Z",188,11,"Jeff Green",0,6,6,1,5,6
"10272",401,2,0,0,1,0,2,0,0,0,9,1,0,0,1,0,1,1037952,"2023-12-19T00:00:00.000Z",38017729,15,"David Roddy",0,1,3,2,3,3.2
"10273",402,0,0,0,0,0,0,0,0,0,0,0,0,0,0,0,0,1037952,"2023-12-19T00:00:00.000Z",48248287,15,"Jacob Gilyard",0,0,0,0,0,0
"10274",403,0,0,0,0,0,0,0,0,0,0,0,0,0,0,0,0,1037952,"2023-12-19T00:00:00.000Z",401,15,"Derrick Rose",0,0,0,0,0,0
"10275",404,0,0,0,0,0,0,0,0,0,0,0,0,0,0,0,0,1037952,"2023-12-19T00:00:00.000Z",3,15,"Steven Adams",0,0,0,0,0,0
"10276",405,0,0,0,0,0,0,0,0,0,0,0,0,0,0,0,0,1037952,"2023-12-19T00:00:00.000Z",420,15,"Marcus Smart",0,0,0,0,0,0
"10277",406,0,0,0,0,0,0,0,0,0,0,0,0,0,0,0,0,1037952,"2023-12-19T00:00:00.000Z",666505,15,"Brandon Clarke",0,0,0,0,0,0
"10278",407,0,0,0,0,0,0,0,0,0,0,0,0,0,0,0,0,1037952,"2023-12-19T00:00:00.000Z",56677830,15,"GG Jackson",0,0,0,0,0,0
"10279",408,0,0,0,0,0,0,0,0,0,0,0,0,0,0,0,0,1037952,"2023-12-19T00:00:00.000Z",254,15,"Luke Kennard",0,0,0,0,0,0
"10280",409,0,0,0,0,0,0,0,0,0,0,0,0,0,0,0,0,1037952,"2023-12-19T00:00:00.000Z",38017728,15,"Jake LaRavia",0,0,0,0,0,0
"10281",410,0,0,0,0,0,0,0,0,0,0,0,0,0,0,0,0,1037952,"2023-12-19T00:00:00.000Z",38017732,15,"Kenneth Lofton Jr.",0,0,0,0,0,0
"10282",411,3,3,2,8,4,13,8,5,5,26,2,2,25,4,1,2,1037957,"2023-12-20T00:00:00.000Z",210,12,"Buddy Hield",4,29,32,28,7,44.3
"10283",412,0,0,4,3,0,5,2,2,2,23,0,1,6,4,0,1,1037957,"2023-12-20T00:00:00.000Z",3547243,12,"Obi Toppin",0,10,10,6,4,9.8
"10284",413,0,2,5,4,1,9,5,7,7,25,1,2,18,6,0,1,1037957,"2023-12-20T00:00:00.000Z",452,12,"Myles Turner",2,24,24,18,6,30.2
"10285",414,6,0,5,1,0,6,3,0,0,28,0,3,6,5,0,0,1037957,"2023-12-20T00:00:00.000Z",69,12,"Bruce Brown",0,11,17,12,11,21
"10286",415,13,1,2,9,3,14,6,4,4,28,1,0,19,3,1,4,1037957,"2023-12-20T00:00:00.000Z",3547245,12,"Tyrese Haliburton",2,22,35,32,16,44.1
"10287",416,1,0,2,6,4,7,5,0,0,29,0,2,14,2,1,2,1037957,"2023-12-20T00:00:00.000Z",38017686,12,"Bennedict Mathurin",1,16,17,15,3,18.9
"10288",417,1,0,2,4,4,6,6,3,3,23,0,1,19,2,1,1,1037957,"2023-12-20T00:00:00.000Z",3547250,12,"Aaron Nesmith",1,21,22,20,3,24.9
"10289",418,0,0,2,2,2,4,4,0,0,8,2,2,10,4,0,0,1037957,"2023-12-20T00:00:00.000Z",3547264,12,"Jalen Smith",0,14,14,10,4,14.8
"10290",419,9,0,4,0,0,3,3,4,3,20,1,1,9,5,1,1,1037957,"2023-12-20T00:00:00.000Z",304,12,"T.J. McConnell",1,14,23,18,14,30.5
"10291",420,1,2,2,1,0,7,4,3,2,15,1,3,10,3,1,1,1037957,"2023-12-20T00:00:00.000Z",17896035,12,"Isaiah Jackson",3,13,14,11,4,23.1
"10292",421,1,0,0,1,0,5,2,2,2,9,0,3,6,0,0,0,1037957,"2023-12-20T00:00:00.000Z",3547207,12,"Jordan Nwora",0,6,7,7,1,7.5
"10293",422,2,0,0,0,0,1,1,0,0,6,0,0,2,0,0,0,1037957,"2023-12-20T00:00:00.000Z",242,12,"James Johnson",0,2,4,4,2,5
"10294",423,0,0,0,0,0,0,0,0,0,0,0,0,0,0,0,0,1037957,"2023-12-20T00:00:00.000Z",38017507,12,"Andrew Nembhard",0,0,0,0,0,0
"10295",424,0,0,0,0,0,0,0,0,0,0,0,0,0,0,0,0,1037957,"2023-12-20T00:00:00.000Z",38017701,12,"Kendall Brown",0,0,0,0,0,0
"10296",425,0,0,0,0,0,0,0,0,0,0,0,0,0,0,0,0,1037954,"2023-12-19T00:00:00.000Z",45658838,10,"Lester Quinones",0,0,0,0,0,0
"10297",426,0,0,0,0,0,0,0,0,0,0,0,0,0,0,0,0,1037704,"2023-11-08T00:00:00.000Z",666960,17,"Lindell Wigginton",0,0,0,0,0,0
"10298",427,0,0,0,0,0,0,0,0,0,0,0,0,0,0,0,0,1037704,"2023-11-08T00:00:00.000Z",666453,17,"Marques Bolden",0,0,0,0,0,0
"10299",428,0,0,0,0,0,0,0,0,0,0,0,0,0,0,0,0,1037704,"2023-11-08T00:00:00.000Z",315,17,"Khris Middleton",0,0,0,0,0,0
"10300",429,0,0,0,0,0,0,0,0,0,0,0,0,0,0,0,0,1037704,"2023-11-08T00:00:00.000Z",38017691,17,"TyTy Washington Jr.",0,0,0,0,0,0
"10301",430,3,1,12,1,0,8,3,0,0,37,3,4,6,15,0,2,1037704,"2023-11-08T00:00:00.000Z",56677826,9,"Ausar Thompson",1,21,24,9,18,29.5
"10302",431,2,1,1,2,1,3,1,0,0,18,0,2,3,1,0,1,1037707,"2023-11-08T00:00:00.000Z",3547258,7,"Josh Green",1,4,6,5,3,9.2
"10303",432,1,0,1,9,5,11,6,0,0,26,1,0,17,2,0,3,1037707,"2023-11-08T00:00:00.000Z",191,7,"Tim Hardaway Jr.",0,19,20,18,3,17.9
"10304",433,2,0,1,3,1,4,2,2,1,12,0,0,6,1,0,0,1037707,"2023-11-08T00:00:00.000Z",38017679,7,"Jaden Hardy",0,7,9,8,3,10.2
"10305",434,7,2,8,4,0,15,4,8,6,39,6,2,14,14,4,0,1037707,"2023-11-08T00:00:00.000Z",17896055,28,"Scottie Barnes",6,28,35,21,21,59.3
"10306",435,5,1,2,4,1,13,7,4,3,30,0,4,18,2,2,2,1037707,"2023-11-08T00:00:00.000Z",409,28,"Dennis Schroder",3,20,25,23,7,34.9
"10307",436,1,0,2,8,4,11,6,0,0,26,0,0,16,2,1,0,1037707,"2023-11-08T00:00:00.000Z",3089,28,"Gary Trent Jr.",1,18,19,17,3,22.9
"10308",437,0,0,0,0,0,1,0,0,0,6,0,1,0,0,0,2,1037707,"2023-11-08T00:00:00.000Z",56677828,28,"Gradey Dick",0,0,0,0,0,-2
"10309",438,3,0,4,4,2,5,2,2,2,15,0,2,8,4,0,0,1037707,"2023-11-08T00:00:00.000Z",3547275,28,"Malachi Flynn",0,12,15,11,7,17.3
"10310",439,0,0,3,2,0,3,0,0,0,15,0,1,0,3,1,0,1037707,"2023-11-08T00:00:00.000Z",376,28,"Otto Porter Jr.",1,3,3,0,3,6.6
"10311",440,2,0,5,2,0,13,7,5,4,27,1,1,18,6,0,3,1037702,"2023-11-08T00:00:00.000Z",237,14,"LeBron James",0,24,26,20,8,25.2
"10312",441,2,2,6,8,3,17,7,0,0,37,2,1,17,8,0,0,1037708,"2023-11-08T00:00:00.000Z",375,8,"Michael Porter Jr.",2,25,27,19,10,35.6
"10313",442,3,1,7,2,1,14,5,4,3,34,4,2,14,11,3,2,1037708,"2023-11-08T00:00:00.000Z",177,8,"Aaron Gordon",4,25,28,17,14,41.7
"10314",443,5,1,10,8,1,25,14,10,6,37,3,3,35,13,3,3,1037708,"2023-11-08T00:00:00.000Z",246,8,"Nikola Jokic",4,48,53,40,18,67.1
"10315",444,3,0,2,3,0,8,3,4,4,35,1,3,10,3,1,0,1037708,"2023-11-08T00:00:00.000Z",81,8,"Kentavious Caldwell-Pope",1,13,16,13,6,21.1
"10316",445,6,0,2,7,3,17,8,2,1,32,0,5,20,2,0,0,1037708,"2023-11-08T00:00:00.000Z",236,8,"Reggie Jackson",0,22,28,26,8,31.4
"10317",446,1,0,0,2,1,2,1,0,0,16,0,2,3,0,0,1,1037708,"2023-11-08T00:00:00.000Z",38017727,8,"Collin Gillespie",0,3,4,4,1,3.5
"10318",447,2,0,2,2,1,3,1,2,1,16,0,1,4,2,0,0,1037708,"2023-11-08T00:00:00.000Z",38017709,8,"Christian Braun",0,6,8,6,4,9.4
"10319",448,0,0,0,0,0,0,0,0,0,0,0,0,0,0,0,0,1037705,"2023-11-08T00:00:00.000Z",303,19,"CJ McCollum",0,0,0,0,0,0
"10320",449,0,0,0,0,0,0,0,0,0,0,0,0,0,0,0,0,1037705,"2023-11-08T00:00:00.000Z",18677986,19,"Trey Murphy III",0,0,0,0,0,0
"10321",450,0,0,0,0,0,0,0,0,0,0,0,0,0,0,0,0,1037703,"2023-11-08T00:00:00.000Z",285,16,"Kevin Love",0,0,0,0,0,0
"10322",451,0,0,0,1,0,1,0,0,0,2,0,0,0,0,0,0,1037979,"2023-12-22T00:00:00.000Z",17896044,26,"Kessler Edwards",0,0,0,0,0,0
"10323",452,2,0,3,10,4,17,8,0,0,27,0,0,20,3,0,2,1037978,"2023-12-22T00:00:00.000Z",443,10,"Klay Thompson",0,23,25,22,5,24.6
"10324",453,3,0,2,2,1,11,9,3,3,27,2,2,22,4,1,1,1037978,"2023-12-22T00:00:00.000Z",17553979,10,"Jonathan Kuminga",1,26,29,25,7,33.3
"10325",454,0,0,3,0,0,3,2,1,1,11,2,2,5,5,0,0,1037978,"2023-12-22T00:00:00.000Z",282,10,"Kevon Looney",0,10,10,5,5,11
"10326",455,5,0,4,5,2,9,3,2,2,29,3,2,10,7,1,1,1037978,"2023-12-22T00:00:00.000Z",56677858,10,"Brandin Podziemski",1,17,22,15,12,27.9
"10327",456,7,1,4,13,8,18,9,5,4,27,0,0,30,4,0,2,1037978,"2023-12-22T00:00:00.000Z",115,10,"Stephen Curry",1,34,41,37,11,46.3
"10328",457,10,0,7,3,0,7,2,1,0,25,0,2,4,7,1,1,1037978,"2023-12-22T00:00:00.000Z",367,10,"Chris Paul",1,11,21,14,17,29.4
"10329",458,3,1,10,0,0,7,5,0,0,25,5,2,10,15,0,1,1037978,"2023-12-22T00:00:00.000Z",56677799,10,"Trayce Jackson-Davis",1,25,28,13,18,34.5
"10330",459,0,0,2,3,0,4,1,4,3,19,1,1,5,3,1,2,1037978,"2023-12-22T00:00:00.000Z",17553992,10,"Moses Moody",1,8,8,5,3,9.6
"10331",460,0,0,1,1,0,3,0,0,0,14,0,3,0,1,1,1,1037978,"2023-12-22T00:00:00.000Z",251,10,"Cory Joseph",1,1,1,0,1,3.2
"10332",461,1,0,0,0,0,1,0,0,0,2,0,0,0,0,0,0,1037978,"2023-12-22T00:00:00.000Z",17896070,10,"Usman Garuba",0,0,1,1,1,1.5
"10333",462,0,1,1,8,4,10,5,6,5,37,0,2,19,1,2,0,1037979,"2023-12-22T00:00:00.000Z",30,26,"Harrison Barnes",3,20,20,19,1,29.2
"10334",463,2,0,4,7,3,13,8,2,2,33,1,3,21,5,0,1,1037979,"2023-12-22T00:00:00.000Z",38017688,26,"Keegan Murray",0,26,28,23,7,29
"10335",464,11,0,10,2,0,15,12,5,4,35,1,3,28,11,0,3,1037979,"2023-12-22T00:00:00.000Z",406,26,"Domantas Sabonis",0,39,50,39,22,54.7
"10336",465,5,0,1,6,2,9,5,1,1,27,1,1,13,2,1,1,1037979,"2023-12-22T00:00:00.000Z",221,26,"Kevin Huerter",1,15,20,18,7,24.9
"10337",466,7,2,6,6,2,17,9,4,3,32,0,2,23,6,3,2,1037979,"2023-12-22T00:00:00.000Z",161,26,"De'Aaron Fox",5,29,36,30,13,53.7
"10338",467,1,1,2,2,0,3,0,2,1,17,1,3,1,3,1,0,1037979,"2023-12-22T00:00:00.000Z",38017714,26,"Keon Ellis",2,4,5,2,4,12.1
"10339",468,0,0,1,0,0,2,1,4,3,11,0,3,5,1,0,1,1037979,"2023-12-22T00:00:00.000Z",306,26,"JaVale McGee",0,6,6,5,1,5.2
"10340",469,0,0,3,0,0,1,0,0,0,12,1,1,0,4,0,1,1037979,"2023-12-22T00:00:00.000Z",290,26,"Trey Lyles",0,4,4,0,4,3.8
"10341",470,1,0,2,0,0,6,5,3,1,18,1,4,11,3,0,1,1037986,"2023-12-23T00:00:00.000Z",17896038,3,"Day'Ron Sharpe",0,14,15,12,4,15.1
"10342",471,5,0,6,1,1,3,2,0,0,19,0,1,5,6,1,1,1037986,"2023-12-23T00:00:00.000Z",351,3,"Royce O'Neale",1,11,16,10,11,21.7
"10343",472,3,0,0,2,1,6,2,2,1,19,0,3,6,0,0,1,1037986,"2023-12-23T00:00:00.000Z",421,3,"Dennis Smith Jr.",0,6,9,9,3,9.5
"10344",473,1,0,1,0,0,2,1,0,0,6,1,2,2,2,0,0,1037986,"2023-12-23T00:00:00.000Z",56677722,3,"Jalen Wilson",0,4,5,3,3,5.9
"10345",474,0,0,0,0,0,0,0,0,0,1,0,0,0,0,0,0,1037986,"2023-12-23T00:00:00.000Z",17896058,3,"Trendon Watford",0,0,0,0,0,0
"10346",475,0,0,0,0,0,0,0,0,0,1,0,0,0,0,0,0,1037986,"2023-12-23T00:00:00.000Z",174,3,"Harry Giles III",0,0,0,0,0,0
"10347",476,11,0,4,10,4,26,9,6,6,39,2,5,28,6,3,8,3277425,"2023-11-14T00:00:00.000Z",3547239,4,"LaMelo Ball",3,34,45,39,17,52.7
"10348",477,1,0,4,5,3,7,4,2,1,29,0,4,12,4,1,1,3277425,"2023-11-14T00:00:00.000Z",38017708,4,"Bryce McGowens",1,16,17,13,5,20.3
"10349",478,0,0,0,1,0,2,0,0,0,3,0,0,0,0,0,0,3277425,"2023-11-14T00:00:00.000Z",56677866,4,"Leaky Black",0,0,0,0,0,0
"10350",479,0,0,0,0,0,0,0,0,0,0,0,0,0,0,0,0,3277425,"2023-11-14T00:00:00.000Z",56677848,4,"Amari Bailey",0,0,0,0,0,0
"10351",480,1,1,1,2,0,3,1,0,0,16,0,2,2,1,0,0,3277427,"2023-11-14T00:00:00.000Z",108,23,"Robert Covington",1,3,4,3,2,7.7
"10352",481,3,0,7,1,0,17,11,1,0,37,0,3,22,7,1,1,3277427,"2023-11-14T00:00:00.000Z",200,23,"Tobias Harris",1,29,32,25,10,36.9
"10353",482,6,0,9,4,0,22,11,17,17,38,3,4,39,12,3,5,3277427,"2023-11-14T00:00:00.000Z",145,23,"Joel Embiid",3,51,57,45,18,66.4
"10354",483,3,0,5,2,0,11,5,4,4,36,0,4,14,5,1,0,3277427,"2023-11-14T00:00:00.000Z",69,12,"Bruce Brown",1,19,22,17,8,27.5
"10355",484,15,1,6,12,7,18,11,5,4,38,1,1,33,7,2,0,3277427,"2023-11-14T00:00:00.000Z",3547245,12,"Tyrese Haliburton",3,40,55,48,22,72.9
"10356",485,1,0,0,1,1,2,2,1,0,3,0,2,5,0,0,0,3277427,"2023-11-14T00:00:00.000Z",3547264,12,"Jalen Smith",0,5,6,6,1,6.5
"10357",486,1,0,2,3,0,5,1,0,0,29,0,2,2,2,1,5,3277427,"2023-11-14T00:00:00.000Z",210,12,"Buddy Hield",1,4,5,3,3,3.9
"10358",487,3,0,2,2,0,8,5,1,1,13,1,3,11,3,0,1,3277427,"2023-11-14T00:00:00.000Z",304,12,"T.J. McConnell",0,14,17,14,6,18.1
"10359",488,2,1,4,0,0,4,1,8,5,17,5,4,7,9,0,1,3277427,"2023-11-14T00:00:00.000Z",17896035,12,"Isaiah Jackson",1,16,18,9,11,22.8
"10360",489,3,0,1,0,0,3,1,0,0,19,1,1,2,2,0,3,3277425,"2023-11-14T00:00:00.000Z",422,4,"Ish Smith",0,4,7,5,5,5.9
"10361",490,0,0,2,1,1,2,1,0,0,15,0,1,3,2,0,0,3277425,"2023-11-14T00:00:00.000Z",56677846,4,"Nick Smith Jr.",0,5,5,3,2,5.4
"10362",491,0,0,0,0,0,0,0,0,0,0,0,0,0,0,0,0,3277425,"2023-11-14T00:00:00.000Z",17896037,4,"James Bouknight",0,0,0,0,0,0
"10363",492,0,0,0,0,0,0,0,0,0,0,0,0,0,0,0,0,3277425,"2023-11-14T00:00:00.000Z",62,4,"Miles Bridges",0,0,0,0,0,0
"10364",493,0,0,0,0,0,0,0,0,0,0,0,0,0,0,0,0,3277425,"2023-11-14T00:00:00.000Z",204,4,"Gordon Hayward",0,0,0,0,0,0
"10365",494,0,0,0,0,0,0,0,0,0,0,0,0,0,0,0,0,3277425,"2023-11-14T00:00:00.000Z",666748,4,"Cody Martin",0,0,0,0,0,0
"10366",495,0,0,0,0,0,0,0,0,0,0,0,0,0,0,0,0,3277425,"2023-11-14T00:00:00.000Z",56677823,4,"Brandon Miller",0,0,0,0,0,0
"10367",496,0,0,0,0,0,0,0,0,0,0,0,0,0,0,0,0,3277425,"2023-11-14T00:00:00.000Z",347,4,"Frank Ntilikina",0,0,0,0,0,0
"10368",497,0,0,0,0,0,0,0,0,0,0,0,0,0,0,0,0,3277425,"2023-11-14T00:00:00.000Z",403,4,"Terry Rozier",0,0,0,0,0,0
"10369",498,5,0,1,1,1,14,10,14,11,34,3,1,32,4,2,3,3277425,"2023-11-14T00:00:00.000Z",79,16,"Jimmy Butler",2,36,41,37,9,47.3
"10370",499,2,2,3,5,2,8,5,0,0,33,1,1,12,4,5,0,3277425,"2023-11-14T00:00:00.000Z",3092,16,"Haywood Highsmith",7,16,18,14,6,40.8
"10371",500,2,0,4,7,3,11,7,4,3,29,1,1,20,5,3,1,3277428,"2023-11-14T00:00:00.000Z",666679,3,"Cameron Johnson",3,25,27,22,7,37
"10372",501,0,0,0,0,0,0,0,0,0,0,0,0,0,0,0,0,1037997,"2023-12-25T00:00:00.000Z",56677873,7,"Dexter Dennis",0,0,0,0,0,0
"10373",502,0,0,0,0,0,0,0,0,0,0,0,0,0,0,0,0,1037997,"2023-12-25T00:00:00.000Z",3547258,7,"Josh Green",0,0,0,0,0,0
"10374",503,0,0,0,0,0,0,0,0,0,0,0,0,0,0,0,0,1037997,"2023-12-25T00:00:00.000Z",228,7,"Kyrie Irving",0,0,0,0,0,0
"10375",504,0,0,0,0,0,0,0,0,0,0,0,0,0,0,0,0,1037997,"2023-12-25T00:00:00.000Z",257,7,"Maxi Kleber",0,0,0,0,0,0
"10376",505,2,0,3,9,3,19,9,3,2,39,0,6,23,3,0,4,1037998,"2023-12-26T00:00:00.000Z",54,9,"Bojan Bogdanovic",0,26,28,25,5,25.6
"10377",506,4,0,7,2,1,7,2,4,2,36,4,2,7,11,0,0,1037998,"2023-12-26T00:00:00.000Z",3547267,9,"Isaiah Stewart",0,18,22,11,15,26.2
"10378",507,4,1,10,0,0,11,6,0,0,33,5,3,12,15,1,1,1037998,"2023-12-26T00:00:00.000Z",38017694,9,"Jalen Duren",2,27,31,16,19,41
"10379",508,4,1,1,2,0,12,3,6,3,28,2,5,9,3,3,1,1037998,"2023-12-26T00:00:00.000Z",38017682,9,"Jaden Ivey",4,12,16,13,7,29.6
"10380",509,5,1,8,4,3,21,15,10,8,37,1,4,41,9,1,3,1037998,"2023-12-26T00:00:00.000Z",17896075,9,"Cade Cunningham",2,50,55,46,14,62.3
"10381",510,0,0,4,6,2,11,4,6,5,25,1,1,15,5,0,2,1037998,"2023-12-26T00:00:00.000Z",77,9,"Alec Burks",0,20,20,15,5,19
"10382",511,0,0,0,0,0,0,0,0,0,0,0,0,0,0,0,0,1037998,"2023-12-26T00:00:00.000Z",24,9,"Marvin Bagley III",0,0,0,0,0,0
"10383",512,0,0,0,0,0,0,0,0,0,0,0,0,0,0,0,0,1037998,"2023-12-26T00:00:00.000Z",197,9,"Joe Harris",0,0,0,0,0,0
"10384",513,11,2,2,4,2,13,8,0,0,35,0,3,18,2,2,2,1037995,"2023-12-25T00:00:00.000Z",473,2,"Derrick White",4,20,31,29,13,46.9
"10385",514,7,1,5,5,3,10,7,1,1,38,2,1,18,7,1,2,1037995,"2023-12-25T00:00:00.000Z",214,2,"Jrue Holiday",2,25,32,25,14,40.9
"10386",515,0,0,1,4,0,5,1,0,0,15,1,0,2,2,0,0,1037995,"2023-12-25T00:00:00.000Z",17896060,2,"Sam Hauser",0,4,4,2,2,4.4
"10387",516,1,1,6,4,2,4,2,0,0,23,0,3,6,6,0,0,1037995,"2023-12-25T00:00:00.000Z",219,2,"Al Horford",1,12,13,7,7,17.7
"10388",517,0,0,0,6,2,8,4,0,0,13,2,1,10,2,0,0,1037995,"2023-12-25T00:00:00.000Z",3547276,2,"Payton Pritchard",0,12,12,10,2,12.4
"10389",518,1,0,1,0,0,0,0,0,0,7,0,3,0,1,1,0,1037995,"2023-12-25T00:00:00.000Z",17553967,2,"Neemias Queta",1,1,2,1,2,5.7
"10390",519,0,0,0,0,0,0,0,0,0,0,0,0,0,0,0,0,1037995,"2023-12-25T00:00:00.000Z",17896094,2,"Dalano Banton",0,0,0,0,0,0
"10391",520,1,0,4,5,3,8,6,2,0,19,0,1,15,4,0,0,1037999,"2023-12-26T00:00:00.000Z",17896045,30,"Corey Kispert",0,19,20,16,5,21.3
"10392",521,3,1,5,4,0,7,1,0,0,23,0,1,2,5,3,2,1037999,"2023-12-26T00:00:00.000Z",3547242,30,"Deni Avdija",4,7,10,5,8,22.5
"10393",522,6,1,3,8,2,18,6,3,3,36,1,5,17,4,0,6,1037999,"2023-12-26T00:00:00.000Z",265,30,"Kyle Kuzma",1,21,27,23,10,27.8
"10394",523,3,3,7,0,0,7,6,2,1,32,6,4,13,13,2,3,1037999,"2023-12-26T00:00:00.000Z",666577,30,"Daniel Gafford",5,26,29,16,16,45.1
"10395",524,3,0,2,11,6,20,11,2,2,33,0,3,30,2,3,3,1037999,"2023-12-26T00:00:00.000Z",666848,30,"Jordan Poole",3,32,35,33,5,42.9
"10396",525,6,1,6,6,4,13,8,2,2,34,0,0,22,6,1,2,1037999,"2023-12-26T00:00:00.000Z",249,30,"Tyus Jones",2,28,34,28,12,42.2
"10397",526,0,0,0,0,0,0,0,0,0,0,0,0,0,0,0,0,1037751,"2023-11-15T00:00:00.000Z",666754,1,"Garrison Mathews",0,0,0,0,0,0
"10398",527,0,0,0,0,0,0,0,0,0,0,0,0,0,0,0,0,1037751,"2023-11-15T00:00:00.000Z",319,1,"Patty Mills",0,0,0,0,0,0
"10399",528,0,0,0,0,0,0,0,0,0,0,0,0,0,0,0,0,1037751,"2023-11-15T00:00:00.000Z",56677838,1,"Kobe Bufkin",0,0,0,0,0,0
"10400",529,0,0,4,11,8,14,11,0,0,31,0,2,30,4,1,0,1037753,"2023-11-15T00:00:00.000Z",38,17,"Malik Beasley",1,34,34,30,4,37.8
"10401",530,13,0,4,10,4,18,9,16,15,31,0,1,37,4,2,4,1037753,"2023-11-15T00:00:00.000Z",278,17,"Damian Lillard",2,41,54,50,17,63.3
"10402",531,0,2,6,3,2,11,7,2,2,31,1,5,18,7,0,0,1037753,"2023-11-15T00:00:00.000Z",377,17,"Bobby Portis",2,25,25,18,7,32.4
"10403",532,0,0,6,3,1,3,1,0,0,23,1,2,3,7,0,1,1037753,"2023-11-15T00:00:00.000Z",105,17,"Pat Connaughton",0,10,10,3,7,10.4
"10404",533,1,0,0,0,0,3,2,0,0,10,0,2,4,0,1,0,1037753,"2023-11-15T00:00:00.000Z",38017676,17,"MarJon Beauchamp",1,4,5,5,1,8.5
"10405",534,0,0,0,0,0,5,1,0,0,15,2,3,2,2,0,0,1037753,"2023-11-15T00:00:00.000Z",2148,17,"Thanasis Antetokounmpo",0,4,4,2,2,4.4
"10406",535,2,0,1,4,3,8,4,2,2,16,0,2,13,1,0,0,1037753,"2023-11-15T00:00:00.000Z",368,17,"Cameron Payne",0,14,16,15,3,17.2
"10407",536,0,0,0,1,0,1,0,0,0,7,0,0,0,0,0,0,1037753,"2023-11-15T00:00:00.000Z",38017733,17,"A.J. Green",0,0,0,0,0,0
"10408",537,0,0,1,1,0,1,0,0,0,2,0,0,0,1,1,1,1037753,"2023-11-15T00:00:00.000Z",38017691,17,"TyTy Washington Jr.",1,1,1,0,1,3.2
"10409",538,0,0,0,1,0,1,0,0,0,2,0,1,0,0,0,1,1037753,"2023-11-15T00:00:00.000Z",666960,17,"Lindell Wigginton",0,0,0,0,0,-1
"10410",539,0,0,0,0,0,0,0,0,0,2,0,0,0,0,0,0,1037753,"2023-11-15T00:00:00.000Z",284,17,"Robin Lopez",0,0,0,0,0,0
"10411",540,0,0,0,0,0,0,0,0,0,0,0,0,0,0,0,0,1037753,"2023-11-15T00:00:00.000Z",15,17,"Giannis Antetokounmpo",0,0,0,0,0,0
"10412",541,0,0,0,0,0,0,0,0,0,0,0,0,0,0,0,0,1037753,"2023-11-15T00:00:00.000Z",666453,17,"Marques Bolden",0,0,0,0,0,0
"10413",542,0,0,0,0,0,0,0,0,0,0,0,0,0,0,0,0,1037753,"2023-11-15T00:00:00.000Z",112,17,"Jae Crowder",0,0,0,0,0,0
"10414",543,0,0,0,0,0,0,0,0,0,0,0,0,0,0,0,0,1037753,"2023-11-15T00:00:00.000Z",56677854,17,"Chris Livingston",0,0,0,0,0,0
"10415",544,3,0,3,2,0,8,3,0,0,22,1,1,6,4,2,4,1037751,"2023-11-15T00:00:00.000Z",131,20,"Donte DiVincenzo",2,10,13,9,7,17.3
"10416",545,4,0,0,5,3,11,6,6,5,28,0,3,20,0,1,2,1037751,"2023-11-15T00:00:00.000Z",3547269,20,"Immanuel Quickley",1,20,24,24,4,27
"10417",546,0,0,1,0,0,9,5,1,1,17,3,2,11,4,1,0,1037751,"2023-11-15T00:00:00.000Z",201,20,"Isaiah Hartenstein",1,15,15,11,4,18.8
"10418",547,0,0,0,0,0,0,0,0,0,1,0,1,0,0,0,0,1037751,"2023-11-15T00:00:00.000Z",17896033,20,"Miles McBride",0,0,0,0,0,0
"10419",548,0,0,0,0,0,0,0,0,0,0,0,0,0,0,0,0,1037751,"2023-11-15T00:00:00.000Z",160,20,"Evan Fournier",0,0,0,0,0,0
"10420",549,0,0,0,0,0,0,0,0,0,0,0,0,0,0,0,0,1037751,"2023-11-15T00:00:00.000Z",666675,20,"DaQuan Jeffries",0,0,0,0,0,0
"10421",550,0,0,0,0,0,0,0,0,0,0,0,0,0,0,0,0,1037751,"2023-11-15T00:00:00.000Z",17896063,20,"Jericho Sims",0,0,0,0,0,0
"10422",551,0,0,0,0,0,0,0,0,0,0,0,0,0,0,0,0,1038037,"2023-12-31T00:00:00.000Z",3547297,1,"Trent Forrest",0,0,0,0,0,0
"10423",552,0,0,0,0,0,0,0,0,0,0,0,0,0,0,0,0,1038030,"2023-12-29T00:00:00.000Z",17896022,13,"Brandon Boston Jr.",0,0,0,0,0,0
"10424",553,0,0,0,0,0,0,0,0,0,0,0,0,0,0,0,0,1038030,"2023-12-29T00:00:00.000Z",38017725,13,"Moussa Diabate",0,0,0,0,0,0
"10425",554,0,0,0,0,0,0,0,0,0,0,0,0,0,0,0,0,1038023,"2023-12-29T00:00:00.000Z",666564,1,"Bruno Fernando",0,0,0,0,0,0
"10426",555,0,0,0,0,0,0,0,0,0,0,0,0,0,0,0,0,1038023,"2023-12-29T00:00:00.000Z",3547297,1,"Trent Forrest",0,0,0,0,0,0
"10427",556,0,0,0,0,0,0,0,0,0,0,0,0,0,0,0,0,1038023,"2023-12-29T00:00:00.000Z",38017689,1,"AJ Griffin",0,0,0,0,0,0
"10428",557,0,0,0,0,0,0,0,0,0,0,0,0,0,0,0,0,1038023,"2023-12-29T00:00:00.000Z",301,1,"Wesley Matthews",0,0,0,0,0,0
"10429",558,0,0,0,0,0,0,0,0,0,0,0,0,0,0,0,0,1038023,"2023-12-29T00:00:00.000Z",56677838,1,"Kobe Bufkin",0,0,0,0,0,0
"10430",559,0,0,0,0,0,0,0,0,0,0,0,0,0,0,0,0,1038023,"2023-12-29T00:00:00.000Z",56677806,1,"Mouhamed Gueye",0,0,0,0,0,0
"10431",560,0,0,0,0,0,0,0,0,0,0,0,0,0,0,0,0,1038023,"2023-12-29T00:00:00.000Z",666656,1,"De'Andre Hunter",0,0,0,0,0,0
"10432",561,0,0,0,0,0,0,0,0,0,0,0,0,0,0,0,0,1038023,"2023-12-29T00:00:00.000Z",4197387,1,"Vit Krejci",0,0,0,0,0,0
"10433",562,0,0,0,0,0,0,0,0,0,0,0,0,0,0,0,0,1038023,"2023-12-29T00:00:00.000Z",56677855,1,"Seth Lundy",0,0,0,0,0,0
"10434",563,0,0,0,2,0,2,0,2,2,12,0,1,2,0,0,0,1038023,"2023-12-29T00:00:00.000Z",30,26,"Harrison Barnes",0,2,2,2,0,2
"10435",564,0,0,0,0,0,0,0,0,0,0,0,0,0,0,0,0,1038029,"2023-12-29T00:00:00.000Z",476,25,"Robert Williams III",0,0,0,0,0,0
"10436",565,0,1,1,4,1,5,1,5,4,12,2,1,7,3,1,1,1038029,"2023-12-29T00:00:00.000Z",38017649,27,"Julian Champagnie",2,10,10,7,3,15.6
"10437",566,4,0,3,0,0,3,0,2,2,29,1,2,2,4,1,3,1038029,"2023-12-29T00:00:00.000Z",38017699,27,"Jeremy Sochan",1,6,10,6,8,12.8
"10438",567,2,1,2,1,0,10,8,3,1,18,1,3,17,3,0,1,1038029,"2023-12-29T00:00:00.000Z",102,27,"Zach Collins",1,20,22,19,5,25.6
"10439",568,5,1,3,6,3,16,8,4,3,31,0,1,22,3,4,0,1038029,"2023-12-29T00:00:00.000Z",3547246,27,"Devin Vassell",5,25,30,27,8,48.1
"10440",569,3,0,3,3,1,12,5,0,0,29,3,1,11,6,1,3,1038029,"2023-12-29T00:00:00.000Z",38017692,27,"Malaki Branham",1,17,20,14,9,22.7
"10441",570,7,0,5,8,3,18,9,11,8,32,2,4,29,7,1,1,1038029,"2023-12-29T00:00:00.000Z",666682,27,"Keldon Johnson",1,36,43,36,14,49.9
"10442",571,2,0,1,4,3,6,5,0,0,31,1,0,13,2,1,0,1038030,"2023-12-29T00:00:00.000Z",666511,13,"Amir Coffey",1,15,17,15,4,21.4
"10443",572,3,0,6,8,2,21,8,6,5,36,1,6,23,7,1,4,1038030,"2023-12-29T00:00:00.000Z",172,13,"Paul George",1,30,33,26,10,34.9
"10444",573,1,1,14,0,0,8,7,1,1,33,6,3,15,20,0,2,1038030,"2023-12-29T00:00:00.000Z",493,13,"Ivica Zubac",1,35,36,16,21,41.5
"10445",574,2,0,2,6,0,10,3,6,5,23,1,1,11,3,1,0,1038030,"2023-12-29T00:00:00.000Z",666743,13,"Terance Mann",1,14,16,13,5,20.6
"10446",575,13,3,4,9,2,13,4,8,6,44,0,1,16,4,0,5,1038030,"2023-12-29T00:00:00.000Z",192,13,"James Harden",3,20,33,29,17,44.3
"10447",576,5,0,8,8,2,16,9,4,2,32,2,2,22,10,1,1,1037792,"2023-11-20T00:00:00.000Z",666682,27,"Keldon Johnson",1,32,37,27,15,43.5
"10448",577,4,2,3,4,0,12,4,1,1,26,0,1,9,3,0,2,1037792,"2023-11-20T00:00:00.000Z",56677822,27,"Victor Wembanyama",2,12,16,13,7,22.6
"10449",578,0,0,3,5,1,11,4,4,3,28,0,1,12,3,2,2,1037792,"2023-11-20T00:00:00.000Z",102,27,"Zach Collins",2,15,15,12,3,19.6
"10450",579,1,1,3,5,1,7,2,0,0,23,1,2,5,4,1,1,1037792,"2023-11-20T00:00:00.000Z",38017649,27,"Julian Champagnie",2,9,10,6,5,16.3
"10451",580,1,0,6,3,0,12,3,2,2,29,2,1,8,8,0,1,1037792,"2023-11-20T00:00:00.000Z",38017699,27,"Jeremy Sochan",0,16,17,9,9,18.1
"10452",581,0,0,0,0,0,0,0,0,0,0,0,0,0,0,0,0,3277481,"2023-11-21T00:00:00.000Z",260,23,"Furkan Korkmaz",0,0,0,0,0,0
"10453",582,0,0,0,0,0,0,0,0,0,0,0,0,0,0,0,0,3277481,"2023-11-21T00:00:00.000Z",3547294,23,"Kenyon Martin Jr.",0,0,0,0,0,0
"10454",583,0,0,0,0,0,0,0,0,0,0,0,0,0,0,0,0,3277481,"2023-11-21T00:00:00.000Z",56913527,23,"Ricky Council IV",0,0,0,0,0,0
"10455",584,1,0,2,2,1,7,3,0,0,27,2,2,7,4,1,3,3277480,"2023-11-21T00:00:00.000Z",666656,1,"De'Andre Hunter",1,11,12,8,5,13.3
"10456",585,6,1,6,2,0,12,6,5,5,33,1,2,17,7,2,1,3277480,"2023-11-21T00:00:00.000Z",17896040,1,"Jalen Johnson",3,24,30,23,13,42.4
"10457",586,1,2,2,0,0,9,6,3,2,19,3,4,14,5,0,1,3277480,"2023-11-21T00:00:00.000Z",83,1,"Clint Capela",2,19,20,15,6,26.5
"10458",587,5,0,2,6,4,20,11,2,2,34,1,3,28,3,2,5,3277480,"2023-11-21T00:00:00.000Z",334,1,"Dejounte Murray",2,31,36,33,8,40.1
"10459",588,8,0,1,8,5,17,13,8,7,39,0,3,38,1,3,3,3277480,"2023-11-21T00:00:00.000Z",490,1,"Trae Young",3,39,47,46,9,57.2
"10460",589,0,0,2,5,2,15,10,4,4,26,0,4,26,2,0,0,3277480,"2023-11-21T00:00:00.000Z",53,1,"Bogdan Bogdanovic",0,28,28,26,2,28.4
"10461",590,2,0,9,4,2,7,4,5,2,31,2,0,12,11,0,0,3277480,"2023-11-21T00:00:00.000Z",3547256,1,"Saddiq Bey",0,23,25,14,13,28.2
"10462",591,1,2,4,2,1,3,1,0,0,14,3,0,3,7,2,1,3277481,"2023-11-21T00:00:00.000Z",108,23,"Robert Covington",4,10,11,4,8,23.9
"10463",592,0,0,0,0,0,0,0,0,0,0,0,0,0,0,0,0,3277479,"2023-11-21T00:00:00.000Z",489,28,"Thaddeus Young",0,0,0,0,0,0
"10464",593,0,0,0,2,1,5,2,2,2,12,0,0,7,0,0,1,3277481,"2023-11-21T00:00:00.000Z",2175,23,"Danuel House Jr.",0,7,7,7,0,6
"10465",594,0,0,0,0,0,1,0,0,0,7,1,2,0,1,0,1,3277481,"2023-11-21T00:00:00.000Z",17896025,23,"Jaden Springer",0,1,1,0,1,0.2
"10466",595,0,0,1,0,0,4,2,0,0,9,2,1,4,3,1,0,3277481,"2023-11-21T00:00:00.000Z",3547270,23,"Paul Reed",1,7,7,4,3,10.6
"10467",596,0,0,0,0,0,0,0,0,0,3,0,0,0,0,0,0,3277481,"2023-11-21T00:00:00.000Z",328,23,"Marcus Morris",0,0,0,0,0,0
"10468",597,2,0,2,0,0,9,5,0,0,15,2,0,10,4,1,1,3277479,"2023-11-21T00:00:00.000Z",462,22,"Moritz Wagner",1,14,16,12,6,19.8
"10469",598,0,0,0,3,2,3,2,0,0,4,0,0,6,0,0,0,3277479,"2023-11-21T00:00:00.000Z",666818,22,"Chuma Okeke",0,6,6,6,0,6
"10470",599,0,0,0,0,0,0,0,0,0,2,0,0,0,0,0,0,3277479,"2023-11-21T00:00:00.000Z",666885,22,"Admiral Schofield",0,0,0,0,0,0
"10471",600,1,4,8,2,0,7,4,4,3,25,1,3,11,9,0,1,3277480,"2023-11-21T00:00:00.000Z",452,12,"Myles Turner",4,20,21,12,10,34.3
"10472",601,1,1,3,1,1,3,1,0,0,12,0,2,3,3,0,1,1038064,"2024-01-03T00:00:00.000Z",329,7,"Markieff Morris",1,6,7,4,4,10.1
"10473",602,1,1,2,6,1,10,4,3,2,11,0,0,11,2,0,0,1038064,"2024-01-03T00:00:00.000Z",38017679,7,"Jaden Hardy",1,13,14,12,3,17.9
"10474",603,0,0,0,1,1,4,1,0,0,8,0,1,3,0,1,0,1038064,"2024-01-03T00:00:00.000Z",17554004,7,"AJ Lawson",1,3,3,3,0,6
"10475",604,1,1,3,0,0,3,1,4,3,8,2,1,5,5,0,0,1038064,"2024-01-03T00:00:00.000Z",56677859,7,"Olivier-Maxence Prosper",1,10,11,6,6,15.5
"10476",605,0,0,1,0,0,1,0,2,0,6,1,0,0,2,1,0,1038064,"2024-01-03T00:00:00.000Z",24489167,7,"Brandon Williams",1,2,2,0,2,5.4
"10477",606,0,0,0,0,0,0,0,0,0,0,0,0,0,0,0,0,1038064,"2024-01-03T00:00:00.000Z",17896028,7,"Greg Brown III",0,0,0,0,0,0
"10478",607,2,0,2,3,0,6,2,1,1,17,0,1,5,2,0,0,1038064,"2024-01-03T00:00:00.000Z",65,25,"Malcolm Brogdon",0,7,9,7,4,10.4
"10479",608,0,0,0,0,0,0,0,0,0,0,0,0,0,0,0,0,1038062,"2024-01-03T00:00:00.000Z",401,15,"Derrick Rose",0,0,0,0,0,0
"10480",609,0,0,1,6,2,9,3,0,0,18,0,0,8,1,1,0,1038060,"2024-01-03T00:00:00.000Z",17895858,20,"Quentin Grimes",1,9,9,8,1,12.2
"10481",610,1,1,1,0,0,2,2,0,0,12,2,2,4,3,0,0,1038060,"2024-01-03T00:00:00.000Z",3547249,20,"Precious Achiuwa",1,7,8,5,4,12.1
"10482",611,0,0,0,0,0,0,0,0,0,1,0,0,0,0,0,0,1038060,"2024-01-03T00:00:00.000Z",19,20,"Ryan Arcidiacono",0,0,0,0,0,0
"10483",612,0,0,0,0,0,0,0,0,0,0,0,0,0,0,0,0,1038060,"2024-01-03T00:00:00.000Z",160,20,"Evan Fournier",0,0,0,0,0,0
"10484",613,0,0,0,0,0,0,0,0,0,0,0,0,0,0,0,0,1038060,"2024-01-03T00:00:00.000Z",173,20,"Taj Gibson",0,0,0,0,0,0
"10485",614,1,0,2,3,0,9,6,0,0,21,1,1,12,3,0,1,1038058,"2024-01-03T00:00:00.000Z",38017676,17,"MarJon Beauchamp",0,15,16,13,4,16.1
"10486",615,2,0,2,2,1,4,3,0,0,14,0,1,7,2,1,1,1038058,"2024-01-03T00:00:00.000Z",56677852,17,"Andre Jackson Jr.",1,9,11,9,4,14.4
"10487",616,1,0,2,1,0,2,1,0,0,6,0,4,2,2,0,2,1038064,"2024-01-03T00:00:00.000Z",56783340,25,"Duop Reath",0,4,5,3,3,3.9
"10488",617,0,0,3,5,1,12,6,3,3,22,1,3,16,4,0,0,1038064,"2024-01-03T00:00:00.000Z",38017690,25,"Shaedon Sharpe",0,20,20,16,4,20.8
"10489",618,4,0,4,1,0,3,1,2,2,17,1,2,4,5,0,1,1038064,"2024-01-03T00:00:00.000Z",38017711,25,"Jabari Walker",0,9,13,8,9,15
"10490",619,1,0,2,6,4,6,4,0,0,23,0,4,12,2,1,0,1038064,"2024-01-03T00:00:00.000Z",666923,25,"Matisse Thybulle",1,14,15,13,3,18.9
"10491",620,0,0,5,5,3,5,3,0,0,17,0,0,9,5,1,0,1038064,"2024-01-03T00:00:00.000Z",17896120,25,"Ish Wainright",1,14,14,9,5,18
"10492",621,2,0,1,1,0,4,1,0,0,15,0,0,2,1,0,0,1038064,"2024-01-03T00:00:00.000Z",56677791,25,"Kris Murray",0,3,5,4,3,6.2
"10493",622,1,0,4,0,0,4,2,2,1,8,1,0,5,5,0,1,1038064,"2024-01-03T00:00:00.000Z",3547289,25,"Skylar Mays",0,10,11,6,6,11.5
"10494",623,1,0,1,0,0,0,0,0,0,2,0,0,0,1,0,0,1038058,"2024-01-03T00:00:00.000Z",56677854,17,"Chris Livingston",0,1,2,1,2,2.7
"10495",624,0,0,1,0,0,0,0,0,0,2,0,0,0,1,0,0,1038058,"2024-01-03T00:00:00.000Z",284,17,"Robin Lopez",0,1,1,0,1,1.2
"10496",625,0,0,1,0,0,0,0,0,0,2,0,2,0,1,0,0,1038058,"2024-01-03T00:00:00.000Z",2148,17,"Thanasis Antetokounmpo",0,1,1,0,1,1.2
"10497",626,3,1,0,6,1,16,9,9,6,32,2,3,25,2,1,3,3277502,"2023-11-24T00:00:00.000Z",38017682,9,"Jaden Ivey",2,27,30,28,5,34.9
"10498",627,0,1,4,5,1,8,4,2,1,25,3,1,10,7,0,0,3277505,"2023-11-24T00:00:00.000Z",68,18,"Troy Brown Jr.",1,17,17,10,7,21.4
"10499",628,0,0,0,0,0,0,0,0,0,0,0,0,0,0,0,0,3277505,"2023-11-24T00:00:00.000Z",56677782,18,"Leonard Miller",0,0,0,0,0,0
"10500",629,0,0,4,6,3,10,6,3,3,28,0,2,18,4,0,0,3277502,"2023-11-24T00:00:00.000Z",210,12,"Buddy Hield",0,22,22,18,4,22.8
"10501",630,2,0,2,5,3,8,6,0,0,24,1,1,15,3,0,0,3277502,"2023-11-24T00:00:00.000Z",3547243,12,"Obi Toppin",0,18,20,17,5,21.6
"10502",631,2,5,5,3,1,14,8,6,6,27,5,5,23,10,1,2,3277502,"2023-11-24T00:00:00.000Z",452,12,"Myles Turner",6,33,35,25,12,54
"10503",632,5,0,4,3,0,10,3,5,4,37,0,3,10,4,3,0,3277502,"2023-11-24T00:00:00.000Z",69,12,"Bruce Brown",3,14,19,15,9,31.3
"10504",633,10,0,2,13,5,23,9,3,3,32,0,0,26,2,0,1,3277502,"2023-11-24T00:00:00.000Z",3547245,12,"Tyrese Haliburton",0,28,38,36,12,42.4
"10505",634,0,0,1,2,1,12,6,2,2,31,1,4,15,2,1,1,3277502,"2023-11-24T00:00:00.000Z",38017686,12,"Bennedict Mathurin",1,17,17,15,2,19.4
"10506",635,1,0,5,6,1,7,2,2,2,18,1,1,7,6,0,2,3277500,"2023-11-24T00:00:00.000Z",285,16,"Kevin Love",0,13,14,8,7,13.7
"10507",636,1,0,3,3,0,5,1,0,0,18,0,3,2,3,1,0,3277500,"2023-11-24T00:00:00.000Z",666747,16,"Caleb Martin",1,5,6,3,4,10.1
"10508",637,2,0,0,2,0,3,0,0,0,6,0,0,0,0,0,0,3277500,"2023-11-24T00:00:00.000Z",38017736,16,"Cole Swider",0,0,2,2,2,3
"10509",638,0,0,0,0,0,0,0,0,0,0,0,0,0,0,0,0,3277500,"2023-11-24T00:00:00.000Z",3547257,16,"R.J. Hampton",0,0,0,0,0,0
"10510",639,0,0,0,0,0,0,0,0,0,0,0,0,0,0,0,0,3277500,"2023-11-24T00:00:00.000Z",666633,16,"Tyler Herro",0,0,0,0,0,0
"10511",640,0,0,0,0,0,0,0,0,0,0,0,0,0,0,0,0,3277500,"2023-11-24T00:00:00.000Z",38017696,16,"Nikola Jovic",0,0,0,0,0,0
"10512",641,0,0,0,0,0,0,0,0,0,0,0,0,0,0,0,0,3277500,"2023-11-24T00:00:00.000Z",397,16,"Duncan Robinson",0,0,0,0,0,0
"10513",642,0,0,0,0,0,0,0,0,0,0,0,0,0,0,0,0,3277500,"2023-11-24T00:00:00.000Z",39398582,16,"Orlando Robinson",0,0,0,0,0,0
"10514",643,0,0,0,0,0,0,0,0,0,0,0,0,0,0,0,0,3277500,"2023-11-24T00:00:00.000Z",19465585,16,"Dru Smith",0,0,0,0,0,0
"10515",644,2,1,0,7,2,8,2,0,0,22,1,4,6,1,2,0,3277505,"2023-11-24T00:00:00.000Z",666400,18,"Nickeil Alexander-Walker",3,7,9,8,3,19.2
"10516",645,0,0,5,2,2,3,2,2,2,21,1,1,8,6,1,1,3277502,"2023-11-24T00:00:00.000Z",3547264,12,"Jalen Smith",1,14,14,8,6,17.2
"10517",646,4,0,10,5,4,15,9,5,5,38,1,3,27,11,0,4,3277505,"2023-11-24T00:00:00.000Z",447,18,"Karl-Anthony Towns",0,38,42,31,15,42.2
"10518",647,0,2,8,0,0,8,5,2,2,36,3,5,12,11,0,3,3277505,"2023-11-24T00:00:00.000Z",176,18,"Rudy Gobert",2,23,23,12,11,28.2
"10519",648,5,2,7,9,2,21,8,18,17,40,0,2,35,7,2,4,3277505,"2023-11-24T00:00:00.000Z",3547238,18,"Anthony Edwards",4,42,47,40,12,58.9
"10520",649,8,0,2,3,2,7,2,0,0,30,1,1,6,3,1,1,3277505,"2023-11-24T00:00:00.000Z",104,18,"Mike Conley",1,9,17,14,11,23.6
"10521",650,1,1,1,1,0,6,1,0,0,13,1,1,2,2,1,3,3277505,"2023-11-24T00:00:00.000Z",320,18,"Shake Milton",2,4,5,3,3,8.9
"10522",652,0,0,0,0,0,0,0,0,0,0,0,0,0,0,0,0,1038100,"2024-01-08T00:00:00.000Z",38017712,30,"Ryan Rollins",0,0,0,0,0,0
"10523",653,0,2,2,2,1,12,4,0,0,21,6,1,9,8,0,0,1038098,"2024-01-08T00:00:00.000Z",18678001,4,"JT Thor",2,17,17,9,8,24.6
"10524",654,0,0,0,0,0,0,0,0,0,0,0,0,0,0,0,0,1038098,"2024-01-08T00:00:00.000Z",56677848,4,"Amari Bailey",0,0,0,0,0,0
"10525",655,0,0,0,0,0,0,0,0,0,0,0,0,0,0,0,0,1038098,"2024-01-08T00:00:00.000Z",3547239,4,"LaMelo Ball",0,0,0,0,0,0
"10526",656,0,0,0,0,0,0,0,0,0,0,0,0,0,0,0,0,1038098,"2024-01-08T00:00:00.000Z",204,4,"Gordon Hayward",0,0,0,0,0,0
"10527",657,0,0,0,0,0,0,0,0,0,0,0,0,0,0,0,0,1038098,"2024-01-08T00:00:00.000Z",666748,4,"Cody Martin",0,0,0,0,0,0
"10528",658,0,0,0,0,0,0,0,0,0,0,0,0,0,0,0,0,1038098,"2024-01-08T00:00:00.000Z",666950,4,"P.J. Washington",0,0,0,0,0,0
"10529",659,0,0,0,0,0,0,0,0,0,0,0,0,0,0,0,0,1038098,"2024-01-08T00:00:00.000Z",38017698,4,"Mark Williams",0,0,0,0,0,0
"10530",660,7,1,7,3,1,16,7,4,3,44,0,0,18,7,3,2,1038098,"2024-01-08T00:00:00.000Z",125,5,"DeMar DeRozan",4,25,32,25,14,46.9
"10531",661,0,1,4,2,1,6,2,4,3,23,1,1,8,5,1,2,1038098,"2024-01-08T00:00:00.000Z",3547248,5,"Patrick Williams",2,13,13,8,5,18
"10532",662,0,0,10,0,0,12,9,3,3,22,5,1,21,15,0,2,1038098,"2024-01-08T00:00:00.000Z",137,5,"Andre Drummond",0,36,36,21,15,37
"10533",663,3,1,2,3,1,7,2,0,0,34,0,4,5,2,2,0,1038098,"2024-01-08T00:00:00.000Z",89,5,"Alex Caruso",3,7,10,8,5,20.9
"10534",664,4,0,4,2,1,11,5,4,3,39,0,1,14,4,1,2,1038101,"2024-01-08T00:00:00.000Z",56677785,16,"Jaime Jaquez Jr.",1,18,22,18,8,25.8
"10535",665,6,2,5,5,1,9,2,4,1,21,3,3,6,8,2,2,1038101,"2024-01-08T00:00:00.000Z",38017696,16,"Nikola Jovic",4,14,20,12,14,34.6
"10536",666,3,0,11,0,0,12,9,7,4,32,1,4,22,12,1,3,1038101,"2024-01-08T00:00:00.000Z",4,16,"Bam Adebayo",1,34,37,25,15,40.9
"10537",667,3,0,1,10,5,20,10,3,3,34,2,2,28,3,0,1,1038101,"2024-01-08T00:00:00.000Z",666633,16,"Tyler Herro",0,31,34,31,6,35.1
"10538",668,1,2,1,1,1,3,2,2,1,16,1,1,6,2,0,0,1038101,"2024-01-08T00:00:00.000Z",286,16,"Kyle Lowry",2,8,9,7,3,15.9
"10539",669,4,0,4,3,1,7,4,7,6,23,3,2,15,7,1,1,1038101,"2024-01-08T00:00:00.000Z",285,16,"Kevin Love",1,22,26,19,11,31.4
"10540",670,2,1,2,3,2,6,4,2,2,29,0,2,12,2,0,0,1038101,"2024-01-08T00:00:00.000Z",391,16,"Josh Richardson",1,14,16,14,4,20.4
"10541",671,5,0,6,7,3,19,10,5,4,42,0,3,27,6,0,1,1038098,"2024-01-08T00:00:00.000Z",666956,5,"Coby White",0,33,38,32,11,40.7
"10542",672,1,0,0,4,3,5,4,2,2,20,0,2,13,0,0,0,1038099,"2024-01-08T00:00:00.000Z",3547243,12,"Obi Toppin",0,13,14,14,1,14.5
"10543",673,0,0,0,0,0,0,0,0,0,0,0,0,0,0,0,0,1038099,"2024-01-08T00:00:00.000Z",3547207,12,"Jordan Nwora",0,0,0,0,0,0
"10544",674,0,0,0,0,0,0,0,0,0,0,0,0,0,0,0,0,1038099,"2024-01-08T00:00:00.000Z",56677861,12,"Ben Sheppard",0,0,0,0,0,0
"10545",675,0,0,0,0,0,0,0,0,0,0,0,0,0,0,0,0,1038099,"2024-01-08T00:00:00.000Z",56677832,12,"Jarace Walker",0,0,0,0,0,0
"10546",676,0,2,0,1,0,5,2,0,0,17,2,0,4,2,0,0,1037855,"2023-11-29T00:00:00.000Z",38017695,11,"Tari Eason",2,6,6,4,2,12.4
"10547",677,2,1,2,3,2,6,4,3,2,22,0,1,12,2,1,0,1037855,"2023-11-29T00:00:00.000Z",188,11,"Jeff Green",2,14,16,14,4,23.4
"10548",678,2,0,2,1,0,1,0,0,0,6,0,0,0,2,0,0,1037855,"2023-11-29T00:00:00.000Z",56677809,11,"Jermaine Samuels Jr.",0,2,4,2,4,5.4
"10549",679,0,0,2,2,1,4,3,2,1,6,0,1,8,2,0,0,1037855,"2023-11-29T00:00:00.000Z",56677831,11,"Cam Whitmore",0,10,10,8,2,10.4
"10550",680,1,0,0,0,0,2,1,0,0,6,0,1,2,0,0,0,1037855,"2023-11-29T00:00:00.000Z",47738533,11,"Jeenathan Williams",0,2,3,3,1,3.5
"10551",681,0,0,0,1,1,1,1,0,0,5,1,0,3,1,0,0,1037855,"2023-11-29T00:00:00.000Z",3547281,11,"Nate Hinton",0,4,4,3,1,4.2
"10552",682,0,0,0,0,0,0,0,0,0,0,0,0,0,0,0,0,1037855,"2023-11-29T00:00:00.000Z",296,11,"Boban Marjanovic",0,0,0,0,0,0
"10553",683,0,0,0,0,0,0,0,0,0,0,0,0,0,0,0,0,1037855,"2023-11-29T00:00:00.000Z",357,11,"Victor Oladipo",0,0,0,0,0,0
"10554",684,0,0,0,0,0,0,0,0,0,0,0,0,0,0,0,0,1037855,"2023-11-29T00:00:00.000Z",3547301,11,"Jae'Sean Tate",0,0,0,0,0,0
"10555",685,0,0,0,0,0,0,0,0,0,0,0,0,0,0,0,0,1037855,"2023-11-29T00:00:00.000Z",56677825,11,"Amen Thompson",0,0,0,0,0,0
"10556",686,3,0,7,1,0,18,9,20,18,38,3,1,36,10,0,3,1037859,"2023-11-30T00:00:00.000Z",79,16,"Jimmy Butler",0,46,49,39,13,49.5
"10557",687,1,0,1,1,0,2,1,0,0,15,0,4,2,1,0,1,1037859,"2023-11-30T00:00:00.000Z",3092,16,"Haywood Highsmith",0,3,4,3,2,3.7
"10558",688,2,0,4,0,0,9,3,2,1,12,0,1,7,4,0,0,1037859,"2023-11-30T00:00:00.000Z",4,16,"Bam Adebayo",0,11,13,9,6,14.8
"10559",689,2,0,0,9,3,18,6,0,0,28,6,1,15,6,0,2,1037858,"2023-11-30T00:00:00.000Z",666679,3,"Cameron Johnson",0,21,23,17,8,23.2
"10560",690,1,1,3,6,4,7,5,0,0,39,3,0,14,6,2,1,1037858,"2023-11-30T00:00:00.000Z",158,3,"Dorian Finney-Smith",3,20,21,15,7,30.7
"10561",691,2,2,5,0,0,13,9,2,2,30,9,1,20,14,1,1,1037858,"2023-11-30T00:00:00.000Z",666508,3,"Nicolas Claxton",3,34,36,22,16,47.8
"10562",692,2,0,1,6,4,9,5,2,2,29,0,3,16,1,1,1,1037859,"2023-11-30T00:00:00.000Z",397,16,"Duncan Robinson",1,17,19,18,3,22.2
"10563",693,3,1,2,6,3,10,6,0,0,26,1,5,15,3,0,0,1037859,"2023-11-30T00:00:00.000Z",286,16,"Kyle Lowry",1,18,21,18,6,26.1
"10564",694,3,0,3,2,0,11,8,4,3,32,1,3,19,4,0,2,1037859,"2023-11-30T00:00:00.000Z",391,16,"Josh Richardson",0,23,26,22,7,26.3
"10565",695,1,0,5,3,1,13,8,7,7,33,0,3,24,5,1,3,1037859,"2023-11-30T00:00:00.000Z",56677785,16,"Jaime Jaquez Jr.",1,29,30,25,6,31.5
"10566",696,6,0,7,0,0,1,1,4,3,17,1,2,5,8,1,0,1037859,"2023-11-30T00:00:00.000Z",285,16,"Kevin Love",1,13,19,11,14,26.6
"10567",697,4,0,9,5,2,22,9,3,2,38,0,1,22,9,1,2,1037858,"2023-11-30T00:00:00.000Z",61,3,"Mikal Bridges",1,31,35,26,13,39.8
"10568",698,8,0,4,6,1,9,3,2,2,34,0,1,9,4,0,1,1037858,"2023-11-30T00:00:00.000Z",130,3,"Spencer Dinwiddie",0,13,21,17,12,24.8
"10569",699,0,0,3,0,0,5,4,3,1,18,2,3,9,5,2,0,1037858,"2023-11-30T00:00:00.000Z",17896038,3,"Day'Ron Sharpe",2,14,14,9,5,21
"10570",700,1,1,2,5,2,21,11,3,2,25,0,1,26,2,0,1,1037858,"2023-11-30T00:00:00.000Z",17896048,3,"Cam Thomas",1,28,29,27,3,31.9
"10571",701,2,0,1,5,3,12,5,0,0,19,2,2,13,3,0,1,1038129,"2024-01-12T00:00:00.000Z",17896027,15,"Ziaire Williams",0,16,18,15,5,18.6
"10572",702,4,0,5,5,3,11,7,0,0,27,1,3,17,6,1,2,1038129,"2024-01-12T00:00:00.000Z",38017729,15,"David Roddy",1,23,27,21,10,31.2
"10573",703,1,0,1,1,0,1,0,0,0,6,0,1,0,1,0,0,1038129,"2024-01-12T00:00:00.000Z",666703,15,"John Konchar",0,1,2,1,2,2.7
"10574",704,8,0,1,2,0,2,0,0,0,20,0,1,0,1,0,1,1038129,"2024-01-12T00:00:00.000Z",48248287,15,"Jacob Gilyard",0,1,9,8,9,12.2
"10575",705,1,1,2,4,2,10,5,0,0,20,2,4,12,4,0,0,1038129,"2024-01-12T00:00:00.000Z",38017728,15,"Jake LaRavia",1,16,17,13,5,21.3
"10576",706,1,0,2,1,0,5,1,3,2,9,3,1,4,5,0,0,1038129,"2024-01-12T00:00:00.000Z",56677830,15,"GG Jackson",0,9,10,5,6,11.5
"10577",707,0,0,0,0,0,0,0,0,0,0,0,0,0,0,0,0,1038129,"2024-01-12T00:00:00.000Z",17896067,15,"Santi Aldama",0,0,0,0,0,0
"10578",708,2,0,1,1,0,6,4,1,1,25,0,2,9,1,1,2,1038127,"2024-01-12T00:00:00.000Z",391,16,"Josh Richardson",1,10,12,11,3,14.2
"10579",709,1,0,2,4,1,6,2,1,0,16,1,3,5,3,1,1,1038127,"2024-01-12T00:00:00.000Z",285,16,"Kevin Love",1,8,9,6,4,12.1
"10580",710,2,0,4,2,1,6,3,4,4,24,0,1,11,4,1,0,1038127,"2024-01-12T00:00:00.000Z",666747,16,"Caleb Martin",1,15,17,13,6,21.8
"10581",711,0,0,0,0,0,0,0,0,0,0,0,0,0,0,0,0,1038127,"2024-01-12T00:00:00.000Z",39398582,16,"Orlando Robinson",0,0,0,0,0,0
"10582",712,0,0,0,0,0,0,0,0,0,0,0,0,0,0,0,0,1038127,"2024-01-12T00:00:00.000Z",79,16,"Jimmy Butler",0,0,0,0,0,0
"10583",713,0,0,0,0,0,0,0,0,0,0,0,0,0,0,0,0,1038127,"2024-01-12T00:00:00.000Z",666633,16,"Tyler Herro",0,0,0,0,0,0
"10584",714,0,0,0,0,0,0,0,0,0,0,0,0,0,0,0,0,1038127,"2024-01-12T00:00:00.000Z",286,16,"Kyle Lowry",0,0,0,0,0,0
"10585",715,0,0,0,0,0,0,0,0,0,0,0,0,0,0,0,0,1038127,"2024-01-12T00:00:00.000Z",19465585,16,"Dru Smith",0,0,0,0,0,0
"10586",716,0,0,0,0,0,0,0,0,0,0,0,0,0,0,0,0,1038127,"2024-01-12T00:00:00.000Z",38017736,16,"Cole Swider",0,0,0,0,0,0
"10587",717,3,0,1,9,3,9,3,0,0,32,1,4,9,2,0,0,1038127,"2024-01-12T00:00:00.000Z",38017724,22,"Caleb Houstan",0,11,14,12,5,15.9
"10588",718,6,0,5,7,1,26,10,6,4,36,3,2,25,8,0,4,1038127,"2024-01-12T00:00:00.000Z",38017683,22,"Paolo Banchero",0,33,39,31,14,39.6
"10589",719,1,1,9,0,0,1,1,2,0,20,0,1,2,9,1,0,1038127,"2024-01-12T00:00:00.000Z",666442,22,"Goga Bitadze",2,11,12,3,10,20.3
"10590",720,0,0,0,0,0,0,0,0,0,0,0,0,0,0,0,0,1038127,"2024-01-12T00:00:00.000Z",85,22,"Wendell Carter Jr.",0,0,0,0,0,0
"10591",721,3,1,2,2,0,10,0,5,5,29,0,0,5,2,0,3,1038130,"2024-01-12T00:00:00.000Z",419,25,"Anfernee Simons",1,7,10,8,5,11.9
"10592",722,3,0,2,5,2,7,2,4,3,26,0,1,9,2,0,1,1038130,"2024-01-12T00:00:00.000Z",65,25,"Malcolm Brogdon",0,11,14,12,5,14.9
"10593",723,0,1,3,0,0,1,1,0,0,9,3,3,2,6,0,1,1038130,"2024-01-12T00:00:00.000Z",39613724,25,"Ibou Badji",1,8,8,2,6,11.2
"10594",724,0,0,0,0,0,0,0,0,0,0,0,0,0,0,0,0,1038129,"2024-01-12T00:00:00.000Z",3,15,"Steven Adams",0,0,0,0,0,0
"10595",725,0,2,7,0,0,5,2,2,2,22,4,3,6,11,0,0,1038129,"2024-01-12T00:00:00.000Z",493,13,"Ivica Zubac",2,17,17,6,11,25.2
"10596",726,0,0,0,0,0,0,0,0,0,0,0,0,0,0,0,0,7050283,"2023-12-08T00:00:00.000Z",17896073,22,"Jalen Suggs",0,0,0,0,0,0
"10597",727,1,0,3,3,1,10,4,1,0,29,0,1,9,3,1,2,7050283,"2023-12-08T00:00:00.000Z",54,9,"Bojan Bogdanovic",1,12,13,10,4,15.1
"10598",728,3,1,6,3,1,3,1,0,0,29,1,3,3,7,0,1,7050283,"2023-12-08T00:00:00.000Z",3547267,9,"Isaiah Stewart",1,10,13,6,10,17.9
"10599",729,3,1,2,1,0,10,6,2,2,28,0,0,14,2,1,1,7050285,"2023-12-08T00:00:00.000Z",249,30,"Tyus Jones",2,16,19,17,5,25.9
"10600",730,2,0,6,2,1,6,4,4,2,25,4,3,11,10,0,2,7050285,"2023-12-08T00:00:00.000Z",56677844,30,"Bilal Coulibaly",0,21,23,13,12,24
"10601",731,1,0,2,5,0,9,2,0,0,19,0,3,4,2,0,0,7050285,"2023-12-08T00:00:00.000Z",167,30,"Danilo Gallinari",0,6,7,5,3,7.9
"10602",732,2,1,2,7,1,11,3,0,0,21,0,2,7,2,0,0,7050285,"2023-12-08T00:00:00.000Z",17896045,30,"Corey Kispert",1,9,11,9,4,15.4
"10603",733,0,0,3,2,0,4,1,4,3,14,0,1,5,3,0,3,7050285,"2023-12-08T00:00:00.000Z",18677954,30,"Jared Butler",0,8,8,5,3,5.6
"10604",734,0,0,0,3,2,3,2,2,2,15,0,1,8,0,1,1,7050285,"2023-12-08T00:00:00.000Z",337,30,"Mike Muscala",1,8,8,8,0,10
"10605",735,0,0,2,0,0,3,0,0,0,4,2,1,0,4,0,0,7050285,"2023-12-08T00:00:00.000Z",38017704,30,"Patrick Baldwin Jr.",0,4,4,0,4,4.8
"10606",736,0,0,0,1,0,4,1,0,0,4,3,1,2,3,0,0,7050285,"2023-12-08T00:00:00.000Z",3547302,30,"Anthony Gill",0,5,5,2,3,5.6
"10607",738,0,1,1,1,0,2,1,1,1,4,0,0,3,1,0,1,7050285,"2023-12-08T00:00:00.000Z",17896106,30,"Eugene Omoruyi",1,4,4,3,1,6.2
"10608",739,0,0,0,0,0,0,0,0,0,0,0,0,0,0,0,0,7050285,"2023-12-08T00:00:00.000Z",38017687,30,"Johnny Davis",0,0,0,0,0,0
"10609",740,0,0,0,0,0,0,0,0,0,0,0,0,0,0,0,0,7050285,"2023-12-08T00:00:00.000Z",38017712,30,"Ryan Rollins",0,0,0,0,0,0
"10610",741,0,0,0,0,0,0,0,0,0,0,0,0,0,0,0,0,7050285,"2023-12-08T00:00:00.000Z",414,30,"Landry Shamet",0,0,0,0,0,0
"10611",742,0,0,0,0,0,0,0,0,0,0,0,0,0,0,0,0,7050285,"2023-12-08T00:00:00.000Z",487,30,"Delon Wright",0,0,0,0,0,0
"10612",743,5,0,1,4,0,10,3,1,1,30,0,4,7,1,1,2,7050282,"2023-12-08T00:00:00.000Z",409,28,"Dennis Schroder",1,8,13,12,6,16.7
"10613",744,2,0,2,3,0,7,0,0,0,20,0,0,0,2,0,0,7050282,"2023-12-08T00:00:00.000Z",3089,28,"Gary Trent Jr.",0,2,4,2,4,5.4
"10614",745,1,0,6,4,3,10,7,0,0,22,4,4,17,10,0,4,7050282,"2023-12-08T00:00:00.000Z",3547249,28,"Precious Achiuwa",0,27,28,18,11,26.5
"10615",746,4,0,0,4,0,7,3,2,2,18,0,1,8,0,2,1,7050282,"2023-12-08T00:00:00.000Z",3547275,28,"Malachi Flynn",2,8,12,12,4,19
"10616",747,1,0,0,1,0,1,0,0,0,6,0,0,0,0,0,0,7050282,"2023-12-08T00:00:00.000Z",376,28,"Otto Porter Jr.",0,0,1,1,1,1.5
"10617",748,0,1,2,3,0,9,4,1,1,13,1,4,9,3,0,1,7050282,"2023-12-08T00:00:00.000Z",58,28,"Chris Boucher",1,12,12,9,3,14.6
"10618",749,1,1,1,3,0,9,4,8,8,39,4,4,16,5,0,1,7050288,"2023-12-08T00:00:00.000Z",666541,21,"Luguentz Dort",1,21,22,17,6,25.5
"10619",750,2,1,5,1,1,15,12,4,3,40,0,3,28,5,3,1,7050288,"2023-12-08T00:00:00.000Z",38017703,21,"Jalen Williams",4,33,35,30,7,48
"10620",751,6,1,7,3,1,14,8,2,2,31,0,2,19,7,1,2,1037641,"2023-10-30T00:00:00.000Z",38017703,21,"Jalen Williams",2,26,32,25,13,40.4
"10621",752,3,4,4,5,4,5,4,2,2,24,0,5,14,4,2,3,1037641,"2023-10-30T00:00:00.000Z",38017685,21,"Chet Holmgren",6,18,21,17,7,38.3
"10622",753,3,1,4,2,0,18,9,5,3,28,3,1,21,7,1,1,1037641,"2023-10-30T00:00:00.000Z",17896065,21,"Josh Giddey",2,28,31,24,10,38.9
"10623",754,0,0,0,0,0,0,0,0,0,0,0,0,0,0,0,0,1037633,"2023-10-30T00:00:00.000Z",56677843,3,"Noah Clowney",0,0,0,0,0,0
"10624",755,0,0,0,0,0,0,0,0,0,0,0,0,0,0,0,0,1037633,"2023-10-30T00:00:00.000Z",666679,3,"Cameron Johnson",0,0,0,0,0,0
"10625",756,0,0,0,0,0,0,0,0,0,0,0,0,0,0,0,0,1037633,"2023-10-30T00:00:00.000Z",56677841,3,"Dariq Whitehead",0,0,0,0,0,0
"10626",757,0,0,0,0,0,0,0,0,0,0,0,0,0,0,0,0,1037633,"2023-10-30T00:00:00.000Z",56677722,3,"Jalen Wilson",0,0,0,0,0,0
"10627",758,4,0,8,3,1,23,11,9,9,33,1,2,32,9,3,5,1037641,"2023-10-30T00:00:00.000Z",175,21,"Shai Gilgeous-Alexander",3,41,45,36,13,52.8
"10628",759,1,3,8,0,0,0,0,4,2,21,1,2,2,9,0,0,1037641,"2023-10-30T00:00:00.000Z",24572055,21,"Olivier Sarr",3,11,12,3,10,23.3
"10629",760,0,0,1,2,1,2,1,3,3,13,0,1,6,1,0,0,1037641,"2023-10-30T00:00:00.000Z",44,21,"Davis Bertans",0,7,7,6,1,7.2
"10630",761,0,0,0,5,3,6,3,0,0,20,0,1,9,0,0,1,1037641,"2023-10-30T00:00:00.000Z",3547272,21,"Isaiah Joe",0,9,9,9,0,8
"10631",762,2,0,4,1,0,2,1,2,2,22,0,2,4,4,0,1,1037641,"2023-10-30T00:00:00.000Z",56677833,21,"Cason Wallace",0,8,10,6,6,10.8
"10632",763,2,0,0,2,2,4,4,1,0,18,1,0,10,1,0,1,1037641,"2023-10-30T00:00:00.000Z",38017716,21,"Ousmane Dieng",0,11,13,12,3,13.2
"10633",764,0,0,0,0,0,0,0,0,0,2,0,0,0,0,0,0,1037641,"2023-10-30T00:00:00.000Z",17896036,21,"Tre Mann",0,0,0,0,0,0
"10634",765,0,0,0,0,0,0,0,0,0,0,0,0,0,0,0,0,1037641,"2023-10-30T00:00:00.000Z",4197029,21,"Vasilije Micic",0,0,0,0,0,0
"10635",766,5,0,2,7,3,15,5,5,4,36,0,1,17,2,0,7,1037641,"2023-10-30T00:00:00.000Z",17896075,9,"Cade Cunningham",0,19,24,22,7,19.9
"10636",767,7,0,1,4,3,9,4,0,0,21,1,3,11,2,0,0,1037641,"2023-10-30T00:00:00.000Z",77,9,"Alec Burks",0,13,20,18,9,23.9
"10637",768,1,0,3,0,0,4,3,8,7,24,1,1,13,4,0,0,1037641,"2023-10-30T00:00:00.000Z",24,9,"Marvin Bagley III",0,17,18,14,5,19.3
"10638",769,3,1,1,6,4,13,7,2,2,19,1,5,20,2,1,1,1037641,"2023-10-30T00:00:00.000Z",38017682,9,"Jaden Ivey",2,22,25,23,5,31.9
"10639",770,1,1,3,9,2,12,4,0,0,30,0,0,10,3,2,2,1037637,"2023-10-30T00:00:00.000Z",18,28,"OG Anunoby",3,13,14,11,4,22.1
"10640",771,3,0,5,6,0,21,9,3,2,35,1,1,20,6,1,0,1037637,"2023-10-30T00:00:00.000Z",416,28,"Pascal Siakam",1,26,29,23,9,34.7
"10641",772,1,1,5,0,0,8,6,3,2,29,5,3,14,10,0,2,1037637,"2023-10-30T00:00:00.000Z",373,28,"Jakob Poeltl",1,24,25,15,11,28.5
"10642",773,2,1,8,4,1,19,8,3,3,37,4,3,20,12,2,4,1037637,"2023-10-30T00:00:00.000Z",17896055,28,"Scottie Barnes",3,32,34,22,14,42.4
"10643",774,8,0,1,3,1,10,4,1,1,32,0,1,10,1,1,1,1037637,"2023-10-30T00:00:00.000Z",409,28,"Dennis Schroder",1,11,19,18,9,25.2
"10644",775,0,0,5,3,0,7,2,0,0,21,1,3,4,6,2,0,1037637,"2023-10-30T00:00:00.000Z",56677828,28,"Gradey Dick",2,10,10,4,6,17.2
"10645",776,8,1,4,12,4,16,6,2,2,26,0,0,18,4,0,1,1037934,"2023-12-16T00:00:00.000Z",324,26,"Malik Monk",1,22,30,26,12,36.8
"10646",777,0,0,0,0,0,3,2,0,0,4,0,1,4,0,0,1,1037934,"2023-12-16T00:00:00.000Z",306,26,"JaVale McGee",0,4,4,4,0,3
"10647",778,2,0,4,2,1,3,1,0,0,11,0,0,3,4,0,0,1037934,"2023-12-16T00:00:00.000Z",4197162,26,"Aleksandar Vezenkov",0,7,9,5,6,10.8
"10648",779,1,0,0,1,0,5,2,0,0,18,0,3,4,0,0,0,1037934,"2023-12-16T00:00:00.000Z",17553994,26,"Davion Mitchell",0,4,5,5,1,5.5
"10649",780,4,0,6,6,5,16,12,7,7,30,1,1,36,7,2,0,1037935,"2023-12-16T00:00:00.000Z",274,13,"Kawhi Leonard",2,43,47,40,11,56.4
"10650",781,7,0,4,6,3,18,11,0,0,31,0,4,25,4,2,2,1037935,"2023-12-16T00:00:00.000Z",172,13,"Paul George",2,29,36,32,11,44.3
"10651",782,2,2,7,0,0,9,5,4,3,28,4,2,13,11,1,0,1037935,"2023-12-16T00:00:00.000Z",493,13,"Ivica Zubac",3,24,26,15,13,38.2
"10652",783,4,0,1,4,2,8,4,3,3,27,0,1,13,1,0,0,1037935,"2023-12-16T00:00:00.000Z",666743,13,"Terance Mann",0,14,18,17,5,20.2
"10653",784,12,2,4,4,1,6,2,7,5,28,0,3,10,4,1,1,1037935,"2023-12-16T00:00:00.000Z",192,13,"James Harden",3,14,26,22,16,40.8
"10654",785,0,1,2,2,1,10,6,3,3,24,0,1,16,2,0,1,1037935,"2023-12-16T00:00:00.000Z",380,13,"Norman Powell",1,18,18,16,2,20.4
"10655",786,0,0,1,3,1,3,1,0,0,17,0,3,3,1,0,0,1037935,"2023-12-16T00:00:00.000Z",666511,13,"Amir Coffey",0,4,4,3,1,4.2
"10656",787,0,0,1,0,0,3,1,6,5,15,0,4,7,1,1,0,1037935,"2023-12-16T00:00:00.000Z",439,13,"Daniel Theis",1,8,8,7,1,11.2
"10657",788,2,0,2,3,1,3,1,0,0,5,0,1,3,2,0,0,1037935,"2023-12-16T00:00:00.000Z",17896022,13,"Brandon Boston Jr.",0,5,7,5,4,8.4
"10658",789,0,0,1,0,0,0,0,0,0,5,0,0,0,1,0,1,1037935,"2023-12-16T00:00:00.000Z",56677856,13,"Jordan Miller",0,1,1,0,1,0.2
"10659",790,0,1,0,1,0,2,1,0,0,5,0,0,2,0,0,3,1037935,"2023-12-16T00:00:00.000Z",17896051,13,"Joshua Primo",1,2,2,2,0,2
"10660",791,1,0,2,0,0,0,0,0,0,5,0,0,0,2,0,0,1037935,"2023-12-16T00:00:00.000Z",24417679,13,"Xavier Moon",0,2,3,1,3,3.9
"10661",792,0,0,0,3,2,3,2,0,0,5,0,0,6,0,0,0,1037935,"2023-12-16T00:00:00.000Z",56677849,13,"Kobe Brown",0,6,6,6,0,6
"10662",793,0,0,2,5,1,9,3,0,0,25,0,0,7,2,0,0,1037934,"2023-12-16T00:00:00.000Z",38017739,29,"Simone Fontecchio",0,9,9,7,2,9.4
"10663",794,3,0,5,5,2,13,7,2,2,28,1,2,18,6,0,2,1037934,"2023-12-16T00:00:00.000Z",297,29,"Lauri Markkanen",0,24,27,21,9,27.7
"10664",795,13,1,5,2,1,7,4,0,0,29,0,3,9,5,1,1,1037934,"2023-12-16T00:00:00.000Z",358,29,"Kelly Olynyk",2,14,27,22,18,39.5
"10665",796,1,0,2,6,2,18,10,7,6,33,1,2,28,3,1,1,1037934,"2023-12-16T00:00:00.000Z",413,29,"Collin Sexton",1,31,32,29,4,35.1
"10666",797,3,1,3,4,1,10,5,0,0,27,1,1,11,4,1,6,1037934,"2023-12-16T00:00:00.000Z",139,29,"Kris Dunn",2,15,18,14,7,20.3
"10667",798,1,1,2,0,0,0,0,4,2,19,1,2,2,3,0,1,1037934,"2023-12-16T00:00:00.000Z",38017705,29,"Walker Kessler",1,5,6,3,4,9.1
"10668",799,5,0,2,4,2,11,4,3,2,26,1,0,12,3,3,1,1037934,"2023-12-16T00:00:00.000Z",666650,29,"Talen Horton-Tucker",3,15,20,17,8,31.1
"10669",800,0,0,1,3,1,7,2,0,0,23,3,2,5,4,1,0,1037934,"2023-12-16T00:00:00.000Z",38017620,29,"Ochai Agbaji",1,9,9,5,4,12.8
"10670",801,0,0,0,0,0,0,0,0,0,0,0,0,0,0,0,0,1037694,"2023-11-06T00:00:00.000Z",38017689,1,"AJ Griffin",0,0,0,0,0,0
"10671",802,5,0,5,0,0,4,3,3,2,30,3,4,8,8,0,4,1037692,"2023-11-06T00:00:00.000Z",406,26,"Domantas Sabonis",0,16,21,13,13,21.1
"10672",803,2,0,3,8,3,10,5,1,0,25,0,0,13,3,1,3,1037692,"2023-11-06T00:00:00.000Z",221,26,"Kevin Huerter",1,16,18,15,5,19.6
"10673",804,2,1,0,5,1,11,2,0,0,27,1,2,5,1,0,0,1037692,"2023-11-06T00:00:00.000Z",17553994,26,"Davion Mitchell",1,6,8,7,3,12.2
"10674",805,6,0,1,4,2,13,5,0,0,33,0,2,12,1,2,0,1037687,"2023-11-06T00:00:00.000Z",249,30,"Tyus Jones",2,13,19,18,7,28.2
"10675",806,0,1,3,3,1,7,3,3,3,19,0,3,10,3,0,0,1037687,"2023-11-06T00:00:00.000Z",56677844,30,"Bilal Coulibaly",1,13,13,10,3,16.6
"10676",807,1,1,4,6,2,14,5,10,8,36,1,5,20,5,1,1,1037693,"2023-11-06T00:00:00.000Z",378,2,"Kristaps Porzingis",2,25,26,21,6,32.5
"10677",808,4,0,7,8,3,21,10,4,3,39,0,5,26,7,1,3,1037693,"2023-11-06T00:00:00.000Z",70,2,"Jaylen Brown",1,33,37,30,11,40.4
"10678",809,6,0,8,4,0,16,4,6,4,42,3,3,12,11,1,3,1037693,"2023-11-06T00:00:00.000Z",214,2,"Jrue Holiday",1,23,29,18,17,34.2
"10679",810,0,0,1,0,0,1,0,0,0,4,0,0,0,1,1,0,1037693,"2023-11-06T00:00:00.000Z",3547279,2,"Lamar Stevens",1,1,1,0,1,4.2
"10680",811,0,1,3,8,3,8,3,2,2,25,1,3,11,4,1,1,1037693,"2023-11-06T00:00:00.000Z",17896060,2,"Sam Hauser",2,15,15,11,4,20.8
"10681",812,3,0,3,1,0,3,0,0,0,20,3,2,0,6,0,0,1037693,"2023-11-06T00:00:00.000Z",3547276,2,"Payton Pritchard",0,6,9,3,9,11.7
"10682",813,0,0,8,1,0,8,3,1,1,25,6,3,7,14,0,2,1037694,"2023-11-06T00:00:00.000Z",3547244,1,"Onyeka Okongwu",0,21,21,7,14,21.8
"10683",814,0,0,0,0,0,0,0,0,0,0,0,0,0,0,0,0,1037694,"2023-11-06T00:00:00.000Z",319,1,"Patty Mills",0,0,0,0,0,0
"10684",815,0,0,0,0,0,0,0,0,0,0,0,0,0,0,0,0,1037694,"2023-11-06T00:00:00.000Z",56677838,1,"Kobe Bufkin",0,0,0,0,0,0
"10685",816,0,0,0,0,0,0,0,0,0,0,0,0,0,0,0,0,1037694,"2023-11-06T00:00:00.000Z",56677855,1,"Seth Lundy",0,0,0,0,0,0
"10686",817,0,0,0,0,0,0,0,0,0,0,0,0,0,0,0,0,1037694,"2023-11-06T00:00:00.000Z",301,1,"Wesley Matthews",0,0,0,0,0,0
"10687",818,0,0,0,0,0,0,0,0,0,0,0,0,0,0,0,0,1037694,"2023-11-06T00:00:00.000Z",56677875,1,"Miles Norris",0,0,0,0,0,0
"10688",819,0,0,0,0,0,0,0,0,0,0,0,0,0,0,0,0,1037693,"2023-11-06T00:00:00.000Z",17553967,2,"Neemias Queta",0,0,0,0,0,0
"10689",820,0,0,0,0,0,0,0,0,0,0,0,0,0,0,0,0,1037693,"2023-11-06T00:00:00.000Z",56677864,2,"Jordan Walsh",0,0,0,0,0,0
"10690",821,0,0,0,0,0,0,0,0,0,0,0,0,0,0,0,0,1037693,"2023-11-06T00:00:00.000Z",473,2,"Derrick White",0,0,0,0,0,0
"10691",822,5,1,6,4,0,15,6,2,1,34,6,2,13,12,3,0,1037694,"2023-11-06T00:00:00.000Z",17896040,1,"Jalen Johnson",4,25,30,18,17,46.9
"10692",823,0,0,0,0,0,0,0,0,0,0,0,0,0,0,0,0,1037692,"2023-11-06T00:00:00.000Z",56677825,11,"Amen Thompson",0,0,0,0,0,0
"10693",824,2,0,1,1,1,3,1,4,2,15,0,1,5,1,0,1,1037692,"2023-11-06T00:00:00.000Z",17896030,26,"Chris Duarte",0,6,8,7,3,8.2
"10694",825,0,0,0,0,0,0,0,0,0,0,0,0,0,0,0,0,1037689,"2023-11-06T00:00:00.000Z",285,16,"Kevin Love",0,0,0,0,0,0
"10695",826,3,0,6,5,2,17,11,4,4,34,0,3,28,6,0,1,1037989,"2023-12-23T00:00:00.000Z",38017703,21,"Jalen Williams",0,34,37,31,9,38.7
"10696",827,2,1,3,3,0,6,2,0,0,21,1,2,4,4,0,0,1037970,"2023-12-21T00:00:00.000Z",85,22,"Wendell Carter Jr.",1,8,10,6,6,14.8
"10697",828,5,0,1,6,2,11,5,3,2,35,1,4,14,2,0,0,1037970,"2023-12-21T00:00:00.000Z",196,22,"Gary Harris",0,16,21,19,7,23.9
"10698",829,1,2,2,0,0,0,0,2,1,19,0,2,1,2,1,1,1037970,"2023-12-21T00:00:00.000Z",56677827,22,"Anthony Black",3,3,4,2,3,12.9
"10699",830,2,1,5,4,1,15,10,0,0,27,3,1,21,8,1,1,1037970,"2023-12-21T00:00:00.000Z",462,22,"Moritz Wagner",2,29,31,23,10,38.6
"10700",831,6,0,7,6,1,17,7,3,3,33,4,2,18,11,2,0,1037970,"2023-12-21T00:00:00.000Z",3547251,22,"Cole Anthony",2,29,35,24,17,46.2
"10701",832,0,3,1,0,0,7,2,1,0,14,3,2,4,4,1,1,1037970,"2023-12-21T00:00:00.000Z",229,22,"Jonathan Isaac",4,8,8,4,4,19.8
"10702",833,0,1,1,3,0,3,0,0,0,18,0,2,0,1,0,0,1037970,"2023-12-21T00:00:00.000Z",38017724,22,"Caleb Houstan",1,1,1,0,1,4.2
"10703",834,0,0,0,0,0,0,0,0,0,0,0,0,0,0,0,0,1037970,"2023-12-21T00:00:00.000Z",666442,22,"Goga Bitadze",0,0,0,0,0,0
"10704",835,0,0,0,0,0,0,0,0,0,0,0,0,0,0,0,0,1037970,"2023-12-21T00:00:00.000Z",666818,22,"Chuma Okeke",0,0,0,0,0,0
"10705",836,0,0,0,0,0,0,0,0,0,0,0,0,0,0,0,0,1037970,"2023-12-21T00:00:00.000Z",666885,22,"Admiral Schofield",0,0,0,0,0,0
"10706",837,0,0,0,0,0,0,0,0,0,0,0,0,0,0,0,0,1037970,"2023-12-21T00:00:00.000Z",165,22,"Markelle Fultz",0,0,0,0,0,0
"10707",838,0,0,0,0,0,0,0,0,0,0,0,0,0,0,0,0,1037970,"2023-12-21T00:00:00.000Z",38017607,22,"Kevon Harris",0,0,0,0,0,0
"10708",839,0,0,0,0,0,0,0,0,0,0,0,0,0,0,0,0,1037970,"2023-12-21T00:00:00.000Z",56677839,22,"Jett Howard",0,0,0,0,0,0
"10709",840,0,0,0,0,0,0,0,0,0,0,0,0,0,0,0,0,1037970,"2023-12-21T00:00:00.000Z",226,22,"Joe Ingles",0,0,0,0,0,0
"10710",841,0,0,0,0,0,0,0,0,0,0,0,0,0,0,0,0,1037970,"2023-12-21T00:00:00.000Z",17553983,22,"Trevelin Queen",0,0,0,0,0,0
"10711",842,0,0,0,0,0,0,0,0,0,0,0,0,0,0,0,0,1037970,"2023-12-21T00:00:00.000Z",17896073,22,"Jalen Suggs",0,0,0,0,0,0
"10712",843,0,0,5,2,0,14,8,8,8,36,1,4,24,6,1,1,1037983,"2023-12-23T00:00:00.000Z",17896026,22,"Franz Wagner",1,30,30,24,6,33.2
"10713",844,4,0,6,0,0,20,11,16,12,36,1,1,34,7,1,3,1037983,"2023-12-23T00:00:00.000Z",38017683,22,"Paolo Banchero",1,41,45,38,11,48.4
"10714",845,0,0,0,0,0,0,0,0,0,0,0,0,0,0,0,0,1037983,"2023-12-23T00:00:00.000Z",17553983,22,"Trevelin Queen",0,0,0,0,0,0
"10715",846,0,0,0,0,0,0,0,0,0,0,0,0,0,0,0,0,1037983,"2023-12-23T00:00:00.000Z",17896073,22,"Jalen Suggs",0,0,0,0,0,0
"10716",847,5,1,1,4,3,6,4,0,0,23,1,2,11,2,1,1,1037989,"2023-12-23T00:00:00.000Z",480,21,"Kenrich Williams",2,13,18,16,7,25.9
"10717",848,1,0,0,0,0,1,0,0,0,6,1,0,0,1,0,1,1037989,"2023-12-23T00:00:00.000Z",17896078,21,"Aaron Wiggins",0,1,2,1,2,1.7
"10718",849,1,0,2,1,0,1,0,0,0,6,0,1,0,2,0,0,1037989,"2023-12-23T00:00:00.000Z",38017706,21,"Jaylin Williams",0,2,3,1,3,3.9
"10719",850,0,0,0,0,0,0,0,0,0,0,0,0,0,0,0,0,1037989,"2023-12-23T00:00:00.000Z",17896065,21,"Josh Giddey",0,0,0,0,0,0
"10720",851,0,0,0,1,0,1,0,0,0,3,0,0,0,0,0,0,1037752,"2023-11-15T00:00:00.000Z",2175,23,"Danuel House Jr.",0,0,0,0,0,0
"10721",852,3,0,4,11,7,20,11,5,2,27,0,1,31,4,0,1,1037750,"2023-11-15T00:00:00.000Z",191,7,"Tim Hardaway Jr.",0,35,38,34,7,39.3
"10722",853,3,0,7,1,0,6,2,2,1,19,0,3,5,7,0,0,1037750,"2023-11-15T00:00:00.000Z",151,7,"Dante Exum",0,12,15,8,10,17.9
"10723",854,2,0,1,0,0,1,1,0,0,7,0,1,2,1,0,0,1037750,"2023-11-15T00:00:00.000Z",379,7,"Dwight Powell",0,3,5,4,3,6.2
"10724",855,2,0,2,2,2,6,6,1,1,20,0,1,15,2,1,0,1037750,"2023-11-15T00:00:00.000Z",114,7,"Seth Curry",1,17,19,17,4,23.4
"10725",856,1,0,1,3,1,7,2,0,0,26,1,3,5,2,0,1,1037751,"2023-11-15T00:00:00.000Z",666656,1,"De'Andre Hunter",0,7,8,6,3,7.9
"10726",857,0,2,5,4,4,9,7,0,0,31,0,1,18,5,0,3,1037751,"2023-11-15T00:00:00.000Z",17896040,1,"Jalen Johnson",2,23,23,18,5,27
"10727",858,1,2,3,0,0,5,4,2,0,26,0,2,8,3,2,0,1037751,"2023-11-15T00:00:00.000Z",83,1,"Clint Capela",4,11,12,9,4,25.1
"10728",859,2,0,5,3,0,12,6,3,1,33,0,1,13,5,1,1,1037751,"2023-11-15T00:00:00.000Z",334,1,"Dejounte Murray",1,18,20,15,7,24
"10729",860,17,0,1,4,0,12,4,9,7,35,0,0,15,1,2,3,1037751,"2023-11-15T00:00:00.000Z",490,1,"Trae Young",2,16,33,32,18,44.7
"10730",861,3,1,2,11,4,15,8,8,8,29,1,4,28,3,2,1,1037751,"2023-11-15T00:00:00.000Z",53,1,"Bogdan Bogdanovic",3,31,34,31,6,44.1
"10731",862,2,0,1,5,2,10,7,0,0,28,1,3,16,2,2,2,1037751,"2023-11-15T00:00:00.000Z",3547256,1,"Saddiq Bey",2,18,20,18,4,25.4
"10732",863,1,1,4,0,0,4,2,4,4,22,2,4,8,6,1,4,1037751,"2023-11-15T00:00:00.000Z",3547244,1,"Onyeka Okongwu",2,14,15,9,7,18.7
"10733",864,1,0,2,1,1,1,1,0,0,10,1,2,3,3,1,0,1037751,"2023-11-15T00:00:00.000Z",301,1,"Wesley Matthews",1,6,7,4,4,11.1
"10734",865,0,0,0,0,0,0,0,0,0,0,0,0,0,0,0,0,1037751,"2023-11-15T00:00:00.000Z",666564,1,"Bruno Fernando",0,0,0,0,0,0
"10735",866,0,0,0,0,0,0,0,0,0,0,0,0,0,0,0,0,1037751,"2023-11-15T00:00:00.000Z",3547297,1,"Trent Forrest",0,0,0,0,0,0
"10736",867,0,0,0,0,0,0,0,0,0,0,0,0,0,0,0,0,1037751,"2023-11-15T00:00:00.000Z",38017689,1,"AJ Griffin",0,0,0,0,0,0
"10737",868,0,0,0,0,0,0,0,0,0,0,0,0,0,0,0,0,1037751,"2023-11-15T00:00:00.000Z",666754,1,"Garrison Mathews",0,0,0,0,0,0
"10738",869,0,0,0,0,0,0,0,0,0,0,0,0,0,0,0,0,1037751,"2023-11-15T00:00:00.000Z",319,1,"Patty Mills",0,0,0,0,0,0
"10739",870,0,0,0,0,0,0,0,0,0,0,0,0,0,0,0,0,1037751,"2023-11-15T00:00:00.000Z",56677838,1,"Kobe Bufkin",0,0,0,0,0,0
"10740",871,0,0,4,11,8,14,11,0,0,31,0,2,30,4,1,0,1037753,"2023-11-15T00:00:00.000Z",38,17,"Malik Beasley",1,34,34,30,4,37.8
"10741",872,13,0,4,10,4,18,9,16,15,31,0,1,37,4,2,4,1037753,"2023-11-15T00:00:00.000Z",278,17,"Damian Lillard",2,41,54,50,17,63.3
"10742",873,0,2,6,3,2,11,7,2,2,31,1,5,18,7,0,0,1037753,"2023-11-15T00:00:00.000Z",377,17,"Bobby Portis",2,25,25,18,7,32.4
"10743",874,0,0,6,3,1,3,1,0,0,23,1,2,3,7,0,1,1037753,"2023-11-15T00:00:00.000Z",105,17,"Pat Connaughton",0,10,10,3,7,10.4
"10744",875,1,0,0,0,0,3,2,0,0,10,0,2,4,0,1,0,1037753,"2023-11-15T00:00:00.000Z",38017676,17,"MarJon Beauchamp",1,4,5,5,1,8.5
"10745",876,0,0,0,0,0,0,0,0,0,0,0,0,0,0,0,0,1038027,"2023-12-29T00:00:00.000Z",666489,8,"Vlatko Cancar",0,0,0,0,0,0
"10746",877,0,0,0,0,0,0,0,0,0,0,0,0,0,0,0,0,1038027,"2023-12-29T00:00:00.000Z",38017727,8,"Collin Gillespie",0,0,0,0,0,0
"10747",878,0,0,0,0,0,0,0,0,0,0,0,0,0,0,0,0,1038027,"2023-12-29T00:00:00.000Z",177,8,"Aaron Gordon",0,0,0,0,0,0
"10748",879,0,0,0,0,0,0,0,0,0,0,0,0,0,0,0,0,1038027,"2023-12-29T00:00:00.000Z",17896103,8,"Jay Huff",0,0,0,0,0,0
"10749",880,0,0,0,0,0,0,0,0,0,0,0,0,0,0,0,0,1038027,"2023-12-29T00:00:00.000Z",56677871,8,"Hunter Tyson",0,0,0,0,0,0
"10750",881,1,1,3,3,0,6,2,0,0,32,1,3,4,4,3,1,1038027,"2023-12-29T00:00:00.000Z",666541,21,"Luguentz Dort",4,8,9,5,5,21.3
"10751",882,8,2,4,7,4,18,10,5,2,38,1,3,26,5,3,3,1038038,"2023-12-31T00:00:00.000Z",227,19,"Brandon Ingram",5,31,39,34,13,56
"10752",883,1,1,2,4,2,7,3,2,2,22,1,5,10,3,0,0,1038039,"2023-12-31T00:00:00.000Z",56677833,21,"Cason Wallace",1,13,14,11,4,18.1
"10753",884,2,1,2,1,0,3,1,1,1,6,1,1,3,3,0,0,1038039,"2023-12-31T00:00:00.000Z",38017706,21,"Jaylin Williams",1,6,8,5,5,12.6
"10754",885,0,0,4,0,0,0,0,0,0,11,1,0,0,5,0,2,1038039,"2023-12-31T00:00:00.000Z",17896078,21,"Aaron Wiggins",0,5,5,0,5,4
"10755",886,4,0,2,0,0,1,1,0,0,12,1,4,2,3,1,0,1038039,"2023-12-31T00:00:00.000Z",4197029,21,"Vasilije Micic",1,5,9,6,7,14.6
"10756",887,2,0,4,2,0,4,1,0,0,18,0,0,2,4,0,0,1038039,"2023-12-31T00:00:00.000Z",480,21,"Kenrich Williams",0,6,8,4,6,9.8
"10757",888,0,0,0,1,1,1,1,0,0,2,0,0,3,0,0,0,1038039,"2023-12-31T00:00:00.000Z",27924547,21,"Lindy Waters III",0,3,3,3,0,3
"10758",889,0,0,0,0,0,0,0,0,0,0,0,0,0,0,0,0,1038039,"2023-12-31T00:00:00.000Z",3547271,21,"Aleksej Pokusevski",0,0,0,0,0,0
"10759",890,2,0,2,2,0,2,0,0,0,19,0,2,0,2,0,1,1038040,"2023-12-31T00:00:00.000Z",38017649,27,"Julian Champagnie",0,2,4,2,4,4.4
"10760",891,5,0,3,4,1,11,4,0,0,24,0,1,9,3,0,1,1038040,"2023-12-31T00:00:00.000Z",38017699,27,"Jeremy Sochan",0,12,17,14,8,19.1
"10761",892,3,1,5,8,3,16,8,2,2,24,2,0,21,7,0,3,1038040,"2023-12-31T00:00:00.000Z",56677822,27,"Victor Wembanyama",1,28,31,24,10,33.9
"10762",893,1,0,4,4,2,15,9,2,2,31,1,3,22,5,2,2,1038040,"2023-12-31T00:00:00.000Z",3547246,27,"Devin Vassell",2,27,28,23,6,33.5
"10763",894,0,0,1,5,1,9,4,3,2,23,0,0,11,1,0,1,1038040,"2023-12-31T00:00:00.000Z",38017692,27,"Malaki Branham",0,12,12,11,1,11.2
"10764",895,4,0,5,5,1,9,3,0,0,20,2,1,7,7,0,0,1038040,"2023-12-31T00:00:00.000Z",17896059,27,"Sandro Mamukelashvili",0,14,18,11,11,21.4
"10765",896,2,0,0,2,1,4,2,0,0,16,0,2,5,0,1,0,1038040,"2023-12-31T00:00:00.000Z",359,27,"Cedi Osman",1,5,7,7,2,11
"10766",897,1,0,0,3,0,3,0,0,0,16,0,1,0,0,0,1,1038040,"2023-12-31T00:00:00.000Z",305,27,"Doug McDermott",0,0,1,1,1,0.5
"10767",898,2,0,3,5,0,10,4,0,0,22,1,3,8,4,0,1,1038040,"2023-12-31T00:00:00.000Z",3547274,27,"Tre Jones",0,12,14,10,6,14.8
"10768",899,6,0,1,2,0,3,0,2,1,17,0,2,1,1,0,1,1038040,"2023-12-31T00:00:00.000Z",38017693,27,"Blake Wesley",0,2,8,7,7,10.2
"10769",900,1,0,3,1,1,6,3,2,1,12,1,2,8,4,2,0,1038040,"2023-12-31T00:00:00.000Z",38017730,27,"Dominick Barlow",2,12,13,9,5,20.3
"10770",901,0,0,0,0,0,0,0,0,0,0,0,0,0,0,0,0,1037800,"2023-11-22T00:00:00.000Z",165,22,"Markelle Fultz",0,0,0,0,0,0
"10771",902,0,0,0,0,0,0,0,0,0,0,0,0,0,0,0,0,1037804,"2023-11-22T00:00:00.000Z",38017710,28,"Christian Koloko",0,0,0,0,0,0
"10772",903,0,0,0,0,0,0,0,0,0,0,0,0,0,0,0,0,1037804,"2023-11-22T00:00:00.000Z",56677869,28,"Markquis Nowell",0,0,0,0,0,0
"10773",904,0,0,0,0,0,0,0,0,0,0,0,0,0,0,0,0,1037804,"2023-11-22T00:00:00.000Z",489,28,"Thaddeus Young",0,0,0,0,0,0
"10774",905,2,2,2,4,0,6,1,0,0,27,0,6,2,2,0,2,1037808,"2023-11-22T00:00:00.000Z",666541,21,"Luguentz Dort",2,4,6,4,4,11.4
"10775",906,0,1,2,2,1,3,2,0,0,24,1,1,5,3,0,1,1037808,"2023-11-22T00:00:00.000Z",56677833,21,"Cason Wallace",1,8,8,5,3,10.6
"10776",907,2,4,8,3,0,11,5,11,8,32,5,3,18,13,1,2,1037808,"2023-11-22T00:00:00.000Z",38017685,21,"Chet Holmgren",5,31,33,20,15,49.6
"10777",908,2,0,5,3,1,13,4,2,1,29,1,1,10,6,2,2,1037808,"2023-11-22T00:00:00.000Z",17896065,21,"Josh Giddey",2,16,18,12,8,24.2
"10778",909,12,3,4,3,1,19,11,18,17,37,1,2,40,5,1,2,1037808,"2023-11-22T00:00:00.000Z",175,21,"Shai Gilgeous-Alexander",4,45,57,52,17,74
"10779",910,0,1,1,7,5,9,6,3,3,27,0,0,20,1,0,0,1037808,"2023-11-22T00:00:00.000Z",3547272,21,"Isaiah Joe",1,21,21,20,1,24.2
"10780",911,0,0,0,0,0,0,0,0,0,0,0,0,0,0,0,0,1037808,"2023-11-22T00:00:00.000Z",44,21,"Davis Bertans",0,0,0,0,0,0
"10781",912,0,0,0,0,0,0,0,0,0,0,0,0,0,0,0,0,1037808,"2023-11-22T00:00:00.000Z",38017716,21,"Ousmane Dieng",0,0,0,0,0,0
"10782",913,0,0,0,0,0,0,0,0,0,0,0,0,0,0,0,0,1037808,"2023-11-22T00:00:00.000Z",17896036,21,"Tre Mann",0,0,0,0,0,0
"10783",914,6,1,1,8,2,13,5,3,3,36,2,4,15,3,0,0,1037809,"2023-11-22T00:00:00.000Z",666682,27,"Keldon Johnson",1,18,24,21,9,30.6
"10784",915,3,3,13,2,1,13,7,7,7,33,2,2,22,15,1,2,1037809,"2023-11-22T00:00:00.000Z",56677822,27,"Victor Wembanyama",4,37,40,25,18,54.5
"10785",916,3,1,7,5,2,13,6,2,2,28,2,6,16,9,0,1,1037809,"2023-11-22T00:00:00.000Z",102,27,"Zach Collins",1,25,28,19,12,33.3
"10786",917,1,0,0,3,0,6,0,0,0,21,1,0,0,1,0,0,1037809,"2023-11-22T00:00:00.000Z",38017692,27,"Malaki Branham",0,1,2,1,2,2.7
"10787",918,7,0,3,5,2,15,6,6,5,31,2,3,19,5,0,1,1037809,"2023-11-22T00:00:00.000Z",38017699,27,"Jeremy Sochan",0,24,31,26,12,34.5
"10788",919,0,0,0,0,0,0,0,0,0,2,0,0,0,0,0,3,1037809,"2023-11-22T00:00:00.000Z",17895854,27,"Charles Bassey",0,0,0,0,0,-3
"10789",920,0,0,0,0,0,0,0,0,0,0,0,0,0,0,0,0,1037803,"2023-11-22T00:00:00.000Z",38017734,16,"Jamal Cain",0,0,0,0,0,0
"10790",921,0,0,2,0,0,1,0,0,0,9,0,1,0,2,1,0,1037809,"2023-11-22T00:00:00.000Z",38017730,27,"Dominick Barlow",1,2,2,0,2,5.4
"10791",922,0,0,0,0,0,0,0,0,0,0,0,0,0,0,0,0,1037809,"2023-11-22T00:00:00.000Z",38017649,27,"Julian Champagnie",0,0,0,0,0,0
"10792",923,0,0,0,0,0,0,0,0,0,0,0,0,0,0,0,0,1037809,"2023-11-22T00:00:00.000Z",180,27,"Devonte' Graham",0,0,0,0,0,0
"10793",924,0,0,0,0,0,0,0,0,0,0,0,0,0,0,0,0,1037803,"2023-11-22T00:00:00.000Z",3547257,16,"R.J. Hampton",0,0,0,0,0,0
"10794",925,0,0,0,0,0,0,0,0,0,0,0,0,0,0,0,0,1037803,"2023-11-22T00:00:00.000Z",666633,16,"Tyler Herro",0,0,0,0,0,0
"10795",926,3,0,4,2,2,6,4,4,3,17,2,4,13,6,0,2,1038102,"2024-01-08T00:00:00.000Z",358,29,"Kelly Olynyk",0,19,22,16,9,22.7
"10796",927,0,0,0,0,0,0,0,0,0,0,0,0,0,0,0,0,1038102,"2024-01-08T00:00:00.000Z",666881,29,"Luka Samanic",0,0,0,0,0,0
"10797",928,0,0,0,0,0,0,0,0,0,0,0,0,0,0,0,0,1038102,"2024-01-08T00:00:00.000Z",11891374,29,"Omer Yurtseven",0,0,0,0,0,0
"10798",929,0,0,0,0,0,0,0,0,0,0,0,0,0,0,0,0,1038102,"2024-01-08T00:00:00.000Z",17896023,29,"Josh Christopher",0,0,0,0,0,0
"10799",930,0,0,0,0,0,0,0,0,0,0,0,0,0,0,0,0,1038102,"2024-01-08T00:00:00.000Z",56677824,29,"Taylor Hendricks",0,0,0,0,0,0
"10800",931,0,0,0,0,0,0,0,0,0,0,0,0,0,0,0,0,1038102,"2024-01-08T00:00:00.000Z",38017630,29,"Johnny Juzang",0,0,0,0,0,0
"10801",932,0,0,0,0,0,0,0,0,0,0,0,0,0,0,0,0,1038102,"2024-01-08T00:00:00.000Z",19465584,29,"Micah Potter",0,0,0,0,0,0
"10802",933,0,0,0,0,0,0,0,0,0,0,0,0,0,0,0,0,1038102,"2024-01-08T00:00:00.000Z",56677842,29,"Brice Sensabaugh",0,0,0,0,0,0
"10803",934,7,0,3,10,3,12,4,3,3,30,0,6,14,3,1,1,1038101,"2024-01-08T00:00:00.000Z",397,16,"Duncan Robinson",1,17,24,21,10,30.1
"10804",935,0,0,3,2,1,2,1,0,0,16,0,0,3,3,0,0,1038101,"2024-01-08T00:00:00.000Z",3092,16,"Haywood Highsmith",0,6,6,3,3,6.6
"10805",936,0,0,0,0,0,0,0,0,0,0,0,0,0,0,0,0,1038101,"2024-01-08T00:00:00.000Z",74,16,"Thomas Bryant",0,0,0,0,0,0
"10806",937,0,0,0,0,0,0,0,0,0,0,0,0,0,0,0,0,1038101,"2024-01-08T00:00:00.000Z",38017734,16,"Jamal Cain",0,0,0,0,0,0
"10807",938,0,0,0,0,0,0,0,0,0,0,0,0,0,0,0,0,1038101,"2024-01-08T00:00:00.000Z",39398582,16,"Orlando Robinson",0,0,0,0,0,0
"10808",939,0,0,0,0,0,0,0,0,0,0,0,0,0,0,0,0,1038101,"2024-01-08T00:00:00.000Z",79,16,"Jimmy Butler",0,0,0,0,0,0
"10809",940,0,0,0,0,0,0,0,0,0,0,0,0,0,0,0,0,1038101,"2024-01-08T00:00:00.000Z",3547257,16,"R.J. Hampton",0,0,0,0,0,0
"10810",941,0,0,0,0,0,0,0,0,0,0,0,0,0,0,0,0,1038101,"2024-01-08T00:00:00.000Z",666747,16,"Caleb Martin",0,0,0,0,0,0
"10811",942,0,0,0,0,0,0,0,0,0,0,0,0,0,0,0,0,1038101,"2024-01-08T00:00:00.000Z",19465585,16,"Dru Smith",0,0,0,0,0,0
"10812",943,0,0,0,0,0,0,0,0,0,0,0,0,0,0,0,0,1038101,"2024-01-08T00:00:00.000Z",38017736,16,"Cole Swider",0,0,0,0,0,0
"10813",944,1,0,1,4,1,8,3,2,2,34,3,5,9,4,1,0,1038101,"2024-01-08T00:00:00.000Z",3547301,11,"Jae'Sean Tate",1,13,14,10,5,18.3
"10814",945,0,0,3,5,1,13,3,3,3,32,3,3,10,6,0,1,1038101,"2024-01-08T00:00:00.000Z",38017684,11,"Jabari Smith Jr.",0,16,16,10,6,16.2
"10815",946,2,0,7,2,1,15,9,4,3,33,4,6,22,11,3,3,1038101,"2024-01-08T00:00:00.000Z",17896062,11,"Alperen Sengun",3,33,35,24,13,44.2
"10816",947,0,0,0,0,0,0,0,0,0,0,0,0,0,0,0,0,1038101,"2024-01-08T00:00:00.000Z",357,11,"Victor Oladipo",0,0,0,0,0,0
"10817",948,0,0,0,0,0,0,0,0,0,0,0,0,0,0,0,0,1038101,"2024-01-08T00:00:00.000Z",66,11,"Dillon Brooks",0,0,0,0,0,0
"10818",949,0,0,0,0,0,0,0,0,0,0,0,0,0,0,0,0,1038101,"2024-01-08T00:00:00.000Z",38017695,11,"Tari Eason",0,0,0,0,0,0
"10819",950,0,0,0,0,0,0,0,0,0,0,0,0,0,0,0,0,1038101,"2024-01-08T00:00:00.000Z",3547281,11,"Nate Hinton",0,0,0,0,0,0
"10820",951,0,0,0,0,0,0,0,0,0,0,0,0,0,0,0,0,1037874,"2023-12-02T00:00:00.000Z",17896041,3,"Keon Johnson",0,0,0,0,0,0
"10821",952,0,0,0,0,0,0,0,0,0,0,0,0,0,0,0,0,1037874,"2023-12-02T00:00:00.000Z",417,3,"Ben Simmons",0,0,0,0,0,0
"10822",953,0,0,0,0,0,0,0,0,0,0,0,0,0,0,0,0,1037874,"2023-12-02T00:00:00.000Z",56677722,3,"Jalen Wilson",0,0,0,0,0,0
"10823",954,0,0,0,0,0,0,0,0,0,0,0,0,0,0,0,0,1037874,"2023-12-02T00:00:00.000Z",165,22,"Markelle Fultz",0,0,0,0,0,0
"10824",955,0,0,0,0,0,0,0,0,0,0,0,0,0,0,0,0,1037874,"2023-12-02T00:00:00.000Z",38017607,22,"Kevon Harris",0,0,0,0,0,0
"10825",956,3,0,4,2,2,11,7,0,0,29,1,1,16,5,0,1,1037876,"2023-12-02T00:00:00.000Z",39398582,16,"Orlando Robinson",0,21,24,19,8,25.5
"10826",957,3,0,1,3,2,11,7,1,1,30,1,6,17,2,0,2,1037876,"2023-12-02T00:00:00.000Z",397,16,"Duncan Robinson",0,19,22,20,5,21.9
"10827",958,0,0,0,0,0,0,0,0,0,0,0,0,0,0,0,0,1037874,"2023-12-02T00:00:00.000Z",56677839,22,"Jett Howard",0,0,0,0,0,0
"10828",959,0,0,0,0,0,0,0,0,0,0,0,0,0,0,0,0,1037874,"2023-12-02T00:00:00.000Z",17553983,22,"Trevelin Queen",0,0,0,0,0,0
"10829",960,0,0,0,0,0,0,0,0,0,0,0,0,0,0,0,0,1037878,"2023-12-02T00:00:00.000Z",2148,17,"Thanasis Antetokounmpo",0,0,0,0,0,0
"10830",961,2,0,7,3,0,4,0,4,4,29,1,2,4,8,0,0,1037876,"2023-12-02T00:00:00.000Z",286,16,"Kyle Lowry",0,12,14,6,10,16.6
"10831",962,3,0,3,2,1,9,4,5,2,29,0,1,11,3,2,0,1037876,"2023-12-02T00:00:00.000Z",56677785,16,"Jaime Jaquez Jr.",2,14,17,14,6,25.1
"10832",963,0,0,0,0,0,0,0,0,0,5,0,2,0,0,0,0,1037876,"2023-12-02T00:00:00.000Z",38017734,16,"Jamal Cain",0,0,0,0,0,0
"10833",964,0,0,0,0,0,0,0,0,0,0,0,0,0,0,0,0,1037876,"2023-12-02T00:00:00.000Z",74,16,"Thomas Bryant",0,0,0,0,0,0
"10834",965,0,0,0,0,0,0,0,0,0,0,0,0,0,0,0,0,1037876,"2023-12-02T00:00:00.000Z",38017696,16,"Nikola Jovic",0,0,0,0,0,0
"10835",966,1,0,9,0,0,5,2,3,2,36,1,3,6,10,0,2,1037875,"2023-12-02T00:00:00.000Z",17896076,6,"Evan Mobley",0,16,17,7,11,17.5
"10836",967,1,0,7,0,0,9,8,5,3,34,5,2,19,12,1,2,1037875,"2023-12-02T00:00:00.000Z",9,6,"Jarrett Allen",1,31,32,20,13,35.9
"10837",968,6,1,1,7,2,23,9,3,2,34,0,1,22,1,3,2,1037875,"2023-12-02T00:00:00.000Z",666581,6,"Darius Garland",4,23,29,28,7,42.2
"10838",969,4,0,2,5,2,19,7,5,4,33,1,2,20,3,2,4,1037875,"2023-12-02T00:00:00.000Z",322,6,"Donovan Mitchell",2,23,27,24,7,31.6
"10839",970,4,0,7,3,1,6,4,0,0,33,0,3,9,7,4,1,1037875,"2023-12-02T00:00:00.000Z",3547247,6,"Isaac Okoro",4,16,20,13,11,34.4
"10840",971,2,0,3,4,1,8,5,2,1,22,0,1,12,3,0,0,1037875,"2023-12-02T00:00:00.000Z",344,6,"Georges Niang",0,15,17,14,5,18.6
"10841",972,0,0,0,0,0,0,0,0,0,4,0,1,0,0,0,0,1037875,"2023-12-02T00:00:00.000Z",56677872,6,"Craig Porter",0,0,0,0,0,0
"10842",973,1,0,0,1,0,1,0,0,0,3,0,1,0,0,0,0,1037875,"2023-12-02T00:00:00.000Z",3547299,6,"Sam Merrill",0,0,1,1,1,1.5
"10843",974,0,0,0,0,0,0,0,0,0,0,0,0,0,0,0,0,1037875,"2023-12-02T00:00:00.000Z",248,6,"Damian Jones",0,0,0,0,0,0
"10844",975,0,0,0,0,0,0,0,0,0,0,0,0,0,0,0,0,1037875,"2023-12-02T00:00:00.000Z",277,6,"Caris LeVert",0,0,0,0,0,0
"10845",976,2,3,9,2,1,17,10,10,9,39,3,2,30,12,3,2,1037608,"2023-10-26T00:00:00.000Z",117,14,"Anthony Davis",6,42,44,32,14,63.4
"10846",977,1,0,1,2,1,7,4,2,1,28,1,5,10,2,1,1,1037608,"2023-10-26T00:00:00.000Z",17553995,14,"Austin Reaves",1,12,13,11,3,15.9
"10847",978,5,1,4,7,1,16,6,1,1,33,0,2,14,4,2,3,1037608,"2023-10-26T00:00:00.000Z",405,14,"D'Angelo Russell",3,18,23,19,9,32.3
"10848",979,6,0,2,5,0,10,3,2,1,35,1,1,7,3,3,0,1037608,"2023-10-26T00:00:00.000Z",1603383,14,"Gabe Vincent",3,10,16,13,9,28.6
"10849",980,0,1,0,2,1,3,2,2,2,13,0,2,7,0,1,1,1037608,"2023-10-26T00:00:00.000Z",666609,14,"Rui Hachimura",2,7,7,7,0,12
"10850",981,0,0,1,3,0,5,2,0,0,12,0,2,4,1,0,1,1037608,"2023-10-26T00:00:00.000Z",666860,14,"Cameron Reddish",0,5,5,4,1,4.2
"10851",982,0,0,2,0,0,0,0,0,0,6,0,3,0,2,1,2,1037608,"2023-10-26T00:00:00.000Z",666626,14,"Jaxson Hayes",1,2,2,0,2,3.4
"10852",983,3,0,7,3,0,10,3,5,5,31,2,0,11,9,0,4,1037610,"2023-10-27T00:00:00.000Z",17896027,15,"Ziaire Williams",0,20,23,14,12,22.3
"10853",984,2,3,7,2,2,12,9,2,1,29,2,5,21,9,0,1,1037610,"2023-10-27T00:00:00.000Z",231,15,"Jaren Jackson Jr.",3,30,32,23,11,42.8
"10854",985,2,2,6,3,1,9,5,4,2,34,2,5,13,8,3,5,1037610,"2023-10-27T00:00:00.000Z",3547285,15,"Xavier Tillman",5,21,23,15,10,35.6
"10855",986,3,0,2,10,1,17,4,6,6,32,1,3,15,3,2,2,1037610,"2023-10-27T00:00:00.000Z",3547287,15,"Desmond Bane",2,18,21,18,6,27.1
"10856",987,5,0,1,7,3,13,7,3,3,31,1,3,20,2,5,2,1037610,"2023-10-27T00:00:00.000Z",420,15,"Marcus Smart",5,22,27,25,7,42.9
"10857",988,2,0,2,2,0,4,0,0,0,15,0,3,0,2,1,2,1037610,"2023-10-27T00:00:00.000Z",38017729,15,"David Roddy",1,2,4,2,4,6.4
"10858",989,2,2,6,1,0,2,1,0,0,30,0,1,2,6,1,0,1037610,"2023-10-27T00:00:00.000Z",666703,15,"John Konchar",3,8,10,4,8,21.2
"10859",990,3,0,2,3,2,14,6,2,2,22,2,2,16,4,1,3,1037610,"2023-10-27T00:00:00.000Z",401,15,"Derrick Rose",1,20,23,19,7,25.3
"10860",991,0,0,2,2,1,3,2,2,1,16,3,1,6,5,0,2,1037610,"2023-10-27T00:00:00.000Z",38017728,15,"Jake LaRavia",0,11,11,6,5,10
"10861",992,0,0,0,0,0,0,0,0,0,0,0,0,0,0,0,0,1037610,"2023-10-27T00:00:00.000Z",48248287,15,"Jacob Gilyard",0,0,0,0,0,0
"10862",993,0,0,0,0,0,0,0,0,0,0,0,0,0,0,0,0,1037610,"2023-10-27T00:00:00.000Z",56677830,15,"GG Jackson",0,0,0,0,0,0
"10863",994,0,0,0,0,0,0,0,0,0,0,0,0,0,0,0,0,1037610,"2023-10-27T00:00:00.000Z",38017732,15,"Kenneth Lofton Jr.",0,0,0,0,0,0
"10864",995,0,0,0,0,0,0,0,0,0,0,0,0,0,0,0,0,1037610,"2023-10-27T00:00:00.000Z",666786,15,"Ja Morant",0,0,0,0,0,0
"10865",996,6,0,1,5,2,13,4,2,2,24,1,6,12,2,1,5,1037609,"2023-10-27T00:00:00.000Z",17896075,9,"Cade Cunningham",1,14,20,18,8,21.4
"10866",997,3,1,3,3,1,10,2,2,1,29,0,4,6,3,1,3,1037609,"2023-10-27T00:00:00.000Z",3547241,9,"Killian Hayes",2,9,12,9,6,17.1
"10867",998,2,1,4,7,3,10,5,12,11,31,0,1,24,4,1,0,1037609,"2023-10-27T00:00:00.000Z",77,9,"Alec Burks",2,28,30,26,6,37.8
"10868",999,4,0,2,6,2,14,8,0,0,23,0,4,18,2,1,2,1037609,"2023-10-27T00:00:00.000Z",38017682,9,"Jaden Ivey",1,20,24,22,6,27.4
"10869",1000,1,0,0,1,0,3,1,0,0,11,0,2,2,0,1,0,1037609,"2023-10-27T00:00:00.000Z",197,9,"Joe Harris",1,2,3,3,1,6.5
"10870",1001,3,0,4,4,1,8,1,0,0,16,0,1,3,4,1,0,1037901,"2023-12-12T00:00:00.000Z",221,26,"Kevin Huerter",1,7,10,6,7,15.3
"10871",1002,3,0,3,7,3,16,5,1,1,25,0,3,14,3,0,4,1037901,"2023-12-12T00:00:00.000Z",161,26,"De'Aaron Fox",0,17,20,17,6,18.1
"10872",1003,2,0,2,2,0,3,1,0,0,17,0,3,2,2,0,3,1037900,"2023-12-12T00:00:00.000Z",185,10,"Draymond Green",0,4,6,4,4,4.4
"10873",1004,2,0,3,0,0,0,0,0,0,11,2,2,0,5,1,0,1037900,"2023-12-12T00:00:00.000Z",282,10,"Kevon Looney",1,5,7,2,7,12
"10874",1005,0,0,5,8,1,10,2,2,2,27,0,1,7,5,0,1,1037900,"2023-12-12T00:00:00.000Z",443,10,"Klay Thompson",0,12,12,7,5,12
"10875",1006,4,0,5,15,4,24,8,4,4,32,0,2,24,5,3,1,1037900,"2023-12-12T00:00:00.000Z",115,10,"Stephen Curry",3,29,33,28,9,44
"10876",1007,11,0,5,4,3,8,5,3,2,30,0,4,15,5,2,1,1037900,"2023-12-12T00:00:00.000Z",367,10,"Chris Paul",2,20,31,26,16,42.5
"10877",1008,0,0,3,3,2,6,3,6,4,24,1,3,12,4,0,2,1037900,"2023-12-12T00:00:00.000Z",17553992,10,"Moses Moody",0,16,16,12,4,14.8
"10878",1009,0,0,4,3,1,10,6,7,3,28,2,4,16,6,1,1,1037900,"2023-12-12T00:00:00.000Z",17553979,10,"Jonathan Kuminga",1,22,22,16,6,25.2
"10879",1010,5,0,0,5,2,8,3,0,0,22,0,4,8,0,0,4,1037901,"2023-12-12T00:00:00.000Z",324,26,"Malik Monk",0,8,13,13,5,11.5
"10880",1011,3,0,5,3,0,4,1,2,1,20,1,1,3,6,1,0,1037901,"2023-12-12T00:00:00.000Z",290,26,"Trey Lyles",1,9,12,6,9,17.7
"10881",1012,0,0,0,0,0,3,3,1,0,6,1,1,6,1,0,1,1037901,"2023-12-12T00:00:00.000Z",306,26,"JaVale McGee",0,7,7,6,1,6.2
"10882",1013,3,0,3,3,1,7,4,0,0,20,0,0,9,3,1,0,1037901,"2023-12-12T00:00:00.000Z",4197162,26,"Aleksandar Vezenkov",1,12,15,12,6,20.1
"10883",1014,2,0,0,1,0,3,0,2,1,15,0,1,1,0,0,0,1037901,"2023-12-12T00:00:00.000Z",17553994,26,"Davion Mitchell",0,1,3,3,2,4
"10884",1015,0,0,0,0,0,0,0,0,0,0,0,0,0,0,0,0,1037901,"2023-12-12T00:00:00.000Z",56677845,26,"Colby Jones",0,0,0,0,0,0
"10885",1016,0,0,0,0,0,0,0,0,0,0,0,0,0,0,0,0,1037901,"2023-12-12T00:00:00.000Z",56677862,26,"Jalen Slawson",0,0,0,0,0,0
"10886",1017,7,0,5,3,1,8,4,4,4,30,1,1,13,6,0,2,1037903,"2023-12-13T00:00:00.000Z",3547242,30,"Deni Avdija",0,19,26,20,13,28.7
"10887",1018,4,1,7,8,4,19,10,4,3,29,0,1,27,7,1,1,1037903,"2023-12-13T00:00:00.000Z",265,30,"Kyle Kuzma",2,34,38,31,11,46.4
"10888",1019,3,0,6,1,0,7,5,0,0,30,2,3,10,8,1,0,1037902,"2023-12-13T00:00:00.000Z",56677826,9,"Ausar Thompson",1,18,21,13,11,27.1
"10889",1020,2,0,1,9,5,19,11,8,6,34,0,1,33,1,1,1,1037902,"2023-12-13T00:00:00.000Z",54,9,"Bojan Bogdanovic",1,34,36,35,3,39.2
"10890",1021,2,0,2,1,0,3,1,2,2,22,2,3,4,4,0,2,1037902,"2023-12-13T00:00:00.000Z",3547267,9,"Isaiah Stewart",0,8,10,6,6,9.8
"10891",1022,7,0,5,8,1,17,5,12,10,30,1,3,21,6,0,1,1037902,"2023-12-13T00:00:00.000Z",17896075,9,"Cade Cunningham",0,27,34,28,13,37.7
"10892",1023,6,0,3,0,0,8,3,0,0,32,0,2,6,3,1,1,1037902,"2023-12-13T00:00:00.000Z",3547241,9,"Killian Hayes",1,9,15,12,9,20.6
"10893",1024,0,1,3,0,0,7,5,0,0,16,0,6,10,3,1,1,1037902,"2023-12-13T00:00:00.000Z",3547240,9,"James Wiseman",2,13,13,10,3,18.6
"10894",1025,0,0,3,2,0,4,1,0,0,27,0,1,2,3,1,0,1037902,"2023-12-13T00:00:00.000Z",17896071,9,"Isaiah Livers",1,5,5,2,3,8.6
"10895",1026,1,1,1,5,1,13,6,0,0,33,1,1,13,2,3,3,1037674,"2023-11-04T00:00:00.000Z",17896024,19,"Herbert Jones",4,15,16,14,3,25.9
"10896",1027,6,2,1,6,1,12,5,3,2,33,0,3,13,1,2,0,1037674,"2023-11-04T00:00:00.000Z",303,19,"CJ McCollum",4,14,20,19,7,35.2
"10897",1028,4,0,0,2,0,3,0,0,0,10,0,1,0,0,1,0,1037674,"2023-11-04T00:00:00.000Z",3547260,19,"Kira Lewis Jr.",1,0,4,4,4,9
"10898",1029,2,0,1,7,2,13,5,0,0,26,4,2,12,5,1,0,1037674,"2023-11-04T00:00:00.000Z",3547256,1,"Saddiq Bey",1,17,19,14,7,24
"10899",1030,2,0,3,3,1,10,6,0,0,19,5,5,13,8,1,2,1037673,"2023-11-04T00:00:00.000Z",462,22,"Moritz Wagner",1,21,23,15,10,26.6
"10900",1031,0,0,0,0,0,0,0,0,0,0,0,0,0,0,0,0,1037673,"2023-11-04T00:00:00.000Z",85,22,"Wendell Carter Jr.",0,0,0,0,0,0
"10901",1032,0,0,0,0,0,0,0,0,0,0,0,0,0,0,0,0,1037673,"2023-11-04T00:00:00.000Z",165,22,"Markelle Fultz",0,0,0,0,0,0
"10902",1033,0,0,0,0,0,0,0,0,0,0,0,0,0,0,0,0,1037672,"2023-11-04T00:00:00.000Z",56677832,12,"Jarace Walker",0,0,0,0,0,0
"10903",1034,0,0,0,0,0,0,0,0,0,0,0,0,0,0,0,0,1037672,"2023-11-04T00:00:00.000Z",56677794,12,"Isaiah Wong",0,0,0,0,0,0
"10904",1035,0,0,0,0,0,0,0,0,0,0,0,0,0,0,0,0,1037672,"2023-11-04T00:00:00.000Z",666748,4,"Cody Martin",0,0,0,0,0,0
"10905",1036,0,0,0,0,0,0,0,0,0,0,0,0,0,0,0,0,1037672,"2023-11-04T00:00:00.000Z",347,4,"Frank Ntilikina",0,0,0,0,0,0
"10906",1037,0,0,5,8,4,11,5,1,1,24,0,3,15,5,1,1,1037674,"2023-11-04T00:00:00.000Z",56677837,19,"Jordan Hawkins",1,20,20,15,5,23
"10907",1038,5,1,2,2,1,4,3,0,0,22,1,0,7,3,1,0,1037674,"2023-11-04T00:00:00.000Z",38017677,19,"Dyson Daniels",2,10,15,12,8,24.1
"10908",1039,1,0,1,3,0,4,1,2,2,17,1,2,4,2,0,1,1037674,"2023-11-04T00:00:00.000Z",17896017,19,"Matt Ryan",0,6,7,5,3,6.9
"10909",1040,0,0,0,0,0,0,0,0,0,1,0,0,0,0,0,0,1037674,"2023-11-04T00:00:00.000Z",38017663,19,"E.J. Liddell",0,0,0,0,0,0
"10910",1041,0,0,0,0,0,0,0,0,0,0,0,0,0,0,0,0,1037674,"2023-11-04T00:00:00.000Z",491,19,"Cody Zeller",0,0,0,0,0,0
"10911",1042,0,0,0,0,0,1,0,0,0,4,0,0,0,0,0,0,1037673,"2023-11-04T00:00:00.000Z",56677867,14,"Alex Fudge",0,0,0,0,0,0
"10912",1043,0,0,0,0,0,0,0,0,0,4,0,0,0,0,0,1,1037673,"2023-11-04T00:00:00.000Z",56677836,14,"Maxwell Lewis",0,0,0,0,0,-1
"10913",1044,0,0,0,2,0,2,0,0,0,4,0,1,0,0,0,0,1037673,"2023-11-04T00:00:00.000Z",56677868,14,"D'Moi Hodge",0,0,0,0,0,0
"10914",1045,0,0,0,0,0,0,0,0,0,0,0,0,0,0,0,0,1037673,"2023-11-04T00:00:00.000Z",666609,14,"Rui Hachimura",0,0,0,0,0,0
"10915",1046,0,0,0,0,0,0,0,0,0,0,0,0,0,0,0,0,1037673,"2023-11-04T00:00:00.000Z",56677835,14,"Jalen Hood-Schifino",0,0,0,0,0,0
"10916",1047,0,0,0,0,0,0,0,0,0,0,0,0,0,0,0,0,1037673,"2023-11-04T00:00:00.000Z",383,14,"Taurean Prince",0,0,0,0,0,0
"10917",1048,0,0,0,0,0,0,0,0,0,0,0,0,0,0,0,0,1037673,"2023-11-04T00:00:00.000Z",457,14,"Jarred Vanderbilt",0,0,0,0,0,0
"10918",1049,0,0,3,1,1,3,3,0,0,15,1,1,7,4,0,0,1037672,"2023-11-04T00:00:00.000Z",18678001,4,"JT Thor",0,11,11,7,4,11.8
"10919",1050,0,0,0,0,0,0,0,0,0,0,0,0,0,0,0,0,1037672,"2023-11-04T00:00:00.000Z",422,4,"Ish Smith",0,0,0,0,0,0
"10920",1051,0,0,1,1,1,1,1,0,0,2,0,0,3,1,0,0,1037953,"2023-12-19T00:00:00.000Z",284,17,"Robin Lopez",0,4,4,3,1,4.2
"10921",1052,1,0,0,0,0,0,0,0,0,1,0,0,0,0,0,0,1037953,"2023-12-19T00:00:00.000Z",2148,17,"Thanasis Antetokounmpo",0,0,1,1,1,1.5
"10922",1053,0,0,0,0,0,0,0,0,0,0,0,0,0,0,0,0,1037953,"2023-12-19T00:00:00.000Z",666453,17,"Marques Bolden",0,0,0,0,0,0
"10923",1054,0,0,0,0,0,0,0,0,0,0,0,0,0,0,0,0,1037953,"2023-12-19T00:00:00.000Z",112,17,"Jae Crowder",0,0,0,0,0,0
"10924",1055,0,0,0,0,0,0,0,0,0,0,0,0,0,0,0,0,1037953,"2023-12-19T00:00:00.000Z",56677854,17,"Chris Livingston",0,0,0,0,0,0
"10925",1056,0,0,0,0,0,0,0,0,0,0,0,0,0,0,0,0,1037953,"2023-12-19T00:00:00.000Z",38017691,17,"TyTy Washington Jr.",0,0,0,0,0,0
"10926",1057,0,0,0,0,0,0,0,0,0,0,0,0,0,0,0,0,1037953,"2023-12-19T00:00:00.000Z",666960,17,"Lindell Wigginton",0,0,0,0,0,0
"10927",1058,0,0,0,0,0,0,0,0,0,0,0,0,0,0,0,0,1037954,"2023-12-19T00:00:00.000Z",185,10,"Draymond Green",0,0,0,0,0,0
"10928",1059,4,1,4,15,6,21,9,0,0,40,0,0,24,4,1,1,1037954,"2023-12-19T00:00:00.000Z",443,10,"Klay Thompson",2,28,32,28,8,39.8
"10929",1060,2,0,3,4,1,13,8,2,0,34,4,0,17,7,2,1,1037954,"2023-12-19T00:00:00.000Z",17553979,10,"Jonathan Kuminga",2,24,26,19,9,33.4
"10930",1061,2,0,5,0,0,2,1,1,1,14,1,0,3,6,0,1,1037954,"2023-12-19T00:00:00.000Z",282,10,"Kevon Looney",0,9,11,5,8,12.2
"10931",1062,1,0,4,3,1,4,2,0,0,16,1,2,5,5,1,1,1037954,"2023-12-19T00:00:00.000Z",56677858,10,"Brandin Podziemski",1,10,11,6,6,14.5
"10932",1063,6,0,3,11,6,21,11,5,5,38,0,5,33,3,0,4,1037954,"2023-12-19T00:00:00.000Z",115,10,"Stephen Curry",0,36,42,39,9,41.6
"10933",1064,0,1,6,1,1,4,2,0,0,21,3,3,5,9,3,2,1037955,"2023-12-19T00:00:00.000Z",56677850,25,"Toumani Camara",4,14,14,5,9,25.8
"10934",1065,4,2,1,4,3,15,8,3,3,36,0,2,22,1,0,2,1037955,"2023-12-19T00:00:00.000Z",182,25,"Jerami Grant",2,23,27,26,5,33.2
"10935",1066,3,0,11,0,0,18,6,4,4,40,4,3,16,15,0,3,1037955,"2023-12-19T00:00:00.000Z",22,25,"Deandre Ayton",0,31,34,19,18,35.5
"10936",1067,0,0,1,0,0,1,0,0,0,8,0,2,0,1,0,0,1037955,"2023-12-19T00:00:00.000Z",38017690,25,"Shaedon Sharpe",0,1,1,0,1,1.2
"10937",1068,7,0,3,7,2,23,9,5,3,38,0,2,23,3,1,1,1037955,"2023-12-19T00:00:00.000Z",419,25,"Anfernee Simons",1,26,33,30,10,39.1
"10938",1069,4,0,4,9,4,10,5,0,0,32,0,0,14,4,0,1,1037955,"2023-12-19T00:00:00.000Z",65,25,"Malcolm Brogdon",0,18,22,18,8,23.8
"10939",1070,0,0,0,0,0,0,0,0,0,0,0,0,0,0,0,0,1037955,"2023-12-19T00:00:00.000Z",666476,25,"Moses Brown",0,0,0,0,0,0
"10940",1071,12,0,6,5,1,12,4,0,0,35,1,2,9,7,0,0,1037954,"2023-12-19T00:00:00.000Z",367,10,"Chris Paul",0,16,28,21,19,35.4
"10941",1072,0,3,5,3,1,10,6,15,11,29,1,4,24,6,0,2,1037952,"2023-12-19T00:00:00.000Z",231,15,"Jaren Jackson Jr.",3,30,30,24,6,38.2
"10942",1073,0,1,2,0,0,5,4,0,0,22,0,3,8,2,1,1,1037952,"2023-12-19T00:00:00.000Z",48,15,"Bismack Biyombo",2,10,10,8,2,15.4
"10943",1074,5,0,0,9,3,19,8,2,2,35,1,1,21,1,0,4,1037952,"2023-12-19T00:00:00.000Z",3547287,15,"Desmond Bane",0,22,27,26,6,25.7
"10944",1075,8,1,3,5,0,24,12,12,10,35,3,2,34,6,2,5,1037952,"2023-12-19T00:00:00.000Z",666786,15,"Ja Morant",3,40,48,42,14,57.2
"10945",1076,1,0,5,0,0,1,1,0,0,9,0,1,2,5,0,0,1037722,"2023-11-11T00:00:00.000Z",261,2,"Luke Kornet",0,7,8,3,6,9.5
"10946",1077,0,0,0,2,0,2,0,0,0,5,0,0,0,0,0,1,1037722,"2023-11-11T00:00:00.000Z",338,2,"Svi Mykhailiuk",0,0,0,0,0,-1
"10947",1078,0,0,0,0,0,0,0,0,0,0,0,0,0,0,0,0,1037722,"2023-11-11T00:00:00.000Z",3547279,2,"Lamar Stevens",0,0,0,0,0,0
"10948",1079,0,0,0,0,0,0,0,0,0,0,0,0,0,0,0,0,1037722,"2023-11-11T00:00:00.000Z",38017707,2,"JD Davison",0,0,0,0,0,0
"10949",1080,0,0,0,0,0,0,0,0,0,0,0,0,0,0,0,0,1037722,"2023-11-11T00:00:00.000Z",3547295,2,"Nathan Knight",0,0,0,0,0,0
"10950",1081,0,0,0,0,0,0,0,0,0,0,0,0,0,0,0,0,1037722,"2023-11-11T00:00:00.000Z",17553967,2,"Neemias Queta",0,0,0,0,0,0
"10951",1082,0,0,0,0,0,0,0,0,0,0,0,0,0,0,0,0,1037722,"2023-11-11T00:00:00.000Z",56677864,2,"Jordan Walsh",0,0,0,0,0,0
"10952",1083,2,0,2,8,2,13,3,0,0,28,1,0,8,3,1,0,1037722,"2023-11-11T00:00:00.000Z",18,28,"OG Anunoby",1,11,13,10,5,17.6
"10953",1084,3,0,5,4,0,17,6,6,5,28,2,0,17,7,3,3,1037722,"2023-11-11T00:00:00.000Z",416,28,"Pascal Siakam",3,24,27,20,10,35.9
"10954",1085,2,0,1,0,0,10,6,0,0,21,2,3,12,3,0,1,1037722,"2023-11-11T00:00:00.000Z",373,28,"Jakob Poeltl",0,15,17,14,5,17.6
"10955",1086,4,1,4,9,2,15,4,0,0,29,1,1,10,5,1,1,1037722,"2023-11-11T00:00:00.000Z",17896055,28,"Scottie Barnes",2,15,19,14,9,27
"10956",1087,4,0,1,3,1,7,3,7,7,25,0,3,14,1,1,1,1037722,"2023-11-11T00:00:00.000Z",409,28,"Dennis Schroder",1,15,19,18,5,23.2
"10957",1088,0,0,0,0,0,0,0,0,0,0,0,0,0,0,0,0,1037732,"2023-11-12T00:00:00.000Z",56677870,27,"Sir'Jabari Rice",0,0,0,0,0,0
"10958",1089,4,1,4,3,1,14,5,9,8,37,2,1,19,6,0,2,1037732,"2023-11-12T00:00:00.000Z",79,16,"Jimmy Butler",1,25,29,23,10,33.2
"10959",1090,1,0,3,3,0,4,0,0,0,26,1,3,0,4,0,0,1037732,"2023-11-12T00:00:00.000Z",3092,16,"Haywood Highsmith",0,4,5,1,5,6.3
"10960",1091,6,0,7,0,0,20,10,5,4,34,4,0,24,11,3,0,1037732,"2023-11-12T00:00:00.000Z",4,16,"Bam Adebayo",3,35,41,30,17,55.2
"10961",1092,4,1,4,7,4,16,8,6,6,39,1,1,26,5,0,0,1037732,"2023-11-12T00:00:00.000Z",397,16,"Duncan Robinson",1,31,35,30,9,41
"10962",1093,4,0,3,4,2,7,4,2,2,26,0,2,12,3,1,0,1037732,"2023-11-12T00:00:00.000Z",391,16,"Josh Richardson",1,15,19,16,7,24.6
"10963",1094,3,1,5,2,1,10,4,2,2,32,1,1,11,6,4,1,1037732,"2023-11-12T00:00:00.000Z",56677785,16,"Jaime Jaquez Jr.",5,17,20,14,9,36.7
"10964",1095,0,0,2,7,2,8,3,4,4,14,0,2,12,2,0,0,1037732,"2023-11-12T00:00:00.000Z",285,16,"Kevin Love",0,14,14,12,2,14.4
"10965",1096,0,0,0,0,0,0,0,0,0,0,0,0,0,0,0,0,1037723,"2023-11-11T00:00:00.000Z",56677806,1,"Mouhamed Gueye",0,0,0,0,0,0
"10966",1097,0,0,0,0,0,0,0,0,0,0,0,0,0,0,0,0,1037723,"2023-11-11T00:00:00.000Z",56677855,1,"Seth Lundy",0,0,0,0,0,0
"10967",1098,0,0,0,0,0,0,0,0,0,0,0,0,0,0,0,0,1037723,"2023-11-11T00:00:00.000Z",56677875,1,"Miles Norris",0,0,0,0,0,0
"10968",1099,4,0,2,7,2,17,8,2,2,38,1,3,20,3,1,3,1037723,"2023-11-11T00:00:00.000Z",56677785,16,"Jaime Jaquez Jr.",1,23,27,24,7,29.6
"10969",1100,5,1,5,5,0,13,3,7,5,34,1,2,11,6,2,1,1037723,"2023-11-11T00:00:00.000Z",3092,16,"Haywood Highsmith",3,17,22,16,11,33.7
"10970",1101,0,0,0,0,0,0,0,0,0,0,0,0,0,0,0,0,1037993,"2023-12-25T00:00:00.000Z",666453,17,"Marques Bolden",0,0,0,0,0,0
"10971",1102,0,0,0,0,0,0,0,0,0,0,0,0,0,0,0,0,1037993,"2023-12-25T00:00:00.000Z",112,17,"Jae Crowder",0,0,0,0,0,0
"10972",1103,0,0,0,0,0,0,0,0,0,0,0,0,0,0,0,0,1037993,"2023-12-25T00:00:00.000Z",38017691,17,"TyTy Washington Jr.",0,0,0,0,0,0
"10973",1104,0,0,0,0,0,0,0,0,0,0,0,0,0,0,0,0,1037993,"2023-12-25T00:00:00.000Z",666960,17,"Lindell Wigginton",0,0,0,0,0,0
"10974",1105,0,0,0,0,0,0,0,0,0,0,0,0,0,0,0,0,1037994,"2023-12-25T00:00:00.000Z",17896070,10,"Usman Garuba",0,0,0,0,0,0
"10975",1106,0,0,0,0,0,0,0,0,0,0,0,0,0,0,0,0,1037994,"2023-12-25T00:00:00.000Z",185,10,"Draymond Green",0,0,0,0,0,0
"10976",1107,0,0,0,0,0,0,0,0,0,0,0,0,0,0,0,0,1037994,"2023-12-25T00:00:00.000Z",38017727,8,"Collin Gillespie",0,0,0,0,0,0
"10977",1108,0,0,0,0,0,0,0,0,0,0,0,0,0,0,0,0,1037994,"2023-12-25T00:00:00.000Z",17896103,8,"Jay Huff",0,0,0,0,0,0
"10978",1109,1,1,6,10,3,12,3,0,0,32,0,1,9,6,1,3,1037994,"2023-12-25T00:00:00.000Z",443,10,"Klay Thompson",2,15,16,10,7,20.7
"10979",1110,2,0,5,1,0,8,4,8,5,23,0,1,13,5,0,1,1037994,"2023-12-25T00:00:00.000Z",17553979,10,"Jonathan Kuminga",0,18,20,15,7,21
"10980",1111,2,0,3,0,0,3,2,0,0,22,0,3,4,3,0,1,1037994,"2023-12-25T00:00:00.000Z",282,10,"Kevon Looney",0,7,9,6,5,9.6
"10981",1112,6,0,5,4,3,7,4,2,2,34,4,1,13,9,5,2,1037994,"2023-12-25T00:00:00.000Z",56677858,10,"Brandin Podziemski",5,22,28,19,15,45.8
"10982",1113,4,1,1,13,3,21,7,1,1,34,1,4,18,2,1,3,1037994,"2023-12-25T00:00:00.000Z",115,10,"Stephen Curry",2,20,24,22,6,29.4
"10983",1114,3,0,2,5,3,10,5,0,0,28,1,1,13,3,0,1,1037994,"2023-12-25T00:00:00.000Z",367,10,"Chris Paul",0,16,19,16,6,20.1
"10984",1115,1,0,3,0,0,4,3,2,2,15,0,5,8,3,0,0,1037994,"2023-12-25T00:00:00.000Z",56677799,10,"Trayce Jackson-Davis",0,11,12,9,4,13.1
"10985",1116,2,1,2,4,2,11,7,6,6,29,1,5,22,3,0,2,1037994,"2023-12-25T00:00:00.000Z",475,10,"Andrew Wiggins",1,25,27,24,5,29.6
"10986",1117,2,0,3,3,0,11,5,4,4,20,2,2,14,5,0,0,1037994,"2023-12-25T00:00:00.000Z",407,10,"Dario Saric",0,19,21,16,7,23
"10987",1118,0,0,0,0,0,0,0,0,0,3,0,0,0,0,0,0,1037994,"2023-12-25T00:00:00.000Z",17553992,10,"Moses Moody",0,0,0,0,0,0
"10988",1119,0,0,0,0,0,0,0,0,0,0,0,0,0,0,0,0,1037994,"2023-12-25T00:00:00.000Z",251,10,"Cory Joseph",0,0,0,0,0,0
"10989",1120,0,0,0,0,0,0,0,0,0,0,0,0,0,0,0,0,1037994,"2023-12-25T00:00:00.000Z",57875092,10,"Gui Santos",0,0,0,0,0,0
"10990",1121,0,0,0,0,0,0,0,0,0,0,0,0,0,0,0,0,1037994,"2023-12-25T00:00:00.000Z",2189,10,"Gary Payton II",0,0,0,0,0,0
"10991",1122,0,0,0,0,0,0,0,0,0,0,0,0,0,0,0,0,1037994,"2023-12-25T00:00:00.000Z",45658838,10,"Lester Quinones",0,0,0,0,0,0
"10992",1123,0,0,0,0,0,0,0,0,0,0,0,0,0,0,0,0,1037994,"2023-12-25T00:00:00.000Z",398,10,"Jerome Robinson",0,0,0,0,0,0
"10993",1124,0,0,0,1,1,2,1,2,2,18,0,2,5,0,0,2,1037995,"2023-12-25T00:00:00.000Z",666860,14,"Cameron Reddish",0,5,5,5,0,3
"10994",1125,0,0,2,0,0,5,3,0,0,23,4,4,6,6,1,0,1037995,"2023-12-25T00:00:00.000Z",457,14,"Jarred Vanderbilt",1,12,12,6,6,16.2
"10995",1126,0,0,0,0,0,0,0,0,0,0,0,0,0,0,0,0,1037772,"2023-11-18T00:00:00.000Z",666969,19,"Zion Williamson",0,0,0,0,0,0
"10996",1127,0,0,0,0,0,0,0,0,0,0,0,0,0,0,0,0,1037772,"2023-11-18T00:00:00.000Z",17896097,19,"Jose Alvarado",0,0,0,0,0,0
"10997",1128,0,0,0,0,0,0,0,0,0,0,0,0,0,0,0,0,1037772,"2023-11-18T00:00:00.000Z",38017663,19,"E.J. Liddell",0,0,0,0,0,0
"10998",1129,0,0,0,0,0,0,0,0,0,0,0,0,0,0,0,0,1037772,"2023-11-18T00:00:00.000Z",303,19,"CJ McCollum",0,0,0,0,0,0
"10999",1130,0,0,0,0,0,0,0,0,0,0,0,0,0,0,0,0,1037774,"2023-11-18T00:00:00.000Z",112,17,"Jae Crowder",0,0,0,0,0,0
"11000",1131,0,0,0,0,0,0,0,0,0,0,0,0,0,0,0,0,1037774,"2023-11-18T00:00:00.000Z",56677854,17,"Chris Livingston",0,0,0,0,0,0
"11001",1132,0,0,0,0,0,0,0,0,0,0,0,0,0,0,0,0,1037774,"2023-11-18T00:00:00.000Z",315,17,"Khris Middleton",0,0,0,0,0,0
"11002",1133,1,0,6,2,0,7,0,0,0,19,2,1,0,8,0,2,1037774,"2023-11-18T00:00:00.000Z",247,7,"Derrick Jones Jr.",0,8,9,1,9,9.1
"11003",1134,2,1,4,3,1,5,3,0,0,17,1,1,7,5,0,0,1037773,"2023-11-18T00:00:00.000Z",110,5,"Torrey Craig",1,12,14,9,7,19
"11004",1135,1,0,1,9,3,9,3,0,0,14,0,2,9,1,0,0,1037773,"2023-11-18T00:00:00.000Z",87,5,"Jevon Carter",0,10,11,10,2,11.7
"11005",1136,2,0,1,2,0,2,0,2,2,13,0,2,2,1,0,1,1037773,"2023-11-18T00:00:00.000Z",17895983,5,"Ayo Dosunmu",0,3,5,4,3,5.2
"11006",1137,0,1,6,0,0,3,2,2,2,15,3,3,6,9,1,1,1037773,"2023-11-18T00:00:00.000Z",137,5,"Andre Drummond",2,15,15,6,9,21.8
"11007",1138,1,1,1,1,0,5,1,0,0,15,3,2,2,4,1,0,1037773,"2023-11-18T00:00:00.000Z",3547248,5,"Patrick Williams",2,6,7,3,5,14.3
"11008",1139,0,0,0,0,0,0,0,0,0,0,0,0,0,0,0,0,1037773,"2023-11-18T00:00:00.000Z",17896116,5,"Terry Taylor",0,0,0,0,0,0
"11009",1140,0,0,0,0,0,0,0,0,0,0,0,0,0,0,0,0,1037773,"2023-11-18T00:00:00.000Z",38017719,5,"Dalen Terry",0,0,0,0,0,0
"11010",1141,0,0,0,0,0,0,0,0,0,0,0,0,0,0,0,0,1037773,"2023-11-18T00:00:00.000Z",27,5,"Lonzo Ball",0,0,0,0,0,0
"11011",1142,0,0,0,0,0,0,0,0,0,0,0,0,0,0,0,0,1037773,"2023-11-18T00:00:00.000Z",38017736,16,"Cole Swider",0,0,0,0,0,0
"11012",1143,0,0,0,0,0,0,0,0,0,0,0,0,0,0,0,0,1037775,"2023-11-18T00:00:00.000Z",56677870,27,"Sir'Jabari Rice",0,0,0,0,0,0
"11013",1144,0,0,0,0,0,0,0,0,0,0,0,0,0,0,0,0,1037775,"2023-11-18T00:00:00.000Z",3547246,27,"Devin Vassell",0,0,0,0,0,0
"11014",1145,4,0,2,6,3,15,8,7,7,34,3,5,26,5,1,2,1037775,"2023-11-18T00:00:00.000Z",3547287,15,"Desmond Bane",1,31,35,30,9,39
"11015",1146,0,1,2,8,2,20,7,12,11,27,3,3,27,5,1,2,1037775,"2023-11-18T00:00:00.000Z",231,15,"Jaren Jackson Jr.",2,32,32,27,5,37
"11016",1147,4,0,2,9,3,13,5,3,3,36,0,4,16,2,0,4,1037776,"2023-11-18T00:00:00.000Z",443,10,"Klay Thompson",0,18,22,20,6,20.4
"11017",1148,3,1,1,8,5,19,12,4,2,35,0,4,31,1,0,0,1037776,"2023-11-18T00:00:00.000Z",475,10,"Andrew Wiggins",1,32,35,34,4,39.7
"11018",1149,5,1,9,0,0,5,3,0,0,35,5,0,6,14,1,1,1037776,"2023-11-18T00:00:00.000Z",282,10,"Kevon Looney",2,20,25,11,19,35.3
"11019",1150,11,1,3,7,4,9,4,0,0,38,1,3,12,4,3,0,1037776,"2023-11-18T00:00:00.000Z",367,10,"Chris Paul",4,16,27,23,15,45.3
"11020",1151,4,1,6,0,0,7,3,3,1,19,3,1,7,9,0,3,1038057,"2024-01-03T00:00:00.000Z",444,6,"Tristan Thompson",1,16,20,11,13,23.8
"11021",1152,0,1,1,1,0,3,2,0,0,6,0,0,4,1,0,0,1038057,"2024-01-03T00:00:00.000Z",248,6,"Damian Jones",1,5,5,4,1,8.2
"11022",1153,0,0,0,0,0,0,0,0,0,0,0,0,0,0,0,0,1038057,"2024-01-03T00:00:00.000Z",666676,6,"Ty Jerome",0,0,0,0,0,0
"11023",1154,0,0,0,0,0,0,0,0,0,0,0,0,0,0,0,0,1038057,"2024-01-03T00:00:00.000Z",56677847,6,"Emoni Bates",0,0,0,0,0,0
"11024",1155,0,0,0,0,0,0,0,0,0,0,0,0,0,0,0,0,1038057,"2024-01-03T00:00:00.000Z",666581,6,"Darius Garland",0,0,0,0,0,0
"11025",1156,0,0,0,0,0,0,0,0,0,0,0,0,0,0,0,0,1038057,"2024-01-03T00:00:00.000Z",17896076,6,"Evan Mobley",0,0,0,0,0,0
"11026",1157,2,0,4,1,1,4,4,0,0,22,0,2,9,4,3,0,1038058,"2024-01-03T00:00:00.000Z",3547250,12,"Aaron Nesmith",3,13,15,11,6,25.8
"11027",1158,3,0,5,4,1,8,5,2,2,19,2,2,13,7,0,1,1038058,"2024-01-03T00:00:00.000Z",3547264,12,"Jalen Smith",0,20,23,16,10,24.9
"11028",1159,2,2,7,4,1,9,6,4,2,30,0,4,15,7,0,2,1038058,"2024-01-03T00:00:00.000Z",452,12,"Myles Turner",2,22,24,17,9,30.4
"11029",1160,2,0,5,1,0,7,5,6,5,28,0,6,15,5,0,4,1038058,"2024-01-03T00:00:00.000Z",69,12,"Bruce Brown",0,20,22,17,7,20
"11030",1161,12,3,2,11,5,20,10,6,6,34,0,1,31,2,1,0,1038058,"2024-01-03T00:00:00.000Z",3547245,12,"Tyrese Haliburton",4,33,45,43,14,63.4
"11031",1162,0,0,0,4,2,8,3,3,2,13,0,1,10,0,1,0,1038058,"2024-01-03T00:00:00.000Z",210,12,"Buddy Hield",1,10,10,10,0,13
"11032",1163,0,0,0,0,0,0,0,0,0,0,0,0,0,0,0,0,1038053,"2024-01-02T00:00:00.000Z",17896017,19,"Matt Ryan",0,0,0,0,0,0
"11033",1164,0,0,0,0,0,0,0,0,0,0,0,0,0,0,0,0,1038053,"2024-01-02T00:00:00.000Z",38017726,19,"Dereon Seabron",0,0,0,0,0,0
"11034",1165,2,0,4,9,5,12,6,0,0,27,0,2,17,4,1,1,1038053,"2024-01-02T00:00:00.000Z",666679,3,"Cameron Johnson",1,21,23,19,6,26.8
"11035",1166,1,0,3,4,1,6,1,0,0,20,1,1,3,4,2,0,1038053,"2024-01-02T00:00:00.000Z",158,3,"Dorian Finney-Smith",2,7,8,4,5,15.3
"11036",1167,1,2,3,0,0,7,4,0,0,23,0,1,8,3,0,0,1038053,"2024-01-02T00:00:00.000Z",666508,3,"Nicolas Claxton",2,11,12,9,4,19.1
"11037",1168,2,0,1,5,2,11,4,3,3,29,2,0,13,3,0,4,1038053,"2024-01-02T00:00:00.000Z",61,3,"Mikal Bridges",0,16,18,15,5,15.6
"11038",1169,5,0,0,4,0,6,0,0,0,21,0,1,0,0,0,1,1038053,"2024-01-02T00:00:00.000Z",130,3,"Spencer Dinwiddie",0,0,5,5,5,6.5
"11039",1170,5,0,4,5,0,6,0,0,0,28,4,3,0,8,1,3,1038053,"2024-01-02T00:00:00.000Z",351,3,"Royce O'Neale",1,8,13,5,13,17.1
"11040",1171,2,0,4,5,2,6,3,0,0,22,1,5,8,5,0,2,1038052,"2024-01-02T00:00:00.000Z",38017731,15,"Vince Williams Jr.",0,13,15,10,7,15
"11041",1172,0,0,0,0,0,0,0,0,0,1,0,0,0,0,0,0,1038052,"2024-01-02T00:00:00.000Z",17896027,15,"Ziaire Williams",0,0,0,0,0,0
"11042",1173,2,0,2,6,1,12,4,2,1,37,1,5,10,3,3,1,1038056,"2024-01-02T00:00:00.000Z",38017688,26,"Keegan Murray",3,13,15,12,5,24.6
"11043",1174,4,0,10,1,1,21,11,1,0,35,9,5,23,19,1,11,1038056,"2024-01-02T00:00:00.000Z",406,26,"Domantas Sabonis",1,42,46,27,23,43.8
"11044",1175,4,0,3,4,2,11,5,0,0,29,4,1,12,7,1,1,1038056,"2024-01-02T00:00:00.000Z",17896030,26,"Chris Duarte",1,19,23,16,11,28.4
"11045",1176,0,0,0,0,0,0,0,0,0,0,0,0,0,0,0,0,1037826,"2023-11-25T00:00:00.000Z",56677847,6,"Emoni Bates",0,0,0,0,0,0
"11046",1177,0,0,0,0,0,0,0,0,0,0,0,0,0,0,0,0,1037826,"2023-11-25T00:00:00.000Z",666676,6,"Ty Jerome",0,0,0,0,0,0
"11047",1178,0,0,0,0,0,0,0,0,0,0,0,0,0,0,0,0,1037826,"2023-11-25T00:00:00.000Z",38017662,6,"Isaiah Mobley",0,0,0,0,0,0
"11048",1179,0,0,0,0,0,0,0,0,0,0,0,0,0,0,0,0,1037826,"2023-11-25T00:00:00.000Z",404,6,"Ricky Rubio",0,0,0,0,0,0
"11049",1180,0,0,0,0,0,0,0,0,0,0,0,0,0,0,0,0,1037826,"2023-11-25T00:00:00.000Z",666940,6,"Dean Wade",0,0,0,0,0,0
"11050",1181,10,0,4,2,1,8,4,6,6,32,1,1,15,5,2,2,1037826,"2023-11-25T00:00:00.000Z",17553995,14,"Austin Reaves",2,20,30,25,15,40
"11051",1182,0,0,2,3,2,7,5,1,1,17,1,1,13,3,0,1,1037826,"2023-11-25T00:00:00.000Z",486,14,"Christian Wood",0,16,16,13,3,15.6
"11052",1183,0,0,0,0,0,0,0,0,0,0,0,0,0,0,0,0,1037826,"2023-11-25T00:00:00.000Z",56677738,14,"Colin Castleton",0,0,0,0,0,0
"11053",1184,0,0,0,0,0,0,0,0,0,0,0,0,0,0,0,0,1037826,"2023-11-25T00:00:00.000Z",666609,14,"Rui Hachimura",0,0,0,0,0,0
"11054",1185,0,0,0,0,0,0,0,0,0,0,0,0,0,0,0,0,1037826,"2023-11-25T00:00:00.000Z",666860,14,"Cameron Reddish",0,0,0,0,0,0
"11055",1186,0,0,0,0,0,0,0,0,0,0,0,0,0,0,0,0,1037826,"2023-11-25T00:00:00.000Z",457,14,"Jarred Vanderbilt",0,0,0,0,0,0
"11056",1187,0,0,0,0,0,0,0,0,0,0,0,0,0,0,0,0,1037826,"2023-11-25T00:00:00.000Z",1603383,14,"Gabe Vincent",0,0,0,0,0,0
"11057",1188,0,0,0,0,0,0,0,0,0,0,0,0,0,0,0,0,1037828,"2023-11-25T00:00:00.000Z",17896022,13,"Brandon Boston Jr.",0,0,0,0,0,0
"11058",1189,0,0,0,0,0,0,0,0,0,0,0,0,0,0,0,0,1037828,"2023-11-25T00:00:00.000Z",56677856,13,"Jordan Miller",0,0,0,0,0,0
"11059",1190,0,0,0,0,0,0,0,0,0,0,0,0,0,0,0,0,1037828,"2023-11-25T00:00:00.000Z",24417679,13,"Xavier Moon",0,0,0,0,0,0
"11060",1191,0,0,0,0,0,0,0,0,0,0,0,0,0,0,0,0,1037828,"2023-11-25T00:00:00.000Z",371,13,"Mason Plumlee",0,0,0,0,0,0
"11061",1192,0,0,0,0,0,0,0,0,0,0,0,0,0,0,0,0,1037828,"2023-11-25T00:00:00.000Z",17896051,13,"Joshua Primo",0,0,0,0,0,0
"11062",1193,1,1,1,3,1,5,1,2,1,20,0,1,4,1,1,0,1037828,"2023-11-25T00:00:00.000Z",247,7,"Derrick Jones Jr.",2,5,6,5,2,12.7
"11063",1194,1,0,1,2,1,3,2,0,0,35,3,4,5,4,0,1,1037828,"2023-11-25T00:00:00.000Z",666965,7,"Grant Williams",0,9,10,6,5,10.3
"11064",1195,1,2,3,0,0,4,0,2,0,21,2,3,0,5,0,0,1037828,"2023-11-25T00:00:00.000Z",217,7,"Richaun Holmes",2,5,6,1,6,13.5
"11065",1196,3,0,6,7,3,22,11,1,1,32,0,3,26,6,1,1,1037828,"2023-11-25T00:00:00.000Z",228,7,"Kyrie Irving",1,32,35,29,9,39.7
"11066",1197,4,2,3,8,1,27,12,5,5,38,0,4,30,3,2,4,1037828,"2023-11-25T00:00:00.000Z",132,7,"Luka Doncic",4,33,37,34,7,47.6
"11067",1198,3,0,2,0,0,0,0,2,2,15,0,2,2,2,0,0,1037828,"2023-11-25T00:00:00.000Z",379,7,"Dwight Powell",0,4,7,5,5,8.9
"11068",1199,0,0,3,9,2,14,5,0,0,29,0,2,12,3,0,1,1037828,"2023-11-25T00:00:00.000Z",191,7,"Tim Hardaway Jr.",0,15,15,12,3,14.6
"11069",1200,1,0,1,1,0,2,0,0,0,9,0,2,0,1,0,0,1037828,"2023-11-25T00:00:00.000Z",3547258,7,"Josh Green",0,1,2,1,2,2.7
"11070",1201,6,2,1,5,1,15,6,4,4,31,0,3,17,1,1,4,1038116,"2024-01-10T00:00:00.000Z",335,8,"Jamal Murray",3,18,24,23,7,32.2
"11071",1202,1,0,3,2,1,4,2,0,0,17,0,1,5,3,1,1,1038116,"2024-01-10T00:00:00.000Z",38017709,8,"Christian Braun",1,8,9,6,4,12.1
"11072",1203,2,0,2,4,2,9,5,0,0,24,1,1,12,3,0,0,1038118,"2024-01-10T00:00:00.000Z",3089,28,"Gary Trent Jr.",0,15,17,14,5,18.6
"11073",1204,1,0,2,1,1,2,1,0,0,9,0,2,3,2,0,0,1038118,"2024-01-10T00:00:00.000Z",436,28,"Garrett Temple",0,5,6,4,3,6.9
"11074",1205,0,0,0,0,0,0,0,0,0,0,0,0,0,0,0,0,1038118,"2024-01-10T00:00:00.000Z",376,28,"Otto Porter Jr.",0,0,0,0,0,0
"11075",1206,0,0,0,0,0,0,0,0,0,0,0,0,0,0,0,0,1038118,"2024-01-10T00:00:00.000Z",416,28,"Pascal Siakam",0,0,0,0,0,0
"11076",1207,0,0,0,0,0,0,0,0,0,0,0,0,0,0,0,0,1038118,"2024-01-10T00:00:00.000Z",56677828,28,"Gradey Dick",0,0,0,0,0,0
"11077",1208,0,0,0,0,0,0,0,0,0,0,0,0,0,0,0,0,1038118,"2024-01-10T00:00:00.000Z",56677805,28,"Javon Freeman-Liberty",0,0,0,0,0,0
"11078",1209,0,0,0,0,0,0,0,0,0,0,0,0,0,0,0,0,1038118,"2024-01-10T00:00:00.000Z",38017710,28,"Christian Koloko",0,0,0,0,0,0
"11079",1210,0,0,0,0,0,0,0,0,0,0,0,0,0,0,0,0,1038118,"2024-01-10T00:00:00.000Z",56677869,28,"Markquis Nowell",0,0,0,0,0,0
"11080",1211,0,0,0,0,0,0,0,0,0,0,0,0,0,0,0,0,1038118,"2024-01-10T00:00:00.000Z",373,28,"Jakob Poeltl",0,0,0,0,0,0
"11081",1212,1,1,2,0,0,11,9,1,1,22,3,1,19,5,1,1,1038117,"2024-01-10T00:00:00.000Z",56677799,10,"Trayce Jackson-Davis",2,24,25,20,6,31.5
"11082",1213,3,0,2,2,0,3,1,2,2,14,1,2,4,3,1,2,1038117,"2024-01-10T00:00:00.000Z",407,10,"Dario Saric",1,7,10,7,6,13.1
"11083",1214,2,0,1,2,0,3,1,0,0,17,2,2,2,3,0,2,1038117,"2024-01-10T00:00:00.000Z",251,10,"Cory Joseph",0,5,7,4,5,6.6
"11084",1215,0,1,1,5,2,12,4,2,2,35,3,4,12,4,0,1,1038119,"2024-01-11T00:00:00.000Z",3547247,6,"Isaac Okoro",1,16,16,12,4,18.8
"11085",1216,2,0,1,1,0,1,0,4,4,27,0,5,4,1,2,0,1038119,"2024-01-11T00:00:00.000Z",666940,6,"Dean Wade",2,5,7,6,3,14.2
"11086",1217,4,4,9,0,0,5,3,6,6,38,3,5,12,12,2,1,1038119,"2024-01-11T00:00:00.000Z",9,6,"Jarrett Allen",6,24,28,16,16,49.4
"11087",1218,0,0,0,2,0,2,0,0,0,7,0,0,0,0,0,0,1038119,"2024-01-11T00:00:00.000Z",666908,6,"Max Strus",0,0,0,0,0,0
"11088",1219,6,0,10,12,4,30,15,13,11,40,2,1,45,12,4,7,1038119,"2024-01-11T00:00:00.000Z",322,6,"Donovan Mitchell",4,57,63,51,18,73.4
"11089",1220,1,1,3,9,3,14,5,12,8,35,0,2,21,3,1,1,1038119,"2024-01-11T00:00:00.000Z",277,6,"Caris LeVert",2,24,25,22,4,31.1
"11090",1221,1,0,7,11,2,12,2,0,0,32,2,1,6,9,1,0,1038119,"2024-01-11T00:00:00.000Z",3547299,6,"Sam Merrill",1,15,16,7,10,21.3
"11091",1222,2,0,3,4,2,6,3,2,2,16,1,3,10,4,0,0,1038119,"2024-01-11T00:00:00.000Z",344,6,"Georges Niang",0,14,16,12,6,17.8
"11092",1223,0,0,1,0,0,0,0,4,1,10,1,3,1,2,1,1,1038119,"2024-01-11T00:00:00.000Z",444,6,"Tristan Thompson",1,3,3,1,2,5.4
"11093",1224,0,0,0,0,0,0,0,0,0,0,0,0,0,0,0,0,1038119,"2024-01-11T00:00:00.000Z",56677847,6,"Emoni Bates",0,0,0,0,0,0
"11094",1225,0,0,0,0,0,0,0,0,0,0,0,0,0,0,0,0,1038119,"2024-01-11T00:00:00.000Z",248,6,"Damian Jones",0,0,0,0,0,0
"11095",1226,0,0,0,0,0,0,0,0,0,0,0,0,0,0,0,0,7049317,"2023-12-06T00:00:00.000Z",56677875,1,"Miles Norris",0,0,0,0,0,0
"11096",1227,0,0,0,0,0,0,0,0,0,0,0,0,0,0,0,0,7049315,"2023-12-06T00:00:00.000Z",56677869,28,"Markquis Nowell",0,0,0,0,0,0
"11097",1228,8,0,2,1,1,16,7,5,4,35,0,2,19,2,1,0,7049315,"2023-12-06T00:00:00.000Z",79,16,"Jimmy Butler",1,21,29,27,10,36.4
"11098",1229,3,1,10,7,4,16,9,4,2,31,2,1,24,12,0,0,7049315,"2023-12-06T00:00:00.000Z",666747,16,"Caleb Martin",1,36,39,27,15,45.9
"11099",1230,4,1,9,3,2,9,5,3,3,33,3,3,15,12,3,1,7049315,"2023-12-06T00:00:00.000Z",39398582,16,"Orlando Robinson",4,27,31,19,16,46.4
"11100",1231,7,0,5,10,3,19,9,0,0,32,1,1,21,6,1,0,7049315,"2023-12-06T00:00:00.000Z",397,16,"Duncan Robinson",1,27,34,28,13,41.7
"11101",1232,3,2,4,4,1,4,1,0,0,28,0,2,3,4,0,2,7049315,"2023-12-06T00:00:00.000Z",286,16,"Kyle Lowry",2,7,10,6,7,16.3
"11102",1233,2,4,1,0,0,6,2,4,3,22,0,2,7,1,0,0,7049318,"2023-12-06T00:00:00.000Z",12,18,"Kyle Anderson",4,8,10,9,3,23.2
"11103",1234,2,0,2,7,2,17,9,3,3,40,2,2,23,4,1,3,7049320,"2023-12-06T00:00:00.000Z",66,11,"Dillon Brooks",1,27,29,25,6,30.8
"11104",1235,1,0,14,1,1,4,2,1,1,32,4,1,6,18,0,3,7049320,"2023-12-06T00:00:00.000Z",38017684,11,"Jabari Smith Jr.",0,24,25,7,19,26.1
"11105",1236,7,2,5,2,0,13,8,11,5,35,1,4,21,6,1,4,7049320,"2023-12-06T00:00:00.000Z",17896062,11,"Alperen Sengun",3,27,34,28,13,43.7
"11106",1237,1,0,7,3,1,12,6,2,2,25,0,3,15,7,0,3,7049320,"2023-12-06T00:00:00.000Z",17895966,11,"Jalen Green",0,22,23,16,8,21.9
"11107",1238,9,1,3,7,3,14,4,0,0,38,0,0,11,3,3,3,7049320,"2023-12-06T00:00:00.000Z",458,11,"Fred VanVleet",4,14,23,20,12,37.1
"11108",1239,2,1,1,8,2,9,3,0,0,25,0,1,8,1,0,1,7049318,"2023-12-06T00:00:00.000Z",68,18,"Troy Brown Jr.",1,9,11,10,3,14.2
"11109",1240,2,1,5,7,1,18,7,0,0,29,3,2,15,8,0,1,7049318,"2023-12-06T00:00:00.000Z",667378,18,"Naz Reid",1,23,25,17,10,29.6
"11110",1241,0,0,1,1,0,2,0,0,0,12,0,0,0,1,0,0,7049318,"2023-12-06T00:00:00.000Z",320,18,"Shake Milton",0,1,1,0,1,1.2
"11111",1242,0,0,0,0,0,0,0,0,0,0,0,0,0,0,0,0,7049318,"2023-12-06T00:00:00.000Z",38017715,18,"Josh Minott",0,0,0,0,0,0
"11112",1243,0,0,0,0,0,0,0,0,0,0,0,0,0,0,0,0,7049318,"2023-12-06T00:00:00.000Z",38017700,18,"Wendell Moore Jr.",0,0,0,0,0,0
"11113",1244,0,0,0,0,0,0,0,0,0,0,0,0,0,0,0,0,7049318,"2023-12-06T00:00:00.000Z",17895968,18,"Daishen Nix",0,0,0,0,0,0
"11114",1245,0,0,0,0,0,0,0,0,0,0,0,0,0,0,0,0,7049318,"2023-12-06T00:00:00.000Z",56677851,18,"Jaylen Clark",0,0,0,0,0,0
"11115",1246,0,0,0,0,0,0,0,0,0,0,0,0,0,0,0,0,7049318,"2023-12-06T00:00:00.000Z",17896056,18,"Luka Garza",0,0,0,0,0,0
"11116",1247,0,0,0,0,0,0,0,0,0,0,0,0,0,0,0,0,7049318,"2023-12-06T00:00:00.000Z",3547259,18,"Jaden McDaniels",0,0,0,0,0,0
"11117",1248,0,0,0,0,0,0,0,0,0,0,0,0,0,0,0,0,7049318,"2023-12-06T00:00:00.000Z",666767,18,"Jordan McLaughlin",0,0,0,0,0,0
"11118",1249,0,0,0,0,0,0,0,0,0,0,0,0,0,0,0,0,7049318,"2023-12-06T00:00:00.000Z",56677782,18,"Leonard Miller",0,0,0,0,0,0
"11119",1250,6,0,6,3,0,8,3,2,0,32,2,2,6,8,2,1,7049318,"2023-12-06T00:00:00.000Z",359,27,"Cedi Osman",2,14,20,12,14,29.6
"11120",1251,0,0,0,0,0,0,0,0,0,0,0,0,0,0,0,0,1037649,"2023-11-01T00:00:00.000Z",666754,1,"Garrison Mathews",0,0,0,0,0,0
"11121",1252,0,0,0,0,0,0,0,0,0,0,0,0,0,0,0,0,1037649,"2023-11-01T00:00:00.000Z",319,1,"Patty Mills",0,0,0,0,0,0
"11122",1253,0,0,0,0,0,0,0,0,0,0,0,0,0,0,0,0,1037649,"2023-11-01T00:00:00.000Z",56677855,1,"Seth Lundy",0,0,0,0,0,0
"11123",1254,0,0,0,0,0,0,0,0,0,0,0,0,0,0,0,0,1037649,"2023-11-01T00:00:00.000Z",301,1,"Wesley Matthews",0,0,0,0,0,0
"11124",1255,0,0,0,0,0,0,0,0,0,0,0,0,0,0,0,0,1037649,"2023-11-01T00:00:00.000Z",56677875,1,"Miles Norris",0,0,0,0,0,0
"11125",1256,3,1,2,4,2,16,10,1,0,24,3,5,22,5,2,1,1037649,"2023-11-01T00:00:00.000Z",3547242,30,"Deni Avdija",3,27,30,25,8,40.5
"11126",1257,6,0,9,6,1,21,11,3,2,25,0,1,25,9,0,1,1037649,"2023-11-01T00:00:00.000Z",265,30,"Kyle Kuzma",0,34,40,31,15,43.8
"11127",1258,1,1,3,4,1,7,2,2,2,22,1,3,7,4,1,2,1037649,"2023-11-01T00:00:00.000Z",337,30,"Mike Muscala",2,11,12,8,5,17.3
"11128",1259,1,0,0,6,2,13,5,1,1,20,0,1,13,0,1,1,1037649,"2023-11-01T00:00:00.000Z",666848,30,"Jordan Poole",1,13,14,14,1,16.5
"11129",1260,3,0,1,3,0,6,3,0,0,22,0,1,6,1,1,1,1037649,"2023-11-01T00:00:00.000Z",249,30,"Tyus Jones",1,7,10,9,4,13.7
"11130",1261,5,0,3,10,6,23,12,1,0,36,0,2,30,3,0,3,1037651,"2023-11-01T00:00:00.000Z",666633,16,"Tyler Herro",0,33,38,35,8,38.1
"11131",1262,3,1,3,5,2,5,2,0,0,30,0,3,6,3,2,2,1037651,"2023-11-01T00:00:00.000Z",286,16,"Kyle Lowry",3,9,12,9,6,21.1
"11132",1263,3,0,3,5,1,9,1,2,1,30,0,2,4,3,1,0,1037651,"2023-11-01T00:00:00.000Z",391,16,"Josh Richardson",1,7,10,7,6,15.1
"11133",1264,2,1,4,4,3,5,3,0,0,22,0,0,9,4,1,1,1037651,"2023-11-01T00:00:00.000Z",3092,16,"Haywood Highsmith",2,13,15,11,6,21.8
"11134",1265,2,0,3,6,1,8,2,0,0,21,0,4,5,3,0,1,1037651,"2023-11-01T00:00:00.000Z",397,16,"Duncan Robinson",0,8,10,7,5,10.6
"11135",1266,0,0,4,0,0,4,3,2,2,15,1,4,8,5,1,2,1037651,"2023-11-01T00:00:00.000Z",74,16,"Thomas Bryant",1,13,13,8,5,15
"11136",1267,0,0,0,0,0,0,0,0,0,0,0,0,0,0,0,0,1037651,"2023-11-01T00:00:00.000Z",38017696,16,"Nikola Jovic",0,0,0,0,0,0
"11137",1268,0,0,0,0,0,0,0,0,0,0,0,0,0,0,0,0,1037651,"2023-11-01T00:00:00.000Z",39398582,16,"Orlando Robinson",0,0,0,0,0,0
"11138",1269,0,0,0,0,0,0,0,0,0,0,0,0,0,0,0,0,1037651,"2023-11-01T00:00:00.000Z",19465585,16,"Dru Smith",0,0,0,0,0,0
"11139",1270,0,0,0,0,0,0,0,0,0,0,0,0,0,0,0,0,1037651,"2023-11-01T00:00:00.000Z",38017734,16,"Jamal Cain",0,0,0,0,0,0
"11140",1271,0,0,0,0,0,0,0,0,0,0,0,0,0,0,0,0,1037651,"2023-11-01T00:00:00.000Z",3547257,16,"R.J. Hampton",0,0,0,0,0,0
"11141",1272,0,0,0,0,0,0,0,0,0,0,0,0,0,0,0,0,1037651,"2023-11-01T00:00:00.000Z",285,16,"Kevin Love",0,0,0,0,0,0
"11142",1273,0,0,0,0,0,0,0,0,0,0,0,0,0,0,0,0,1037651,"2023-11-01T00:00:00.000Z",666747,16,"Caleb Martin",0,0,0,0,0,0
"11143",1274,0,2,3,3,1,9,4,0,0,18,2,3,9,5,0,0,1037655,"2023-11-01T00:00:00.000Z",3547268,8,"Zeke Nnaji",2,14,14,9,5,21
"11144",1275,1,0,2,1,0,3,2,0,0,16,0,2,4,2,0,2,1037655,"2023-11-01T00:00:00.000Z",38017721,8,"Peyton Watson",0,6,7,5,3,5.9
"11145",1276,4,0,2,3,1,6,4,0,0,36,4,6,9,6,0,1,1037938,"2023-12-17T00:00:00.000Z",56677852,17,"Andre Jackson Jr.",0,15,19,13,10,21.2
"11146",1277,11,0,5,8,5,19,11,13,12,36,0,2,39,5,3,3,1037938,"2023-12-17T00:00:00.000Z",278,17,"Damian Lillard",3,44,55,50,16,67.5
"11147",1278,0,0,2,2,1,7,5,0,0,24,4,3,11,6,0,0,1037938,"2023-12-17T00:00:00.000Z",377,17,"Bobby Portis",0,17,17,11,6,18.2
"11148",1279,0,0,0,0,0,0,0,0,0,0,0,0,0,0,0,0,1037937,"2023-12-17T00:00:00.000Z",38017726,19,"Dereon Seabron",0,0,0,0,0,0
"11149",1280,0,0,1,0,0,0,0,0,0,12,0,2,0,1,0,0,1037938,"2023-12-17T00:00:00.000Z",38017676,17,"MarJon Beauchamp",0,1,1,0,1,1.2
"11150",1281,4,0,1,3,1,4,2,0,0,17,1,0,5,2,1,1,1037938,"2023-12-17T00:00:00.000Z",105,17,"Pat Connaughton",1,7,11,9,6,15.4
"11151",1282,1,0,0,4,0,4,0,0,0,11,0,2,0,0,0,0,1037938,"2023-12-17T00:00:00.000Z",368,17,"Cameron Payne",0,0,1,1,1,1.5
"11152",1283,0,0,0,0,0,0,0,0,0,1,0,0,0,0,0,0,1037938,"2023-12-17T00:00:00.000Z",56677854,17,"Chris Livingston",0,0,0,0,0,0
"11153",1284,0,0,0,0,0,0,0,0,0,1,0,0,0,0,0,0,1037938,"2023-12-17T00:00:00.000Z",666453,17,"Marques Bolden",0,0,0,0,0,0
"11154",1285,0,0,0,0,0,0,0,0,0,1,0,0,0,0,0,0,1037938,"2023-12-17T00:00:00.000Z",38017733,17,"A.J. Green",0,0,0,0,0,0
"11155",1286,0,0,0,0,0,0,0,0,0,1,0,0,0,0,0,0,1037938,"2023-12-17T00:00:00.000Z",666960,17,"Lindell Wigginton",0,0,0,0,0,0
"11156",1287,0,0,0,0,0,0,0,0,0,1,0,0,0,0,0,0,1037938,"2023-12-17T00:00:00.000Z",2148,17,"Thanasis Antetokounmpo",0,0,0,0,0,0
"11157",1288,0,0,0,0,0,0,0,0,0,0,0,0,0,0,0,0,1037938,"2023-12-17T00:00:00.000Z",284,17,"Robin Lopez",0,0,0,0,0,0
"11158",1289,0,0,0,0,0,0,0,0,0,0,0,0,0,0,0,0,1037938,"2023-12-17T00:00:00.000Z",38,17,"Malik Beasley",0,0,0,0,0,0
"11159",1290,0,0,0,0,0,0,0,0,0,0,0,0,0,0,0,0,1037938,"2023-12-17T00:00:00.000Z",112,17,"Jae Crowder",0,0,0,0,0,0
"11160",1291,0,0,0,0,0,0,0,0,0,0,0,0,0,0,0,0,1037938,"2023-12-17T00:00:00.000Z",38017691,17,"TyTy Washington Jr.",0,0,0,0,0,0
"11161",1292,1,0,3,4,2,12,7,2,2,35,1,4,18,4,2,2,1037938,"2023-12-17T00:00:00.000Z",66,11,"Dillon Brooks",2,22,23,19,5,28.3
"11162",1293,2,1,5,4,1,13,7,1,1,28,0,5,16,5,0,0,1037938,"2023-12-17T00:00:00.000Z",38017684,11,"Jabari Smith Jr.",1,21,23,18,7,28
"11163",1294,5,1,6,3,0,15,8,6,4,31,2,4,20,8,1,0,1037938,"2023-12-17T00:00:00.000Z",17896062,11,"Alperen Sengun",2,28,33,25,13,43.1
"11164",1295,7,0,2,4,2,11,6,2,2,29,0,0,16,2,0,1,1037938,"2023-12-17T00:00:00.000Z",17895966,11,"Jalen Green",0,18,25,23,9,27.9
"11165",1296,6,2,1,8,4,16,8,2,2,39,1,2,22,2,1,1,1037938,"2023-12-17T00:00:00.000Z",458,11,"Fred VanVleet",3,24,30,28,8,41.4
"11166",1297,1,0,6,2,1,8,5,0,0,30,0,2,11,6,2,0,1037938,"2023-12-17T00:00:00.000Z",38017695,11,"Tari Eason",2,17,18,12,7,25.7
"11167",1298,2,0,1,1,0,3,0,0,0,12,0,2,0,1,1,2,1037938,"2023-12-17T00:00:00.000Z",213,11,"Aaron Holiday",1,1,3,2,3,5.2
"11168",1299,1,0,0,1,1,5,4,8,7,17,0,0,16,0,0,1,1037938,"2023-12-17T00:00:00.000Z",188,11,"Jeff Green",0,16,17,17,1,16.5
"11169",1300,1,0,1,0,0,2,0,0,0,19,2,2,0,3,1,2,1037938,"2023-12-17T00:00:00.000Z",3547301,11,"Jae'Sean Tate",1,3,4,1,4,6.1
"11170",1301,1,0,3,3,2,7,4,0,0,14,0,0,10,3,1,0,1037708,"2023-11-08T00:00:00.000Z",17553992,10,"Moses Moody",1,13,14,11,4,18.1
"11171",1302,0,0,0,0,0,2,1,0,0,11,0,0,2,0,0,0,1037708,"2023-11-08T00:00:00.000Z",38017721,8,"Peyton Watson",0,2,2,2,0,2
"11172",1303,0,0,1,1,0,1,0,0,0,8,0,2,0,1,0,0,1037708,"2023-11-08T00:00:00.000Z",56677776,8,"Julian Strawther",0,1,1,0,1,1.2
"11173",1304,2,0,2,0,0,1,0,0,0,6,0,0,0,2,0,0,1037708,"2023-11-08T00:00:00.000Z",3547268,8,"Zeke Nnaji",0,2,4,2,4,5.4
"11174",1305,0,0,0,0,0,0,0,0,0,0,0,0,0,0,0,0,1037708,"2023-11-08T00:00:00.000Z",17896007,8,"Braxton Key",0,0,0,0,0,0
"11175",1306,0,0,0,0,0,0,0,0,0,0,0,0,0,0,0,0,1037708,"2023-11-08T00:00:00.000Z",56677582,8,"Jalen Pickett",0,0,0,0,0,0
"11176",1307,0,0,0,0,0,0,0,0,0,0,0,0,0,0,0,0,1037708,"2023-11-08T00:00:00.000Z",56677871,8,"Hunter Tyson",0,0,0,0,0,0
"11177",1308,0,0,0,0,0,0,0,0,0,0,0,0,0,0,0,0,1037708,"2023-11-08T00:00:00.000Z",666489,8,"Vlatko Cancar",0,0,0,0,0,0
"11178",1309,0,0,0,0,0,0,0,0,0,0,0,0,0,0,0,0,1037708,"2023-11-08T00:00:00.000Z",17896103,8,"Jay Huff",0,0,0,0,0,0
"11179",1310,0,0,0,0,0,0,0,0,0,0,0,0,0,0,0,0,1037708,"2023-11-08T00:00:00.000Z",335,8,"Jamal Murray",0,0,0,0,0,0
"11180",1311,0,0,2,3,0,13,4,4,3,29,3,3,11,5,0,1,1037708,"2023-11-08T00:00:00.000Z",475,10,"Andrew Wiggins",0,16,16,11,5,16
"11181",1312,2,1,7,7,3,18,9,6,5,36,4,1,26,11,1,1,1037710,"2023-11-09T00:00:00.000Z",38017686,12,"Bennedict Mathurin",2,37,39,28,13,47.2
"11182",1313,0,0,0,2,1,3,2,2,2,13,0,4,7,0,0,1,1037710,"2023-11-09T00:00:00.000Z",3547243,12,"Obi Toppin",0,7,7,7,0,6
"11183",1314,4,1,5,9,4,16,8,1,1,37,1,4,21,6,0,1,1037710,"2023-11-09T00:00:00.000Z",452,12,"Myles Turner",1,27,31,25,10,36.2
"11184",1315,7,1,7,4,1,9,3,4,4,38,2,0,11,9,2,2,1037710,"2023-11-09T00:00:00.000Z",69,12,"Bruce Brown",3,20,27,18,16,39.3
"11185",1316,10,1,5,9,5,17,10,4,4,38,1,1,29,6,0,2,1037710,"2023-11-09T00:00:00.000Z",3547245,12,"Tyrese Haliburton",1,35,45,39,16,52.2
"11186",1317,2,0,2,11,2,14,4,1,1,22,0,3,11,2,1,2,1037710,"2023-11-09T00:00:00.000Z",210,12,"Buddy Hield",1,13,15,13,4,17.4
"11187",1318,0,2,2,0,0,2,1,2,1,11,1,3,3,3,1,0,1037710,"2023-11-09T00:00:00.000Z",17896035,12,"Isaiah Jackson",3,6,6,3,3,15.6
"11188",1319,0,0,1,3,2,4,2,0,0,17,0,5,6,1,0,1,1037710,"2023-11-09T00:00:00.000Z",3547250,12,"Aaron Nesmith",0,7,7,6,1,6.2
"11189",1320,2,0,2,2,2,5,4,0,0,20,0,3,10,2,1,1,1037710,"2023-11-09T00:00:00.000Z",38017507,12,"Andrew Nembhard",1,12,14,12,4,17.4
"11190",1321,0,0,0,1,0,4,1,0,0,8,0,1,2,0,0,0,1037710,"2023-11-09T00:00:00.000Z",439,12,"Daniel Theis",0,2,2,2,0,2
"11191",1322,0,0,0,0,0,0,0,0,0,0,0,0,0,0,0,0,1037710,"2023-11-09T00:00:00.000Z",304,12,"T.J. McConnell",0,0,0,0,0,0
"11192",1323,0,0,0,0,0,0,0,0,0,0,0,0,0,0,0,0,1037710,"2023-11-09T00:00:00.000Z",3547207,12,"Jordan Nwora",0,0,0,0,0,0
"11193",1324,0,0,0,0,0,0,0,0,0,0,0,0,0,0,0,0,1037710,"2023-11-09T00:00:00.000Z",56677861,12,"Ben Sheppard",0,0,0,0,0,0
"11194",1325,0,0,0,0,0,0,0,0,0,0,0,0,0,0,0,0,1037710,"2023-11-09T00:00:00.000Z",3547264,12,"Jalen Smith",0,0,0,0,0,0
"11195",1326,2,0,1,4,2,9,4,4,2,23,0,4,12,1,3,2,1037991,"2023-12-23T00:00:00.000Z",56677747,25,"Scoot Henderson",3,13,15,14,3,23.2
"11196",1327,2,0,1,5,1,6,2,0,0,16,1,0,5,2,1,0,1037991,"2023-12-23T00:00:00.000Z",666923,25,"Matisse Thybulle",1,7,9,7,4,13.4
"11197",1328,0,0,1,2,0,2,0,0,0,9,0,3,0,1,0,0,1037991,"2023-12-23T00:00:00.000Z",56783340,25,"Duop Reath",0,1,1,0,1,1.2
"11198",1329,1,0,0,0,0,2,0,2,1,5,0,0,1,0,0,1,1037991,"2023-12-23T00:00:00.000Z",3547289,25,"Skylar Mays",0,1,2,2,1,1.5
"11199",1330,0,0,1,0,0,1,1,0,0,5,1,2,2,2,1,0,1037991,"2023-12-23T00:00:00.000Z",56677791,25,"Kris Murray",1,4,4,2,2,7.4
"11200",1331,2,0,0,0,0,1,0,0,0,4,0,0,0,0,0,0,1037991,"2023-12-23T00:00:00.000Z",56677829,25,"Rayan Rupert",0,0,2,2,2,3
"11201",1332,0,0,1,1,1,1,1,0,0,4,0,1,3,1,0,0,1037991,"2023-12-23T00:00:00.000Z",17896120,25,"Ish Wainright",0,4,4,3,1,4.2
"11202",1333,0,0,0,0,0,0,0,0,0,0,0,0,0,0,0,0,1037991,"2023-12-23T00:00:00.000Z",666476,25,"Moses Brown",0,0,0,0,0,0
"11203",1334,1,1,2,0,0,5,5,4,4,22,2,4,14,4,1,0,1037990,"2023-12-23T00:00:00.000Z",379,7,"Dwight Powell",2,18,19,15,5,26.3
"11204",1335,0,0,2,1,0,3,0,0,0,12,0,1,0,2,0,0,1037990,"2023-12-23T00:00:00.000Z",56677859,7,"Olivier-Maxence Prosper",0,2,2,0,2,2.4
"11205",1336,5,1,4,5,4,9,8,0,0,33,1,5,20,5,1,0,1037986,"2023-12-23T00:00:00.000Z",3547267,9,"Isaiah Stewart",2,25,30,25,10,39.5
"11206",1337,7,2,6,6,3,11,6,10,8,35,0,4,23,6,0,3,1037986,"2023-12-23T00:00:00.000Z",38017682,9,"Jaden Ivey",2,29,36,30,13,43.7
"11207",1338,6,0,3,5,1,20,9,4,3,33,0,4,22,3,0,2,1037986,"2023-12-23T00:00:00.000Z",17896075,9,"Cade Cunningham",0,25,31,28,9,32.6
"11208",1339,0,0,0,0,0,0,0,0,0,0,0,0,0,0,0,0,1037990,"2023-12-23T00:00:00.000Z",329,7,"Markieff Morris",0,0,0,0,0,0
"11209",1340,0,0,0,0,0,0,0,0,0,0,0,0,0,0,0,0,1037990,"2023-12-23T00:00:00.000Z",3547258,7,"Josh Green",0,0,0,0,0,0
"11210",1341,0,0,0,0,0,0,0,0,0,0,0,0,0,0,0,0,1037990,"2023-12-23T00:00:00.000Z",228,7,"Kyrie Irving",0,0,0,0,0,0
"11211",1342,0,0,0,0,0,0,0,0,0,0,0,0,0,0,0,0,1037990,"2023-12-23T00:00:00.000Z",257,7,"Maxi Kleber",0,0,0,0,0,0
"11212",1343,0,0,0,0,0,0,0,0,0,0,0,0,0,0,0,0,1037990,"2023-12-23T00:00:00.000Z",56677840,7,"Dereck Lively II",0,0,0,0,0,0
"11213",1344,1,0,5,4,2,6,4,2,2,22,0,0,12,5,1,0,1037990,"2023-12-23T00:00:00.000Z",38017649,27,"Julian Champagnie",1,17,18,13,6,22.5
"11214",1345,0,0,0,0,0,0,0,0,0,0,0,0,0,0,0,0,1037985,"2023-12-23T00:00:00.000Z",254,15,"Luke Kennard",0,0,0,0,0,0
"11215",1346,0,0,0,0,0,0,0,0,0,0,0,0,0,0,0,0,1037985,"2023-12-23T00:00:00.000Z",401,15,"Derrick Rose",0,0,0,0,0,0
"11216",1347,4,0,7,6,4,16,9,2,1,30,2,2,23,9,0,3,1037990,"2023-12-23T00:00:00.000Z",38017699,27,"Jeremy Sochan",0,32,36,27,13,36.8
"11217",1348,0,0,3,2,0,3,0,2,2,14,0,2,2,3,2,0,1037990,"2023-12-23T00:00:00.000Z",56677817,27,"Sidy Cissoko",2,5,5,2,3,11.6
"11218",1349,0,1,3,2,0,4,2,2,1,18,2,2,5,5,0,1,1037991,"2023-12-23T00:00:00.000Z",38017711,25,"Jabari Walker",1,10,10,5,5,13
"11219",1350,0,0,0,0,0,0,0,0,0,0,0,0,0,0,0,0,1037991,"2023-12-23T00:00:00.000Z",39613724,25,"Ibou Badji",0,0,0,0,0,0
"11220",1351,0,0,0,0,0,0,0,0,0,0,0,0,0,0,0,0,3277451,"2023-11-17T00:00:00.000Z",56677857,5,"Julian Phillips",0,0,0,0,0,0
"11221",1352,0,0,0,0,0,0,0,0,0,0,0,0,0,0,0,0,3277450,"2023-11-17T00:00:00.000Z",17895990,26,"Jordan Ford",0,0,0,0,0,0
"11222",1353,0,0,0,0,0,0,0,0,0,0,0,0,0,0,0,0,3277450,"2023-11-17T00:00:00.000Z",56677845,26,"Colby Jones",0,0,0,0,0,0
"11223",1354,0,0,0,0,0,0,0,0,0,0,0,0,0,0,0,0,3277450,"2023-11-17T00:00:00.000Z",273,26,"Alex Len",0,0,0,0,0,0
"11224",1355,0,0,0,0,0,0,0,0,0,0,0,0,0,0,0,0,3277450,"2023-11-17T00:00:00.000Z",290,26,"Trey Lyles",0,0,0,0,0,0
"11225",1356,0,1,1,0,0,0,0,0,0,1,0,0,0,1,0,0,3277452,"2023-11-17T00:00:00.000Z",491,19,"Cody Zeller",1,1,1,0,1,4.2
"11226",1357,0,0,0,0,0,0,0,0,0,0,0,0,0,0,0,0,3277452,"2023-11-17T00:00:00.000Z",38017663,19,"E.J. Liddell",0,0,0,0,0,0
"11227",1358,0,0,0,0,0,0,0,0,0,0,0,0,0,0,0,0,3277452,"2023-11-17T00:00:00.000Z",303,19,"CJ McCollum",0,0,0,0,0,0
"11228",1359,0,0,0,0,0,0,0,0,0,0,0,0,0,0,0,0,3277452,"2023-11-17T00:00:00.000Z",18677986,19,"Trey Murphy III",0,0,0,0,0,0
"11229",1360,0,0,0,0,0,0,0,0,0,0,0,0,0,0,0,0,3277452,"2023-11-17T00:00:00.000Z",340,19,"Larry Nance Jr.",0,0,0,0,0,0
"11230",1361,0,0,0,0,0,0,0,0,0,0,0,0,0,0,0,0,3277452,"2023-11-17T00:00:00.000Z",38017726,19,"Dereon Seabron",0,0,0,0,0,0
"11231",1362,0,0,8,6,2,14,8,1,0,33,3,3,18,11,0,0,3277452,"2023-11-17T00:00:00.000Z",375,8,"Michael Porter Jr.",0,29,29,18,11,31.2
"11232",1363,2,0,7,4,0,14,7,3,0,39,1,4,14,8,2,0,3277452,"2023-11-17T00:00:00.000Z",177,8,"Aaron Gordon",2,22,24,16,10,32.6
"11233",1364,3,0,4,1,1,20,10,4,2,36,0,1,23,4,1,3,3277451,"2023-11-17T00:00:00.000Z",125,5,"DeMar DeRozan",1,27,30,26,7,32.3
"11234",1365,0,2,1,5,4,6,5,4,4,23,0,4,18,1,2,1,3277451,"2023-11-17T00:00:00.000Z",89,5,"Alex Caruso",4,19,19,18,1,30.2
"11235",1366,6,0,7,3,0,16,4,2,2,30,3,4,10,10,0,1,3277451,"2023-11-17T00:00:00.000Z",460,5,"Nikola Vucevic",0,20,26,16,16,30
"11236",1367,3,0,6,11,4,20,12,7,6,41,0,4,34,6,2,3,3277451,"2023-11-17T00:00:00.000Z",268,5,"Zach LaVine",2,40,43,37,9,48.7
"11237",1368,4,0,1,3,0,6,2,1,0,30,0,2,4,1,0,2,3277451,"2023-11-17T00:00:00.000Z",666956,5,"Coby White",0,5,9,8,5,9.2
"11238",1369,1,0,1,0,0,0,0,0,0,10,0,0,0,1,0,0,3277451,"2023-11-17T00:00:00.000Z",87,5,"Jevon Carter",0,1,2,1,2,2.7
"11239",1370,2,1,7,6,3,16,8,8,7,37,1,3,26,8,5,3,3277455,"2023-11-17T00:00:00.000Z",274,13,"Kawhi Leonard",6,34,36,28,10,53.6
"11240",1371,3,1,7,10,4,22,8,3,3,40,1,2,23,8,2,3,3277455,"2023-11-17T00:00:00.000Z",172,13,"Paul George",3,31,34,26,11,43.1
"11241",1372,2,2,4,0,0,8,6,2,0,35,3,2,12,7,0,1,3277455,"2023-11-17T00:00:00.000Z",493,13,"Ivica Zubac",2,19,21,14,9,28.4
"11242",1373,3,1,5,2,0,3,0,2,1,21,1,3,1,6,1,0,3277455,"2023-11-17T00:00:00.000Z",666743,13,"Terance Mann",2,7,10,4,9,18.7
"11243",1374,7,1,8,4,2,11,8,7,6,34,1,1,24,9,0,3,3277455,"2023-11-17T00:00:00.000Z",192,13,"James Harden",1,33,40,31,16,45.3
"11244",1375,0,0,0,0,0,0,0,0,0,0,0,0,0,0,0,0,3277455,"2023-11-17T00:00:00.000Z",666511,13,"Amir Coffey",0,0,0,0,0,0
"11245",1376,0,1,0,1,1,1,1,0,0,2,0,0,3,0,0,1,1038052,"2024-01-02T00:00:00.000Z",17896059,27,"Sandro Mamukelashvili",1,3,3,3,0,5
"11246",1377,1,0,1,2,0,8,5,2,0,21,0,4,10,1,2,1,1038052,"2024-01-02T00:00:00.000Z",38017693,27,"Blake Wesley",2,11,12,11,2,17.7
"11247",1378,0,0,0,0,0,0,0,0,0,0,0,0,0,0,0,0,1038052,"2024-01-02T00:00:00.000Z",3547163,27,"Mamadi Diakite",0,0,0,0,0,0
"11248",1379,0,0,0,0,0,0,0,0,0,0,0,0,0,0,0,0,1038052,"2024-01-02T00:00:00.000Z",180,27,"Devonte' Graham",0,0,0,0,0,0
"11249",1380,0,0,0,0,0,0,0,0,0,0,0,0,0,0,0,0,1038052,"2024-01-02T00:00:00.000Z",17895854,27,"Charles Bassey",0,0,0,0,0,0
"11250",1381,0,0,0,0,0,0,0,0,0,0,0,0,0,0,0,0,1038052,"2024-01-02T00:00:00.000Z",56677817,27,"Sidy Cissoko",0,0,0,0,0,0
"11251",1382,0,0,0,0,0,0,0,0,0,0,0,0,0,0,0,0,1038052,"2024-01-02T00:00:00.000Z",102,27,"Zach Collins",0,0,0,0,0,0
"11252",1383,0,0,0,0,0,0,0,0,0,0,0,0,0,0,0,0,1038052,"2024-01-02T00:00:00.000Z",17896049,27,"David Duke Jr.",0,0,0,0,0,0
"11253",1384,0,0,0,0,0,0,0,0,0,0,0,0,0,0,0,0,1038054,"2024-01-02T00:00:00.000Z",3547271,21,"Aleksej Pokusevski",0,0,0,0,0,0
"11254",1385,2,1,0,2,0,4,2,0,0,21,2,4,4,2,1,2,1038051,"2024-01-02T00:00:00.000Z",17896025,23,"Jaden Springer",2,6,8,6,4,13.4
"11255",1386,0,0,4,0,0,3,1,0,0,13,0,2,2,4,2,0,1038051,"2024-01-02T00:00:00.000Z",3547270,23,"Paul Reed",2,6,6,2,4,12.8
"11256",1387,1,0,0,0,0,3,0,0,0,9,0,0,0,0,0,0,1038051,"2024-01-02T00:00:00.000Z",3547294,23,"Kenyon Martin Jr.",0,0,1,1,1,1.5
"11257",1388,0,0,2,0,0,1,0,0,0,7,0,3,0,2,1,2,1038051,"2024-01-02T00:00:00.000Z",28,23,"Mo Bamba",1,2,2,0,2,3.4
"11258",1389,0,0,0,1,0,1,0,0,0,6,0,0,0,0,0,0,1038051,"2024-01-02T00:00:00.000Z",56913527,23,"Ricky Council IV",0,0,0,0,0,0
"11259",1390,0,0,2,0,0,2,0,0,0,4,0,0,0,2,0,2,1038051,"2024-01-02T00:00:00.000Z",38017732,23,"Kenneth Lofton Jr.",0,2,2,0,2,0.4
"11260",1391,0,0,0,0,0,0,0,0,0,0,0,0,0,0,0,0,1038051,"2024-01-02T00:00:00.000Z",108,23,"Robert Covington",0,0,0,0,0,0
"11261",1392,5,1,4,2,2,9,5,0,0,25,1,2,12,5,0,1,1038053,"2024-01-02T00:00:00.000Z",227,19,"Brandon Ingram",1,17,22,17,10,27.5
"11262",1393,5,1,2,0,0,9,5,0,0,26,1,3,10,3,0,4,1038053,"2024-01-02T00:00:00.000Z",666969,19,"Zion Williamson",1,13,18,15,8,20.1
"11263",1394,0,1,9,1,1,5,5,0,0,20,3,0,11,12,1,1,1038053,"2024-01-02T00:00:00.000Z",455,19,"Jonas Valanciunas",2,23,23,11,12,30.4
"11264",1395,1,1,2,4,2,10,5,2,2,24,2,1,14,4,2,3,1038053,"2024-01-02T00:00:00.000Z",17896024,19,"Herbert Jones",3,18,19,15,5,26.3
"11265",1396,5,0,4,8,4,11,6,0,0,24,2,0,16,6,0,2,1038053,"2024-01-02T00:00:00.000Z",303,19,"CJ McCollum",0,22,27,21,11,28.7
"11266",1397,1,1,1,2,0,6,2,2,2,16,1,0,6,2,1,0,1038053,"2024-01-02T00:00:00.000Z",3547293,19,"Naji Marshall",2,8,9,7,3,15.9
"11267",1398,2,0,2,6,3,9,4,3,2,22,1,2,13,3,2,1,1038053,"2024-01-02T00:00:00.000Z",17896097,19,"Jose Alvarado",2,16,18,15,5,24.6
"11268",1399,0,0,6,2,1,4,2,2,1,20,2,2,6,8,2,1,1038053,"2024-01-02T00:00:00.000Z",340,19,"Larry Nance Jr.",2,14,14,6,8,20.6
"11269",1400,1,2,0,8,2,13,3,4,3,26,0,0,11,0,0,0,1038053,"2024-01-02T00:00:00.000Z",56677837,19,"Jordan Hawkins",2,11,12,12,1,18.5
"11270",1401,0,0,0,0,0,0,0,0,0,0,0,0,0,0,0,0,1037834,"2023-11-26T00:00:00.000Z",38017719,5,"Dalen Terry",0,0,0,0,0,0
"11271",1402,0,0,0,0,0,0,0,0,0,0,0,0,0,0,0,0,1037621,"2023-10-28T00:00:00.000Z",414,30,"Landry Shamet",0,0,0,0,0,0
"11272",1403,1,0,10,12,4,14,6,0,0,34,0,2,16,10,0,1,1037621,"2023-10-28T00:00:00.000Z",17896027,15,"Ziaire Williams",0,26,27,17,11,28.5
"11273",1404,2,1,5,4,2,12,4,6,6,31,0,4,16,5,1,1,1037621,"2023-10-28T00:00:00.000Z",231,15,"Jaren Jackson Jr.",2,21,23,18,7,30
"11274",1405,3,0,6,2,2,7,3,0,0,24,1,4,8,7,0,1,1037621,"2023-10-28T00:00:00.000Z",3547285,15,"Xavier Tillman",0,15,18,11,10,19.9
"11275",1406,5,1,1,10,4,20,10,2,2,34,1,4,26,2,1,5,1037621,"2023-10-28T00:00:00.000Z",3547287,15,"Desmond Bane",2,28,33,31,7,36.9
"11276",1407,6,2,4,5,1,8,4,0,0,32,0,2,9,4,2,2,1037621,"2023-10-28T00:00:00.000Z",420,15,"Marcus Smart",4,13,19,15,10,32.8
"11277",1408,1,0,1,5,1,9,2,0,0,16,0,0,5,1,0,0,1037621,"2023-10-28T00:00:00.000Z",38017728,15,"Jake LaRavia",0,6,7,6,2,7.7
"11278",1409,1,2,6,3,1,4,2,0,0,22,3,0,5,9,2,1,1037621,"2023-10-28T00:00:00.000Z",666703,15,"John Konchar",4,14,15,6,10,28.3
"11279",1410,5,1,0,2,1,8,3,0,0,18,1,0,7,1,1,3,1037621,"2023-10-28T00:00:00.000Z",401,15,"Derrick Rose",2,8,13,12,6,18.7
"11280",1411,2,1,6,4,3,8,5,1,1,24,0,3,14,6,0,1,1037621,"2023-10-28T00:00:00.000Z",38017729,15,"David Roddy",1,20,22,16,8,26.2
"11281",1412,1,0,0,0,0,1,0,0,0,5,0,2,0,0,0,1,1037621,"2023-10-28T00:00:00.000Z",38017732,15,"Kenneth Lofton Jr.",0,0,1,1,1,0.5
"11282",1413,0,0,0,0,0,0,0,0,0,0,0,0,0,0,0,0,1037621,"2023-10-28T00:00:00.000Z",48248287,15,"Jacob Gilyard",0,0,0,0,0,0
"11283",1414,0,0,0,0,0,0,0,0,0,0,0,0,0,0,0,0,1037621,"2023-10-28T00:00:00.000Z",56677830,15,"GG Jackson",0,0,0,0,0,0
"11284",1415,0,0,0,0,0,0,0,0,0,0,0,0,0,0,0,0,1037621,"2023-10-28T00:00:00.000Z",666786,15,"Ja Morant",0,0,0,0,0,0
"11285",1416,3,0,0,2,1,6,3,0,0,22,0,0,7,0,1,2,1037620,"2023-10-28T00:00:00.000Z",38017682,9,"Jaden Ivey",1,7,10,10,3,12.5
"11286",1417,1,0,2,1,0,2,1,0,0,6,1,0,2,3,0,0,1037620,"2023-10-28T00:00:00.000Z",56677792,9,"Marcus Sasser",0,5,6,3,4,7.1
"11287",1418,1,0,1,2,1,2,1,0,0,10,0,0,3,1,0,1,1037620,"2023-10-28T00:00:00.000Z",197,9,"Joe Harris",0,4,5,4,2,4.7
"11288",1419,0,0,0,0,0,0,0,0,0,1,0,0,0,0,0,0,1037620,"2023-10-28T00:00:00.000Z",44477024,9,"Stanley Umude",0,0,0,0,0,0
"11289",1420,0,0,0,0,0,0,0,0,0,0,0,0,0,0,0,0,1037620,"2023-10-28T00:00:00.000Z",42097199,9,"Jared Rhoden",0,0,0,0,0,0
"11290",1421,0,0,0,0,0,0,0,0,0,0,0,0,0,0,0,0,1037620,"2023-10-28T00:00:00.000Z",3547240,9,"James Wiseman",0,0,0,0,0,0
"11291",1422,0,0,0,0,0,0,0,0,0,0,0,0,0,0,0,0,1037620,"2023-10-28T00:00:00.000Z",54,9,"Bojan Bogdanovic",0,0,0,0,0,0
"11292",1423,0,0,0,0,0,0,0,0,0,0,0,0,0,0,0,0,1037620,"2023-10-28T00:00:00.000Z",17896071,9,"Isaiah Livers",0,0,0,0,0,0
"11293",1424,0,0,0,0,0,0,0,0,0,0,0,0,0,0,0,0,1037620,"2023-10-28T00:00:00.000Z",330,9,"Monte Morris",0,0,0,0,0,0
"11294",1425,4,2,1,1,0,13,7,7,6,32,1,3,20,2,1,1,1037620,"2023-10-28T00:00:00.000Z",125,5,"DeMar DeRozan",3,22,26,24,6,36.4
"11295",1426,0,0,0,0,0,1,0,0,0,3,0,0,0,0,0,0,1037596,"2023-10-25T00:00:00.000Z",38017704,30,"Patrick Baldwin Jr.",0,0,0,0,0,0
"11296",1427,5,0,4,3,0,3,0,0,0,18,0,3,0,4,0,1,1037598,"2023-10-25T00:00:00.000Z",226,22,"Joe Ingles",0,4,9,5,9,11.3
"11297",1428,0,1,3,4,1,8,5,0,0,17,3,0,11,6,0,0,1037598,"2023-10-25T00:00:00.000Z",196,22,"Gary Harris",1,17,17,11,6,21.2
"11298",1429,0,1,3,1,0,1,0,4,4,15,0,4,4,3,0,3,1037598,"2023-10-25T00:00:00.000Z",462,22,"Moritz Wagner",1,7,7,4,3,7.6
"11299",1430,0,1,3,3,1,6,4,3,2,14,1,2,11,4,0,2,1037598,"2023-10-25T00:00:00.000Z",229,22,"Jonathan Isaac",1,15,15,11,4,16.8
"11300",1431,1,2,0,0,0,2,2,1,1,5,0,0,5,0,0,0,1037598,"2023-10-25T00:00:00.000Z",56677827,22,"Anthony Black",2,5,6,6,1,12.5
"11301",1432,0,0,1,2,1,2,1,0,0,5,0,0,3,1,0,0,1037598,"2023-10-25T00:00:00.000Z",38017724,22,"Caleb Houstan",0,4,4,3,1,4.2
"11302",1433,0,0,3,1,0,1,0,0,0,5,0,0,0,3,0,0,1037598,"2023-10-25T00:00:00.000Z",666818,22,"Chuma Okeke",0,3,3,0,3,3.6
"11303",1434,1,0,0,1,0,1,0,0,0,5,0,0,0,0,1,0,1037598,"2023-10-25T00:00:00.000Z",56677839,22,"Jett Howard",1,0,1,1,1,4.5
"11304",1435,0,0,0,0,0,0,0,0,0,0,0,0,0,0,0,0,1037598,"2023-10-25T00:00:00.000Z",38017607,22,"Kevon Harris",0,0,0,0,0,0
"11305",1436,0,0,0,0,0,0,0,0,0,0,0,0,0,0,0,0,1037598,"2023-10-25T00:00:00.000Z",17553983,22,"Trevelin Queen",0,0,0,0,0,0
"11306",1437,0,0,0,0,0,0,0,0,0,0,0,0,0,0,0,0,1037598,"2023-10-25T00:00:00.000Z",666885,22,"Admiral Schofield",0,0,0,0,0,0
"11307",1438,2,0,4,6,4,7,5,0,0,26,0,4,14,4,1,2,1037598,"2023-10-25T00:00:00.000Z",66,11,"Dillon Brooks",1,18,20,16,6,22.8
"11308",1439,4,0,4,5,1,9,3,0,0,24,0,1,7,4,3,0,1037595,"2023-10-25T00:00:00.000Z",53,1,"Bogdan Bogdanovic",3,11,15,11,8,26.8
"11309",1440,0,0,0,0,0,0,0,0,0,0,0,0,0,0,0,0,1037595,"2023-10-25T00:00:00.000Z",56677838,1,"Kobe Bufkin",0,0,0,0,0,0
"11310",1441,0,0,0,0,0,0,0,0,0,0,0,0,0,0,0,0,1037595,"2023-10-25T00:00:00.000Z",666564,1,"Bruno Fernando",0,0,0,0,0,0
"11311",1442,0,0,6,1,0,9,4,0,0,24,3,1,8,9,0,2,1037601,"2023-10-25T00:00:00.000Z",3547249,28,"Precious Achiuwa",0,17,17,8,9,16.8
"11312",1443,4,0,5,0,0,18,6,9,7,34,8,0,19,13,2,0,1037600,"2023-10-25T00:00:00.000Z",79,16,"Jimmy Butler",2,32,36,23,17,46.6
"11313",1444,2,0,8,6,3,9,4,2,2,28,2,5,13,10,0,1,1037600,"2023-10-25T00:00:00.000Z",285,16,"Kevin Love",0,23,25,15,12,27
"11314",1445,3,2,6,0,0,13,7,10,8,32,2,3,22,8,0,2,1037600,"2023-10-25T00:00:00.000Z",4,16,"Bam Adebayo",2,30,33,25,11,40.1
"11315",1446,3,0,2,7,2,24,7,0,0,34,0,1,16,2,3,2,1037600,"2023-10-25T00:00:00.000Z",666633,16,"Tyler Herro",3,18,21,19,5,29.9
"11316",1447,2,1,2,0,0,1,0,0,0,32,0,4,0,2,2,0,1037600,"2023-10-25T00:00:00.000Z",286,16,"Kyle Lowry",3,2,4,2,4,14.4
"11317",1448,1,0,2,3,0,7,1,0,0,20,1,1,2,3,1,0,1037600,"2023-10-25T00:00:00.000Z",666747,16,"Caleb Martin",1,5,6,3,4,10.1
"11318",1449,2,0,2,0,0,3,3,0,0,13,0,2,6,2,2,1,1037600,"2023-10-25T00:00:00.000Z",56677785,16,"Jaime Jaquez Jr.",2,8,10,8,4,16.4
"11319",1450,3,0,4,0,0,5,2,5,4,16,2,0,8,6,1,1,1037600,"2023-10-25T00:00:00.000Z",74,16,"Thomas Bryant",1,14,17,11,9,21.7
"11320",1451,5,0,3,5,2,20,10,0,0,36,2,3,22,5,2,2,1037911,"2023-12-14T00:00:00.000Z",70,2,"Jaylen Brown",2,27,32,27,10,39.5
"11321",1452,3,3,8,10,3,22,9,8,6,36,3,1,27,11,0,3,1037911,"2023-12-14T00:00:00.000Z",434,2,"Jayson Tatum",3,38,41,30,14,50.7
"11322",1453,0,2,5,6,1,11,5,8,7,31,1,2,18,6,1,3,1037911,"2023-12-14T00:00:00.000Z",378,2,"Kristaps Porzingis",3,24,24,18,6,31.2
"11323",1454,3,0,3,4,2,10,5,2,2,35,2,0,14,5,3,3,1037911,"2023-12-14T00:00:00.000Z",473,2,"Derrick White",3,19,22,17,8,30.5
"11324",1455,4,0,1,3,1,11,7,0,0,37,2,2,15,3,0,2,1037911,"2023-12-14T00:00:00.000Z",214,2,"Jrue Holiday",0,18,22,19,7,22.6
"11325",1456,1,0,0,3,3,3,3,0,0,18,0,2,9,0,0,0,1037911,"2023-12-14T00:00:00.000Z",17896060,2,"Sam Hauser",0,9,10,10,1,10.5
"11326",1457,3,1,7,2,1,4,3,0,0,24,3,1,7,10,0,0,1037911,"2023-12-14T00:00:00.000Z",219,2,"Al Horford",1,17,20,10,13,26.5
"11327",1458,2,0,8,0,0,9,5,0,0,17,1,5,10,9,0,2,1037914,"2023-12-14T00:00:00.000Z",666508,3,"Nicolas Claxton",0,19,21,12,11,21.8
"11328",1459,0,0,3,2,0,13,5,6,3,27,0,3,13,3,0,0,1037914,"2023-12-14T00:00:00.000Z",17896048,3,"Cam Thomas",0,16,16,13,3,16.6
"11329",1460,8,0,4,4,1,11,5,7,6,24,0,3,17,4,1,2,1037914,"2023-12-14T00:00:00.000Z",130,3,"Spencer Dinwiddie",1,21,29,25,12,34.8
"11330",1461,6,2,2,1,0,9,4,0,0,22,2,2,8,4,0,2,1037914,"2023-12-14T00:00:00.000Z",17896058,3,"Trendon Watford",2,12,18,14,10,25.8
"11331",1462,5,1,9,1,0,9,4,0,0,26,4,4,8,13,0,3,1037914,"2023-12-14T00:00:00.000Z",17896038,3,"Day'Ron Sharpe",1,21,26,13,18,31.1
"11332",1463,1,0,1,0,0,1,1,0,0,14,0,1,2,1,1,1,1037914,"2023-12-14T00:00:00.000Z",351,3,"Royce O'Neale",1,3,4,3,2,6.7
"11333",1464,0,0,0,1,0,3,0,0,0,16,4,2,0,4,1,1,1037914,"2023-12-14T00:00:00.000Z",158,3,"Dorian Finney-Smith",1,4,4,0,4,6.8
"11334",1465,2,0,3,1,1,4,2,2,2,17,1,0,7,4,0,0,1037914,"2023-12-14T00:00:00.000Z",56677722,3,"Jalen Wilson",0,11,13,9,6,14.8
"11335",1466,2,0,0,6,2,9,2,0,0,15,2,0,6,2,0,1,1037914,"2023-12-14T00:00:00.000Z",9051997,3,"Armoni Brooks",0,8,10,8,4,10.4
"11336",1467,1,0,3,1,0,9,4,3,3,15,3,1,11,6,1,0,1037914,"2023-12-14T00:00:00.000Z",174,3,"Harry Giles III",1,17,18,12,7,22.7
"11337",1468,0,0,0,0,0,0,0,0,0,0,0,0,0,0,0,0,1037911,"2023-12-14T00:00:00.000Z",56677847,6,"Emoni Bates",0,0,0,0,0,0
"11338",1469,0,0,0,0,0,0,0,0,0,0,0,0,0,0,0,0,1037911,"2023-12-14T00:00:00.000Z",666676,6,"Ty Jerome",0,0,0,0,0,0
"11339",1470,0,0,0,0,0,0,0,0,0,0,0,0,0,0,0,0,1037911,"2023-12-14T00:00:00.000Z",17896076,6,"Evan Mobley",0,0,0,0,0,0
"11340",1471,0,0,0,0,0,0,0,0,0,0,0,0,0,0,0,0,1037911,"2023-12-14T00:00:00.000Z",38017662,6,"Isaiah Mobley",0,0,0,0,0,0
"11341",1472,2,0,1,4,1,7,2,0,0,21,2,1,5,3,0,2,1037916,"2023-12-14T00:00:00.000Z",30,26,"Harrison Barnes",0,8,10,7,5,9.6
"11342",1473,1,0,1,2,0,8,4,8,7,31,2,4,15,3,1,1,1037916,"2023-12-14T00:00:00.000Z",38017688,26,"Keegan Murray",1,18,19,16,4,22.1
"11343",1474,7,0,14,2,1,13,8,2,1,40,2,2,18,16,0,2,1037916,"2023-12-14T00:00:00.000Z",406,26,"Domantas Sabonis",0,34,41,25,23,45.7
"11344",1475,2,1,1,3,0,8,2,0,0,20,1,1,4,2,2,1,1037916,"2023-12-14T00:00:00.000Z",221,26,"Kevin Huerter",3,6,8,6,4,17.4
"11345",1476,0,0,0,0,0,0,0,0,0,0,0,0,0,0,0,0,1037693,"2023-11-06T00:00:00.000Z",38017707,2,"JD Davison",0,0,0,0,0,0
"11346",1477,0,0,0,0,0,0,0,0,0,0,0,0,0,0,0,0,1037693,"2023-11-06T00:00:00.000Z",3547295,2,"Nathan Knight",0,0,0,0,0,0
"11347",1478,3,0,6,14,7,19,10,5,4,38,1,2,31,7,1,1,1037695,"2023-11-06T00:00:00.000Z",56677837,19,"Jordan Hawkins",1,38,41,34,10,45.9
"11348",1479,0,0,0,1,0,2,1,0,0,9,0,1,2,0,0,0,1037695,"2023-11-06T00:00:00.000Z",3547260,19,"Kira Lewis Jr.",0,2,2,2,0,2
"11349",1480,1,0,0,6,4,8,5,3,3,25,0,3,17,0,0,0,1037695,"2023-11-06T00:00:00.000Z",17896017,19,"Matt Ryan",0,17,18,18,1,18.5
"11350",1481,1,1,2,1,1,5,4,0,0,21,0,0,9,2,1,3,1037695,"2023-11-06T00:00:00.000Z",38017677,19,"Dyson Daniels",2,11,12,10,3,15.9
"11351",1482,1,0,2,1,1,3,2,0,0,15,1,1,5,3,0,1,1037695,"2023-11-06T00:00:00.000Z",340,19,"Larry Nance Jr.",0,8,9,6,4,9.1
"11352",1483,0,0,1,0,0,0,0,0,0,4,0,0,0,1,0,0,1037695,"2023-11-06T00:00:00.000Z",491,19,"Cody Zeller",0,1,1,0,1,1.2
"11353",1484,0,0,0,0,0,0,0,0,0,0,0,0,0,0,0,0,1037695,"2023-11-06T00:00:00.000Z",38017663,19,"E.J. Liddell",0,0,0,0,0,0
"11354",1485,1,0,1,3,1,4,2,1,1,17,0,3,6,1,2,0,1037695,"2023-11-06T00:00:00.000Z",38017727,8,"Collin Gillespie",2,7,8,7,2,14.7
"11355",1486,1,0,2,9,5,13,8,1,0,19,0,1,21,2,0,1,1037695,"2023-11-06T00:00:00.000Z",56677776,8,"Julian Strawther",0,23,24,22,3,23.9
"11356",1487,1,1,1,0,0,0,0,0,0,6,1,2,0,2,0,1,1037695,"2023-11-06T00:00:00.000Z",3547268,8,"Zeke Nnaji",1,2,3,1,3,5.9
"11357",1488,0,0,0,0,0,0,0,0,0,1,0,0,0,0,0,0,1037695,"2023-11-06T00:00:00.000Z",17896007,8,"Braxton Key",0,0,0,0,0,0
"11358",1489,0,0,0,1,1,1,1,0,0,1,0,0,3,0,0,0,1037695,"2023-11-06T00:00:00.000Z",56677582,8,"Jalen Pickett",0,3,3,3,0,3
"11359",1490,0,0,0,0,0,0,0,0,0,0,0,0,0,0,0,0,1037695,"2023-11-06T00:00:00.000Z",215,8,"Justin Holiday",0,0,0,0,0,0
"11360",1491,0,0,0,0,0,0,0,0,0,0,0,0,0,0,0,0,1037695,"2023-11-06T00:00:00.000Z",250,8,"DeAndre Jordan",0,0,0,0,0,0
"11361",1492,1,0,7,3,1,11,6,2,1,27,1,0,14,8,1,0,1037698,"2023-11-08T00:00:00.000Z",360,23,"Kelly Oubre Jr.",1,22,23,15,9,28.1
"11362",1493,3,0,7,4,1,12,5,6,6,38,2,1,17,9,0,2,1037698,"2023-11-08T00:00:00.000Z",200,23,"Tobias Harris",0,26,29,20,12,30.3
"11363",1494,4,4,9,4,1,20,10,6,6,37,1,3,27,10,1,6,1037698,"2023-11-08T00:00:00.000Z",145,23,"Joel Embiid",5,37,41,31,14,54
"11364",1495,2,0,4,7,1,9,1,0,0,29,0,2,3,4,1,1,1037698,"2023-11-08T00:00:00.000Z",313,23,"De'Anthony Melton",1,7,9,5,6,12.8
"11365",1496,5,2,8,11,3,27,11,1,0,39,1,4,25,9,1,1,1037698,"2023-11-08T00:00:00.000Z",3547254,23,"Tyrese Maxey",3,34,39,30,14,51.3
"11366",1497,4,0,5,1,0,2,1,0,0,15,0,2,2,5,0,0,1037698,"2023-11-08T00:00:00.000Z",45,23,"Patrick Beverley",0,7,11,6,9,14
"11367",1498,1,1,2,2,1,3,2,0,0,26,2,2,5,4,0,0,1037698,"2023-11-08T00:00:00.000Z",33,23,"Nicolas Batum",1,9,10,6,5,14.3
"11368",1499,0,0,1,2,1,4,2,0,0,15,2,2,5,3,2,0,1037698,"2023-11-08T00:00:00.000Z",108,23,"Robert Covington",2,8,8,5,3,14.6
"11369",1500,2,0,2,2,0,3,1,2,2,31,0,2,4,2,2,1,1037695,"2023-11-06T00:00:00.000Z",17896024,19,"Herbert Jones",2,6,8,6,4,14.4
"11370",1501,6,1,10,2,2,8,5,3,2,28,1,2,14,11,2,2,1038006,"2023-12-26T00:00:00.000Z",472,13,"Russell Westbrook",3,25,31,20,17,43.2
"11371",1502,0,0,0,0,0,0,0,0,0,0,0,0,0,0,0,0,1038005,"2023-12-26T00:00:00.000Z",38017690,25,"Shaedon Sharpe",0,0,0,0,0,0
"11372",1503,0,0,0,0,0,0,0,0,0,0,0,0,0,0,0,0,1038005,"2023-12-26T00:00:00.000Z",476,25,"Robert Williams III",0,0,0,0,0,0
"11373",1504,1,0,3,3,0,8,3,3,3,36,2,2,9,5,1,2,1038005,"2023-12-26T00:00:00.000Z",30,26,"Harrison Barnes",1,14,15,10,6,17.5
"11374",1505,2,1,3,7,1,11,2,0,0,36,1,1,5,4,0,0,1038005,"2023-12-26T00:00:00.000Z",38017688,26,"Keegan Murray",1,9,11,7,6,15.8
"11375",1506,5,0,9,0,0,19,14,7,6,36,3,4,34,12,0,2,1038005,"2023-12-26T00:00:00.000Z",406,26,"Domantas Sabonis",0,46,51,39,17,53.9
"11376",1507,2,1,1,5,1,8,2,0,0,22,1,1,5,2,0,0,1038005,"2023-12-26T00:00:00.000Z",221,26,"Kevin Huerter",1,7,9,7,4,13.4
"11377",1508,4,1,6,15,7,26,16,6,4,38,2,2,43,8,2,5,1038005,"2023-12-26T00:00:00.000Z",161,26,"De'Aaron Fox",3,51,55,47,12,62.6
"11378",1509,4,1,1,7,1,11,3,0,0,19,0,2,7,1,0,0,1038005,"2023-12-26T00:00:00.000Z",324,26,"Malik Monk",1,8,12,11,5,17.2
"11379",1510,1,0,0,0,0,2,2,0,0,5,1,1,4,1,0,1,1038005,"2023-12-26T00:00:00.000Z",306,26,"JaVale McGee",0,5,6,5,2,5.7
"11380",1511,1,0,3,0,0,2,2,0,0,8,0,0,4,3,1,0,1038005,"2023-12-26T00:00:00.000Z",17896030,26,"Chris Duarte",1,7,8,5,4,12.1
"11381",1512,0,0,0,0,0,0,0,0,0,2,0,0,0,0,0,0,1038005,"2023-12-26T00:00:00.000Z",17896044,26,"Kessler Edwards",0,0,0,0,0,0
"11382",1513,0,0,1,2,0,3,1,0,0,2,0,0,2,1,0,0,1038005,"2023-12-26T00:00:00.000Z",17553994,26,"Davion Mitchell",0,3,3,2,1,3.2
"11383",1514,0,0,0,0,0,0,0,0,0,2,0,0,0,0,0,0,1038005,"2023-12-26T00:00:00.000Z",273,26,"Alex Len",0,0,0,0,0,0
"11384",1515,0,0,0,0,0,0,0,0,0,2,0,0,0,0,1,0,1038005,"2023-12-26T00:00:00.000Z",666925,26,"Juan Toscano-Anderson",1,0,0,0,0,3
"11385",1516,1,1,8,0,0,6,5,4,3,33,2,2,13,10,0,1,1038006,"2023-12-26T00:00:00.000Z",3547282,4,"Nick Richards",1,23,24,14,11,28.5
"11386",1517,4,0,1,0,0,4,2,0,0,16,0,1,4,1,0,1,1038006,"2023-12-26T00:00:00.000Z",422,4,"Ish Smith",0,5,9,8,5,10.2
"11387",1518,3,0,4,2,0,10,7,4,4,27,4,3,18,8,2,2,1038006,"2023-12-26T00:00:00.000Z",666950,4,"P.J. Washington",2,26,29,21,11,36.1
"11388",1520,0,0,0,0,0,0,0,0,0,0,0,0,0,0,0,0,1038006,"2023-12-26T00:00:00.000Z",18678001,4,"JT Thor",0,0,0,0,0,0
"11389",1521,0,0,0,0,0,0,0,0,0,0,0,0,0,0,0,0,1038006,"2023-12-26T00:00:00.000Z",56677848,4,"Amari Bailey",0,0,0,0,0,0
"11390",1522,0,0,0,0,0,0,0,0,0,0,0,0,0,0,0,0,1038006,"2023-12-26T00:00:00.000Z",3547239,4,"LaMelo Ball",0,0,0,0,0,0
"11391",1523,0,0,0,0,0,0,0,0,0,0,0,0,0,0,0,0,1038006,"2023-12-26T00:00:00.000Z",56677866,4,"Leaky Black",0,0,0,0,0,0
"11392",1524,0,0,0,0,0,0,0,0,0,0,0,0,0,0,0,0,1038006,"2023-12-26T00:00:00.000Z",56677823,4,"Brandon Miller",0,0,0,0,0,0
"11393",1525,0,0,0,0,0,0,0,0,0,0,0,0,0,0,0,0,1038006,"2023-12-26T00:00:00.000Z",347,4,"Frank Ntilikina",0,0,0,0,0,0
"11394",1526,5,0,1,2,1,2,1,0,0,15,1,1,3,2,2,1,1037782,"2023-11-19T00:00:00.000Z",48248287,15,"Jacob Gilyard",2,5,10,8,7,17.9
"11395",1527,0,0,0,0,0,0,0,0,0,0,0,0,0,0,0,0,1037782,"2023-11-19T00:00:00.000Z",56677830,15,"GG Jackson",0,0,0,0,0,0
"11396",1528,1,0,1,0,0,0,0,0,0,13,0,1,0,1,1,2,1037781,"2023-11-19T00:00:00.000Z",379,7,"Dwight Powell",1,1,2,1,2,3.7
"11397",1529,0,0,0,2,1,4,1,2,1,10,0,2,4,0,1,1,1037781,"2023-11-19T00:00:00.000Z",38017679,7,"Jaden Hardy",1,4,4,4,0,6
"11398",1530,0,0,3,1,0,1,0,0,0,5,0,0,0,3,0,0,1037781,"2023-11-19T00:00:00.000Z",56677859,7,"Olivier-Maxence Prosper",0,3,3,0,3,3.6
"11399",1531,0,0,0,0,0,3,3,2,1,5,2,1,7,2,0,0,1037781,"2023-11-19T00:00:00.000Z",217,7,"Richaun Holmes",0,9,9,7,2,9.4
"11400",1532,1,1,0,2,0,4,1,0,0,5,0,0,2,0,0,0,1037781,"2023-11-19T00:00:00.000Z",329,7,"Markieff Morris",1,2,3,3,1,6.5
"11401",1533,0,0,0,0,0,0,0,0,0,0,0,0,0,0,0,0,1037781,"2023-11-19T00:00:00.000Z",17896028,7,"Greg Brown III",0,0,0,0,0,0
"11402",1534,0,0,0,0,0,0,0,0,0,0,0,0,0,0,0,0,1037781,"2023-11-19T00:00:00.000Z",114,7,"Seth Curry",0,0,0,0,0,0
"11403",1535,0,0,0,0,0,0,0,0,0,0,0,0,0,0,0,0,1037781,"2023-11-19T00:00:00.000Z",56677873,7,"Dexter Dennis",0,0,0,0,0,0
"11404",1536,0,0,0,0,0,0,0,0,0,0,0,0,0,0,0,0,1037781,"2023-11-19T00:00:00.000Z",257,7,"Maxi Kleber",0,0,0,0,0,0
"11405",1537,0,0,0,0,0,0,0,0,0,0,0,0,0,0,0,0,1037781,"2023-11-19T00:00:00.000Z",17554004,7,"AJ Lawson",0,0,0,0,0,0
"11406",1538,1,0,0,0,0,1,0,0,0,9,1,0,0,1,0,0,1037781,"2023-11-19T00:00:00.000Z",17896044,26,"Kessler Edwards",0,1,2,1,2,2.7
"11407",1539,0,0,0,0,0,0,0,0,0,0,0,0,0,0,0,0,1037782,"2023-11-19T00:00:00.000Z",38017728,15,"Jake LaRavia",0,0,0,0,0,0
"11408",1540,4,0,5,4,0,11,3,0,0,24,2,2,6,7,0,0,1037782,"2023-11-19T00:00:00.000Z",17896027,15,"Ziaire Williams",0,13,17,10,11,20.4
"11409",1541,0,0,2,2,0,2,0,0,0,20,0,0,0,2,0,0,1037782,"2023-11-19T00:00:00.000Z",38017729,15,"David Roddy",0,2,2,0,2,2.4
"11410",1542,0,2,0,3,2,4,2,0,0,17,0,2,6,0,0,0,1037782,"2023-11-19T00:00:00.000Z",38017731,15,"Vince Williams Jr.",2,6,6,6,0,12
"11411",1543,0,0,0,0,0,0,0,0,0,0,0,0,0,0,0,0,1037782,"2023-11-19T00:00:00.000Z",3,15,"Steven Adams",0,0,0,0,0,0
"11412",1544,0,0,0,0,0,0,0,0,0,0,0,0,0,0,0,0,1037781,"2023-11-19T00:00:00.000Z",290,26,"Trey Lyles",0,0,0,0,0,0
"11413",1545,1,1,1,1,1,1,1,0,0,34,2,4,3,3,1,1,1037783,"2023-11-19T00:00:00.000Z",38017620,29,"Ochai Agbaji",2,6,7,4,4,13.1
"11414",1546,0,2,10,10,2,27,15,9,6,50,7,3,38,17,2,1,1037783,"2023-11-19T00:00:00.000Z",297,29,"Lauri Markkanen",4,55,55,38,17,69.4
"11415",1547,0,0,0,0,0,0,0,0,0,0,0,0,0,0,0,0,1037782,"2023-11-19T00:00:00.000Z",666505,15,"Brandon Clarke",0,0,0,0,0,0
"11416",1548,0,0,0,0,0,0,0,0,0,0,0,0,0,0,0,0,1037782,"2023-11-19T00:00:00.000Z",254,15,"Luke Kennard",0,0,0,0,0,0
"11417",1549,0,0,0,0,0,0,0,0,0,0,0,0,0,0,0,0,1037782,"2023-11-19T00:00:00.000Z",666786,15,"Ja Morant",0,0,0,0,0,0
"11418",1550,0,0,0,0,0,0,0,0,0,0,0,0,0,0,0,0,1037782,"2023-11-19T00:00:00.000Z",401,15,"Derrick Rose",0,0,0,0,0,0
"11419",1551,0,0,0,0,0,0,0,0,0,0,0,0,0,0,0,0,1038098,"2024-01-08T00:00:00.000Z",38017698,4,"Mark Williams",0,0,0,0,0,0
"11420",1552,7,1,7,3,1,16,7,4,3,44,0,0,18,7,3,2,1038098,"2024-01-08T00:00:00.000Z",125,5,"DeMar DeRozan",4,25,32,25,14,46.9
"11421",1553,0,1,4,2,1,6,2,4,3,23,1,1,8,5,1,2,1038098,"2024-01-08T00:00:00.000Z",3547248,5,"Patrick Williams",2,13,13,8,5,18
"11422",1554,0,0,10,0,0,12,9,3,3,22,5,1,21,15,0,2,1038098,"2024-01-08T00:00:00.000Z",137,5,"Andre Drummond",0,36,36,21,15,37
"11423",1555,3,1,2,3,1,7,2,0,0,34,0,4,5,2,2,0,1038098,"2024-01-08T00:00:00.000Z",89,5,"Alex Caruso",3,7,10,8,5,20.9
"11424",1556,4,0,4,2,1,11,5,4,3,39,0,1,14,4,1,2,1038101,"2024-01-08T00:00:00.000Z",56677785,16,"Jaime Jaquez Jr.",1,18,22,18,8,25.8
"11425",1557,3,1,5,6,3,27,14,7,5,37,5,3,36,10,3,2,1038093,"2024-01-07T00:00:00.000Z",3547238,18,"Anthony Edwards",4,46,49,39,13,62.5
"11426",1558,3,0,1,4,1,9,3,0,0,19,0,1,7,1,1,0,1038097,"2024-01-07T00:00:00.000Z",472,13,"Russell Westbrook",1,8,11,10,4,15.7
"11427",1559,0,0,0,0,0,0,0,0,0,0,0,0,0,0,0,0,1038097,"2024-01-07T00:00:00.000Z",450,13,"PJ Tucker",0,0,0,0,0,0
"11428",1560,0,0,0,0,0,0,0,0,0,0,0,0,0,0,0,0,1038097,"2024-01-07T00:00:00.000Z",38017725,13,"Moussa Diabate",0,0,0,0,0,0
"11429",1561,0,0,0,0,0,0,0,0,0,0,0,0,0,0,0,0,1038097,"2024-01-07T00:00:00.000Z",24417679,13,"Xavier Moon",0,0,0,0,0,0
"11430",1562,0,0,0,0,0,0,0,0,0,0,0,0,0,0,0,0,1038097,"2024-01-07T00:00:00.000Z",17896051,13,"Joshua Primo",0,0,0,0,0,0
"11431",1563,0,0,0,0,0,0,0,0,0,0,0,0,0,0,0,0,1038095,"2024-01-07T00:00:00.000Z",666786,15,"Ja Morant",0,0,0,0,0,0
"11432",1564,2,0,1,5,1,7,1,0,0,24,0,1,3,1,0,0,1038098,"2024-01-08T00:00:00.000Z",38017708,4,"Bryce McGowens",0,4,6,5,3,7.2
"11433",1565,5,2,6,8,4,18,9,3,2,40,2,3,24,8,1,5,1038098,"2024-01-08T00:00:00.000Z",62,4,"Miles Bridges",3,32,37,29,13,45.1
"11434",1566,1,3,7,0,0,6,5,0,0,39,1,4,10,8,0,0,1038098,"2024-01-08T00:00:00.000Z",3547282,4,"Nick Richards",3,18,19,11,9,30.1
"11435",1567,4,0,6,7,0,11,2,0,0,31,0,4,4,6,1,3,1038098,"2024-01-08T00:00:00.000Z",56677823,4,"Brandon Miller",1,10,14,8,10,17.2
"11436",1568,8,0,3,13,7,18,10,12,12,44,0,2,39,3,0,0,1038098,"2024-01-08T00:00:00.000Z",403,4,"Terry Rozier",0,42,50,47,11,54.6
"11437",1569,1,0,0,0,0,4,1,0,0,15,0,1,2,0,0,0,1038098,"2024-01-08T00:00:00.000Z",422,4,"Ish Smith",0,2,3,3,1,3.5
"11438",1571,3,0,2,6,3,15,6,0,0,32,2,2,15,4,1,3,1038098,"2024-01-08T00:00:00.000Z",56677846,4,"Nick Smith Jr.",1,19,22,18,7,24.3
"11439",1572,2,0,2,1,1,1,1,0,0,4,0,1,3,2,0,0,1038098,"2024-01-08T00:00:00.000Z",17896037,4,"James Bouknight",0,5,7,5,4,8.4
"11440",1573,0,0,0,0,0,0,0,0,0,0,0,0,0,0,0,0,1038098,"2024-01-08T00:00:00.000Z",56677866,4,"Leaky Black",0,0,0,0,0,0
"11441",1574,0,0,0,0,0,0,0,0,0,0,0,0,0,0,0,0,1038098,"2024-01-08T00:00:00.000Z",347,4,"Frank Ntilikina",0,0,0,0,0,0
"11442",1575,2,1,0,1,0,4,2,2,1,20,0,3,5,0,0,1,1038101,"2024-01-08T00:00:00.000Z",188,11,"Jeff Green",1,5,7,7,2,10
"11443",1576,4,0,3,7,4,14,9,4,4,28,0,1,26,3,2,3,1037882,"2023-12-02T00:00:00.000Z",324,26,"Malik Monk",2,29,33,30,7,38.6
"11444",1577,0,0,0,0,0,0,0,0,0,0,0,0,0,0,0,0,7049314,"2023-12-06T00:00:00.000Z",56677830,15,"GG Jackson",0,0,0,0,0,0
"11445",1578,0,0,0,0,0,0,0,0,0,0,0,0,0,0,0,0,7049314,"2023-12-06T00:00:00.000Z",254,15,"Luke Kennard",0,0,0,0,0,0
"11446",1579,0,0,0,0,0,0,0,0,0,0,0,0,0,0,0,0,7049313,"2023-12-06T00:00:00.000Z",17553983,22,"Trevelin Queen",0,0,0,0,0,0
"11447",1580,0,0,0,0,0,0,0,0,0,0,0,0,0,0,0,0,1037883,"2023-12-02T00:00:00.000Z",56677868,14,"D'Moi Hodge",0,0,0,0,0,0
"11448",1581,0,0,0,0,0,0,0,0,0,0,0,0,0,0,0,0,1037883,"2023-12-02T00:00:00.000Z",1603383,14,"Gabe Vincent",0,0,0,0,0,0
"11449",1582,1,0,1,4,2,9,4,0,0,33,1,4,10,2,0,1,1037883,"2023-12-02T00:00:00.000Z",66,11,"Dillon Brooks",0,12,13,11,3,12.9
"11450",1583,3,3,8,3,0,7,4,2,2,30,1,5,10,9,2,3,1037883,"2023-12-02T00:00:00.000Z",38017684,11,"Jabari Smith Jr.",5,19,22,13,12,37.3
"11451",1584,5,2,10,8,3,25,8,2,2,34,3,2,21,13,2,0,1037883,"2023-12-02T00:00:00.000Z",17896062,11,"Alperen Sengun",4,34,39,26,18,56.1
"11452",1585,2,0,6,6,1,15,4,2,1,32,1,1,10,7,0,6,1037883,"2023-12-02T00:00:00.000Z",17895966,11,"Jalen Green",0,17,19,12,9,15.4
"11453",1586,7,0,4,7,4,15,7,4,4,40,1,1,22,5,0,3,1037883,"2023-12-02T00:00:00.000Z",458,11,"Fred VanVleet",0,27,34,29,12,35.5
"11454",1587,3,0,0,2,1,6,5,0,0,14,1,2,11,1,0,0,1037883,"2023-12-02T00:00:00.000Z",213,11,"Aaron Holiday",0,12,15,14,4,16.7
"11455",1588,0,0,2,0,0,2,1,0,0,14,0,2,2,2,0,0,1037883,"2023-12-02T00:00:00.000Z",3547301,11,"Jae'Sean Tate",0,4,4,2,2,4.4
"11456",1589,2,1,5,1,0,5,2,2,2,20,2,2,6,7,1,1,1037883,"2023-12-02T00:00:00.000Z",38017695,11,"Tari Eason",2,13,15,8,9,22.4
"11457",1590,0,0,1,0,0,2,0,0,0,11,0,3,0,1,0,2,1037883,"2023-12-02T00:00:00.000Z",188,11,"Jeff Green",0,1,1,0,1,-0.8
"11458",1591,0,0,2,0,0,0,0,0,0,3,0,0,0,2,0,0,1037883,"2023-12-02T00:00:00.000Z",56677809,11,"Jermaine Samuels Jr.",0,2,2,0,2,2.4
"11459",1592,0,1,0,0,0,0,0,0,0,3,0,0,0,0,0,0,1037883,"2023-12-02T00:00:00.000Z",19465326,11,"Jock Landale",1,0,0,0,0,3
"11460",1593,1,0,2,0,0,2,1,6,3,3,1,0,5,3,0,0,1037883,"2023-12-02T00:00:00.000Z",56677831,11,"Cam Whitmore",0,8,9,6,4,10.1
"11461",1594,0,0,2,0,0,1,0,0,0,3,0,1,0,2,0,0,1037883,"2023-12-02T00:00:00.000Z",3547281,11,"Nate Hinton",0,2,2,0,2,2.4
"11462",1595,0,0,0,0,0,0,0,0,0,0,0,0,0,0,0,0,1037883,"2023-12-02T00:00:00.000Z",75,11,"Reggie Bullock",0,0,0,0,0,0
"11463",1596,0,0,0,0,0,0,0,0,0,0,0,0,0,0,0,0,1037883,"2023-12-02T00:00:00.000Z",296,11,"Boban Marjanovic",0,0,0,0,0,0
"11464",1597,0,0,0,0,0,0,0,0,0,0,0,0,0,0,0,0,1037883,"2023-12-02T00:00:00.000Z",357,11,"Victor Oladipo",0,0,0,0,0,0
"11465",1598,0,0,0,0,0,0,0,0,0,0,0,0,0,0,0,0,1037883,"2023-12-02T00:00:00.000Z",56677825,11,"Amen Thompson",0,0,0,0,0,0
"11466",1599,0,0,0,0,0,0,0,0,0,0,0,0,0,0,0,0,1037883,"2023-12-02T00:00:00.000Z",47738533,11,"Jeenathan Williams",0,0,0,0,0,0
"11467",1600,0,0,0,0,0,0,0,0,0,0,0,0,0,0,0,0,7049314,"2023-12-06T00:00:00.000Z",330,9,"Monte Morris",0,0,0,0,0,0
"11468",1601,0,0,2,0,0,2,2,3,2,13,1,0,6,3,2,0,1037642,"2023-10-30T00:00:00.000Z",3547268,8,"Zeke Nnaji",2,9,9,6,3,15.6
"11469",1602,0,0,2,2,0,4,2,0,0,6,0,0,4,2,0,0,1037642,"2023-10-30T00:00:00.000Z",56677776,8,"Julian Strawther",0,6,6,4,2,6.4
"11470",1603,0,0,0,0,0,0,0,0,0,0,0,0,0,0,0,0,1037642,"2023-10-30T00:00:00.000Z",38017727,8,"Collin Gillespie",0,0,0,0,0,0
"11471",1604,1,0,2,0,0,3,1,4,3,10,0,2,5,2,0,0,1037635,"2023-10-30T00:00:00.000Z",3547302,30,"Anthony Gill",0,7,8,6,3,8.9
"11472",1605,3,0,0,0,0,2,0,8,7,12,1,1,7,1,4,1,1037635,"2023-10-30T00:00:00.000Z",38017712,30,"Ryan Rollins",4,8,11,10,4,23.7
"11473",1606,1,1,3,1,1,5,5,4,3,12,3,0,14,6,1,0,1037635,"2023-10-30T00:00:00.000Z",17896106,30,"Eugene Omoruyi",2,20,21,15,7,28.7
"11474",1607,0,0,0,0,0,0,0,0,0,0,0,0,0,0,0,0,1037635,"2023-10-30T00:00:00.000Z",337,30,"Mike Muscala",0,0,0,0,0,0
"11475",1608,0,0,0,0,0,0,0,0,0,0,0,0,0,0,0,0,1037635,"2023-10-30T00:00:00.000Z",38124126,30,"John Butler Jr.",0,0,0,0,0,0
"11476",1609,0,0,0,0,0,0,0,0,0,0,0,0,0,0,0,0,1037642,"2023-10-30T00:00:00.000Z",215,8,"Justin Holiday",0,0,0,0,0,0
"11477",1610,0,0,0,0,0,0,0,0,0,0,0,0,0,0,0,0,1037642,"2023-10-30T00:00:00.000Z",250,8,"DeAndre Jordan",0,0,0,0,0,0
"11478",1611,0,0,0,0,0,0,0,0,0,0,0,0,0,0,0,0,1037642,"2023-10-30T00:00:00.000Z",56677582,8,"Jalen Pickett",0,0,0,0,0,0
"11479",1612,0,0,0,0,0,0,0,0,0,0,0,0,0,0,0,0,1037642,"2023-10-30T00:00:00.000Z",56677871,8,"Hunter Tyson",0,0,0,0,0,0
"11480",1613,2,0,2,1,0,1,0,0,0,14,0,0,0,2,1,1,1037643,"2023-10-30T00:00:00.000Z",666860,14,"Cameron Reddish",1,2,4,2,4,7.4
"11481",1614,0,0,2,0,0,0,0,0,0,10,0,2,0,2,0,0,1037643,"2023-10-30T00:00:00.000Z",666626,14,"Jaxson Hayes",0,2,2,0,2,2.4
"11482",1615,0,0,0,0,0,0,0,0,0,0,0,0,0,0,0,0,1037643,"2023-10-30T00:00:00.000Z",56677738,14,"Colin Castleton",0,0,0,0,0,0
"11483",1616,0,0,0,0,0,0,0,0,0,0,0,0,0,0,0,0,1037643,"2023-10-30T00:00:00.000Z",38017697,14,"Max Christie",0,0,0,0,0,0
"11484",1617,0,0,0,0,0,0,0,0,0,0,0,0,0,0,0,0,1037643,"2023-10-30T00:00:00.000Z",56677868,14,"D'Moi Hodge",0,0,0,0,0,0
"11485",1618,0,0,0,0,0,0,0,0,0,0,0,0,0,0,0,0,1037643,"2023-10-30T00:00:00.000Z",56677836,14,"Maxwell Lewis",0,0,0,0,0,0
"11486",1619,0,4,3,0,0,0,0,0,0,12,2,1,0,5,0,1,1037638,"2023-10-30T00:00:00.000Z",379,7,"Dwight Powell",4,5,5,0,5,17
"11487",1620,0,0,0,2,0,2,0,0,0,2,0,2,0,0,0,1,1037641,"2023-10-30T00:00:00.000Z",3547271,21,"Aleksej Pokusevski",0,0,0,0,0,-1
"11488",1621,0,0,0,0,0,0,0,0,0,0,0,0,0,0,0,0,1037641,"2023-10-30T00:00:00.000Z",17896078,21,"Aaron Wiggins",0,0,0,0,0,0
"11489",1622,0,0,0,0,0,0,0,0,0,0,0,0,0,0,0,0,1037641,"2023-10-30T00:00:00.000Z",56677853,21,"Keyontae Johnson",0,0,0,0,0,0
"11490",1623,0,0,0,0,0,0,0,0,0,0,0,0,0,0,0,0,1037641,"2023-10-30T00:00:00.000Z",27924547,21,"Lindy Waters III",0,0,0,0,0,0
"11491",1624,0,0,1,0,0,0,0,0,0,2,0,0,0,1,0,0,1037641,"2023-10-30T00:00:00.000Z",42097199,9,"Jared Rhoden",0,1,1,0,1,1.2
"11492",1625,0,0,0,0,0,0,0,0,0,2,0,0,0,0,1,0,1037641,"2023-10-30T00:00:00.000Z",44477024,9,"Stanley Umude",1,0,0,0,0,3
"11493",1626,5,0,6,6,2,20,9,8,7,36,1,2,27,7,0,1,1037959,"2023-12-20T00:00:00.000Z",3547238,18,"Anthony Edwards",0,34,39,32,12,41.9
"11494",1627,4,0,0,4,1,7,3,2,2,26,0,1,9,0,0,2,1037959,"2023-12-20T00:00:00.000Z",104,18,"Mike Conley",0,9,13,13,4,13
"11495",1628,1,1,1,6,2,9,4,0,0,20,1,3,10,2,0,4,1037959,"2023-12-20T00:00:00.000Z",667378,18,"Naz Reid",1,12,13,11,3,12.9
"11496",1629,1,0,0,0,0,5,1,0,0,13,0,0,2,0,0,2,1037959,"2023-12-20T00:00:00.000Z",12,18,"Kyle Anderson",0,2,3,3,1,1.5
"11497",1630,2,1,2,1,0,3,2,0,0,16,0,1,4,2,0,0,1037959,"2023-12-20T00:00:00.000Z",666400,18,"Nickeil Alexander-Walker",1,6,8,6,4,12.4
"11498",1631,1,0,1,2,1,4,2,0,0,10,1,0,5,2,0,3,1037959,"2023-12-20T00:00:00.000Z",68,18,"Troy Brown Jr.",0,7,8,6,3,5.9
"11499",1632,3,0,0,0,0,2,0,2,2,13,0,2,2,0,0,1,1037959,"2023-12-20T00:00:00.000Z",320,18,"Shake Milton",0,2,5,5,3,5.5
"11500",1633,1,0,0,0,0,0,0,0,0,2,0,0,0,0,0,0,1037959,"2023-12-20T00:00:00.000Z",666767,18,"Jordan McLaughlin",0,0,1,1,1,1.5
"11501",1634,0,0,0,0,0,1,1,0,0,2,0,0,2,0,1,1,1037959,"2023-12-20T00:00:00.000Z",38017700,18,"Wendell Moore Jr.",1,2,2,2,0,4
"11502",1635,1,0,1,1,0,1,0,0,0,2,0,2,0,1,0,0,1037959,"2023-12-20T00:00:00.000Z",17896056,18,"Luka Garza",0,1,2,1,2,2.7
"11503",1636,0,0,0,0,0,0,0,0,0,0,0,0,0,0,0,0,1037959,"2023-12-20T00:00:00.000Z",56677782,18,"Leonard Miller",0,0,0,0,0,0
"11504",1637,0,0,0,0,0,0,0,0,0,0,0,0,0,0,0,0,1037959,"2023-12-20T00:00:00.000Z",56677851,18,"Jaylen Clark",0,0,0,0,0,0
"11505",1638,0,0,0,0,0,0,0,0,0,0,0,0,0,0,0,0,1037959,"2023-12-20T00:00:00.000Z",38017715,18,"Josh Minott",0,0,0,0,0,0
"11506",1639,0,0,0,0,0,0,0,0,0,0,0,0,0,0,0,0,1037959,"2023-12-20T00:00:00.000Z",17895968,18,"Daishen Nix",0,0,0,0,0,0
"11507",1640,1,0,3,2,1,7,4,0,0,12,1,3,9,4,1,1,1037958,"2023-12-20T00:00:00.000Z",229,22,"Jonathan Isaac",1,13,14,10,5,17.3
"11508",1641,1,0,2,0,0,8,5,1,1,18,5,5,11,7,0,2,1037958,"2023-12-20T00:00:00.000Z",462,22,"Moritz Wagner",0,18,19,12,8,18.9
"11509",1642,1,0,2,2,1,3,2,0,0,5,0,1,5,2,1,0,1037958,"2023-12-20T00:00:00.000Z",666818,22,"Chuma Okeke",1,7,8,6,3,11.9
"11510",1643,0,0,0,0,0,0,0,0,0,0,0,0,0,0,0,0,1037958,"2023-12-20T00:00:00.000Z",165,22,"Markelle Fultz",0,0,0,0,0,0
"11511",1644,0,0,0,0,0,0,0,0,0,0,0,0,0,0,0,0,1037958,"2023-12-20T00:00:00.000Z",38017607,22,"Kevon Harris",0,0,0,0,0,0
"11512",1645,0,0,0,0,0,0,0,0,0,0,0,0,0,0,0,0,1037958,"2023-12-20T00:00:00.000Z",79,16,"Jimmy Butler",0,0,0,0,0,0
"11513",1646,0,0,0,0,0,0,0,0,0,0,0,0,0,0,0,0,1037958,"2023-12-20T00:00:00.000Z",3547257,16,"R.J. Hampton",0,0,0,0,0,0
"11514",1647,0,0,0,0,0,0,0,0,0,0,0,0,0,0,0,0,1037958,"2023-12-20T00:00:00.000Z",285,16,"Kevin Love",0,0,0,0,0,0
"11515",1648,0,0,0,0,0,0,0,0,0,0,0,0,0,0,0,0,1037958,"2023-12-20T00:00:00.000Z",19465585,16,"Dru Smith",0,0,0,0,0,0
"11516",1649,0,0,0,0,0,0,0,0,0,0,0,0,0,0,0,0,1037958,"2023-12-20T00:00:00.000Z",38017736,16,"Cole Swider",0,0,0,0,0,0
"11517",1650,4,1,3,2,0,7,4,1,1,23,2,0,9,5,1,1,1037972,"2023-12-21T00:00:00.000Z",12,18,"Kyle Anderson",2,14,18,13,9,26
"11518",1651,0,0,0,0,0,0,0,0,0,0,0,0,0,0,0,0,3277426,"2023-11-14T00:00:00.000Z",197,9,"Joe Harris",0,0,0,0,0,0
"11519",1652,0,0,0,0,0,0,0,0,0,0,0,0,0,0,0,0,3277426,"2023-11-14T00:00:00.000Z",17896071,9,"Isaiah Livers",0,0,0,0,0,0
"11520",1653,0,0,0,0,0,0,0,0,0,0,0,0,0,0,0,0,3277426,"2023-11-14T00:00:00.000Z",54,9,"Bojan Bogdanovic",0,0,0,0,0,0
"11521",1654,0,0,0,0,0,0,0,0,0,0,0,0,0,0,0,0,3277426,"2023-11-14T00:00:00.000Z",56677729,9,"Malcolm Cazalon",0,0,0,0,0,0
"11522",1655,0,0,0,0,0,0,0,0,0,0,0,0,0,0,0,0,3277426,"2023-11-14T00:00:00.000Z",330,9,"Monte Morris",0,0,0,0,0,0
"11523",1656,1,0,4,11,6,23,12,2,2,36,2,1,32,6,0,1,3277425,"2023-11-14T00:00:00.000Z",666950,4,"P.J. Washington",0,38,39,33,7,39.7
"11524",1657,1,0,1,2,1,6,2,0,0,28,3,1,5,4,0,0,3277425,"2023-11-14T00:00:00.000Z",18678001,4,"JT Thor",0,9,10,6,5,11.3
"11525",1658,0,0,3,0,0,5,5,4,1,23,4,2,11,7,1,0,3277425,"2023-11-14T00:00:00.000Z",38017698,4,"Mark Williams",1,18,18,11,7,22.4
"11526",1659,3,0,3,2,0,5,0,2,2,23,0,1,2,3,0,2,3277425,"2023-11-14T00:00:00.000Z",3547253,4,"Theo Maledon",0,5,8,5,6,8.1
"11527",1660,11,0,4,10,4,26,9,6,6,39,2,5,28,6,3,8,3277425,"2023-11-14T00:00:00.000Z",3547239,4,"LaMelo Ball",3,34,45,39,17,52.7
"11528",1661,1,0,4,5,3,7,4,2,1,29,0,4,12,4,1,1,3277425,"2023-11-14T00:00:00.000Z",38017708,4,"Bryce McGowens",1,16,17,13,5,20.3
"11529",1662,0,0,0,1,0,2,0,0,0,3,0,0,0,0,0,0,3277425,"2023-11-14T00:00:00.000Z",56677866,4,"Leaky Black",0,0,0,0,0,0
"11530",1663,0,0,0,0,0,0,0,0,0,0,0,0,0,0,0,0,3277425,"2023-11-14T00:00:00.000Z",56677848,4,"Amari Bailey",0,0,0,0,0,0
"11531",1664,1,1,1,2,0,3,1,0,0,16,0,2,2,1,0,0,3277427,"2023-11-14T00:00:00.000Z",108,23,"Robert Covington",1,3,4,3,2,7.7
"11532",1665,3,0,7,1,0,17,11,1,0,37,0,3,22,7,1,1,3277427,"2023-11-14T00:00:00.000Z",200,23,"Tobias Harris",1,29,32,25,10,36.9
"11533",1666,6,0,9,4,0,22,11,17,17,38,3,4,39,12,3,5,3277427,"2023-11-14T00:00:00.000Z",145,23,"Joel Embiid",3,51,57,45,18,66.4
"11534",1667,1,0,3,5,0,5,0,4,3,14,0,1,3,3,0,0,3277425,"2023-11-14T00:00:00.000Z",285,16,"Kevin Love",0,6,7,4,4,8.1
"11535",1668,0,0,0,0,0,0,0,0,0,0,0,0,0,0,0,0,3277425,"2023-11-14T00:00:00.000Z",39398582,16,"Orlando Robinson",0,0,0,0,0,0
"11536",1669,0,0,0,0,0,0,0,0,0,0,0,0,0,0,0,0,3277425,"2023-11-14T00:00:00.000Z",38017734,16,"Jamal Cain",0,0,0,0,0,0
"11537",1670,0,0,0,0,0,0,0,0,0,0,0,0,0,0,0,0,3277425,"2023-11-14T00:00:00.000Z",3547257,16,"R.J. Hampton",0,0,0,0,0,0
"11538",1671,0,0,0,0,0,0,0,0,0,0,0,0,0,0,0,0,3277425,"2023-11-14T00:00:00.000Z",666633,16,"Tyler Herro",0,0,0,0,0,0
"11539",1672,0,0,0,0,0,0,0,0,0,0,0,0,0,0,0,0,3277426,"2023-11-14T00:00:00.000Z",42097199,9,"Jared Rhoden",0,0,0,0,0,0
"11540",1673,0,0,0,0,0,0,0,0,0,0,0,0,0,0,0,0,3277426,"2023-11-14T00:00:00.000Z",44477024,9,"Stanley Umude",0,0,0,0,0,0
"11541",1674,5,0,3,5,2,14,6,3,2,35,2,3,16,5,1,1,3277426,"2023-11-14T00:00:00.000Z",666656,1,"De'Andre Hunter",1,21,26,21,10,31.5
"11542",1675,1,1,4,2,2,9,6,2,2,36,1,2,16,5,1,2,3277426,"2023-11-14T00:00:00.000Z",17896040,1,"Jalen Johnson",2,21,22,17,6,27.5
"11543",1,3,0,3,3,1,12,5,0,0,29,3,1,11,6,1,3,1038029,"2023-12-29T00:00:00.000Z",38017692,27,"Malaki Branham",1,17,20,14,9,22.7
"11544",2,0,2,5,6,1,12,4,0,0,36,0,5,9,5,3,0,1038023,"2023-12-29T00:00:00.000Z",38017688,26,"Keegan Murray",5,14,14,9,5,30
"11545",3,7,0,8,0,0,17,12,4,1,35,2,2,25,10,0,1,1038023,"2023-12-29T00:00:00.000Z",406,26,"Domantas Sabonis",0,35,42,32,17,46.5
"11546",4,0,0,0,0,0,0,0,0,0,0,0,0,0,0,0,0,1038023,"2023-12-29T00:00:00.000Z",306,26,"JaVale McGee",0,0,0,0,0,0
"11547",5,0,0,0,0,0,0,0,0,0,0,0,0,0,0,0,0,1038023,"2023-12-29T00:00:00.000Z",666925,26,"Juan Toscano-Anderson",0,0,0,0,0,0
"11548",6,0,0,0,0,0,0,0,0,0,0,0,0,0,0,0,0,1038023,"2023-12-29T00:00:00.000Z",4197162,26,"Aleksandar Vezenkov",0,0,0,0,0,0
"11549",7,0,0,0,0,0,0,0,0,0,0,0,0,0,0,0,0,1038023,"2023-12-29T00:00:00.000Z",17895990,26,"Jordan Ford",0,0,0,0,0,0
"11550",8,0,0,0,0,0,0,0,0,0,0,0,0,0,0,0,0,1038023,"2023-12-29T00:00:00.000Z",56677845,26,"Colby Jones",0,0,0,0,0,0
"11551",9,0,0,0,0,0,0,0,0,0,0,0,0,0,0,0,0,1038023,"2023-12-29T00:00:00.000Z",56677862,26,"Jalen Slawson",0,0,0,0,0,0
"11552",10,0,0,4,0,0,0,0,0,0,4,0,1,0,4,0,0,1038029,"2023-12-29T00:00:00.000Z",666476,25,"Moses Brown",0,4,4,0,4,4.8
"11553",11,7,0,5,8,3,18,9,11,8,32,2,4,29,7,1,1,1038029,"2023-12-29T00:00:00.000Z",666682,27,"Keldon Johnson",1,36,43,36,14,49.9
"11554",12,7,0,1,7,5,18,9,4,4,37,0,2,27,1,1,1,1038029,"2023-12-29T00:00:00.000Z",65,25,"Malcolm Brogdon",1,28,35,34,8,40.7
"11555",13,11,1,3,5,3,21,9,2,1,37,4,5,22,7,1,4,1038029,"2023-12-29T00:00:00.000Z",56677747,25,"Scoot Henderson",2,29,40,33,18,48.9
"11556",14,1,2,1,0,0,0,0,2,2,10,1,3,2,2,0,0,1038029,"2023-12-29T00:00:00.000Z",39613724,25,"Ibou Badji",2,4,5,3,3,11.9
"11557",15,2,0,1,1,1,10,5,0,0,20,1,0,11,2,1,0,1038029,"2023-12-29T00:00:00.000Z",3547289,25,"Skylar Mays",1,13,15,13,4,19.4
"11558",16,0,2,1,4,1,6,3,0,0,27,0,1,7,1,1,1,1038029,"2023-12-29T00:00:00.000Z",666923,25,"Matisse Thybulle",3,8,8,7,1,16.2
"11559",17,1,1,3,2,1,11,7,13,10,30,6,4,25,9,1,1,1038029,"2023-12-29T00:00:00.000Z",38017711,25,"Jabari Walker",2,34,35,26,10,42.3
"11560",18,0,0,0,0,0,0,0,0,0,0,0,0,0,0,0,0,1038029,"2023-12-29T00:00:00.000Z",47957121,25,"Justin Minaya",0,0,0,0,0,0
"11561",19,0,0,0,0,0,0,0,0,0,0,0,0,0,0,0,0,1038029,"2023-12-29T00:00:00.000Z",56677791,25,"Kris Murray",0,0,0,0,0,0
"11562",20,0,0,0,0,0,0,0,0,0,0,0,0,0,0,0,0,1038029,"2023-12-29T00:00:00.000Z",56677829,25,"Rayan Rupert",0,0,0,0,0,0
"11563",21,0,0,0,0,0,0,0,0,0,0,0,0,0,0,0,0,1038029,"2023-12-29T00:00:00.000Z",17896120,25,"Ish Wainright",0,0,0,0,0,0
"11564",22,0,0,0,0,0,0,0,0,0,0,0,0,0,0,0,0,1038029,"2023-12-29T00:00:00.000Z",22,25,"Deandre Ayton",0,0,0,0,0,0
"11565",23,0,0,0,0,0,0,0,0,0,0,0,0,0,0,0,0,1038029,"2023-12-29T00:00:00.000Z",56783340,25,"Duop Reath",0,0,0,0,0,0
"11566",24,0,0,0,0,0,0,0,0,0,0,0,0,0,0,0,0,1038029,"2023-12-29T00:00:00.000Z",38017690,25,"Shaedon Sharpe",0,0,0,0,0,0
"11567",25,1,0,1,8,6,9,6,0,0,23,0,1,18,1,0,2,1038029,"2023-12-29T00:00:00.000Z",305,27,"Doug McDermott",0,19,20,19,2,18.7
"11568",26,0,0,1,0,0,0,0,2,2,9,0,1,2,1,0,1,3277501,"2023-11-24T00:00:00.000Z",56677828,28,"Gradey Dick",0,3,3,2,1,2.2
"11569",27,0,1,4,5,1,8,4,2,1,25,3,1,10,7,0,0,3277505,"2023-11-24T00:00:00.000Z",68,18,"Troy Brown Jr.",1,17,17,10,7,21.4
"11570",28,0,0,0,0,0,0,0,0,0,0,0,0,0,0,0,0,3277505,"2023-11-24T00:00:00.000Z",56677782,18,"Leonard Miller",0,0,0,0,0,0
"11571",29,0,0,4,6,3,10,6,3,3,28,0,2,18,4,0,0,3277502,"2023-11-24T00:00:00.000Z",210,12,"Buddy Hield",0,22,22,18,4,22.8
"11572",30,2,0,2,5,3,8,6,0,0,24,1,1,15,3,0,0,3277502,"2023-11-24T00:00:00.000Z",3547243,12,"Obi Toppin",0,18,20,17,5,21.6
"11573",31,2,5,5,3,1,14,8,6,6,27,5,5,23,10,1,2,3277502,"2023-11-24T00:00:00.000Z",452,12,"Myles Turner",6,33,35,25,12,54
"11574",32,5,0,4,3,0,10,3,5,4,37,0,3,10,4,3,0,3277502,"2023-11-24T00:00:00.000Z",69,12,"Bruce Brown",3,14,19,15,9,31.3
"11575",33,10,0,2,13,5,23,9,3,3,32,0,0,26,2,0,1,3277502,"2023-11-24T00:00:00.000Z",3547245,12,"Tyrese Haliburton",0,28,38,36,12,42.4
"11576",34,0,0,1,2,1,12,6,2,2,31,1,4,15,2,1,1,3277502,"2023-11-24T00:00:00.000Z",38017686,12,"Bennedict Mathurin",1,17,17,15,2,19.4
"11577",35,1,0,5,6,1,7,2,2,2,18,1,1,7,6,0,2,3277500,"2023-11-24T00:00:00.000Z",285,16,"Kevin Love",0,13,14,8,7,13.7
"11578",36,1,0,3,3,0,5,1,0,0,18,0,3,2,3,1,0,3277500,"2023-11-24T00:00:00.000Z",666747,16,"Caleb Martin",1,5,6,3,4,10.1
"11579",37,2,0,0,2,0,3,0,0,0,6,0,0,0,0,0,0,3277500,"2023-11-24T00:00:00.000Z",38017736,16,"Cole Swider",0,0,2,2,2,3
"11580",38,0,0,0,0,0,0,0,0,0,0,0,0,0,0,0,0,3277500,"2023-11-24T00:00:00.000Z",3547257,16,"R.J. Hampton",0,0,0,0,0,0
"11581",39,0,0,0,0,0,0,0,0,0,0,0,0,0,0,0,0,3277500,"2023-11-24T00:00:00.000Z",666633,16,"Tyler Herro",0,0,0,0,0,0
"11582",40,0,0,0,0,0,0,0,0,0,0,0,0,0,0,0,0,3277500,"2023-11-24T00:00:00.000Z",38017696,16,"Nikola Jovic",0,0,0,0,0,0
"11583",41,0,0,0,0,0,0,0,0,0,0,0,0,0,0,0,0,3277500,"2023-11-24T00:00:00.000Z",397,16,"Duncan Robinson",0,0,0,0,0,0
"11584",42,0,0,0,0,0,0,0,0,0,0,0,0,0,0,0,0,3277500,"2023-11-24T00:00:00.000Z",39398582,16,"Orlando Robinson",0,0,0,0,0,0
"11585",43,0,0,0,0,0,0,0,0,0,0,0,0,0,0,0,0,3277500,"2023-11-24T00:00:00.000Z",19465585,16,"Dru Smith",0,0,0,0,0,0
"11586",44,2,1,0,7,2,8,2,0,0,22,1,4,6,1,2,0,3277505,"2023-11-24T00:00:00.000Z",666400,18,"Nickeil Alexander-Walker",3,7,9,8,3,19.2
"11587",45,0,0,5,2,2,3,2,2,2,21,1,1,8,6,1,1,3277502,"2023-11-24T00:00:00.000Z",3547264,12,"Jalen Smith",1,14,14,8,6,17.2
"11588",46,4,0,10,5,4,15,9,5,5,38,1,3,27,11,0,4,3277505,"2023-11-24T00:00:00.000Z",447,18,"Karl-Anthony Towns",0,38,42,31,15,42.2
"11589",47,0,2,8,0,0,8,5,2,2,36,3,5,12,11,0,3,3277505,"2023-11-24T00:00:00.000Z",176,18,"Rudy Gobert",2,23,23,12,11,28.2
"11590",48,5,2,7,9,2,21,8,18,17,40,0,2,35,7,2,4,3277505,"2023-11-24T00:00:00.000Z",3547238,18,"Anthony Edwards",4,42,47,40,12,58.9
"11591",49,8,0,2,3,2,7,2,0,0,30,1,1,6,3,1,1,3277505,"2023-11-24T00:00:00.000Z",104,18,"Mike Conley",1,9,17,14,11,23.6
"11592",50,1,1,1,1,0,6,1,0,0,13,1,1,2,2,1,3,3277505,"2023-11-24T00:00:00.000Z",320,18,"Shake Milton",2,4,5,3,3,8.9
"11593",51,0,0,0,0,0,0,0,0,0,0,0,0,0,0,0,0,1038113,"2024-01-10T00:00:00.000Z",4197387,1,"Vit Krejci",0,0,0,0,0,0
"11594",52,0,0,0,0,0,0,0,0,0,0,0,0,0,0,0,0,1038112,"2024-01-10T00:00:00.000Z",167,30,"Danilo Gallinari",0,0,0,0,0,0
"11595",53,0,0,0,0,0,0,0,0,0,0,0,0,0,0,0,0,1038112,"2024-01-10T00:00:00.000Z",3547302,30,"Anthony Gill",0,0,0,0,0,0
"11596",54,0,0,0,0,0,0,0,0,0,0,0,0,0,0,0,0,1038112,"2024-01-10T00:00:00.000Z",18677954,30,"Jared Butler",0,0,0,0,0,0
"11597",55,1,0,1,4,2,5,3,0,0,18,1,2,8,2,0,1,1038114,"2024-01-10T00:00:00.000Z",56677833,21,"Cason Wallace",0,10,11,9,3,10.9
"11598",56,2,0,5,2,1,4,3,0,0,17,1,0,7,6,0,2,1038114,"2024-01-10T00:00:00.000Z",480,21,"Kenrich Williams",0,13,15,9,8,15.2
"11599",57,0,0,0,0,0,0,0,0,0,0,0,0,0,0,0,0,1038112,"2024-01-10T00:00:00.000Z",17896106,30,"Eugene Omoruyi",0,0,0,0,0,0
"11600",58,0,0,0,0,0,0,0,0,0,0,0,0,0,0,0,0,1038112,"2024-01-10T00:00:00.000Z",414,30,"Landry Shamet",0,0,0,0,0,0
"11601",59,0,0,0,0,0,0,0,0,0,0,0,0,0,0,0,0,1038113,"2024-01-10T00:00:00.000Z",38017732,23,"Kenneth Lofton Jr.",0,0,0,0,0,0
"11602",60,4,0,2,2,1,2,1,0,0,12,0,2,3,2,0,0,1038114,"2024-01-10T00:00:00.000Z",38017706,21,"Jaylin Williams",0,5,9,7,6,11.4
"11603",61,0,0,0,0,0,4,1,0,0,8,0,1,2,0,0,0,1038114,"2024-01-10T00:00:00.000Z",17896078,21,"Aaron Wiggins",0,2,2,2,0,2
"11604",62,0,0,0,0,0,0,0,0,0,0,0,0,0,0,0,0,1038114,"2024-01-10T00:00:00.000Z",3547271,21,"Aleksej Pokusevski",0,0,0,0,0,0
"11605",63,0,0,0,0,0,0,0,0,0,0,0,0,0,0,0,0,1038114,"2024-01-10T00:00:00.000Z",27924547,21,"Lindy Waters III",0,0,0,0,0,0
"11606",64,0,0,0,0,0,0,0,0,0,0,0,0,0,0,0,0,1038113,"2024-01-10T00:00:00.000Z",56677788,23,"Terquavion Smith",0,0,0,0,0,0
"11607",65,0,0,0,0,0,0,0,0,0,0,0,0,0,0,0,0,1038114,"2024-01-10T00:00:00.000Z",44,21,"Davis Bertans",0,0,0,0,0,0
"11608",66,0,0,0,0,0,0,0,0,0,0,0,0,0,0,0,0,1038114,"2024-01-10T00:00:00.000Z",38017716,21,"Ousmane Dieng",0,0,0,0,0,0
"11609",67,3,1,4,9,2,10,3,6,4,32,2,3,12,6,1,0,1038115,"2024-01-10T00:00:00.000Z",89,5,"Alex Caruso",2,18,21,15,9,29.7
"11610",68,4,0,4,6,3,19,5,6,6,43,0,2,19,4,0,1,1038115,"2024-01-10T00:00:00.000Z",125,5,"DeMar DeRozan",0,23,27,23,8,28.8
"11611",69,3,1,12,5,0,17,9,0,0,40,3,4,18,15,0,0,1038115,"2024-01-10T00:00:00.000Z",460,5,"Nikola Vucevic",1,33,36,21,18,43.5
"11612",70,7,1,12,8,4,15,8,6,5,41,1,5,25,13,3,4,1038115,"2024-01-10T00:00:00.000Z",268,5,"Zach LaVine",4,38,45,32,20,59.1
"11613",71,8,1,4,11,6,17,9,7,6,43,0,1,30,4,0,4,1038115,"2024-01-10T00:00:00.000Z",666956,5,"Coby White",1,34,42,38,12,45.8
"11614",72,3,0,2,4,2,8,3,0,0,18,2,0,8,4,0,0,1038115,"2024-01-10T00:00:00.000Z",17895983,5,"Ayo Dosunmu",0,12,15,11,7,17.3
"11615",73,0,0,0,0,0,2,2,0,0,13,0,1,4,0,2,3,1038115,"2024-01-10T00:00:00.000Z",137,5,"Andre Drummond",2,4,4,4,0,7
"11616",74,0,0,0,0,0,0,0,0,0,0,0,0,0,0,0,0,1038115,"2024-01-10T00:00:00.000Z",87,5,"Jevon Carter",0,0,0,0,0,0
"11617",75,0,0,0,0,0,0,0,0,0,0,0,0,0,0,0,0,1038115,"2024-01-10T00:00:00.000Z",110,5,"Torrey Craig",0,0,0,0,0,0
"11618",76,4,1,1,5,1,19,5,3,2,28,1,0,13,2,1,2,7049317,"2023-12-06T00:00:00.000Z",130,3,"Spencer Dinwiddie",2,15,19,17,6,25.4
"11619",77,0,2,6,0,0,5,3,5,2,19,4,4,8,10,0,3,7049317,"2023-12-06T00:00:00.000Z",17896038,3,"Day'Ron Sharpe",2,18,18,8,10,23
"11620",78,0,0,0,0,0,0,0,0,0,1,0,0,0,0,0,0,7049314,"2023-12-06T00:00:00.000Z",17896027,15,"Ziaire Williams",0,0,0,0,0,0
"11621",79,0,1,3,6,3,10,6,0,0,30,2,3,15,5,1,1,7049317,"2023-12-06T00:00:00.000Z",158,3,"Dorian Finney-Smith",2,20,20,15,5,26
"11622",80,2,0,3,4,1,6,2,2,1,21,0,2,6,3,1,0,7049317,"2023-12-06T00:00:00.000Z",351,3,"Royce O'Neale",1,9,11,8,5,15.6
"11623",81,0,1,1,2,0,10,3,0,0,22,1,1,6,2,0,1,7049318,"2023-12-06T00:00:00.000Z",38017699,27,"Jeremy Sochan",1,8,8,6,2,10.4
"11624",82,5,0,2,3,0,8,2,0,0,24,0,2,4,2,1,0,7049318,"2023-12-06T00:00:00.000Z",3547274,27,"Tre Jones",1,6,11,9,7,16.9
"11625",83,2,0,3,8,3,8,3,2,2,22,0,1,11,3,0,0,7049318,"2023-12-06T00:00:00.000Z",305,27,"Doug McDermott",0,14,16,13,5,17.6
"11626",84,0,0,0,0,0,0,0,0,0,0,0,0,0,0,0,0,7049318,"2023-12-06T00:00:00.000Z",180,27,"Devonte' Graham",0,0,0,0,0,0
"11627",85,0,0,0,0,0,0,0,0,0,0,0,0,0,0,0,0,7049318,"2023-12-06T00:00:00.000Z",17896059,27,"Sandro Mamukelashvili",0,0,0,0,0,0
"11628",86,0,0,0,0,0,0,0,0,0,0,0,0,0,0,0,0,7049318,"2023-12-06T00:00:00.000Z",38017730,27,"Dominick Barlow",0,0,0,0,0,0
"11629",87,0,0,0,0,0,0,0,0,0,0,0,0,0,0,0,0,7049318,"2023-12-06T00:00:00.000Z",56677865,27,"Charles Bediako",0,0,0,0,0,0
"11630",88,0,0,0,0,0,0,0,0,0,0,0,0,0,0,0,0,7049314,"2023-12-06T00:00:00.000Z",3,15,"Steven Adams",0,0,0,0,0,0
"11631",89,0,0,0,0,0,0,0,0,0,0,0,0,0,0,0,0,7049314,"2023-12-06T00:00:00.000Z",666505,15,"Brandon Clarke",0,0,0,0,0,0
"11632",90,4,0,5,7,6,13,8,0,0,27,1,3,22,6,1,0,7049320,"2023-12-06T00:00:00.000Z",213,11,"Aaron Holiday",1,28,32,26,10,38.2
"11633",91,0,0,1,1,0,2,0,0,0,15,0,1,0,1,0,2,7049320,"2023-12-06T00:00:00.000Z",3547301,11,"Jae'Sean Tate",0,1,1,0,1,-0.8
"11634",92,0,0,0,0,0,0,0,0,0,0,0,0,0,0,0,0,7049320,"2023-12-06T00:00:00.000Z",296,11,"Boban Marjanovic",0,0,0,0,0,0
"11635",93,0,0,0,0,0,0,0,0,0,0,0,0,0,0,0,0,7049320,"2023-12-06T00:00:00.000Z",47738533,11,"Jeenathan Williams",0,0,0,0,0,0
"11636",94,0,0,0,0,0,0,0,0,0,0,0,0,0,0,0,0,7049320,"2023-12-06T00:00:00.000Z",188,11,"Jeff Green",0,0,0,0,0,0
"11637",95,0,0,0,0,0,0,0,0,0,0,0,0,0,0,0,0,7049320,"2023-12-06T00:00:00.000Z",3547281,11,"Nate Hinton",0,0,0,0,0,0
"11638",96,0,0,2,1,0,1,0,0,0,3,0,2,0,2,0,1,7049315,"2023-12-06T00:00:00.000Z",38017696,16,"Nikola Jovic",0,2,2,0,2,1.4
"11639",97,0,0,0,0,0,0,0,0,0,0,0,0,0,0,0,0,7049315,"2023-12-06T00:00:00.000Z",74,16,"Thomas Bryant",0,0,0,0,0,0
"11640",98,0,0,0,0,0,0,0,0,0,0,0,0,0,0,0,0,7049315,"2023-12-06T00:00:00.000Z",38017734,16,"Jamal Cain",0,0,0,0,0,0
"11641",99,0,0,0,0,0,0,0,0,0,0,0,0,0,0,0,0,7049315,"2023-12-06T00:00:00.000Z",3092,16,"Haywood Highsmith",0,0,0,0,0,0
"11642",100,0,0,0,0,0,0,0,0,0,0,0,0,0,0,0,0,7049315,"2023-12-06T00:00:00.000Z",4,16,"Bam Adebayo",0,0,0,0,0,0
"11643",101,1,0,1,3,1,3,1,0,0,6,0,0,3,1,0,1,3277353,"2023-11-03T00:00:00.000Z",38017716,21,"Ousmane Dieng",0,4,5,4,2,4.7
"11644",102,4,0,0,4,2,20,9,4,4,34,1,0,24,1,0,0,3277352,"2023-11-03T00:00:00.000Z",125,5,"DeMar DeRozan",0,25,29,28,5,31.2
"11645",103,4,0,6,2,1,4,1,0,0,23,0,4,3,6,1,1,3277352,"2023-11-03T00:00:00.000Z",110,5,"Torrey Craig",1,9,13,7,10,18.2
"11646",104,3,0,7,1,1,13,6,0,0,36,6,1,13,13,0,0,3277352,"2023-11-03T00:00:00.000Z",460,5,"Nikola Vucevic",0,26,29,16,16,33.1
"11647",105,5,1,6,6,1,21,10,4,3,39,1,2,24,7,1,2,3277352,"2023-11-03T00:00:00.000Z",268,5,"Zach LaVine",2,31,36,29,12,43.9
"11648",106,2,1,2,8,2,17,7,2,2,35,1,0,18,3,0,2,3277352,"2023-11-03T00:00:00.000Z",666956,5,"Coby White",1,21,23,20,5,25.6
"11649",107,0,0,1,2,1,3,2,0,0,14,0,2,5,1,1,2,3277352,"2023-11-03T00:00:00.000Z",87,5,"Jevon Carter",1,6,6,5,1,7.2
"11650",108,1,0,0,5,3,6,4,6,5,26,0,0,16,0,0,1,3277353,"2023-11-03T00:00:00.000Z",3547272,21,"Isaiah Joe",0,16,17,17,1,16.5
"11651",109,0,0,2,3,1,6,3,0,0,17,0,1,7,2,1,0,3277353,"2023-11-03T00:00:00.000Z",17896078,21,"Aaron Wiggins",1,9,9,7,2,12.4
"11652",110,3,0,1,2,1,5,2,0,0,12,0,1,5,1,0,0,3277353,"2023-11-03T00:00:00.000Z",4197029,21,"Vasilije Micic",0,6,9,8,4,10.7
"11653",111,0,0,0,0,0,0,0,0,0,0,0,0,0,0,0,0,3277353,"2023-11-03T00:00:00.000Z",17896036,21,"Tre Mann",0,0,0,0,0,0
"11654",112,0,0,0,0,0,0,0,0,0,0,0,0,0,0,0,0,3277353,"2023-11-03T00:00:00.000Z",3547271,21,"Aleksej Pokusevski",0,0,0,0,0,0
"11655",113,0,0,0,0,0,0,0,0,0,0,0,0,0,0,0,0,3277353,"2023-11-03T00:00:00.000Z",24572055,21,"Olivier Sarr",0,0,0,0,0,0
"11656",114,0,0,0,0,0,0,0,0,0,0,0,0,0,0,0,0,3277353,"2023-11-03T00:00:00.000Z",27924547,21,"Lindy Waters III",0,0,0,0,0,0
"11657",115,0,0,0,0,0,0,0,0,0,3,0,1,0,0,0,0,3277349,"2023-11-03T00:00:00.000Z",666940,6,"Dean Wade",0,0,0,0,0,0
"11658",116,0,0,1,0,0,0,0,0,0,3,0,1,0,1,0,0,3277349,"2023-11-03T00:00:00.000Z",444,6,"Tristan Thompson",0,1,1,0,1,1.2
"11659",117,0,0,0,0,0,0,0,0,0,0,0,0,0,0,0,0,3277349,"2023-11-03T00:00:00.000Z",56677872,6,"Craig Porter",0,0,0,0,0,0
"11660",118,0,0,0,0,0,0,0,0,0,0,0,0,0,0,0,0,3277349,"2023-11-03T00:00:00.000Z",56677847,6,"Emoni Bates",0,0,0,0,0,0
"11661",119,0,0,0,0,0,0,0,0,0,0,0,0,0,0,0,0,3277349,"2023-11-03T00:00:00.000Z",666676,6,"Ty Jerome",0,0,0,0,0,0
"11662",120,0,0,0,0,0,0,0,0,0,0,0,0,0,0,0,0,3277349,"2023-11-03T00:00:00.000Z",38017662,6,"Isaiah Mobley",0,0,0,0,0,0
"11663",121,0,0,0,0,0,0,0,0,0,0,0,0,0,0,0,0,3277349,"2023-11-03T00:00:00.000Z",404,6,"Ricky Rubio",0,0,0,0,0,0
"11664",122,3,0,5,3,0,5,2,2,2,15,0,1,6,5,0,1,3277353,"2023-11-03T00:00:00.000Z",38017706,21,"Jaylin Williams",0,11,14,9,8,15.5
"11665",123,0,0,0,0,0,0,0,0,0,0,0,0,0,0,0,0,3277353,"2023-11-03T00:00:00.000Z",175,21,"Shai Gilgeous-Alexander",0,0,0,0,0,0
"11666",124,0,0,0,0,0,0,0,0,0,0,0,0,0,0,0,0,3277353,"2023-11-03T00:00:00.000Z",56677853,21,"Keyontae Johnson",0,0,0,0,0,0
"11667",125,0,0,0,0,0,0,0,0,0,0,0,0,0,0,0,0,3277353,"2023-11-03T00:00:00.000Z",480,21,"Kenrich Williams",0,0,0,0,0,0
"11668",126,0,0,0,0,0,0,0,0,0,0,0,0,0,0,0,0,1037971,"2023-12-21T00:00:00.000Z",274,13,"Kawhi Leonard",0,0,0,0,0,0
"11669",127,0,0,0,0,0,0,0,0,0,0,0,0,0,0,0,0,1037971,"2023-12-21T00:00:00.000Z",56677856,13,"Jordan Miller",0,0,0,0,0,0
"11670",128,0,0,0,0,0,0,0,0,0,0,0,0,0,0,0,0,1037971,"2023-12-21T00:00:00.000Z",24417679,13,"Xavier Moon",0,0,0,0,0,0
"11671",129,0,0,0,0,0,0,0,0,0,0,0,0,0,0,0,0,1037971,"2023-12-21T00:00:00.000Z",371,13,"Mason Plumlee",0,0,0,0,0,0
"11672",130,0,0,0,0,0,0,0,0,0,0,0,0,0,0,0,0,1037960,"2023-12-20T00:00:00.000Z",56677841,3,"Dariq Whitehead",0,0,0,0,0,0
"11673",131,2,1,5,1,0,11,5,4,4,27,0,2,14,5,1,2,1037960,"2023-12-20T00:00:00.000Z",666423,20,"RJ Barrett",2,19,21,16,7,27
"11674",132,4,0,5,4,0,20,9,9,8,34,2,3,26,7,0,1,1037960,"2023-12-20T00:00:00.000Z",387,20,"Julius Randle",0,33,37,30,11,39.4
"11675",133,3,2,5,0,0,3,1,0,0,30,5,1,2,10,0,0,1037960,"2023-12-20T00:00:00.000Z",201,20,"Isaiah Hartenstein",2,12,15,5,13,24.5
"11676",134,0,0,0,0,0,0,0,0,0,1,0,0,0,0,0,0,1037962,"2023-12-20T00:00:00.000Z",56677857,5,"Julian Phillips",0,0,0,0,0,0
"11677",135,0,0,0,0,0,0,0,0,0,1,0,0,0,0,0,0,1037962,"2023-12-20T00:00:00.000Z",17896116,5,"Terry Taylor",0,0,0,0,0,0
"11678",136,1,0,6,10,5,15,9,0,0,23,2,2,23,8,3,2,1037960,"2023-12-20T00:00:00.000Z",131,20,"Donte DiVincenzo",3,31,32,24,9,41.1
"11679",137,8,0,6,3,1,15,6,4,3,32,1,0,16,7,1,3,1037960,"2023-12-20T00:00:00.000Z",73,20,"Jalen Brunson",1,23,31,24,15,36.4
"11680",138,0,0,0,0,0,0,0,0,0,0,0,0,0,0,0,0,1037962,"2023-12-20T00:00:00.000Z",110,5,"Torrey Craig",0,0,0,0,0,0
"11681",139,0,0,0,0,0,0,0,0,0,0,0,0,0,0,0,0,1037962,"2023-12-20T00:00:00.000Z",27,5,"Lonzo Ball",0,0,0,0,0,0
"11682",140,0,0,0,0,0,0,0,0,0,0,0,0,0,0,0,0,1037962,"2023-12-20T00:00:00.000Z",56677874,5,"Onuralp Bitim",0,0,0,0,0,0
"11683",142,3,0,1,3,1,4,1,0,0,14,0,2,3,1,0,0,1037962,"2023-12-20T00:00:00.000Z",1603383,14,"Gabe Vincent",0,4,7,6,4,8.7
"11684",143,1,0,2,2,1,9,2,0,0,16,3,0,5,5,0,0,1037962,"2023-12-20T00:00:00.000Z",666609,14,"Rui Hachimura",0,10,11,6,6,12.5
"11685",144,4,1,2,8,4,12,4,0,0,34,0,1,12,2,1,0,1037958,"2023-12-20T00:00:00.000Z",391,16,"Josh Richardson",2,14,18,16,6,26.4
"11686",145,1,0,2,0,0,7,5,2,2,17,3,1,12,5,0,2,1037958,"2023-12-20T00:00:00.000Z",74,16,"Thomas Bryant",0,17,18,13,6,17.5
"11687",146,0,0,0,0,0,0,0,0,0,1,0,0,0,0,0,0,1037962,"2023-12-20T00:00:00.000Z",38017697,14,"Max Christie",0,0,0,0,0,0
"11688",147,0,0,1,0,0,1,1,0,0,1,0,0,2,1,0,0,1037962,"2023-12-20T00:00:00.000Z",666626,14,"Jaxson Hayes",0,3,3,2,1,3.2
"11689",148,0,0,0,0,0,0,0,0,0,1,0,0,0,0,0,0,1037962,"2023-12-20T00:00:00.000Z",56677836,14,"Maxwell Lewis",0,0,0,0,0,0
"11690",149,0,0,1,4,2,4,2,0,0,17,0,1,6,1,0,1,1037963,"2023-12-20T00:00:00.000Z",666754,1,"Garrison Mathews",0,7,7,6,1,6.2
"11691",150,2,0,2,1,0,9,6,0,0,30,3,1,12,5,0,1,1037961,"2023-12-20T00:00:00.000Z",177,8,"Aaron Gordon",0,17,19,14,7,20
"11692",151,7,0,1,7,2,13,4,0,0,35,2,1,10,3,1,1,1037750,"2023-11-15T00:00:00.000Z",666965,7,"Grant Williams",1,13,20,17,10,26.1
"11693",152,2,2,5,0,0,8,7,3,3,24,4,2,17,9,1,1,1037750,"2023-11-15T00:00:00.000Z",56677840,7,"Dereck Lively II",3,26,28,19,11,38.8
"11694",153,1,0,3,4,0,4,0,0,0,37,1,1,0,4,1,0,1037750,"2023-11-15T00:00:00.000Z",3547258,7,"Josh Green",1,4,5,1,5,9.3
"11695",154,10,0,6,11,4,18,7,12,8,32,1,2,26,7,0,3,1037750,"2023-11-15T00:00:00.000Z",132,7,"Luka Doncic",0,33,43,36,17,46.4
"11696",155,3,0,4,11,7,20,11,5,2,27,0,1,31,4,0,1,1037750,"2023-11-15T00:00:00.000Z",191,7,"Tim Hardaway Jr.",0,35,38,34,7,39.3
"11697",156,3,0,7,1,0,6,2,2,1,19,0,3,5,7,0,0,1037750,"2023-11-15T00:00:00.000Z",151,7,"Dante Exum",0,12,15,8,10,17.9
"11698",157,2,0,1,0,0,1,1,0,0,7,0,1,2,1,0,0,1037750,"2023-11-15T00:00:00.000Z",379,7,"Dwight Powell",0,3,5,4,3,6.2
"11699",158,2,0,2,2,2,6,6,1,1,20,0,1,15,2,1,0,1037750,"2023-11-15T00:00:00.000Z",114,7,"Seth Curry",1,17,19,17,4,23.4
"11700",159,0,0,3,5,0,13,6,4,4,37,3,1,16,6,2,0,1037752,"2023-11-15T00:00:00.000Z",108,23,"Robert Covington",2,22,22,16,6,29.2
"11701",160,3,0,7,2,1,12,6,3,3,38,0,0,16,7,0,1,1037752,"2023-11-15T00:00:00.000Z",200,23,"Tobias Harris",0,23,26,19,10,27.9
"11702",161,7,0,6,2,0,16,8,4,4,34,3,3,20,9,1,2,1037752,"2023-11-15T00:00:00.000Z",145,23,"Joel Embiid",1,29,36,27,16,42.3
"11703",162,1,0,6,6,5,10,5,2,1,34,1,3,16,7,0,0,1037752,"2023-11-15T00:00:00.000Z",313,23,"De'Anthony Melton",0,23,24,17,8,25.9
"11704",163,4,0,3,7,3,15,6,5,5,39,0,3,20,3,0,2,1037752,"2023-11-15T00:00:00.000Z",3547254,23,"Tyrese Maxey",0,23,27,24,7,27.6
"11705",164,1,0,1,2,0,4,0,2,0,10,0,1,0,1,0,0,1037752,"2023-11-15T00:00:00.000Z",45,23,"Patrick Beverley",0,1,2,1,2,2.7
"11706",165,0,0,0,1,0,1,0,0,0,3,0,0,0,0,0,0,1037752,"2023-11-15T00:00:00.000Z",2175,23,"Danuel House Jr.",0,0,0,0,0,0
"11707",166,0,0,0,1,0,1,0,0,0,3,0,0,0,0,0,0,1037752,"2023-11-15T00:00:00.000Z",260,23,"Furkan Korkmaz",0,0,0,0,0,0
"11708",167,0,0,0,0,0,0,0,0,0,0,0,0,0,0,0,0,1037752,"2023-11-15T00:00:00.000Z",28,23,"Mo Bamba",0,0,0,0,0,0
"11709",168,2,0,0,6,1,10,2,6,6,26,0,4,11,0,1,1,1037753,"2023-11-15T00:00:00.000Z",56677828,28,"Gradey Dick",1,11,13,13,2,16
"11710",169,5,1,5,2,0,9,4,5,3,29,2,1,11,7,0,4,1037753,"2023-11-15T00:00:00.000Z",416,28,"Pascal Siakam",1,18,23,16,12,25.9
"11711",170,1,2,4,0,0,10,6,2,1,27,7,4,13,11,4,0,1037753,"2023-11-15T00:00:00.000Z",373,28,"Jakob Poeltl",6,24,25,14,12,45.7
"11712",171,7,0,4,3,3,19,11,5,4,31,5,2,29,9,1,3,1037753,"2023-11-15T00:00:00.000Z",17896055,28,"Scottie Barnes",1,38,45,36,16,50.3
"11713",172,5,0,3,4,1,9,2,4,4,23,0,3,9,3,2,2,1037753,"2023-11-15T00:00:00.000Z",409,28,"Dennis Schroder",2,12,17,14,8,24.1
"11714",173,5,1,1,8,0,11,3,1,1,27,2,1,7,3,0,0,1037753,"2023-11-15T00:00:00.000Z",3547275,28,"Malachi Flynn",1,10,15,12,8,21.1
"11715",174,0,1,4,3,1,8,2,4,4,20,5,1,9,9,0,1,1037753,"2023-11-15T00:00:00.000Z",58,28,"Chris Boucher",1,18,18,9,9,21.8
"11716",175,0,2,1,2,1,7,4,2,2,17,3,3,11,4,0,1,1037753,"2023-11-15T00:00:00.000Z",3547249,28,"Precious Achiuwa",2,15,15,11,4,20.8
"11717",176,2,0,1,3,0,3,0,0,0,13,1,1,0,2,0,0,1038087,"2024-01-06T00:00:00.000Z",17896025,23,"Jaden Springer",0,2,4,2,4,5.4
"11718",177,1,0,1,1,0,7,4,2,1,17,1,4,9,2,1,0,1038087,"2024-01-06T00:00:00.000Z",3547294,23,"Kenyon Martin Jr.",1,11,12,10,3,15.9
"11719",178,0,0,0,0,0,0,0,0,0,0,0,0,0,0,0,0,1038087,"2024-01-06T00:00:00.000Z",56913527,23,"Ricky Council IV",0,0,0,0,0,0
"11720",179,0,0,0,0,0,0,0,0,0,0,0,0,0,0,0,0,1038087,"2024-01-06T00:00:00.000Z",108,23,"Robert Covington",0,0,0,0,0,0
"11721",180,0,0,0,0,0,0,0,0,0,0,0,0,0,0,0,0,1038087,"2024-01-06T00:00:00.000Z",145,23,"Joel Embiid",0,0,0,0,0,0
"11722",181,0,0,0,0,0,0,0,0,0,0,0,0,0,0,0,0,1038087,"2024-01-06T00:00:00.000Z",2175,23,"Danuel House Jr.",0,0,0,0,0,0
"11723",182,0,0,0,0,0,0,0,0,0,0,0,0,0,0,0,0,1038087,"2024-01-06T00:00:00.000Z",56677788,23,"Terquavion Smith",0,0,0,0,0,0
"11724",183,0,0,0,0,0,0,0,0,0,0,0,0,0,0,0,0,1038087,"2024-01-06T00:00:00.000Z",200,23,"Tobias Harris",0,0,0,0,0,0
"11725",184,0,0,0,0,0,0,0,0,0,0,0,0,0,0,0,0,1038087,"2024-01-06T00:00:00.000Z",260,23,"Furkan Korkmaz",0,0,0,0,0,0
"11726",185,0,0,0,0,0,0,0,0,0,0,0,0,0,0,0,0,1038087,"2024-01-06T00:00:00.000Z",38017732,23,"Kenneth Lofton Jr.",0,0,0,0,0,0
"11727",186,0,0,0,0,0,0,0,0,0,0,0,0,0,0,0,0,1038061,"2024-01-03T00:00:00.000Z",357,11,"Victor Oladipo",0,0,0,0,0,0
"11728",187,0,0,0,0,0,0,0,0,0,0,0,0,0,0,0,0,1038061,"2024-01-03T00:00:00.000Z",56677809,11,"Jermaine Samuels Jr.",0,0,0,0,0,0
"11729",188,0,0,0,0,0,0,0,0,0,0,0,0,0,0,0,0,1038061,"2024-01-03T00:00:00.000Z",47738533,11,"Jeenathan Williams",0,0,0,0,0,0
"11730",189,5,1,6,6,3,13,6,2,0,32,0,0,15,6,0,0,1038061,"2024-01-03T00:00:00.000Z",666679,3,"Cameron Johnson",1,21,26,20,11,32.7
"11731",190,2,1,1,11,1,16,4,0,0,20,1,2,9,2,0,2,1038061,"2024-01-03T00:00:00.000Z",158,3,"Dorian Finney-Smith",1,11,13,11,4,15.4
"11732",191,0,2,8,0,0,8,6,0,0,28,5,5,12,13,1,1,1038061,"2024-01-03T00:00:00.000Z",666508,3,"Nicolas Claxton",3,25,25,12,13,35.6
"11733",192,3,1,4,12,3,18,5,3,2,36,0,1,15,4,1,1,1038061,"2024-01-03T00:00:00.000Z",61,3,"Mikal Bridges",2,19,22,18,7,29.3
"11734",193,5,0,1,3,2,5,3,5,3,28,0,1,11,1,2,1,1038061,"2024-01-03T00:00:00.000Z",130,3,"Spencer Dinwiddie",2,12,17,16,6,24.7
"11735",194,3,0,3,8,2,13,5,2,1,30,1,3,13,4,2,1,1038061,"2024-01-03T00:00:00.000Z",351,3,"Royce O'Neale",2,17,20,16,7,27.3
"11736",195,1,1,8,0,0,7,4,6,3,20,4,5,11,12,1,1,1038061,"2024-01-03T00:00:00.000Z",17896038,3,"Day'Ron Sharpe",2,23,24,12,13,31.9
"11737",196,0,0,0,0,0,0,0,0,0,5,0,0,0,0,1,0,1038061,"2024-01-03T00:00:00.000Z",56677722,3,"Jalen Wilson",1,0,0,0,0,3
"11738",197,5,0,0,2,0,7,0,4,4,18,0,1,4,0,1,1,1038061,"2024-01-03T00:00:00.000Z",17896048,3,"Cam Thomas",1,4,9,9,5,13.5
"11739",198,1,0,4,2,2,6,3,4,3,20,4,1,11,8,1,0,1038061,"2024-01-03T00:00:00.000Z",17896058,3,"Trendon Watford",1,19,20,12,9,25.1
"11740",199,0,0,1,0,0,0,0,0,0,3,0,0,0,1,0,0,1038061,"2024-01-03T00:00:00.000Z",9051997,3,"Armoni Brooks",0,1,1,0,1,1.2
"11741",200,0,0,0,0,0,0,0,0,0,0,0,0,0,0,0,0,1038061,"2024-01-03T00:00:00.000Z",174,3,"Harry Giles III",0,0,0,0,0,0
"11742",201,1,0,1,4,2,9,4,0,0,33,1,4,10,2,0,1,1037883,"2023-12-02T00:00:00.000Z",66,11,"Dillon Brooks",0,12,13,11,3,12.9
"11743",202,0,0,2,0,0,4,2,2,2,12,3,1,6,5,0,1,3277504,"2023-11-24T00:00:00.000Z",38017687,30,"Johnny Davis",0,11,11,6,5,11
"11744",203,0,0,0,0,0,0,0,0,0,0,0,0,0,0,0,0,3277504,"2023-11-24T00:00:00.000Z",3547302,30,"Anthony Gill",0,0,0,0,0,0
"11745",204,0,0,0,0,0,0,0,0,0,0,0,0,0,0,0,0,3277504,"2023-11-24T00:00:00.000Z",337,30,"Mike Muscala",0,0,0,0,0,0
"11746",205,0,0,0,0,0,0,0,0,0,0,0,0,0,0,0,0,3277504,"2023-11-24T00:00:00.000Z",17896106,30,"Eugene Omoruyi",0,0,0,0,0,0
"11747",206,0,0,0,0,0,0,0,0,0,0,0,0,0,0,0,0,3277504,"2023-11-24T00:00:00.000Z",56677844,30,"Bilal Coulibaly",0,0,0,0,0,0
"11748",207,0,0,0,0,0,0,0,0,0,0,0,0,0,0,0,0,3277504,"2023-11-24T00:00:00.000Z",38017712,30,"Ryan Rollins",0,0,0,0,0,0
"11749",208,0,0,0,0,0,0,0,0,0,0,0,0,0,0,0,0,3277504,"2023-11-24T00:00:00.000Z",487,30,"Delon Wright",0,0,0,0,0,0
"11750",209,6,0,2,7,3,11,3,7,6,29,1,3,15,3,1,2,3277506,"2023-11-24T00:00:00.000Z",443,10,"Klay Thompson",1,18,24,21,9,28.6
"11751",210,0,0,4,4,2,10,4,0,0,25,0,3,10,4,0,3,3277506,"2023-11-24T00:00:00.000Z",475,10,"Andrew Wiggins",0,14,14,10,4,11.8
"11752",211,4,0,7,0,0,3,2,3,2,24,1,3,6,8,2,2,3277506,"2023-11-24T00:00:00.000Z",282,10,"Kevon Looney",2,14,18,10,12,25.6
"11753",212,1,0,2,1,1,4,4,2,0,17,2,0,9,4,0,2,3277506,"2023-11-24T00:00:00.000Z",17553992,10,"Moses Moody",0,13,14,10,5,13.3
"11754",213,6,0,3,13,7,20,11,6,6,35,0,2,35,3,1,6,3277506,"2023-11-24T00:00:00.000Z",115,10,"Stephen Curry",1,38,44,41,9,44.6
"11755",214,10,0,5,3,1,6,2,0,0,29,0,2,5,5,0,1,3277506,"2023-11-24T00:00:00.000Z",367,10,"Chris Paul",0,10,20,15,15,25
"11756",215,4,0,5,7,4,11,7,2,2,26,2,3,20,7,2,3,3277506,"2023-11-24T00:00:00.000Z",407,10,"Dario Saric",2,27,31,24,11,37.4
"11757",216,2,0,1,2,1,7,5,2,1,20,0,0,12,1,0,1,3277506,"2023-11-24T00:00:00.000Z",17553979,10,"Jonathan Kuminga",0,13,15,14,3,15.2
"11758",217,0,1,3,1,0,3,2,0,0,18,0,4,4,3,1,2,3277506,"2023-11-24T00:00:00.000Z",2189,10,"Gary Payton II",2,7,7,4,3,11.6
"11759",218,2,0,2,2,0,5,0,0,0,12,1,0,0,3,0,1,3277506,"2023-11-24T00:00:00.000Z",56677858,10,"Brandin Podziemski",0,3,5,2,5,5.6
"11760",219,0,1,0,0,0,1,0,2,2,5,0,1,2,0,0,1,3277506,"2023-11-24T00:00:00.000Z",56677799,10,"Trayce Jackson-Davis",1,2,2,2,0,4
"11761",220,0,0,0,0,0,0,0,0,0,0,0,0,0,0,0,0,3277506,"2023-11-24T00:00:00.000Z",185,10,"Draymond Green",0,0,0,0,0,0
"11762",221,0,0,0,0,0,0,0,0,0,0,0,0,0,0,0,0,3277506,"2023-11-24T00:00:00.000Z",251,10,"Cory Joseph",0,0,0,0,0,0
"11763",222,0,0,0,0,0,0,0,0,0,0,0,0,0,0,0,0,3277506,"2023-11-24T00:00:00.000Z",57875092,10,"Gui Santos",0,0,0,0,0,0
"11764",223,4,0,4,5,1,7,2,0,0,21,0,0,5,4,1,2,7049316,"2023-12-06T00:00:00.000Z",45,23,"Patrick Beverley",1,9,13,9,8,16.8
"11765",224,0,0,0,0,0,0,0,0,0,0,0,0,0,0,0,0,7049316,"2023-12-06T00:00:00.000Z",28,23,"Mo Bamba",0,0,0,0,0,0
"11766",225,0,0,0,0,0,0,0,0,0,0,0,0,0,0,0,0,1037880,"2023-12-02T00:00:00.000Z",38017728,15,"Jake LaRavia",0,0,0,0,0,0
"11767",226,4,0,6,6,0,15,3,0,0,35,0,2,6,6,1,3,1037652,"2023-11-01T00:00:00.000Z",387,20,"Julius Randle",1,12,16,10,10,19.2
"11768",227,3,1,2,4,2,16,10,1,0,24,3,5,22,5,2,1,1037649,"2023-11-01T00:00:00.000Z",3547242,30,"Deni Avdija",3,27,30,25,8,40.5
"11769",228,6,0,9,6,1,21,11,3,2,25,0,1,25,9,0,1,1037649,"2023-11-01T00:00:00.000Z",265,30,"Kyle Kuzma",0,34,40,31,15,43.8
"11770",229,1,1,3,4,1,7,2,2,2,22,1,3,7,4,1,2,1037649,"2023-11-01T00:00:00.000Z",337,30,"Mike Muscala",2,11,12,8,5,17.3
"11771",230,1,0,0,6,2,13,5,1,1,20,0,1,13,0,1,1,1037649,"2023-11-01T00:00:00.000Z",666848,30,"Jordan Poole",1,13,14,14,1,16.5
"11772",231,3,0,1,3,0,6,3,0,0,22,0,1,6,1,1,1,1037649,"2023-11-01T00:00:00.000Z",249,30,"Tyus Jones",1,7,10,9,4,13.7
"11773",232,5,0,3,10,6,23,12,1,0,36,0,2,30,3,0,3,1037651,"2023-11-01T00:00:00.000Z",666633,16,"Tyler Herro",0,33,38,35,8,38.1
"11774",233,3,1,3,5,2,5,2,0,0,30,0,3,6,3,2,2,1037651,"2023-11-01T00:00:00.000Z",286,16,"Kyle Lowry",3,9,12,9,6,21.1
"11775",234,3,0,3,5,1,9,1,2,1,30,0,2,4,3,1,0,1037651,"2023-11-01T00:00:00.000Z",391,16,"Josh Richardson",1,7,10,7,6,15.1
"11776",235,2,1,4,4,3,5,3,0,0,22,0,0,9,4,1,1,1037651,"2023-11-01T00:00:00.000Z",3092,16,"Haywood Highsmith",2,13,15,11,6,21.8
"11777",236,2,0,3,6,1,8,2,0,0,21,0,4,5,3,0,1,1037651,"2023-11-01T00:00:00.000Z",397,16,"Duncan Robinson",0,8,10,7,5,10.6
"11778",237,0,0,4,0,0,4,3,2,2,15,1,4,8,5,1,2,1037651,"2023-11-01T00:00:00.000Z",74,16,"Thomas Bryant",1,13,13,8,5,15
"11779",238,0,0,0,0,0,0,0,0,0,0,0,0,0,0,0,0,1037651,"2023-11-01T00:00:00.000Z",38017696,16,"Nikola Jovic",0,0,0,0,0,0
"11780",239,0,0,0,0,0,0,0,0,0,0,0,0,0,0,0,0,1037651,"2023-11-01T00:00:00.000Z",39398582,16,"Orlando Robinson",0,0,0,0,0,0
"11781",240,0,0,0,0,0,0,0,0,0,0,0,0,0,0,0,0,1037651,"2023-11-01T00:00:00.000Z",19465585,16,"Dru Smith",0,0,0,0,0,0
"11782",241,0,0,0,0,0,0,0,0,0,0,0,0,0,0,0,0,1037651,"2023-11-01T00:00:00.000Z",38017734,16,"Jamal Cain",0,0,0,0,0,0
"11783",242,0,0,0,0,0,0,0,0,0,0,0,0,0,0,0,0,1037651,"2023-11-01T00:00:00.000Z",3547257,16,"R.J. Hampton",0,0,0,0,0,0
"11784",243,0,0,0,0,0,0,0,0,0,0,0,0,0,0,0,0,1037651,"2023-11-01T00:00:00.000Z",285,16,"Kevin Love",0,0,0,0,0,0
"11785",244,0,0,0,0,0,0,0,0,0,0,0,0,0,0,0,0,1037651,"2023-11-01T00:00:00.000Z",666747,16,"Caleb Martin",0,0,0,0,0,0
"11786",245,0,2,3,3,1,9,4,0,0,18,2,3,9,5,0,0,1037655,"2023-11-01T00:00:00.000Z",3547268,8,"Zeke Nnaji",2,14,14,9,5,21
"11787",246,1,0,2,1,0,3,2,0,0,16,0,2,4,2,0,2,1037655,"2023-11-01T00:00:00.000Z",38017721,8,"Peyton Watson",0,6,7,5,3,5.9
"11788",247,0,2,0,6,1,7,2,1,0,16,0,0,5,0,1,0,1037655,"2023-11-01T00:00:00.000Z",56677776,8,"Julian Strawther",3,5,5,5,0,14
"11789",248,3,0,0,0,0,2,0,0,0,5,0,2,0,0,0,0,1037655,"2023-11-01T00:00:00.000Z",17896007,8,"Braxton Key",0,0,3,3,3,4.5
"11790",249,0,0,2,1,0,2,1,0,0,5,0,1,2,2,0,0,1037655,"2023-11-01T00:00:00.000Z",56677582,8,"Jalen Pickett",0,4,4,2,2,4.4
"11791",250,0,0,1,1,0,2,1,0,0,4,0,2,2,1,0,0,1037655,"2023-11-01T00:00:00.000Z",56677871,8,"Hunter Tyson",0,3,3,2,1,3.2
"11792",251,0,0,0,0,0,0,0,0,0,0,0,0,0,0,0,0,1037975,"2023-12-22T00:00:00.000Z",17896007,8,"Braxton Key",0,0,0,0,0,0
"11793",252,0,0,2,1,0,3,2,0,0,18,1,3,4,3,1,0,1037973,"2023-12-21T00:00:00.000Z",56677850,25,"Toumani Camara",1,7,7,4,3,10.6
"11794",253,4,0,1,7,4,14,6,7,4,32,1,4,20,2,1,2,1037973,"2023-12-21T00:00:00.000Z",182,25,"Jerami Grant",1,22,26,24,6,29.4
"11795",254,2,1,6,0,0,21,10,4,3,35,10,3,23,16,0,5,1037973,"2023-12-21T00:00:00.000Z",22,25,"Deandre Ayton",1,39,41,25,18,43.2
"11796",255,7,0,3,14,7,28,15,5,4,38,1,2,41,4,0,3,1037973,"2023-12-21T00:00:00.000Z",419,25,"Anfernee Simons",0,45,52,48,11,53.3
"11797",256,4,0,2,3,1,8,3,0,0,28,0,3,7,2,1,1,1037973,"2023-12-21T00:00:00.000Z",65,25,"Malcolm Brogdon",1,9,13,11,6,17.4
"11798",257,0,0,0,0,0,0,0,0,0,0,0,0,0,0,0,0,1037973,"2023-12-21T00:00:00.000Z",666476,25,"Moses Brown",0,0,0,0,0,0
"11799",258,0,0,0,0,0,0,0,0,0,0,0,0,0,0,0,0,1037975,"2023-12-22T00:00:00.000Z",56677582,8,"Jalen Pickett",0,0,0,0,0,0
"11800",259,0,0,0,0,0,0,0,0,0,0,0,0,0,0,0,0,1037975,"2023-12-22T00:00:00.000Z",56677871,8,"Hunter Tyson",0,0,0,0,0,0
"11801",260,0,0,0,0,0,0,0,0,0,0,0,0,0,0,0,0,1037975,"2023-12-22T00:00:00.000Z",666489,8,"Vlatko Cancar",0,0,0,0,0,0
"11802",261,1,0,3,8,5,11,6,0,0,26,1,3,17,4,1,0,1037974,"2023-12-22T00:00:00.000Z",3089,28,"Gary Trent Jr.",1,21,22,18,5,26.3
"11803",262,0,0,0,0,0,0,0,0,0,0,0,0,0,0,0,0,1037974,"2023-12-22T00:00:00.000Z",489,28,"Thaddeus Young",0,0,0,0,0,0
"11804",263,0,0,0,0,0,0,0,0,0,0,0,0,0,0,0,0,1037974,"2023-12-22T00:00:00.000Z",56677805,28,"Javon Freeman-Liberty",0,0,0,0,0,0
"11805",264,0,0,0,0,0,0,0,0,0,0,0,0,0,0,0,0,1037974,"2023-12-22T00:00:00.000Z",38017710,28,"Christian Koloko",0,0,0,0,0,0
"11806",265,0,0,0,0,0,0,0,0,0,0,0,0,0,0,0,0,1037974,"2023-12-22T00:00:00.000Z",56677869,28,"Markquis Nowell",0,0,0,0,0,0
"11807",266,0,0,0,0,0,0,0,0,0,0,0,0,0,0,0,0,1037974,"2023-12-22T00:00:00.000Z",2309958,28,"Jontay Porter",0,0,0,0,0,0
"11808",267,1,0,1,3,1,5,2,2,0,14,0,2,5,1,1,0,1037973,"2023-12-21T00:00:00.000Z",337,30,"Mike Muscala",1,6,7,6,2,10.7
"11809",268,0,0,0,0,0,0,0,0,0,0,0,0,0,0,0,0,1037973,"2023-12-21T00:00:00.000Z",17896106,30,"Eugene Omoruyi",0,0,0,0,0,0
"11810",269,0,0,0,0,0,0,0,0,0,0,0,0,0,0,0,0,1037973,"2023-12-21T00:00:00.000Z",38017712,30,"Ryan Rollins",0,0,0,0,0,0
"11811",270,5,0,6,6,2,15,10,0,0,36,0,2,22,6,0,3,1037968,"2023-12-21T00:00:00.000Z",666956,5,"Coby White",0,28,33,27,11,33.7
"11812",271,0,0,2,4,1,8,5,0,0,26,0,2,11,2,1,0,1037968,"2023-12-21T00:00:00.000Z",17895983,5,"Ayo Dosunmu",1,13,13,11,2,16.4
"11813",272,1,0,1,3,2,4,2,0,0,16,0,2,6,1,2,1,1037969,"2023-12-21T00:00:00.000Z",38017507,12,"Andrew Nembhard",2,7,8,7,2,13.7
"11814",273,0,0,0,0,0,0,0,0,0,0,0,0,0,0,0,0,1037972,"2023-12-21T00:00:00.000Z",666767,18,"Jordan McLaughlin",0,0,0,0,0,0
"11815",274,0,0,0,0,0,0,0,0,0,0,0,0,0,0,0,0,1037972,"2023-12-21T00:00:00.000Z",320,18,"Shake Milton",0,0,0,0,0,0
"11816",275,0,0,0,0,0,0,0,0,0,0,0,0,0,0,0,0,1037967,"2023-12-21T00:00:00.000Z",17896076,6,"Evan Mobley",0,0,0,0,0,0
"11817",276,1,0,3,2,0,6,2,1,0,31,1,6,4,4,1,0,3277455,"2023-11-17T00:00:00.000Z",66,11,"Dillon Brooks",1,8,9,5,5,13.3
"11818",277,4,1,3,4,1,5,2,4,4,19,0,4,9,3,0,3,3277453,"2023-11-17T00:00:00.000Z",666650,29,"Talen Horton-Tucker",1,12,16,13,7,18.6
"11819",278,4,1,3,3,0,7,2,3,2,31,0,1,6,3,0,2,3277446,"2023-11-17T00:00:00.000Z",56677844,30,"Bilal Coulibaly",1,9,13,10,7,16.6
"11820",279,1,0,1,3,1,5,3,1,1,26,2,1,8,3,1,0,3277446,"2023-11-17T00:00:00.000Z",17896045,30,"Corey Kispert",1,11,12,9,4,16.1
"11821",280,1,2,5,3,1,7,3,0,0,17,1,3,7,6,0,0,3277446,"2023-11-17T00:00:00.000Z",167,30,"Danilo Gallinari",2,13,14,8,7,21.7
"11822",281,2,0,0,2,1,3,2,0,0,7,0,0,5,0,0,0,3277446,"2023-11-17T00:00:00.000Z",414,30,"Landry Shamet",0,5,7,7,2,8
"11823",282,0,0,0,0,0,0,0,0,0,2,0,0,0,0,0,0,3277446,"2023-11-17T00:00:00.000Z",38017687,30,"Johnny Davis",0,0,0,0,0,0
"11824",283,1,0,1,0,0,0,0,2,2,2,0,0,2,1,0,0,3277446,"2023-11-17T00:00:00.000Z",3547302,30,"Anthony Gill",0,3,4,3,2,4.7
"11825",284,0,0,0,1,1,2,2,0,0,2,0,0,5,0,0,0,3277446,"2023-11-17T00:00:00.000Z",17896106,30,"Eugene Omoruyi",0,5,5,5,0,5
"11826",285,0,0,0,0,0,0,0,0,0,0,0,0,0,0,0,0,3277446,"2023-11-17T00:00:00.000Z",337,30,"Mike Muscala",0,0,0,0,0,0
"11827",286,0,0,0,0,0,0,0,0,0,0,0,0,0,0,0,0,3277446,"2023-11-17T00:00:00.000Z",38017704,30,"Patrick Baldwin Jr.",0,0,0,0,0,0
"11828",287,0,0,0,0,0,0,0,0,0,0,0,0,0,0,0,0,3277446,"2023-11-17T00:00:00.000Z",38124126,30,"John Butler Jr.",0,0,0,0,0,0
"11829",288,0,0,0,0,0,0,0,0,0,0,0,0,0,0,0,0,3277446,"2023-11-17T00:00:00.000Z",38017712,30,"Ryan Rollins",0,0,0,0,0,0
"11830",289,0,0,0,0,0,0,0,0,0,0,0,0,0,0,0,0,3277446,"2023-11-17T00:00:00.000Z",487,30,"Delon Wright",0,0,0,0,0,0
"11831",290,2,2,4,2,1,7,4,0,0,32,1,1,9,5,0,1,3277446,"2023-11-17T00:00:00.000Z",202,20,"Josh Hart",2,14,16,11,7,23
"11832",291,8,2,6,5,1,18,9,6,3,35,1,3,22,7,1,6,3277446,"2023-11-17T00:00:00.000Z",387,20,"Julius Randle",3,29,37,30,15,45.4
"11833",292,1,1,5,0,0,4,3,1,0,27,3,1,6,8,0,0,3277446,"2023-11-17T00:00:00.000Z",399,20,"Mitchell Robinson",1,14,15,7,9,20.1
"11834",293,1,0,2,8,4,9,5,0,0,25,2,1,14,4,0,1,3277446,"2023-11-17T00:00:00.000Z",131,20,"Donte DiVincenzo",0,18,19,15,5,19.3
"11835",294,7,0,4,10,6,23,10,6,6,34,3,2,32,7,0,0,3277446,"2023-11-17T00:00:00.000Z",73,20,"Jalen Brunson",0,39,46,39,14,50.9
"11836",295,4,0,6,7,3,18,10,5,4,33,0,5,27,6,1,1,3277446,"2023-11-17T00:00:00.000Z",3547269,20,"Immanuel Quickley",1,33,37,31,10,42.2
"11837",296,2,1,5,0,0,3,1,2,1,20,3,4,3,8,1,1,3277446,"2023-11-17T00:00:00.000Z",201,20,"Isaiah Hartenstein",2,11,13,5,10,20.6
"11838",297,0,0,0,2,1,3,2,0,0,14,1,2,5,1,1,0,3277446,"2023-11-17T00:00:00.000Z",17896033,20,"Miles McBride",1,6,6,5,1,9.2
"11839",298,1,0,1,4,0,6,1,0,0,16,0,2,2,1,1,0,3277446,"2023-11-17T00:00:00.000Z",160,20,"Evan Fournier",1,3,4,3,2,7.7
"11840",299,0,0,0,0,0,0,0,0,0,2,0,0,0,0,0,0,3277446,"2023-11-17T00:00:00.000Z",666675,20,"DaQuan Jeffries",0,0,0,0,0,0
"11841",300,0,0,1,0,0,0,0,0,0,1,0,0,0,1,0,0,3277446,"2023-11-17T00:00:00.000Z",17896063,20,"Jericho Sims",0,1,1,0,1,1.2
"11842",301,1,0,2,4,2,8,4,0,0,23,1,1,10,3,0,0,1038085,"2024-01-06T00:00:00.000Z",3547243,12,"Obi Toppin",0,13,14,11,4,15.1
"11843",302,0,0,1,0,0,0,0,0,0,3,0,0,0,1,0,0,1038085,"2024-01-06T00:00:00.000Z",56677861,12,"Ben Sheppard",0,1,1,0,1,1.2
"11844",303,1,0,0,0,0,0,0,0,0,1,0,0,0,0,0,0,1038085,"2024-01-06T00:00:00.000Z",56677832,12,"Jarace Walker",0,0,1,1,1,1.5
"11845",304,0,0,0,0,0,0,0,0,0,1,0,0,0,0,0,0,1038085,"2024-01-06T00:00:00.000Z",3547207,12,"Jordan Nwora",0,0,0,0,0,0
"11846",305,1,0,8,6,2,21,13,0,0,46,4,0,28,12,1,0,1038068,"2024-01-03T00:00:00.000Z",38017688,26,"Keegan Murray",1,40,41,29,13,46.9
"11847",306,0,0,0,0,0,0,0,0,0,0,0,0,0,0,0,0,1038064,"2024-01-03T00:00:00.000Z",217,7,"Richaun Holmes",0,0,0,0,0,0
"11848",307,0,0,0,0,0,0,0,0,0,0,0,0,0,0,0,0,1038064,"2024-01-03T00:00:00.000Z",257,7,"Maxi Kleber",0,0,0,0,0,0
"11849",308,2,0,1,3,1,9,4,3,1,20,0,3,10,1,0,3,1038064,"2024-01-03T00:00:00.000Z",182,25,"Jerami Grant",0,11,13,12,3,11.2
"11850",309,0,1,3,4,2,8,3,3,2,20,2,6,10,5,2,2,1038064,"2024-01-03T00:00:00.000Z",56677850,25,"Toumani Camara",3,15,15,10,5,23
"11851",310,12,1,17,0,0,14,8,9,6,45,6,2,22,23,2,6,1038068,"2024-01-03T00:00:00.000Z",406,26,"Domantas Sabonis",3,45,57,34,35,70.6
"11852",311,1,0,0,1,0,3,0,0,0,10,0,3,0,0,1,2,1038068,"2024-01-03T00:00:00.000Z",17896030,26,"Chris Duarte",1,0,1,1,1,2.5
"11853",312,7,0,1,5,0,22,6,4,3,44,3,1,15,4,1,3,1038068,"2024-01-03T00:00:00.000Z",161,26,"De'Aaron Fox",1,19,26,22,11,30.3
"11854",313,2,0,6,4,0,5,0,2,2,18,1,1,2,7,0,1,1038068,"2024-01-03T00:00:00.000Z",221,26,"Kevin Huerter",0,9,11,4,9,12.4
"11855",314,0,0,0,0,0,0,0,0,0,0,0,0,0,0,0,0,1038068,"2024-01-03T00:00:00.000Z",17896044,26,"Kessler Edwards",0,0,0,0,0,0
"11856",315,0,0,0,0,0,0,0,0,0,0,0,0,0,0,0,0,1038068,"2024-01-03T00:00:00.000Z",38017714,26,"Keon Ellis",0,0,0,0,0,0
"11857",316,0,0,0,0,0,1,1,0,0,1,0,0,2,0,0,0,1038085,"2024-01-06T00:00:00.000Z",56677778,12,"Oscar Tshiebwe",0,2,2,2,0,2
"11858",317,0,0,0,0,0,0,0,0,0,0,0,0,0,0,0,0,1038085,"2024-01-06T00:00:00.000Z",69,12,"Bruce Brown",0,0,0,0,0,0
"11859",318,0,0,0,0,0,0,0,0,0,0,0,0,0,0,0,0,1038085,"2024-01-06T00:00:00.000Z",38017507,12,"Andrew Nembhard",0,0,0,0,0,0
"11860",319,0,0,0,0,0,0,0,0,0,0,0,0,0,0,0,0,1038085,"2024-01-06T00:00:00.000Z",56677794,12,"Isaiah Wong",0,0,0,0,0,0
"11861",320,0,0,0,0,0,0,0,0,0,0,0,0,0,0,0,0,1038067,"2024-01-03T00:00:00.000Z",405,14,"D'Angelo Russell",0,0,0,0,0,0
"11862",321,0,0,0,0,0,0,0,0,0,0,0,0,0,0,0,0,1038067,"2024-01-03T00:00:00.000Z",56677738,14,"Colin Castleton",0,0,0,0,0,0
"11863",322,0,0,0,0,0,0,0,0,0,0,0,0,0,0,0,0,1038067,"2024-01-03T00:00:00.000Z",56677867,14,"Alex Fudge",0,0,0,0,0,0
"11864",323,0,0,0,0,0,0,0,0,0,0,0,0,0,0,0,0,1038067,"2024-01-03T00:00:00.000Z",56677868,14,"D'Moi Hodge",0,0,0,0,0,0
"11865",324,0,0,0,0,0,0,0,0,0,0,0,0,0,0,0,0,1038067,"2024-01-03T00:00:00.000Z",56677836,14,"Maxwell Lewis",0,0,0,0,0,0
"11866",325,0,0,0,0,0,0,0,0,0,0,0,0,0,0,0,0,1038067,"2024-01-03T00:00:00.000Z",1603383,14,"Gabe Vincent",0,0,0,0,0,0
"11867",326,1,0,5,3,1,13,8,7,7,33,0,3,24,5,1,3,1037859,"2023-11-30T00:00:00.000Z",56677785,16,"Jaime Jaquez Jr.",1,29,30,25,6,31.5
"11868",327,6,0,7,0,0,1,1,4,3,17,1,2,5,8,1,0,1037859,"2023-11-30T00:00:00.000Z",285,16,"Kevin Love",1,13,19,11,14,26.6
"11869",328,4,0,9,5,2,22,9,3,2,38,0,1,22,9,1,2,1037858,"2023-11-30T00:00:00.000Z",61,3,"Mikal Bridges",1,31,35,26,13,39.8
"11870",329,8,0,4,6,1,9,3,2,2,34,0,1,9,4,0,1,1037858,"2023-11-30T00:00:00.000Z",130,3,"Spencer Dinwiddie",0,13,21,17,12,24.8
"11871",330,0,0,3,0,0,5,4,3,1,18,2,3,9,5,2,0,1037858,"2023-11-30T00:00:00.000Z",17896038,3,"Day'Ron Sharpe",2,14,14,9,5,21
"11872",331,1,1,2,5,2,21,11,3,2,25,0,1,26,2,0,1,1037858,"2023-11-30T00:00:00.000Z",17896048,3,"Cam Thomas",1,28,29,27,3,31.9
"11873",332,1,0,1,4,2,5,2,2,1,14,1,1,7,2,0,1,1037858,"2023-11-30T00:00:00.000Z",464,3,"Lonnie Walker IV",0,9,10,8,3,9.9
"11874",333,0,0,0,0,0,0,0,0,0,0,0,0,0,0,0,0,1037858,"2023-11-30T00:00:00.000Z",174,3,"Harry Giles III",0,0,0,0,0,0
"11875",334,0,0,0,0,0,0,0,0,0,0,0,0,0,0,0,0,1037858,"2023-11-30T00:00:00.000Z",351,3,"Royce O'Neale",0,0,0,0,0,0
"11876",335,0,0,0,0,0,0,0,0,0,0,0,0,0,0,0,0,1037858,"2023-11-30T00:00:00.000Z",421,3,"Dennis Smith Jr.",0,0,0,0,0,0
"11877",336,0,0,0,0,0,0,0,0,0,0,0,0,0,0,0,0,1037858,"2023-11-30T00:00:00.000Z",56677722,3,"Jalen Wilson",0,0,0,0,0,0
"11878",337,6,0,4,4,2,14,8,4,4,32,2,1,22,6,0,2,1037858,"2023-11-30T00:00:00.000Z",204,4,"Gordon Hayward",0,28,34,28,12,36.2
"11879",338,2,0,4,4,3,15,9,2,2,38,1,2,23,5,0,0,1037858,"2023-11-30T00:00:00.000Z",62,4,"Miles Bridges",0,28,30,25,7,32
"11880",339,1,3,7,0,0,12,5,2,2,32,5,2,12,12,1,0,1037858,"2023-11-30T00:00:00.000Z",38017698,4,"Mark Williams",4,24,25,13,13,39.9
"11881",340,3,1,2,5,4,7,5,0,0,22,0,1,14,2,0,0,1037858,"2023-11-30T00:00:00.000Z",38017708,4,"Bryce McGowens",1,16,19,17,5,23.9
"11882",341,13,0,4,9,7,25,13,4,4,40,0,1,37,4,2,3,1037858,"2023-11-30T00:00:00.000Z",403,4,"Terry Rozier",2,41,54,50,17,64.3
"11883",342,0,0,0,0,0,0,0,0,0,13,1,4,0,1,0,2,1037858,"2023-11-30T00:00:00.000Z",422,4,"Ish Smith",0,1,1,0,1,-0.8
"11884",343,0,1,0,3,3,4,3,0,0,14,1,2,9,1,0,0,1037858,"2023-11-30T00:00:00.000Z",56677846,4,"Nick Smith Jr.",1,10,10,9,1,13.2
"11885",344,0,0,0,0,0,0,0,0,0,0,0,0,0,0,0,0,1037858,"2023-11-30T00:00:00.000Z",56677866,4,"Leaky Black",0,0,0,0,0,0
"11886",345,0,0,0,0,0,0,0,0,0,0,0,0,0,0,0,0,1037858,"2023-11-30T00:00:00.000Z",17896037,4,"James Bouknight",0,0,0,0,0,0
"11887",346,7,2,3,8,4,16,8,0,0,36,2,4,20,5,5,4,1037862,"2023-11-30T00:00:00.000Z",666400,18,"Nickeil Alexander-Walker",7,25,32,27,12,53.5
"11888",347,5,1,7,7,4,22,12,5,4,37,4,3,32,11,2,4,1037862,"2023-11-30T00:00:00.000Z",447,18,"Karl-Anthony Towns",3,43,48,37,16,57.7
"11889",348,0,3,10,0,0,11,6,4,3,38,3,4,15,13,0,0,1037862,"2023-11-30T00:00:00.000Z",176,18,"Rudy Gobert",3,28,28,15,13,39.6
"11890",349,2,0,3,3,2,6,3,0,0,29,0,0,8,3,1,1,1037862,"2023-11-30T00:00:00.000Z",68,18,"Troy Brown Jr.",1,11,13,10,5,16.6
"11891",350,7,0,3,6,2,6,2,2,2,29,0,3,8,3,2,2,1037862,"2023-11-30T00:00:00.000Z",104,18,"Mike Conley",2,11,18,15,10,26.1
"11892",351,0,0,0,0,0,0,0,0,0,0,0,0,0,0,0,0,1037639,"2023-10-30T00:00:00.000Z",284,17,"Robin Lopez",0,0,0,0,0,0
"11893",352,0,0,0,0,0,0,0,0,0,0,0,0,0,0,0,0,1037637,"2023-10-30T00:00:00.000Z",419,25,"Anfernee Simons",0,0,0,0,0,0
"11894",353,0,0,0,0,0,0,0,0,0,0,0,0,0,0,0,0,1037637,"2023-10-30T00:00:00.000Z",17896120,25,"Ish Wainright",0,0,0,0,0,0
"11895",354,3,0,1,4,2,10,5,0,0,34,1,0,12,2,1,1,1037638,"2023-10-30T00:00:00.000Z",3547258,7,"Josh Green",1,14,17,15,5,20.9
"11896",355,12,1,12,12,6,22,11,10,7,40,0,4,35,12,1,6,1037638,"2023-10-30T00:00:00.000Z",132,7,"Luka Doncic",2,47,59,47,24,67.4
"11897",356,0,0,5,7,3,14,8,2,2,29,0,1,21,5,0,1,1037638,"2023-10-30T00:00:00.000Z",191,7,"Tim Hardaway Jr.",0,26,26,21,5,26
"11898",357,2,0,4,3,1,4,2,2,2,22,1,2,7,5,1,2,1037638,"2023-10-30T00:00:00.000Z",257,7,"Maxi Kleber",1,12,14,9,7,17
"11899",358,1,0,0,4,2,6,2,0,0,10,0,1,6,0,0,1,1037638,"2023-10-30T00:00:00.000Z",38017679,7,"Jaden Hardy",0,6,7,7,1,6.5
"11900",359,2,0,4,0,0,3,1,0,0,6,0,0,2,4,0,0,1037638,"2023-10-30T00:00:00.000Z",151,7,"Dante Exum",0,6,8,4,6,9.8
"11901",360,2,1,2,3,1,5,1,0,0,15,0,2,3,2,1,1,1037638,"2023-10-30T00:00:00.000Z",114,7,"Seth Curry",2,5,7,5,4,13.4
"11902",361,0,0,0,0,0,0,0,0,0,0,0,0,0,0,0,0,1037639,"2023-10-30T00:00:00.000Z",666960,17,"Lindell Wigginton",0,0,0,0,0,0
"11903",362,4,1,2,2,1,11,4,4,4,29,2,0,13,4,0,1,1037639,"2023-10-30T00:00:00.000Z",79,16,"Jimmy Butler",1,17,21,17,8,25.8
"11904",363,3,0,5,5,1,6,1,0,0,18,0,1,3,5,0,2,1037639,"2023-10-30T00:00:00.000Z",285,16,"Kevin Love",0,8,11,6,8,11.5
"11905",364,0,0,2,1,0,7,4,2,2,22,0,0,10,2,2,1,1037639,"2023-10-30T00:00:00.000Z",74,16,"Thomas Bryant",2,12,12,10,2,17.4
"11906",365,3,0,7,5,2,21,12,10,9,42,1,1,35,8,1,3,1037639,"2023-10-30T00:00:00.000Z",666633,16,"Tyler Herro",1,43,46,38,11,49.1
"11907",366,4,0,4,5,2,6,3,0,0,28,0,4,8,4,2,2,1037639,"2023-10-30T00:00:00.000Z",286,16,"Kyle Lowry",2,12,16,12,8,22.8
"11908",367,0,0,0,0,0,0,0,0,0,0,0,0,0,0,0,0,1037642,"2023-10-30T00:00:00.000Z",17896007,8,"Braxton Key",0,0,0,0,0,0
"11909",368,1,0,6,3,1,16,7,3,0,34,3,3,15,9,1,0,1037642,"2023-10-30T00:00:00.000Z",101,29,"John Collins",1,24,25,16,10,30.3
"11910",369,5,1,9,13,5,24,10,2,2,38,5,2,27,14,0,2,1037642,"2023-10-30T00:00:00.000Z",297,29,"Lauri Markkanen",1,41,46,32,19,52.3
"11911",370,0,1,10,0,0,11,10,3,2,29,3,4,22,13,0,2,1037642,"2023-10-30T00:00:00.000Z",38017705,29,"Walker Kessler",1,35,35,22,13,38.6
"11912",371,8,0,3,3,2,12,7,0,0,29,0,4,16,3,0,1,1037642,"2023-10-30T00:00:00.000Z",666650,29,"Talen Horton-Tucker",0,19,27,24,11,30.6
"11913",372,6,0,1,4,0,10,2,3,0,34,2,1,4,3,1,5,1037642,"2023-10-30T00:00:00.000Z",100,29,"Jordan Clarkson",1,7,13,10,9,14.6
"11914",373,5,0,2,2,0,2,0,4,3,18,2,4,3,4,3,1,1037642,"2023-10-30T00:00:00.000Z",358,29,"Kelly Olynyk",3,7,12,8,9,23.3
"11915",374,0,0,0,5,2,10,5,0,0,17,0,2,12,0,0,1,1037642,"2023-10-30T00:00:00.000Z",413,29,"Collin Sexton",0,12,12,12,0,11
"11916",375,2,0,2,1,0,1,0,0,0,14,0,0,0,2,1,1,1037643,"2023-10-30T00:00:00.000Z",666860,14,"Cameron Reddish",1,2,4,2,4,7.4
"11917",376,0,0,1,1,0,1,0,2,2,6,0,2,2,1,0,0,1037972,"2023-12-21T00:00:00.000Z",68,18,"Troy Brown Jr.",0,3,3,2,1,3.2
"11918",377,0,0,0,0,0,0,0,0,0,0,0,0,0,0,0,0,1037961,"2023-12-20T00:00:00.000Z",376,28,"Otto Porter Jr.",0,0,0,0,0,0
"11919",378,0,0,0,0,0,0,0,0,0,0,0,0,0,0,0,0,1037961,"2023-12-20T00:00:00.000Z",436,28,"Garrett Temple",0,0,0,0,0,0
"11920",379,0,0,0,0,0,0,0,0,0,0,0,0,0,0,0,0,1037961,"2023-12-20T00:00:00.000Z",489,28,"Thaddeus Young",0,0,0,0,0,0
"11921",380,0,0,0,0,0,0,0,0,0,0,0,0,0,0,0,0,1037961,"2023-12-20T00:00:00.000Z",56677805,28,"Javon Freeman-Liberty",0,0,0,0,0,0
"11922",381,6,3,5,10,2,11,2,0,0,28,1,2,6,6,1,2,1037960,"2023-12-20T00:00:00.000Z",351,3,"Royce O'Neale",4,12,18,12,12,32.2
"11923",382,0,1,0,0,0,1,0,0,0,4,0,1,0,0,0,1,1037960,"2023-12-20T00:00:00.000Z",174,3,"Harry Giles III",1,0,0,0,0,2
"11924",383,0,0,0,0,0,0,0,0,0,0,0,0,0,0,0,0,1037961,"2023-12-20T00:00:00.000Z",38017710,28,"Christian Koloko",0,0,0,0,0,0
"11925",384,0,0,0,0,0,0,0,0,0,0,0,0,0,0,0,0,1037961,"2023-12-20T00:00:00.000Z",56677869,28,"Markquis Nowell",0,0,0,0,0,0
"11926",385,0,0,0,0,0,0,0,0,0,0,0,0,0,0,0,0,1037961,"2023-12-20T00:00:00.000Z",2309958,28,"Jontay Porter",0,0,0,0,0,0
"11927",386,2,0,5,7,2,13,5,0,0,32,1,1,12,6,1,0,1037961,"2023-12-20T00:00:00.000Z",375,8,"Michael Porter Jr.",1,18,20,14,8,25.2
"11928",387,0,0,0,0,0,0,0,0,0,0,0,0,0,0,0,0,1037961,"2023-12-20T00:00:00.000Z",38017727,8,"Collin Gillespie",0,0,0,0,0,0
"11929",388,0,0,0,0,0,0,0,0,0,0,0,0,0,0,0,0,1037961,"2023-12-20T00:00:00.000Z",215,8,"Justin Holiday",0,0,0,0,0,0
"11930",389,0,0,0,0,0,0,0,0,0,0,0,0,0,0,0,0,1037956,"2023-12-20T00:00:00.000Z",56677842,29,"Brice Sensabaugh",0,0,0,0,0,0
"11931",390,7,0,7,10,2,26,10,3,3,34,2,0,25,9,1,1,1037957,"2023-12-20T00:00:00.000Z",403,4,"Terry Rozier",1,34,41,32,16,48.3
"11932",391,2,0,3,8,1,21,4,6,6,33,2,0,15,5,2,2,1037960,"2023-12-20T00:00:00.000Z",61,3,"Mikal Bridges",2,20,22,17,7,28
"11933",392,2,0,4,6,4,14,8,1,0,28,0,3,20,4,0,0,1037960,"2023-12-20T00:00:00.000Z",666679,3,"Cameron Johnson",0,24,26,22,6,27.8
"11934",393,2,4,4,0,0,5,3,0,0,26,4,5,6,8,0,0,1037960,"2023-12-20T00:00:00.000Z",666508,3,"Nicolas Claxton",4,14,16,8,10,30.6
"11935",394,5,0,1,7,4,18,8,1,0,32,1,2,20,2,0,1,1037960,"2023-12-20T00:00:00.000Z",17896048,3,"Cam Thomas",0,22,27,25,7,28.9
"11936",395,2,0,2,8,2,11,3,2,2,30,0,0,10,2,1,2,1037960,"2023-12-20T00:00:00.000Z",130,3,"Spencer Dinwiddie",1,12,14,12,4,16.4
"11937",396,0,0,0,0,0,0,0,0,0,0,0,0,0,0,0,0,1037957,"2023-12-20T00:00:00.000Z",56677861,12,"Ben Sheppard",0,0,0,0,0,0
"11938",397,3,0,11,3,2,5,2,4,4,31,2,2,10,13,1,2,1037960,"2023-12-20T00:00:00.000Z",202,20,"Josh Hart",1,23,26,13,16,31.1
"11939",398,2,1,0,6,4,12,7,4,1,24,0,0,19,0,1,1,1037960,"2023-12-20T00:00:00.000Z",3547269,20,"Immanuel Quickley",2,19,21,21,2,27
"11940",399,0,1,1,4,1,7,2,0,0,18,0,1,5,1,1,0,1037960,"2023-12-20T00:00:00.000Z",17895858,20,"Quentin Grimes",2,6,6,5,1,12.2
"11941",400,0,2,2,0,0,2,1,0,0,13,0,3,2,2,0,0,1037960,"2023-12-20T00:00:00.000Z",173,20,"Taj Gibson",2,4,4,2,2,10.4
"11942",401,0,0,0,0,0,0,0,0,0,0,0,0,0,0,0,0,1037786,"2023-11-20T00:00:00.000Z",56677866,4,"Leaky Black",0,0,0,0,0,0
"11943",402,2,1,3,1,0,5,3,2,1,32,1,3,7,4,0,0,1037788,"2023-11-20T00:00:00.000Z",3547242,30,"Deni Avdija",1,11,13,9,6,17.8
"11944",403,13,1,3,5,2,15,10,0,0,31,0,2,22,3,2,2,1037788,"2023-11-20T00:00:00.000Z",265,30,"Kyle Kuzma",3,25,38,35,16,52.1
"11945",404,0,0,0,0,0,0,0,0,0,0,0,0,0,0,0,0,1037787,"2023-11-20T00:00:00.000Z",259,9,"Kevin Knox",0,0,0,0,0,0
"11946",405,0,0,0,0,0,0,0,0,0,0,0,0,0,0,0,0,1037787,"2023-11-20T00:00:00.000Z",54,9,"Bojan Bogdanovic",0,0,0,0,0,0
"11947",406,0,0,0,0,0,0,0,0,0,0,0,0,0,0,0,0,1037787,"2023-11-20T00:00:00.000Z",56677729,9,"Malcolm Cazalon",0,0,0,0,0,0
"11948",407,0,0,0,0,0,0,0,0,0,0,0,0,0,0,0,0,1037787,"2023-11-20T00:00:00.000Z",197,9,"Joe Harris",0,0,0,0,0,0
"11949",408,0,0,0,0,0,0,0,0,0,0,0,0,0,0,0,0,1037787,"2023-11-20T00:00:00.000Z",330,9,"Monte Morris",0,0,0,0,0,0
"11950",409,0,0,0,0,0,0,0,0,0,0,0,0,0,0,0,0,1037787,"2023-11-20T00:00:00.000Z",42097199,9,"Jared Rhoden",0,0,0,0,0,0
"11951",410,2,1,9,9,4,15,5,1,0,38,2,3,14,11,0,4,1037787,"2023-11-20T00:00:00.000Z",375,8,"Michael Porter Jr.",1,25,27,16,13,29.2
"11952",411,2,2,4,0,0,14,7,0,0,29,2,3,14,6,0,0,1037788,"2023-11-20T00:00:00.000Z",666577,30,"Daniel Gafford",2,20,22,16,8,30.2
"11953",412,1,0,1,9,3,26,11,5,5,33,0,4,30,1,0,0,1037788,"2023-11-20T00:00:00.000Z",666848,30,"Jordan Poole",0,31,32,31,2,32.7
"11954",413,3,0,2,1,0,13,9,0,0,26,0,0,18,2,0,0,1037788,"2023-11-20T00:00:00.000Z",249,30,"Tyus Jones",0,20,23,21,5,24.9
"11955",414,0,0,0,0,0,0,0,0,0,1,0,0,0,0,0,0,1037788,"2023-11-20T00:00:00.000Z",18677954,30,"Jared Butler",0,0,0,0,0,0
"11956",415,0,0,0,0,0,0,0,0,0,0,0,0,0,0,0,0,1037788,"2023-11-20T00:00:00.000Z",38017704,30,"Patrick Baldwin Jr.",0,0,0,0,0,0
"11957",416,0,0,0,0,0,0,0,0,0,0,0,0,0,0,0,0,1037788,"2023-11-20T00:00:00.000Z",38124126,30,"John Butler Jr.",0,0,0,0,0,0
"11958",417,7,0,4,1,0,10,4,4,3,37,4,1,11,8,1,2,1037787,"2023-11-20T00:00:00.000Z",177,8,"Aaron Gordon",1,19,26,18,15,32.1
"11959",418,5,1,5,4,1,8,4,0,0,15,0,1,9,5,0,1,1037787,"2023-11-20T00:00:00.000Z",246,8,"Nikola Jokic",1,14,19,14,10,24.5
"11960",419,3,2,2,5,2,17,8,2,2,36,1,2,20,3,2,3,1037787,"2023-11-20T00:00:00.000Z",81,8,"Kentavious Caldwell-Pope",4,23,26,23,6,37.1
"11961",420,6,1,3,3,1,15,9,3,2,32,0,2,21,3,1,0,1037787,"2023-11-20T00:00:00.000Z",236,8,"Reggie Jackson",2,24,30,27,9,39.6
"11962",421,2,1,5,2,2,10,5,4,3,32,1,2,15,6,1,2,1037787,"2023-11-20T00:00:00.000Z",38017709,8,"Christian Braun",2,21,23,17,8,29.2
"11963",422,2,2,1,0,0,2,1,2,2,14,0,1,4,1,0,1,1037787,"2023-11-20T00:00:00.000Z",38017721,8,"Peyton Watson",2,5,7,6,3,13.2
"11964",423,0,0,0,0,0,0,0,0,0,0,0,0,0,0,0,0,1037787,"2023-11-20T00:00:00.000Z",38017727,8,"Collin Gillespie",0,0,0,0,0,0
"11965",424,0,0,0,0,0,0,0,0,0,0,0,0,0,0,0,0,1037787,"2023-11-20T00:00:00.000Z",215,8,"Justin Holiday",0,0,0,0,0,0
"11966",425,0,0,0,0,0,0,0,0,0,0,0,0,0,0,0,0,1037787,"2023-11-20T00:00:00.000Z",250,8,"DeAndre Jordan",0,0,0,0,0,0
"11967",426,8,1,4,3,1,12,6,2,2,30,1,0,15,5,1,1,1038092,"2024-01-07T00:00:00.000Z",227,19,"Brandon Ingram",2,20,28,23,13,38
"11968",427,5,0,2,6,3,7,4,0,0,25,0,1,11,2,1,1,1038092,"2024-01-07T00:00:00.000Z",18677986,19,"Trey Murphy III",1,13,18,16,7,22.9
"11969",428,1,1,11,2,1,10,6,2,2,22,1,2,15,12,0,1,1038092,"2024-01-07T00:00:00.000Z",455,19,"Jonas Valanciunas",1,27,28,16,13,32.9
"11970",429,2,1,2,3,1,7,3,2,2,26,1,1,9,3,0,1,1038092,"2024-01-07T00:00:00.000Z",17896024,19,"Herbert Jones",1,12,14,11,5,17.6
"11971",430,0,0,0,0,0,0,0,0,0,0,0,0,0,0,0,0,1038094,"2024-01-07T00:00:00.000Z",56677729,9,"Malcolm Cazalon",0,0,0,0,0,0
"11972",431,0,0,0,0,0,0,0,0,0,0,0,0,0,0,0,0,1038094,"2024-01-07T00:00:00.000Z",330,9,"Monte Morris",0,0,0,0,0,0
"11973",432,0,0,0,0,0,0,0,0,0,0,0,0,0,0,0,0,1038094,"2024-01-07T00:00:00.000Z",42097199,9,"Jared Rhoden",0,0,0,0,0,0
"11974",433,0,0,0,0,0,0,0,0,0,0,0,0,0,0,0,0,1038094,"2024-01-07T00:00:00.000Z",3547267,9,"Isaiah Stewart",0,0,0,0,0,0
"11975",434,0,0,0,0,0,0,0,0,0,0,0,0,0,0,0,0,1038094,"2024-01-07T00:00:00.000Z",44477024,9,"Stanley Umude",0,0,0,0,0,0
"11976",435,0,0,0,0,0,0,0,0,0,0,0,0,0,0,0,0,1038093,"2024-01-07T00:00:00.000Z",320,18,"Shake Milton",0,0,0,0,0,0
"11977",436,0,0,0,0,0,0,0,0,0,0,0,0,0,0,0,0,1038093,"2024-01-07T00:00:00.000Z",38017715,18,"Josh Minott",0,0,0,0,0,0
"11978",437,0,0,0,0,0,0,0,0,0,0,0,0,0,0,0,0,1038093,"2024-01-07T00:00:00.000Z",56677851,18,"Jaylen Clark",0,0,0,0,0,0
"11979",438,0,0,0,0,0,0,0,0,0,0,0,0,0,0,0,0,1038096,"2024-01-07T00:00:00.000Z",185,10,"Draymond Green",0,0,0,0,0,0
"11980",439,0,0,0,1,0,3,0,0,0,3,3,1,0,3,0,0,1038095,"2024-01-07T00:00:00.000Z",3547285,15,"Xavier Tillman",0,3,3,0,3,3.6
"11981",440,5,1,3,7,2,14,8,5,5,36,2,3,23,5,1,3,1038095,"2024-01-07T00:00:00.000Z",3547287,15,"Desmond Bane",2,28,33,28,10,39.5
"11982",441,8,0,6,13,4,20,9,5,3,38,0,2,25,6,3,5,1038095,"2024-01-07T00:00:00.000Z",420,15,"Marcus Smart",3,31,39,33,14,48.2
"11983",442,1,2,5,4,3,11,6,4,4,37,4,2,19,9,0,0,1038095,"2024-01-07T00:00:00.000Z",38017731,15,"Vince Williams Jr.",2,28,29,20,10,37.3
"11984",443,3,0,2,5,1,10,4,1,0,27,2,4,9,4,2,1,1038095,"2024-01-07T00:00:00.000Z",17896027,15,"Ziaire Williams",2,13,16,12,7,23.3
"11985",444,1,1,5,7,1,11,2,3,2,16,2,2,7,7,1,4,1038095,"2024-01-07T00:00:00.000Z",17896067,15,"Santi Aldama",2,14,15,8,8,18.9
"11986",445,0,0,1,1,0,1,0,0,0,3,0,0,0,1,0,0,1038095,"2024-01-07T00:00:00.000Z",666703,15,"John Konchar",0,1,1,0,1,1.2
"11987",446,0,0,0,0,0,0,0,0,0,0,0,0,0,0,0,0,1038095,"2024-01-07T00:00:00.000Z",38017729,15,"David Roddy",0,0,0,0,0,0
"11988",447,0,0,0,0,0,0,0,0,0,0,0,0,0,0,0,0,1038093,"2024-01-07T00:00:00.000Z",17896056,18,"Luka Garza",0,0,0,0,0,0
"11989",448,0,0,0,0,0,0,0,0,0,0,0,0,0,0,0,0,1038093,"2024-01-07T00:00:00.000Z",17895968,18,"Daishen Nix",0,0,0,0,0,0
"11990",449,0,0,0,0,0,0,0,0,0,0,0,0,0,0,0,0,1038095,"2024-01-07T00:00:00.000Z",401,15,"Derrick Rose",0,0,0,0,0,0
"11991",450,0,0,0,0,0,0,0,0,0,0,0,0,0,0,0,0,1038095,"2024-01-07T00:00:00.000Z",3,15,"Steven Adams",0,0,0,0,0,0
"11992",451,2,0,4,3,1,15,6,1,1,36,0,1,14,4,0,1,7049317,"2023-12-06T00:00:00.000Z",666656,1,"De'Andre Hunter",0,18,20,16,6,20.8
"11993",452,12,0,0,13,5,28,13,2,1,37,2,0,32,2,2,4,1037878,"2023-12-02T00:00:00.000Z",490,1,"Trae Young",2,34,46,44,14,54.4
"11994",453,0,1,3,7,2,18,6,0,0,25,0,2,14,3,2,0,1037878,"2023-12-02T00:00:00.000Z",53,1,"Bogdan Bogdanovic",3,17,17,14,3,26.6
"11995",454,0,0,0,0,0,0,0,0,0,8,1,1,0,1,0,1,1037878,"2023-12-02T00:00:00.000Z",666754,1,"Garrison Mathews",0,1,1,0,1,0.2
"11996",455,2,0,2,7,3,11,5,2,2,25,0,3,15,2,0,1,7049315,"2023-12-06T00:00:00.000Z",3089,28,"Gary Trent Jr.",0,17,19,17,4,19.4
"11997",456,1,0,1,1,1,1,1,0,0,6,0,1,3,1,0,0,7049315,"2023-12-06T00:00:00.000Z",3547275,28,"Malachi Flynn",0,4,5,4,2,5.7
"11998",457,1,1,2,2,0,2,0,0,0,14,0,2,0,2,1,1,7049315,"2023-12-06T00:00:00.000Z",376,28,"Otto Porter Jr.",2,2,3,1,3,8.9
"11999",458,0,0,0,0,0,0,0,0,0,0,0,0,0,0,0,0,7049315,"2023-12-06T00:00:00.000Z",666762,28,"Jalen McDaniels",0,0,0,0,0,0
"12000",459,0,0,0,0,0,0,0,0,0,0,0,0,0,0,0,0,7049315,"2023-12-06T00:00:00.000Z",436,28,"Garrett Temple",0,0,0,0,0,0
"12001",460,0,0,0,0,0,0,0,0,0,0,0,0,0,0,0,0,7049315,"2023-12-06T00:00:00.000Z",489,28,"Thaddeus Young",0,0,0,0,0,0
"12002",461,0,0,2,6,1,8,3,0,0,20,0,1,7,2,0,1,7049318,"2023-12-06T00:00:00.000Z",666400,18,"Nickeil Alexander-Walker",0,9,9,7,2,8.4
"12003",462,2,1,9,3,2,6,5,3,2,32,1,2,14,10,0,6,7049318,"2023-12-06T00:00:00.000Z",447,18,"Karl-Anthony Towns",1,24,26,16,12,26
"12004",463,3,1,6,3,1,20,8,14,12,36,0,1,29,6,0,2,7049319,"2023-12-06T00:00:00.000Z",125,5,"DeMar DeRozan",1,35,38,32,9,41.7
"12005",464,1,2,6,2,1,6,3,2,1,29,3,2,8,9,2,3,7049319,"2023-12-06T00:00:00.000Z",3547248,5,"Patrick Williams",4,17,18,9,10,29.3
"12006",465,3,1,6,3,2,17,8,2,2,34,6,0,20,12,0,2,7049319,"2023-12-06T00:00:00.000Z",460,5,"Nikola Vucevic",1,32,35,23,15,39.9
"12007",466,2,2,2,2,1,7,4,4,3,30,4,2,12,6,0,1,7049319,"2023-12-06T00:00:00.000Z",89,5,"Alex Caruso",2,18,20,14,8,27.2
"12008",467,5,0,9,7,3,16,6,5,4,38,0,3,19,9,0,0,7049319,"2023-12-06T00:00:00.000Z",666956,5,"Coby White",0,28,33,24,14,37.3
"12009",468,2,0,2,4,2,9,3,0,0,22,0,2,8,2,1,4,7049319,"2023-12-06T00:00:00.000Z",17895983,5,"Ayo Dosunmu",1,10,12,10,4,12.4
"12010",469,2,0,1,2,2,4,2,0,0,17,3,2,6,4,1,0,7049319,"2023-12-06T00:00:00.000Z",110,5,"Torrey Craig",1,10,12,8,6,16.8
"12011",470,1,0,0,1,0,2,1,0,0,6,0,0,2,0,0,0,7049319,"2023-12-06T00:00:00.000Z",56677857,5,"Julian Phillips",0,2,3,3,1,3.5
"12012",471,1,0,4,0,0,8,3,2,1,14,5,3,7,9,1,3,7049319,"2023-12-06T00:00:00.000Z",137,5,"Andre Drummond",1,16,17,8,10,19.3
"12013",472,0,0,0,0,0,0,0,0,0,3,0,0,0,0,0,0,7049319,"2023-12-06T00:00:00.000Z",38017719,5,"Dalen Terry",0,0,0,0,0,0
"12014",473,3,0,0,1,0,1,0,0,0,11,0,1,0,0,1,1,7049319,"2023-12-06T00:00:00.000Z",87,5,"Jevon Carter",1,0,3,3,3,6.5
"12015",474,0,0,0,0,0,0,0,0,0,0,0,0,0,0,0,0,7049319,"2023-12-06T00:00:00.000Z",17896116,5,"Terry Taylor",0,0,0,0,0,0
"12016",475,0,0,0,0,0,0,0,0,0,0,0,0,0,0,0,0,7049319,"2023-12-06T00:00:00.000Z",27,5,"Lonzo Ball",0,0,0,0,0,0
"12017",476,0,0,1,0,0,3,0,0,0,14,3,3,0,4,1,2,1037657,"2023-11-01T00:00:00.000Z",3547285,15,"Xavier Tillman",1,4,4,0,4,5.8
"12018",477,3,4,6,0,0,18,10,9,7,48,4,3,27,10,2,0,1037659,"2023-11-01T00:00:00.000Z",117,14,"Anthony Davis",6,37,40,30,13,61.5
"12019",478,7,0,5,3,0,13,5,5,5,38,2,4,15,7,3,5,1037659,"2023-11-01T00:00:00.000Z",17553995,14,"Austin Reaves",3,22,29,22,14,37.9
"12020",479,6,0,2,7,3,19,10,4,4,36,0,2,27,2,0,3,1037659,"2023-11-01T00:00:00.000Z",405,14,"D'Angelo Russell",0,29,35,33,8,35.4
"12021",480,0,0,3,5,1,7,1,2,2,22,0,3,5,3,0,0,1037659,"2023-11-01T00:00:00.000Z",38017697,14,"Max Christie",0,8,8,5,3,8.6
"12022",481,0,1,9,4,2,6,4,0,0,29,2,3,10,11,1,2,1037659,"2023-11-01T00:00:00.000Z",486,14,"Christian Wood",2,21,21,10,11,27.2
"12023",482,0,0,0,0,0,0,0,0,0,0,0,0,0,0,0,0,1037657,"2023-11-01T00:00:00.000Z",38017630,29,"Johnny Juzang",0,0,0,0,0,0
"12024",483,0,0,0,0,0,0,0,0,0,0,0,0,0,0,0,0,1037657,"2023-11-01T00:00:00.000Z",19465584,29,"Micah Potter",0,0,0,0,0,0
"12025",484,0,2,3,5,2,5,2,2,2,19,1,2,8,4,0,1,1037657,"2023-11-01T00:00:00.000Z",17896027,15,"Ziaire Williams",2,12,12,8,4,17.8
"12026",485,8,0,3,3,0,5,1,0,0,28,1,2,2,4,1,0,1037658,"2023-11-01T00:00:00.000Z",367,10,"Chris Paul",1,6,14,10,12,21.8
"12027",486,2,0,6,5,3,9,6,0,0,20,0,1,15,6,0,3,1037658,"2023-11-01T00:00:00.000Z",407,10,"Dario Saric",0,21,23,17,8,22.2
"12028",487,1,0,2,0,0,4,2,0,0,22,0,0,4,2,1,1,1037658,"2023-11-01T00:00:00.000Z",2189,10,"Gary Payton II",1,6,7,5,3,9.9
"12029",488,1,0,1,2,1,9,4,3,3,17,0,2,12,1,1,1,1037658,"2023-11-01T00:00:00.000Z",17553979,10,"Jonathan Kuminga",1,13,14,13,2,16.7
"12030",489,0,1,3,2,0,3,0,2,1,15,0,1,1,3,0,0,1037658,"2023-11-01T00:00:00.000Z",17553992,10,"Moses Moody",1,4,4,1,3,7.6
"12031",490,0,0,0,0,0,0,0,0,0,0,0,0,0,0,0,0,1037658,"2023-11-01T00:00:00.000Z",251,10,"Cory Joseph",0,0,0,0,0,0
"12032",491,0,0,0,0,0,0,0,0,0,0,0,0,0,0,0,0,1037658,"2023-11-01T00:00:00.000Z",56677858,10,"Brandin Podziemski",0,0,0,0,0,0
"12033",492,0,0,0,0,0,0,0,0,0,0,0,0,0,0,0,0,1037658,"2023-11-01T00:00:00.000Z",17896070,10,"Usman Garuba",0,0,0,0,0,0
"12034",493,0,0,0,0,0,0,0,0,0,0,0,0,0,0,0,0,1037658,"2023-11-01T00:00:00.000Z",45658838,10,"Lester Quinones",0,0,0,0,0,0
"12035",494,0,0,0,0,0,0,0,0,0,0,0,0,0,0,0,0,1037658,"2023-11-01T00:00:00.000Z",398,10,"Jerome Robinson",0,0,0,0,0,0
"12036",495,1,0,0,7,4,8,4,2,2,31,1,0,14,1,1,1,1037658,"2023-11-01T00:00:00.000Z",30,26,"Harrison Barnes",1,15,16,15,2,18.7
"12037",496,0,0,0,0,0,0,0,0,0,0,0,0,0,0,0,0,1037659,"2023-11-01T00:00:00.000Z",457,14,"Jarred Vanderbilt",0,0,0,0,0,0
"12038",497,0,0,0,0,0,0,0,0,0,0,0,0,0,0,0,0,1037659,"2023-11-01T00:00:00.000Z",1603383,14,"Gabe Vincent",0,0,0,0,0,0
"12039",498,1,0,6,9,6,16,11,8,7,37,0,6,35,6,2,3,1037659,"2023-11-01T00:00:00.000Z",172,13,"Paul George",2,41,42,36,7,46.7
"12040",499,5,0,5,11,5,28,15,6,3,41,1,2,38,6,2,2,1037659,"2023-11-01T00:00:00.000Z",274,13,"Kawhi Leonard",2,44,49,43,11,56.7
"12041",500,0,0,7,0,0,8,3,2,1,29,2,5,7,9,0,1,1037659,"2023-11-01T00:00:00.000Z",493,13,"Ivica Zubac",0,16,16,7,9,16.8
"12042",501,0,0,1,0,0,0,0,0,0,3,0,3,0,1,0,0,1037992,"2023-12-23T00:00:00.000Z",68,18,"Troy Brown Jr.",0,1,1,0,1,1.2
"12043",502,1,0,1,2,1,4,2,0,0,14,0,0,5,1,0,1,1037992,"2023-12-23T00:00:00.000Z",320,18,"Shake Milton",0,6,7,6,2,6.7
"12044",503,2,0,0,0,0,0,0,0,0,1,0,0,0,0,0,0,1037992,"2023-12-23T00:00:00.000Z",666767,18,"Jordan McLaughlin",0,0,2,2,2,3
"12045",504,0,0,0,0,0,0,0,0,0,0,0,0,0,0,0,0,1037992,"2023-12-23T00:00:00.000Z",17896056,18,"Luka Garza",0,0,0,0,0,0
"12046",505,0,0,0,0,0,0,0,0,0,0,0,0,0,0,0,0,1037992,"2023-12-23T00:00:00.000Z",38017700,18,"Wendell Moore Jr.",0,0,0,0,0,0
"12047",506,0,0,0,0,0,0,0,0,0,0,0,0,0,0,0,0,1037992,"2023-12-23T00:00:00.000Z",56677851,18,"Jaylen Clark",0,0,0,0,0,0
"12048",507,0,0,0,0,0,0,0,0,0,0,0,0,0,0,0,0,1037992,"2023-12-23T00:00:00.000Z",56677782,18,"Leonard Miller",0,0,0,0,0,0
"12049",508,0,0,0,0,0,0,0,0,0,0,0,0,0,0,0,0,1037992,"2023-12-23T00:00:00.000Z",38017715,18,"Josh Minott",0,0,0,0,0,0
"12050",509,0,0,0,0,0,0,0,0,0,0,0,0,0,0,0,0,1037992,"2023-12-23T00:00:00.000Z",17895968,18,"Daishen Nix",0,0,0,0,0,0
"12051",510,0,0,0,0,0,0,0,0,0,0,0,0,0,0,0,0,1037985,"2023-12-23T00:00:00.000Z",17896040,1,"Jalen Johnson",0,0,0,0,0,0
"12052",511,1,0,9,5,1,6,2,0,0,35,2,4,5,11,2,1,1037985,"2023-12-23T00:00:00.000Z",38017731,15,"Vince Williams Jr.",2,16,17,6,12,24.7
"12053",512,1,0,5,5,2,14,8,4,3,28,1,3,21,6,1,3,1037993,"2023-12-25T00:00:00.000Z",666423,20,"RJ Barrett",1,27,28,22,7,29.7
"12054",513,2,0,8,5,2,17,8,6,6,41,1,3,24,9,1,4,1037993,"2023-12-25T00:00:00.000Z",387,20,"Julius Randle",1,33,35,26,11,36.8
"12055",514,4,1,4,0,0,7,5,2,1,33,4,4,11,8,0,0,1037993,"2023-12-25T00:00:00.000Z",201,20,"Isaiah Hartenstein",1,19,23,15,12,29.6
"12056",515,6,0,3,3,1,28,15,9,7,37,1,0,38,4,1,0,1037993,"2023-12-25T00:00:00.000Z",73,20,"Jalen Brunson",1,42,48,44,10,54.8
"12057",516,4,0,1,5,1,6,1,0,0,21,0,4,3,1,1,1,1037993,"2023-12-25T00:00:00.000Z",131,20,"Donte DiVincenzo",1,4,8,7,5,12.2
"12058",517,4,0,9,2,0,7,5,0,0,31,0,1,10,9,2,2,1037993,"2023-12-25T00:00:00.000Z",202,20,"Josh Hart",2,19,23,14,13,30.8
"12059",518,1,0,0,4,2,10,7,4,4,22,0,1,20,0,1,1,1037993,"2023-12-25T00:00:00.000Z",3547269,20,"Immanuel Quickley",1,20,21,21,1,23.5
"12060",519,2,0,1,1,0,2,1,1,0,12,0,0,2,1,0,0,1037993,"2023-12-25T00:00:00.000Z",17895858,20,"Quentin Grimes",0,3,5,4,3,6.2
"12061",520,3,3,3,1,0,1,0,0,0,15,0,2,0,3,0,0,1037993,"2023-12-25T00:00:00.000Z",173,20,"Taj Gibson",3,3,6,3,6,17.1
"12062",521,0,0,0,0,0,0,0,0,0,0,0,0,0,0,0,0,1037993,"2023-12-25T00:00:00.000Z",19,20,"Ryan Arcidiacono",0,0,0,0,0,0
"12063",522,0,0,0,0,0,0,0,0,0,0,0,0,0,0,0,0,1037993,"2023-12-25T00:00:00.000Z",666474,20,"Charles Brown",0,0,0,0,0,0
"12064",523,0,0,0,0,0,0,0,0,0,0,0,0,0,0,0,0,1037993,"2023-12-25T00:00:00.000Z",160,20,"Evan Fournier",0,0,0,0,0,0
"12065",524,0,0,0,0,0,0,0,0,0,0,0,0,0,0,0,0,1037993,"2023-12-25T00:00:00.000Z",666675,20,"DaQuan Jeffries",0,0,0,0,0,0
"12066",525,0,0,0,0,0,0,0,0,0,0,0,0,0,0,0,0,1037993,"2023-12-25T00:00:00.000Z",17896033,20,"Miles McBride",0,0,0,0,0,0
"12067",526,2,0,1,6,0,6,0,0,0,25,0,2,0,1,2,0,1037790,"2023-11-20T00:00:00.000Z",17895858,20,"Quentin Grimes",2,1,3,2,3,10.2
"12068",527,6,0,4,6,3,15,7,8,8,36,0,2,25,4,0,1,1037790,"2023-11-20T00:00:00.000Z",73,20,"Jalen Brunson",0,29,35,31,10,37.8
"12069",528,3,0,4,5,5,18,11,4,4,26,0,0,31,4,0,1,1037791,"2023-11-20T00:00:00.000Z",227,19,"Brandon Ingram",0,35,38,34,7,39.3
"12070",529,5,1,3,0,0,16,12,2,2,30,0,2,26,3,3,1,1037791,"2023-11-20T00:00:00.000Z",666969,19,"Zion Williamson",4,29,34,31,8,48.1
"12071",530,7,3,12,0,0,4,3,4,4,21,1,3,10,13,1,0,1037791,"2023-11-20T00:00:00.000Z",455,19,"Jonas Valanciunas",4,23,30,17,20,48.1
"12072",531,4,2,6,2,1,9,7,4,3,27,1,4,18,7,1,1,1037791,"2023-11-20T00:00:00.000Z",17896024,19,"Herbert Jones",3,25,29,22,11,40.4
"12073",532,5,0,2,4,1,4,1,0,0,25,0,2,3,2,1,0,1037791,"2023-11-20T00:00:00.000Z",38017677,19,"Dyson Daniels",1,5,10,8,7,15.9
"12074",533,2,0,4,5,2,11,3,1,1,29,1,2,9,5,0,1,1037791,"2023-11-20T00:00:00.000Z",56677837,19,"Jordan Hawkins",0,14,16,11,7,17
"12075",534,3,0,0,3,1,5,2,0,0,15,0,0,5,0,0,2,1037791,"2023-11-20T00:00:00.000Z",17896097,19,"Jose Alvarado",0,5,8,8,3,7.5
"12076",535,2,0,0,2,1,3,1,0,0,6,0,1,3,0,1,0,1037791,"2023-11-20T00:00:00.000Z",3547260,19,"Kira Lewis Jr.",1,3,5,5,2,9
"12077",536,3,0,1,1,1,4,3,0,0,20,1,3,7,2,1,1,1037789,"2023-11-20T00:00:00.000Z",3092,16,"Haywood Highsmith",1,9,12,10,5,15.9
"12078",537,6,0,8,0,0,14,8,9,7,30,3,3,23,11,1,1,1037789,"2023-11-20T00:00:00.000Z",4,16,"Bam Adebayo",1,34,40,29,17,47.2
"12079",538,2,0,2,9,6,11,7,2,2,30,0,3,22,2,0,0,1037789,"2023-11-20T00:00:00.000Z",397,16,"Duncan Robinson",0,24,26,24,4,27.4
"12080",539,6,0,4,4,2,6,3,0,0,27,1,1,8,5,0,1,1037789,"2023-11-20T00:00:00.000Z",286,16,"Kyle Lowry",0,13,19,14,11,22
"12081",540,4,0,1,4,3,13,8,0,0,33,2,1,19,3,2,0,1037789,"2023-11-20T00:00:00.000Z",56677785,16,"Jaime Jaquez Jr.",2,22,26,23,7,34.6
"12082",541,1,0,8,5,3,6,4,0,0,15,0,2,11,8,0,1,1037789,"2023-11-20T00:00:00.000Z",285,16,"Kevin Love",0,19,20,12,9,21.1
"12083",542,1,1,2,6,2,12,4,0,0,30,2,2,10,4,0,3,1037789,"2023-11-20T00:00:00.000Z",391,16,"Josh Richardson",1,14,15,11,5,16.3
"12084",543,4,0,3,2,1,2,1,0,0,27,1,1,3,4,0,0,1037788,"2023-11-20T00:00:00.000Z",105,17,"Pat Connaughton",0,7,11,7,8,13.8
"12085",544,1,0,2,3,0,4,1,0,0,15,0,1,2,2,0,0,1037788,"2023-11-20T00:00:00.000Z",38017733,17,"A.J. Green",0,4,5,3,3,5.9
"12086",545,2,0,2,4,2,5,2,0,0,17,0,1,6,2,1,1,1037788,"2023-11-20T00:00:00.000Z",368,17,"Cameron Payne",1,8,10,8,4,13.4
"12087",546,2,0,5,3,0,6,1,0,0,21,0,1,2,5,0,0,1037789,"2023-11-20T00:00:00.000Z",666747,16,"Caleb Martin",0,7,9,4,7,11
"12088",547,0,0,0,0,0,0,0,0,0,1,0,2,0,0,0,0,1037788,"2023-11-20T00:00:00.000Z",284,17,"Robin Lopez",0,0,0,0,0,0
"12089",548,0,0,0,0,0,0,0,0,0,1,0,0,0,0,0,0,1037788,"2023-11-20T00:00:00.000Z",2148,17,"Thanasis Antetokounmpo",0,0,0,0,0,0
"12090",549,0,0,0,0,0,0,0,0,0,1,1,0,0,1,0,0,1037788,"2023-11-20T00:00:00.000Z",56677852,17,"Andre Jackson Jr.",0,1,1,0,1,1.2
"12091",550,0,0,0,0,0,0,0,0,0,0,0,0,0,0,0,0,1037788,"2023-11-20T00:00:00.000Z",38017676,17,"MarJon Beauchamp",0,0,0,0,0,0
"12092",551,0,0,0,0,0,0,0,0,0,0,0,0,0,0,0,0,1038127,"2024-01-12T00:00:00.000Z",17896026,22,"Franz Wagner",0,0,0,0,0,0
"12093",552,2,0,4,2,1,6,3,4,4,24,0,1,11,4,1,0,1038127,"2024-01-12T00:00:00.000Z",666747,16,"Caleb Martin",1,15,17,13,6,21.8
"12094",553,0,0,0,0,0,0,0,0,0,0,0,0,0,0,0,0,1038127,"2024-01-12T00:00:00.000Z",39398582,16,"Orlando Robinson",0,0,0,0,0,0
"12095",554,0,0,0,0,0,0,0,0,0,0,0,0,0,0,0,0,1038127,"2024-01-12T00:00:00.000Z",79,16,"Jimmy Butler",0,0,0,0,0,0
"12096",555,0,0,0,0,0,0,0,0,0,0,0,0,0,0,0,0,1038127,"2024-01-12T00:00:00.000Z",666633,16,"Tyler Herro",0,0,0,0,0,0
"12097",556,0,0,0,0,0,0,0,0,0,0,0,0,0,0,0,0,1038127,"2024-01-12T00:00:00.000Z",286,16,"Kyle Lowry",0,0,0,0,0,0
"12098",557,0,0,0,0,0,0,0,0,0,0,0,0,0,0,0,0,1038127,"2024-01-12T00:00:00.000Z",19465585,16,"Dru Smith",0,0,0,0,0,0
"12099",558,0,0,0,0,0,0,0,0,0,0,0,0,0,0,0,0,1038127,"2024-01-12T00:00:00.000Z",38017736,16,"Cole Swider",0,0,0,0,0,0
"12100",559,3,0,1,9,3,9,3,0,0,32,1,4,9,2,0,0,1038127,"2024-01-12T00:00:00.000Z",38017724,22,"Caleb Houstan",0,11,14,12,5,15.9
"12101",560,6,0,5,7,1,26,10,6,4,36,3,2,25,8,0,4,1038127,"2024-01-12T00:00:00.000Z",38017683,22,"Paolo Banchero",0,33,39,31,14,39.6
"12102",561,1,1,9,0,0,1,1,2,0,20,0,1,2,9,1,0,1038127,"2024-01-12T00:00:00.000Z",666442,22,"Goga Bitadze",2,11,12,3,10,20.3
"12103",562,0,0,0,0,0,0,0,0,0,0,0,0,0,0,0,0,1038127,"2024-01-12T00:00:00.000Z",85,22,"Wendell Carter Jr.",0,0,0,0,0,0
"12104",563,3,1,2,2,0,10,0,5,5,29,0,0,5,2,0,3,1038130,"2024-01-12T00:00:00.000Z",419,25,"Anfernee Simons",1,7,10,8,5,11.9
"12105",564,3,0,2,5,2,7,2,4,3,26,0,1,9,2,0,1,1038130,"2024-01-12T00:00:00.000Z",65,25,"Malcolm Brogdon",0,11,14,12,5,14.9
"12106",565,0,1,3,0,0,1,1,0,0,9,3,3,2,6,0,1,1038130,"2024-01-12T00:00:00.000Z",39613724,25,"Ibou Badji",1,8,8,2,6,11.2
"12107",566,0,0,0,0,0,0,0,0,0,0,0,0,0,0,0,0,1038129,"2024-01-12T00:00:00.000Z",3,15,"Steven Adams",0,0,0,0,0,0
"12108",567,0,2,7,0,0,5,2,2,2,22,4,3,6,11,0,0,1038129,"2024-01-12T00:00:00.000Z",493,13,"Ivica Zubac",2,17,17,6,11,25.2
"12109",568,0,0,0,0,0,0,0,0,0,0,0,0,0,0,0,0,1038126,"2024-01-12T00:00:00.000Z",66,11,"Dillon Brooks",0,0,0,0,0,0
"12110",569,0,0,0,0,0,0,0,0,0,0,0,0,0,0,0,0,1038126,"2024-01-12T00:00:00.000Z",38017695,11,"Tari Eason",0,0,0,0,0,0
"12111",570,0,0,0,0,0,0,0,0,0,0,0,0,0,0,0,0,1038126,"2024-01-12T00:00:00.000Z",3547281,11,"Nate Hinton",0,0,0,0,0,0
"12112",571,0,0,3,4,1,8,3,0,0,26,2,0,7,5,0,1,1038129,"2024-01-12T00:00:00.000Z",666743,13,"Terance Mann",0,12,12,7,5,12
"12113",572,0,0,0,0,0,0,0,0,0,0,0,0,0,0,0,0,1038126,"2024-01-12T00:00:00.000Z",357,11,"Victor Oladipo",0,0,0,0,0,0
"12114",573,0,0,0,0,0,0,0,0,0,0,0,0,0,0,0,0,1038130,"2024-01-12T00:00:00.000Z",666476,25,"Moses Brown",0,0,0,0,0,0
"12115",574,0,0,0,0,0,0,0,0,0,0,0,0,0,0,0,0,1038130,"2024-01-12T00:00:00.000Z",38017690,25,"Shaedon Sharpe",0,0,0,0,0,0
"12116",575,0,0,0,0,0,0,0,0,0,0,0,0,0,0,0,0,1038130,"2024-01-12T00:00:00.000Z",476,25,"Robert Williams III",0,0,0,0,0,0
"12117",576,3,1,4,3,2,14,11,7,7,31,0,0,31,4,1,1,1037901,"2023-12-12T00:00:00.000Z",274,13,"Kawhi Leonard",2,35,38,34,7,45.3
"12118",577,1,0,6,5,2,7,3,1,1,16,0,0,9,6,2,3,1037901,"2023-12-12T00:00:00.000Z",172,13,"Paul George",2,15,16,10,7,20.7
"12119",578,0,0,9,0,0,5,3,1,0,23,0,4,6,9,0,1,1037901,"2023-12-12T00:00:00.000Z",493,13,"Ivica Zubac",0,15,15,6,9,15.8
"12120",579,2,0,4,3,2,6,3,2,2,30,1,1,10,5,1,1,1037901,"2023-12-12T00:00:00.000Z",666743,13,"Terance Mann",1,15,17,12,7,21
"12121",580,7,0,6,4,0,9,4,7,7,28,0,3,15,6,2,2,1037901,"2023-12-12T00:00:00.000Z",192,13,"James Harden",2,21,28,22,13,36.7
"12122",581,2,0,1,4,2,11,5,3,3,27,0,1,15,1,0,1,1037901,"2023-12-12T00:00:00.000Z",380,13,"Norman Powell",0,16,18,17,3,18.2
"12123",582,0,1,5,3,1,5,3,0,0,24,1,5,7,6,0,1,1037901,"2023-12-12T00:00:00.000Z",56677849,13,"Kobe Brown",1,13,13,7,6,16.2
"12124",583,0,0,2,1,0,8,4,0,0,16,1,2,8,3,1,0,1037901,"2023-12-12T00:00:00.000Z",439,13,"Daniel Theis",1,11,11,8,3,14.6
"12125",584,1,0,1,4,2,8,2,0,0,9,0,0,6,1,0,0,1037901,"2023-12-12T00:00:00.000Z",17896031,13,"Nah'Shon Hyland",0,7,8,7,2,8.7
"12126",585,0,0,0,0,0,1,1,0,0,9,1,0,2,1,0,0,1037901,"2023-12-12T00:00:00.000Z",666511,13,"Amir Coffey",0,3,3,2,1,3.2
"12127",586,2,0,0,1,0,2,1,0,0,7,0,1,2,0,0,1,1037901,"2023-12-12T00:00:00.000Z",24417679,13,"Xavier Moon",0,2,4,4,2,4
"12128",587,1,1,0,1,1,1,1,0,0,12,0,0,3,0,0,2,1037901,"2023-12-12T00:00:00.000Z",38017714,26,"Keon Ellis",1,3,4,4,1,5.5
"12129",588,1,1,2,2,0,3,1,4,4,12,0,1,6,2,0,0,1037901,"2023-12-12T00:00:00.000Z",17896030,26,"Chris Duarte",1,8,9,7,3,12.9
"12130",589,0,0,0,1,1,3,3,0,0,8,0,0,7,0,0,0,1037901,"2023-12-12T00:00:00.000Z",17896044,26,"Kessler Edwards",0,7,7,7,0,7
"12131",590,1,0,1,1,1,2,2,0,0,8,0,0,5,1,0,1,1037901,"2023-12-12T00:00:00.000Z",17895990,26,"Jordan Ford",0,6,7,6,2,6.7
"12132",591,0,0,0,0,0,0,0,0,0,0,0,0,0,0,0,0,1037901,"2023-12-12T00:00:00.000Z",273,26,"Alex Len",0,0,0,0,0,0
"12133",592,3,0,5,1,0,8,4,0,0,20,2,0,8,7,0,4,1037901,"2023-12-12T00:00:00.000Z",472,13,"Russell Westbrook",0,15,18,11,10,16.9
"12134",593,0,0,0,0,0,0,0,0,0,0,0,0,0,0,0,0,1037901,"2023-12-12T00:00:00.000Z",450,13,"PJ Tucker",0,0,0,0,0,0
"12135",594,0,0,0,0,0,0,0,0,0,0,0,0,0,0,0,0,1037901,"2023-12-12T00:00:00.000Z",17896022,13,"Brandon Boston Jr.",0,0,0,0,0,0
"12136",595,0,0,0,0,0,0,0,0,0,0,0,0,0,0,0,0,1037901,"2023-12-12T00:00:00.000Z",38017725,13,"Moussa Diabate",0,0,0,0,0,0
"12137",596,0,0,0,0,0,0,0,0,0,0,0,0,0,0,0,0,1037901,"2023-12-12T00:00:00.000Z",56677856,13,"Jordan Miller",0,0,0,0,0,0
"12138",597,0,0,0,0,0,0,0,0,0,0,0,0,0,0,0,0,1037901,"2023-12-12T00:00:00.000Z",371,13,"Mason Plumlee",0,0,0,0,0,0
"12139",598,0,0,0,0,0,0,0,0,0,0,0,0,0,0,0,0,1037901,"2023-12-12T00:00:00.000Z",17896051,13,"Joshua Primo",0,0,0,0,0,0
"12140",599,1,0,1,2,0,3,1,0,0,19,0,2,2,1,0,0,1037901,"2023-12-12T00:00:00.000Z",30,26,"Harrison Barnes",0,3,4,3,2,4.7
"12141",600,1,0,7,5,0,14,6,6,5,31,0,2,17,7,3,0,1037901,"2023-12-12T00:00:00.000Z",38017688,26,"Keegan Murray",3,24,25,18,8,35.9
"12142",601,2,0,4,2,0,2,0,2,1,18,0,3,1,4,1,0,3277405,"2023-11-10T00:00:00.000Z",38017706,21,"Jaylin Williams",1,5,7,3,6,11.8
"12143",602,4,0,2,4,2,15,8,8,8,29,1,2,26,3,0,2,3277403,"2023-11-10T00:00:00.000Z",274,13,"Kawhi Leonard",0,29,33,30,7,33.6
"12144",603,1,2,3,0,0,9,5,4,2,22,5,3,12,8,0,1,3277403,"2023-11-10T00:00:00.000Z",493,13,"Ivica Zubac",2,20,21,13,9,28.1
"12145",604,0,0,0,0,0,0,0,0,0,3,0,0,0,0,0,0,3277405,"2023-11-10T00:00:00.000Z",17896044,26,"Kessler Edwards",0,0,0,0,0,0
"12146",605,0,0,1,2,0,2,0,0,0,5,0,2,0,1,1,1,3277405,"2023-11-10T00:00:00.000Z",17896030,26,"Chris Duarte",1,1,1,0,1,3.2
"12147",606,0,0,0,0,0,0,0,0,0,0,0,0,0,0,0,0,3277405,"2023-11-10T00:00:00.000Z",17895990,26,"Jordan Ford",0,0,0,0,0,0
"12148",607,0,0,0,0,0,0,0,0,0,0,0,0,0,0,0,0,3277405,"2023-11-10T00:00:00.000Z",56677845,26,"Colby Jones",0,0,0,0,0,0
"12149",608,0,0,3,6,1,11,4,2,2,30,2,0,11,5,2,0,3277404,"2023-11-10T00:00:00.000Z",32,24,"Keita Bates-Diop",2,16,16,11,5,23
"12150",609,5,0,8,6,4,27,13,10,8,38,1,4,38,9,0,4,3277404,"2023-11-10T00:00:00.000Z",140,24,"Kevin Durant",0,47,52,43,14,52.3
"12151",610,7,0,6,3,2,8,4,7,4,33,3,3,14,9,1,2,3277404,"2023-11-10T00:00:00.000Z",349,24,"Jusuf Nurkic",1,23,30,21,16,36.3
"12152",611,4,0,7,4,1,8,4,0,0,32,2,6,9,9,1,2,3277404,"2023-11-10T00:00:00.000Z",8,24,"Grayson Allen",1,18,22,13,13,26.8
"12153",612,2,0,2,4,2,17,9,6,4,31,2,4,24,4,2,2,3277404,"2023-11-10T00:00:00.000Z",37,24,"Bradley Beal",2,28,30,26,6,35.8
"12154",613,1,1,3,0,0,3,1,0,0,14,2,2,2,5,0,2,3277404,"2023-11-10T00:00:00.000Z",147,24,"Drew Eubanks",1,7,8,3,6,10.5
"12155",614,0,0,0,0,0,0,0,0,0,0,0,0,0,0,0,0,3277404,"2023-11-10T00:00:00.000Z",3547095,24,"Udoka Azubuike",0,0,0,0,0,0
"12156",615,0,0,0,0,0,0,0,0,0,0,0,0,0,0,0,0,3277404,"2023-11-10T00:00:00.000Z",666451,24,"Bol Bol",0,0,0,0,0,0
"12157",616,0,0,0,0,0,0,0,0,0,0,0,0,0,0,0,0,3277400,"2023-11-10T00:00:00.000Z",56677831,11,"Cam Whitmore",0,0,0,0,0,0
"12158",617,5,1,6,11,3,24,11,9,6,38,0,2,31,6,0,4,3277400,"2023-11-10T00:00:00.000Z",227,19,"Brandon Ingram",1,37,42,36,11,44.7
"12159",618,1,1,6,0,0,16,8,11,8,34,2,5,24,8,0,5,3277400,"2023-11-10T00:00:00.000Z",666969,19,"Zion Williamson",1,32,33,25,9,33.1
"12160",619,2,4,6,1,1,12,7,1,0,29,3,6,15,9,0,2,3277400,"2023-11-10T00:00:00.000Z",455,19,"Jonas Valanciunas",4,24,26,17,11,38.8
"12161",620,2,0,8,3,0,6,2,6,6,41,2,2,10,10,1,2,3277400,"2023-11-10T00:00:00.000Z",38017677,19,"Dyson Daniels",1,20,22,12,12,26
"12162",621,1,0,7,8,3,11,4,4,3,41,0,6,14,7,2,3,3277400,"2023-11-10T00:00:00.000Z",56677837,19,"Jordan Hawkins",2,21,22,15,8,26.9
"12163",622,1,0,2,4,0,8,1,2,2,26,2,1,4,4,0,1,3277405,"2023-11-10T00:00:00.000Z",30,26,"Harrison Barnes",0,8,9,5,5,9.3
"12164",623,1,1,7,10,3,17,8,5,5,40,4,1,24,11,3,3,3277405,"2023-11-10T00:00:00.000Z",38017688,26,"Keegan Murray",4,35,36,25,12,47.7
"12165",624,13,2,7,0,0,15,7,6,3,38,6,5,17,13,1,5,3277405,"2023-11-10T00:00:00.000Z",406,26,"Domantas Sabonis",3,30,43,30,26,56.1
"12166",625,2,1,9,10,4,19,11,2,2,34,0,4,28,9,3,2,3277405,"2023-11-10T00:00:00.000Z",221,26,"Kevin Huerter",4,37,39,30,11,51.8
"12167",627,0,0,0,0,0,0,0,0,0,0,0,0,0,0,0,0,1038058,"2024-01-03T00:00:00.000Z",666960,17,"Lindell Wigginton",0,0,0,0,0,0
"12168",628,0,0,0,0,0,0,0,0,0,0,0,0,0,0,0,0,1038058,"2024-01-03T00:00:00.000Z",666453,17,"Marques Bolden",0,0,0,0,0,0
"12169",629,0,0,0,0,0,0,0,0,0,0,0,0,0,0,0,0,1038058,"2024-01-03T00:00:00.000Z",112,17,"Jae Crowder",0,0,0,0,0,0
"12170",630,0,0,0,0,0,0,0,0,0,0,0,0,0,0,0,0,1038058,"2024-01-03T00:00:00.000Z",38017733,17,"A.J. Green",0,0,0,0,0,0
"12171",631,0,0,0,0,0,0,0,0,0,0,0,0,0,0,0,0,1038058,"2024-01-03T00:00:00.000Z",38017691,17,"TyTy Washington Jr.",0,0,0,0,0,0
"12172",632,0,0,0,0,0,0,0,0,0,0,0,0,0,0,0,0,1038057,"2024-01-03T00:00:00.000Z",38017662,6,"Isaiah Mobley",0,0,0,0,0,0
"12173",633,0,0,0,0,0,0,0,0,0,0,0,0,0,0,0,0,1038057,"2024-01-03T00:00:00.000Z",404,6,"Ricky Rubio",0,0,0,0,0,0
"12174",634,4,0,4,3,1,11,3,0,0,21,2,1,7,6,1,3,1038057,"2024-01-03T00:00:00.000Z",3547242,30,"Deni Avdija",1,13,17,11,10,20.2
"12175",635,3,0,2,6,2,12,7,0,0,23,0,1,16,2,1,1,1038057,"2024-01-03T00:00:00.000Z",265,30,"Kyle Kuzma",1,18,21,19,5,24.9
"12176",636,1,1,2,0,0,8,6,1,0,20,3,2,12,5,0,0,1038057,"2024-01-03T00:00:00.000Z",666577,30,"Daniel Gafford",1,17,18,13,6,22.5
"12177",637,2,0,0,4,2,11,3,0,0,23,3,3,8,3,0,1,1038057,"2024-01-03T00:00:00.000Z",666848,30,"Jordan Poole",0,11,13,10,5,13.6
"12178",638,2,1,2,2,1,11,4,0,0,21,0,0,9,2,1,0,1038057,"2024-01-03T00:00:00.000Z",249,30,"Tyus Jones",2,11,13,11,4,20.4
"12179",639,1,2,4,4,1,12,2,2,0,32,1,4,5,5,3,2,1038057,"2024-01-03T00:00:00.000Z",56677844,30,"Bilal Coulibaly",5,10,11,6,6,25.5
"12180",640,1,0,1,1,1,2,2,0,0,9,0,0,5,1,0,0,1038057,"2024-01-03T00:00:00.000Z",18677954,30,"Jared Butler",0,6,7,6,2,7.7
"12181",641,0,0,0,0,0,3,1,0,0,5,0,0,2,0,0,0,1038057,"2024-01-03T00:00:00.000Z",38017687,30,"Johnny Davis",0,2,2,2,0,2
"12182",642,0,0,0,0,0,0,0,0,0,0,0,0,0,0,0,0,1038057,"2024-01-03T00:00:00.000Z",167,30,"Danilo Gallinari",0,0,0,0,0,0
"12183",643,3,0,1,2,2,9,6,2,2,25,0,4,16,1,0,1,1038058,"2024-01-03T00:00:00.000Z",38017686,12,"Bennedict Mathurin",0,17,20,19,4,20.7
"12184",644,3,0,6,1,0,6,2,2,2,19,0,1,6,6,0,1,1038058,"2024-01-03T00:00:00.000Z",304,12,"T.J. McConnell",0,12,15,9,9,16.7
"12185",645,4,0,5,6,2,12,5,4,3,27,3,3,15,8,1,0,1038058,"2024-01-03T00:00:00.000Z",3547243,12,"Obi Toppin",1,23,27,19,12,33.6
"12186",646,3,0,2,0,0,6,4,1,1,18,2,3,9,4,1,1,1038058,"2024-01-03T00:00:00.000Z",17896035,12,"Isaiah Jackson",1,13,16,12,7,20.3
"12187",647,0,0,0,0,0,0,0,0,0,0,0,0,0,0,0,0,1038058,"2024-01-03T00:00:00.000Z",242,12,"James Johnson",0,0,0,0,0,0
"12188",648,0,0,0,0,0,0,0,0,0,0,0,0,0,0,0,0,1038058,"2024-01-03T00:00:00.000Z",38017507,12,"Andrew Nembhard",0,0,0,0,0,0
"12189",649,2,1,6,8,2,12,3,2,2,36,2,2,10,8,0,0,1038059,"2024-01-03T00:00:00.000Z",3547256,1,"Saddiq Bey",1,18,20,12,10,25.6
"12190",650,3,0,6,4,2,18,11,4,4,29,1,5,28,7,4,1,1038059,"2024-01-03T00:00:00.000Z",17896040,1,"Jalen Johnson",4,35,38,31,10,51.9
"12191",651,0,0,0,0,0,0,0,0,0,0,0,0,0,0,0,0,1037864,"2023-11-30T00:00:00.000Z",38017693,27,"Blake Wesley",0,0,0,0,0,0
"12192",652,0,0,0,0,0,0,0,0,0,0,0,0,0,0,0,0,1037859,"2023-11-30T00:00:00.000Z",38017701,12,"Kendall Brown",0,0,0,0,0,0
"12193",653,0,0,0,0,0,0,0,0,0,0,0,0,0,0,0,0,1037859,"2023-11-30T00:00:00.000Z",3547264,12,"Jalen Smith",0,0,0,0,0,0
"12194",654,0,0,0,0,0,0,0,0,0,0,0,0,0,0,0,0,1037859,"2023-11-30T00:00:00.000Z",56677794,12,"Isaiah Wong",0,0,0,0,0,0
"12195",655,0,0,0,0,0,0,0,0,0,0,0,0,0,0,0,0,1037864,"2023-11-30T00:00:00.000Z",56677865,27,"Charles Bediako",0,0,0,0,0,0
"12196",656,0,0,0,0,0,0,0,0,0,0,0,0,0,0,0,0,1037864,"2023-11-30T00:00:00.000Z",56677817,27,"Sidy Cissoko",0,0,0,0,0,0
"12197",657,0,0,0,0,0,0,0,0,0,0,0,0,0,0,0,0,1037864,"2023-11-30T00:00:00.000Z",56677870,27,"Sir'Jabari Rice",0,0,0,0,0,0
"12198",658,2,0,6,4,2,8,3,4,4,22,0,6,12,6,1,3,1037864,"2023-11-30T00:00:00.000Z",666656,1,"De'Andre Hunter",1,18,20,14,8,22.2
"12199",659,0,0,2,4,3,8,5,0,0,34,2,3,13,4,3,1,1037864,"2023-11-30T00:00:00.000Z",3547256,1,"Saddiq Bey",3,17,17,13,4,25.8
"12200",660,1,1,5,0,0,9,6,0,0,23,4,4,12,9,0,2,1037864,"2023-11-30T00:00:00.000Z",83,1,"Clint Capela",1,21,22,13,10,25.3
"12201",661,2,0,3,4,2,21,10,2,2,35,0,1,24,3,5,0,1037864,"2023-11-30T00:00:00.000Z",334,1,"Dejounte Murray",5,27,29,26,5,45.6
"12202",662,1,1,1,4,0,14,6,0,0,36,1,1,12,2,2,1,1037861,"2023-11-30T00:00:00.000Z",3547248,5,"Patrick Williams",3,14,15,13,3,23.9
"12203",663,5,1,1,5,3,9,4,0,0,29,0,1,11,1,2,7,1037861,"2023-11-30T00:00:00.000Z",89,5,"Alex Caruso",3,12,17,16,6,21.7
"12204",664,6,0,9,4,2,21,11,6,5,40,1,2,29,10,1,4,1037861,"2023-11-30T00:00:00.000Z",460,5,"Nikola Vucevic",1,39,45,35,16,49
"12205",665,6,0,5,3,1,8,6,2,1,39,1,2,14,6,3,2,1037861,"2023-11-30T00:00:00.000Z",17895983,5,"Ayo Dosunmu",3,20,26,20,12,37.2
"12206",666,7,1,4,11,4,20,7,6,5,45,0,3,23,4,1,3,1037861,"2023-11-30T00:00:00.000Z",666956,5,"Coby White",2,27,34,30,11,41.3
"12207",667,2,1,5,6,2,10,4,0,0,27,3,4,10,8,1,2,1037861,"2023-11-30T00:00:00.000Z",110,5,"Torrey Craig",2,18,20,12,10,26.6
"12208",668,1,0,1,2,1,10,5,0,0,18,1,1,11,2,3,0,1037861,"2023-11-30T00:00:00.000Z",87,5,"Jevon Carter",3,13,14,12,3,23.9
"12209",669,0,0,0,0,0,0,0,0,0,0,0,0,0,0,0,0,1037861,"2023-11-30T00:00:00.000Z",56677874,5,"Onuralp Bitim",0,0,0,0,0,0
"12210",670,0,0,0,0,0,0,0,0,0,0,0,0,0,0,0,0,1037860,"2023-11-30T00:00:00.000Z",330,9,"Monte Morris",0,0,0,0,0,0
"12211",671,0,0,0,0,0,0,0,0,0,0,0,0,0,0,0,0,1037860,"2023-11-30T00:00:00.000Z",42097199,9,"Jared Rhoden",0,0,0,0,0,0
"12212",672,0,0,1,3,0,6,1,2,1,19,0,3,3,1,0,1,1037863,"2023-11-30T00:00:00.000Z",56677835,14,"Jalen Hood-Schifino",0,4,4,3,1,3.2
"12213",673,0,1,2,0,0,1,0,2,2,4,1,0,2,3,0,0,1037863,"2023-11-30T00:00:00.000Z",56677738,14,"Colin Castleton",1,5,5,2,3,8.6
"12214",674,0,0,0,1,0,1,0,2,2,4,1,0,2,1,0,0,1037863,"2023-11-30T00:00:00.000Z",56677867,14,"Alex Fudge",0,3,3,2,1,3.2
"12215",675,0,0,0,0,0,0,0,0,0,4,0,0,0,0,0,0,1037863,"2023-11-30T00:00:00.000Z",56677836,14,"Maxwell Lewis",0,0,0,0,0,0
"12216",676,0,0,0,0,0,0,0,0,0,0,0,0,0,0,0,0,1037661,"2023-11-02T00:00:00.000Z",56677729,9,"Malcolm Cazalon",0,0,0,0,0,0
"12217",677,0,0,0,0,0,0,0,0,0,0,0,0,0,0,0,0,1037661,"2023-11-02T00:00:00.000Z",42097199,9,"Jared Rhoden",0,0,0,0,0,0
"12218",678,1,0,2,6,3,8,5,0,0,23,0,1,13,2,1,0,1037663,"2023-11-02T00:00:00.000Z",359,27,"Cedi Osman",1,15,16,14,3,19.9
"12219",679,10,0,4,4,2,8,3,4,4,28,1,3,12,5,1,1,1037663,"2023-11-02T00:00:00.000Z",3547274,27,"Tre Jones",1,17,27,22,15,35
"12220",680,0,0,0,3,2,4,2,0,0,16,0,0,6,0,1,0,1037663,"2023-11-02T00:00:00.000Z",305,27,"Doug McDermott",1,6,6,6,0,9
"12221",681,0,0,0,0,0,0,0,0,0,0,0,0,0,0,0,0,1037663,"2023-11-02T00:00:00.000Z",38017649,27,"Julian Champagnie",0,0,0,0,0,0
"12222",682,0,0,0,0,0,0,0,0,0,0,0,0,0,0,0,0,1037663,"2023-11-02T00:00:00.000Z",180,27,"Devonte' Graham",0,0,0,0,0,0
"12223",683,0,0,0,0,0,0,0,0,0,0,0,0,0,0,0,0,1037663,"2023-11-02T00:00:00.000Z",17896059,27,"Sandro Mamukelashvili",0,0,0,0,0,0
"12224",684,0,0,0,0,0,0,0,0,0,0,0,0,0,0,0,0,1037663,"2023-11-02T00:00:00.000Z",38017693,27,"Blake Wesley",0,0,0,0,0,0
"12225",685,0,0,0,0,0,0,0,0,0,0,0,0,0,0,0,0,1037663,"2023-11-02T00:00:00.000Z",56677865,27,"Charles Bediako",0,0,0,0,0,0
"12226",686,0,0,0,0,0,0,0,0,0,0,0,0,0,0,0,0,1037663,"2023-11-02T00:00:00.000Z",56677817,27,"Sidy Cissoko",0,0,0,0,0,0
"12227",687,1,2,1,2,1,6,4,1,1,19,0,2,10,1,0,0,1037662,"2023-11-02T00:00:00.000Z",462,22,"Moritz Wagner",2,11,12,11,2,18.7
"12228",688,7,0,7,4,2,10,5,6,6,31,0,3,18,7,2,3,1037662,"2023-11-02T00:00:00.000Z",3547251,22,"Cole Anthony",2,25,32,25,14,39.9
"12229",689,1,3,2,3,0,4,1,1,1,12,1,1,3,3,1,0,1037662,"2023-11-02T00:00:00.000Z",229,22,"Jonathan Isaac",4,6,7,4,4,20.1
"12230",690,1,0,2,0,0,4,4,3,1,16,1,2,9,3,2,1,1037662,"2023-11-02T00:00:00.000Z",56677827,22,"Anthony Black",2,12,13,10,4,19.1
"12231",691,0,0,0,0,0,0,0,0,0,0,0,0,0,0,0,0,1037662,"2023-11-02T00:00:00.000Z",666442,22,"Goga Bitadze",0,0,0,0,0,0
"12232",692,0,0,0,0,0,0,0,0,0,0,0,0,0,0,0,0,1037662,"2023-11-02T00:00:00.000Z",165,22,"Markelle Fultz",0,0,0,0,0,0
"12233",693,0,0,0,0,0,0,0,0,0,0,0,0,0,0,0,0,1037662,"2023-11-02T00:00:00.000Z",38017724,22,"Caleb Houstan",0,0,0,0,0,0
"12234",694,0,0,0,0,0,0,0,0,0,0,0,0,0,0,0,0,1037662,"2023-11-02T00:00:00.000Z",56677839,22,"Jett Howard",0,0,0,0,0,0
"12235",695,0,0,0,0,0,0,0,0,0,0,0,0,0,0,0,0,1037662,"2023-11-02T00:00:00.000Z",666818,22,"Chuma Okeke",0,0,0,0,0,0
"12236",696,0,0,0,0,0,0,0,0,0,0,0,0,0,0,0,0,1037662,"2023-11-02T00:00:00.000Z",38017607,22,"Kevon Harris",0,0,0,0,0,0
"12237",697,0,0,0,0,0,0,0,0,0,0,0,0,0,0,0,0,1037662,"2023-11-02T00:00:00.000Z",17553983,22,"Trevelin Queen",0,0,0,0,0,0
"12238",698,0,0,0,0,0,0,0,0,0,0,0,0,0,0,0,0,1037662,"2023-11-02T00:00:00.000Z",666885,22,"Admiral Schofield",0,0,0,0,0,0
"12239",699,0,0,1,1,0,2,0,0,0,12,0,0,0,1,2,0,1037663,"2023-11-02T00:00:00.000Z",356,24,"Josh Okogie",2,1,1,0,1,7.2
"12240",700,1,2,6,5,3,15,10,9,5,37,0,3,28,6,0,3,1037663,"2023-11-02T00:00:00.000Z",140,24,"Kevin Durant",2,34,35,29,7,39.7
"12241",701,2,0,0,0,0,1,0,2,1,7,0,0,1,0,0,1,1037983,"2023-12-23T00:00:00.000Z",304,12,"T.J. McConnell",0,1,3,3,2,3
"12242",702,0,0,0,0,0,0,0,0,0,0,0,0,0,0,0,0,1037983,"2023-12-23T00:00:00.000Z",69,12,"Bruce Brown",0,0,0,0,0,0
"12243",703,1,0,3,5,2,9,4,0,0,21,0,2,10,3,0,2,1037977,"2023-12-22T00:00:00.000Z",66,11,"Dillon Brooks",0,13,14,11,4,13.1
"12244",704,1,0,6,3,1,13,8,5,4,31,2,0,21,8,0,1,1037977,"2023-12-22T00:00:00.000Z",38017684,11,"Jabari Smith Jr.",0,29,30,22,9,31.1
"12245",705,3,0,13,1,1,12,8,5,5,25,2,2,22,15,0,0,1037977,"2023-12-22T00:00:00.000Z",17896062,11,"Alperen Sengun",0,37,40,25,18,44.5
"12246",706,4,0,5,7,3,14,5,4,4,27,1,2,17,6,2,4,1037977,"2023-12-22T00:00:00.000Z",17895966,11,"Jalen Green",2,23,27,21,10,32.2
"12247",707,4,0,2,5,1,8,3,3,3,26,0,2,10,2,1,0,1037977,"2023-12-22T00:00:00.000Z",458,11,"Fred VanVleet",1,12,16,14,6,21.4
"12248",708,0,0,3,3,1,3,1,0,0,15,0,0,3,3,0,2,1037977,"2023-12-22T00:00:00.000Z",213,11,"Aaron Holiday",0,6,6,3,3,4.6
"12249",709,0,2,1,0,0,2,1,0,0,8,0,0,2,1,0,0,1037977,"2023-12-22T00:00:00.000Z",188,11,"Jeff Green",2,3,3,2,1,9.2
"12250",710,1,0,1,2,1,3,1,0,0,10,1,3,3,2,0,1,1037977,"2023-12-22T00:00:00.000Z",3547281,11,"Nate Hinton",0,5,6,4,3,5.9
"12251",711,2,0,4,0,0,5,0,4,4,26,0,3,4,4,0,1,1037973,"2023-12-21T00:00:00.000Z",56677747,25,"Scoot Henderson",0,8,10,6,6,10.8
"12252",712,2,3,2,2,0,3,0,0,0,30,2,2,0,4,3,0,1037973,"2023-12-21T00:00:00.000Z",666923,25,"Matisse Thybulle",6,4,6,2,6,25.8
"12253",713,0,1,4,1,1,7,4,1,1,10,1,4,10,5,0,1,1037973,"2023-12-21T00:00:00.000Z",56783340,25,"Duop Reath",1,15,15,10,5,18
"12254",714,3,1,7,2,1,6,3,2,1,23,4,3,8,11,1,2,1037973,"2023-12-21T00:00:00.000Z",38017711,25,"Jabari Walker",2,19,22,11,14,29.7
"12255",715,0,0,0,0,0,0,0,0,0,0,0,0,0,0,0,0,1037973,"2023-12-21T00:00:00.000Z",3547289,25,"Skylar Mays",0,0,0,0,0,0
"12256",716,0,0,0,0,0,0,0,0,0,0,0,0,0,0,0,0,1037973,"2023-12-21T00:00:00.000Z",56677791,25,"Kris Murray",0,0,0,0,0,0
"12257",717,0,0,0,0,0,0,0,0,0,0,0,0,0,0,0,0,1037973,"2023-12-21T00:00:00.000Z",17896120,25,"Ish Wainright",0,0,0,0,0,0
"12258",718,0,0,0,0,0,0,0,0,0,0,0,0,0,0,0,0,1037973,"2023-12-21T00:00:00.000Z",39613724,25,"Ibou Badji",0,0,0,0,0,0
"12259",719,0,0,0,0,0,0,0,0,0,0,0,0,0,0,0,0,1037973,"2023-12-21T00:00:00.000Z",47957121,25,"Justin Minaya",0,0,0,0,0,0
"12260",720,0,0,0,0,0,0,0,0,0,0,0,0,0,0,0,0,1037973,"2023-12-21T00:00:00.000Z",56677829,25,"Rayan Rupert",0,0,0,0,0,0
"12261",721,0,0,0,0,0,0,0,0,0,0,0,0,0,0,0,0,1037973,"2023-12-21T00:00:00.000Z",38017690,25,"Shaedon Sharpe",0,0,0,0,0,0
"12262",722,0,0,0,0,0,0,0,0,0,0,0,0,0,0,0,0,1037973,"2023-12-21T00:00:00.000Z",476,25,"Robert Williams III",0,0,0,0,0,0
"12263",723,6,0,9,1,0,7,4,7,5,35,2,1,13,11,1,2,1037973,"2023-12-21T00:00:00.000Z",3547242,30,"Deni Avdija",1,24,30,19,17,36.2
"12264",724,6,0,6,7,3,22,11,10,7,37,2,0,32,8,1,3,1037973,"2023-12-21T00:00:00.000Z",265,30,"Kyle Kuzma",1,40,46,38,14,50.6
"12265",725,0,6,5,0,0,10,7,3,2,31,3,6,16,8,4,1,1037973,"2023-12-21T00:00:00.000Z",666577,30,"Daniel Gafford",10,24,24,16,8,54.6
"12266",726,0,0,0,0,0,0,0,0,0,0,0,0,0,0,0,0,1037781,"2023-11-19T00:00:00.000Z",273,26,"Alex Len",0,0,0,0,0,0
"12267",727,0,0,0,0,0,0,0,0,0,0,0,0,0,0,0,0,1037783,"2023-11-19T00:00:00.000Z",666451,24,"Bol Bol",0,0,0,0,0,0
"12268",728,0,1,8,5,3,14,5,2,2,43,4,2,15,12,2,1,1037783,"2023-11-19T00:00:00.000Z",101,29,"John Collins",3,27,27,15,12,37.4
"12269",729,5,0,4,6,1,23,8,7,5,39,3,5,22,7,2,2,1037783,"2023-11-19T00:00:00.000Z",100,29,"Jordan Clarkson",2,29,34,27,12,41.9
"12270",730,11,0,3,5,0,12,2,4,3,34,2,2,7,5,1,5,1037783,"2023-11-19T00:00:00.000Z",56677834,29,"Keyonte George",1,12,23,18,16,27.5
"12271",731,5,0,2,2,0,4,1,4,4,20,3,6,6,5,0,4,1037783,"2023-11-19T00:00:00.000Z",358,29,"Kelly Olynyk",0,11,16,11,10,15.5
"12272",732,3,0,2,10,4,18,9,3,3,29,2,4,25,4,2,1,1037783,"2023-11-19T00:00:00.000Z",666650,29,"Talen Horton-Tucker",2,29,32,28,7,39.3
"12273",733,0,1,0,1,1,3,1,0,0,18,1,1,3,1,0,1,1037783,"2023-11-19T00:00:00.000Z",38017739,29,"Simone Fontecchio",1,4,4,3,1,6.2
"12274",734,0,0,0,0,0,0,0,0,0,0,0,0,0,0,0,0,1037783,"2023-11-19T00:00:00.000Z",139,29,"Kris Dunn",0,0,0,0,0,0
"12275",735,0,0,0,0,0,0,0,0,0,0,0,0,0,0,0,0,1037783,"2023-11-19T00:00:00.000Z",56677824,29,"Taylor Hendricks",0,0,0,0,0,0
"12276",736,6,0,2,7,1,11,4,3,3,34,2,1,12,4,1,3,1037781,"2023-11-19T00:00:00.000Z",30,26,"Harrison Barnes",1,16,22,18,10,25.8
"12277",737,4,0,0,7,2,13,7,1,1,32,3,5,17,3,1,1,1037781,"2023-11-19T00:00:00.000Z",38017688,26,"Keegan Murray",1,20,24,21,7,28.6
"12278",738,6,0,10,2,0,15,13,10,6,35,3,2,32,13,0,1,1037781,"2023-11-19T00:00:00.000Z",406,26,"Domantas Sabonis",0,45,51,38,19,55.6
"12279",739,4,0,8,4,3,8,5,0,0,33,0,3,13,8,2,1,1037781,"2023-11-19T00:00:00.000Z",17896030,26,"Chris Duarte",2,21,25,17,12,33.6
"12280",740,7,0,3,10,6,20,10,5,4,31,1,1,30,4,3,0,1037781,"2023-11-19T00:00:00.000Z",161,26,"De'Aaron Fox",3,34,41,37,11,54.3
"12281",741,3,1,2,6,4,9,4,0,0,18,0,2,12,2,1,2,1037781,"2023-11-19T00:00:00.000Z",324,26,"Malik Monk",2,14,17,15,5,22.9
"12282",742,1,1,0,2,1,5,3,0,0,13,1,2,7,1,0,1,1037781,"2023-11-19T00:00:00.000Z",4197162,26,"Aleksandar Vezenkov",1,8,9,8,2,11.7
"12283",743,0,0,3,0,0,0,0,0,0,9,1,1,0,4,0,0,1037781,"2023-11-19T00:00:00.000Z",38017714,26,"Keon Ellis",0,4,4,0,4,4.8
"12284",744,3,0,3,0,0,0,0,0,0,11,0,0,0,3,1,1,1037783,"2023-11-19T00:00:00.000Z",18678058,24,"Jordan Goodwin",1,3,6,3,6,10.1
"12285",745,0,0,0,0,0,0,0,0,0,0,0,0,0,0,0,0,1037783,"2023-11-19T00:00:00.000Z",3547298,24,"Saben Lee",0,0,0,0,0,0
"12286",746,0,0,0,0,0,0,0,0,0,0,0,0,0,0,0,0,1037783,"2023-11-19T00:00:00.000Z",314,24,"Chimezie Metu",0,0,0,0,0,0
"12287",747,0,0,0,0,0,0,0,0,0,0,0,0,0,0,0,0,1037783,"2023-11-19T00:00:00.000Z",37,24,"Bradley Beal",0,0,0,0,0,0
"12288",748,0,0,0,0,0,0,0,0,0,0,0,0,0,0,0,0,1037783,"2023-11-19T00:00:00.000Z",272,24,"Damion Lee",0,0,0,0,0,0
"12289",749,0,0,0,0,0,0,0,0,0,0,0,0,0,0,0,0,1037783,"2023-11-19T00:00:00.000Z",470,24,"Yuta Watanabe",0,0,0,0,0,0
"12290",750,2,0,2,6,3,13,6,3,3,23,3,0,18,5,1,2,1037783,"2023-11-19T00:00:00.000Z",413,29,"Collin Sexton",1,23,25,20,7,28
"12291",751,5,0,0,6,2,14,8,2,2,34,0,4,20,0,0,6,1038103,"2024-01-08T00:00:00.000Z",57,24,"Devin Booker",0,20,25,25,5,21.5
"12292",752,1,1,1,0,0,3,1,0,0,7,1,1,2,2,0,1,1038078,"2024-01-05T00:00:00.000Z",17896022,13,"Brandon Boston Jr.",1,4,5,3,3,7.9
"12293",753,0,0,0,1,0,1,0,0,0,6,0,0,0,0,0,0,1038078,"2024-01-05T00:00:00.000Z",56677849,13,"Kobe Brown",0,0,0,0,0,0
"12294",754,1,0,5,2,0,9,2,3,2,20,1,3,6,6,3,2,1038077,"2024-01-05T00:00:00.000Z",56677825,11,"Amen Thompson",3,12,13,7,7,21.7
"12295",755,2,0,2,1,1,3,2,0,0,19,0,0,5,2,0,0,1038077,"2024-01-05T00:00:00.000Z",213,11,"Aaron Holiday",0,7,9,7,4,10.4
"12296",756,0,0,2,4,1,10,4,2,2,15,0,1,11,2,2,4,1038077,"2024-01-05T00:00:00.000Z",56677831,11,"Cam Whitmore",2,13,13,11,2,15.4
"12297",757,0,1,0,1,0,1,0,0,0,5,0,0,0,0,0,0,1038077,"2024-01-05T00:00:00.000Z",19465326,11,"Jock Landale",1,0,0,0,0,3
"12298",758,0,0,1,0,0,3,1,0,0,4,2,0,2,3,0,0,1038077,"2024-01-05T00:00:00.000Z",296,11,"Boban Marjanovic",0,5,5,2,3,5.6
"12299",759,0,0,0,0,0,0,0,0,0,0,0,0,0,0,0,0,1038077,"2024-01-05T00:00:00.000Z",66,11,"Dillon Brooks",0,0,0,0,0,0
"12300",760,0,0,0,0,0,0,0,0,0,0,0,0,0,0,0,0,1038077,"2024-01-05T00:00:00.000Z",17895968,18,"Daishen Nix",0,0,0,0,0,0
"12301",761,0,0,0,0,0,0,0,0,0,0,0,0,0,0,0,0,1038075,"2024-01-05T00:00:00.000Z",666474,20,"Charles Brown",0,0,0,0,0,0
"12302",762,0,0,0,0,0,0,0,0,0,0,0,0,0,0,0,0,1038075,"2024-01-05T00:00:00.000Z",399,20,"Mitchell Robinson",0,0,0,0,0,0
"12303",763,2,0,3,2,1,6,3,0,0,19,3,0,7,6,1,0,1038078,"2024-01-05T00:00:00.000Z",340,19,"Larry Nance Jr.",1,13,15,9,8,20.2
"12304",764,1,1,2,6,1,9,1,0,0,17,0,0,3,2,0,0,1038078,"2024-01-05T00:00:00.000Z",18677986,19,"Trey Murphy III",1,5,6,4,3,9.9
"12305",765,2,0,2,1,0,1,0,2,1,7,1,3,1,3,0,0,1038078,"2024-01-05T00:00:00.000Z",491,19,"Cody Zeller",0,4,6,3,5,7.6
"12306",766,0,0,0,0,0,0,0,0,0,0,0,0,0,0,0,0,1038078,"2024-01-05T00:00:00.000Z",17896021,19,"Jeremiah Robinson-Earl",0,0,0,0,0,0
"12307",767,0,0,0,0,0,0,0,0,0,0,0,0,0,0,0,0,1038078,"2024-01-05T00:00:00.000Z",3547260,19,"Kira Lewis Jr.",0,0,0,0,0,0
"12308",768,0,0,0,0,0,0,0,0,0,0,0,0,0,0,0,0,1038078,"2024-01-05T00:00:00.000Z",38017663,19,"E.J. Liddell",0,0,0,0,0,0
"12309",769,0,0,0,0,0,0,0,0,0,0,0,0,0,0,0,0,1038078,"2024-01-05T00:00:00.000Z",17896017,19,"Matt Ryan",0,0,0,0,0,0
"12310",770,0,0,0,0,0,0,0,0,0,0,0,0,0,0,0,0,1038078,"2024-01-05T00:00:00.000Z",38017726,19,"Dereon Seabron",0,0,0,0,0,0
"12311",771,1,1,7,10,6,15,9,0,0,30,0,2,24,7,0,2,1038078,"2024-01-05T00:00:00.000Z",172,13,"Paul George",1,31,32,25,8,34.9
"12312",772,0,0,0,0,0,0,0,0,0,0,0,0,0,0,0,0,1038103,"2024-01-08T00:00:00.000Z",38017725,13,"Moussa Diabate",0,0,0,0,0,0
"12313",773,0,0,0,0,0,0,0,0,0,0,0,0,0,0,0,0,1038103,"2024-01-08T00:00:00.000Z",56677856,13,"Jordan Miller",0,0,0,0,0,0
"12314",774,0,0,0,0,0,3,2,0,0,5,0,0,4,0,0,0,1038103,"2024-01-08T00:00:00.000Z",18678058,24,"Jordan Goodwin",0,4,4,4,0,4
"12315",775,0,0,0,2,0,2,0,2,1,5,0,1,1,0,0,0,1038103,"2024-01-08T00:00:00.000Z",470,24,"Yuta Watanabe",0,1,1,1,0,1
"12316",776,0,0,0,0,0,0,0,0,0,0,0,0,0,0,0,0,7050286,"2023-12-08T00:00:00.000Z",38017734,16,"Jamal Cain",0,0,0,0,0,0
"12317",777,0,0,0,0,0,0,0,0,0,0,0,0,0,0,0,0,7050286,"2023-12-08T00:00:00.000Z",38017696,16,"Nikola Jovic",0,0,0,0,0,0
"12318",778,0,0,3,4,1,11,6,0,0,25,0,0,13,3,0,0,7050287,"2023-12-08T00:00:00.000Z",38017729,15,"David Roddy",0,16,16,13,3,16.6
"12319",779,1,1,1,4,3,14,7,4,4,29,1,5,21,2,1,2,7050287,"2023-12-08T00:00:00.000Z",231,15,"Jaren Jackson Jr.",2,23,24,22,3,28.9
"12320",780,2,0,3,0,0,2,1,0,0,20,0,4,2,3,0,0,7050287,"2023-12-08T00:00:00.000Z",48,15,"Bismack Biyombo",0,5,7,4,5,8.6
"12321",781,1,1,2,6,4,13,6,0,0,37,0,5,16,2,0,4,7050287,"2023-12-08T00:00:00.000Z",3547287,15,"Desmond Bane",1,18,19,17,3,18.9
"12322",782,7,0,1,1,0,7,2,2,2,22,0,1,6,1,0,1,7050287,"2023-12-08T00:00:00.000Z",401,15,"Derrick Rose",0,7,14,13,8,16.7
"12323",783,6,1,6,3,1,8,2,6,4,24,4,1,9,10,0,0,7050287,"2023-12-08T00:00:00.000Z",17896067,15,"Santi Aldama",1,19,25,15,16,33
"12324",784,2,0,0,4,2,6,3,0,0,20,0,4,8,0,0,1,7050287,"2023-12-08T00:00:00.000Z",666809,15,"Jaylen Nowell",0,8,10,10,2,10
"12325",785,1,0,0,8,3,10,4,6,6,25,0,2,17,0,0,0,7981426,"2023-12-08T00:00:00.000Z",3547269,20,"Immanuel Quickley",0,17,18,18,1,18.5
"12326",786,4,2,12,0,0,4,2,2,1,29,4,4,5,16,0,1,7981426,"2023-12-08T00:00:00.000Z",201,20,"Isaiah Hartenstein",2,21,25,9,20,35.2
"12327",787,2,0,1,7,3,10,5,0,0,19,0,1,13,1,0,2,7981426,"2023-12-08T00:00:00.000Z",17895858,20,"Quentin Grimes",0,14,16,15,3,15.2
"12328",788,0,0,0,0,0,0,0,0,0,0,0,0,0,0,0,0,7981426,"2023-12-08T00:00:00.000Z",160,20,"Evan Fournier",0,0,0,0,0,0
"12329",789,0,0,0,0,0,0,0,0,0,0,0,0,0,0,0,0,7981426,"2023-12-08T00:00:00.000Z",666675,20,"DaQuan Jeffries",0,0,0,0,0,0
"12330",790,0,0,0,0,0,0,0,0,0,0,0,0,0,0,0,0,7981426,"2023-12-08T00:00:00.000Z",17896033,20,"Miles McBride",0,0,0,0,0,0
"12331",791,0,1,3,4,1,5,1,0,0,17,0,1,3,3,1,0,7050287,"2023-12-08T00:00:00.000Z",666703,15,"John Konchar",2,6,6,3,3,12.6
"12332",792,0,0,0,2,1,8,5,3,1,17,2,1,12,2,4,0,7050287,"2023-12-08T00:00:00.000Z",3547285,15,"Xavier Tillman",4,14,14,12,2,26.4
"12333",793,2,0,0,1,0,1,0,0,0,4,0,0,0,0,0,0,7050287,"2023-12-08T00:00:00.000Z",48248287,15,"Jacob Gilyard",0,0,2,2,2,3
"12334",794,2,0,0,2,1,3,1,2,2,4,0,0,5,0,1,0,7050287,"2023-12-08T00:00:00.000Z",38017732,15,"Kenneth Lofton Jr.",1,5,7,7,2,11
"12335",795,1,0,1,3,0,5,0,0,0,12,0,2,0,1,0,0,7050283,"2023-12-08T00:00:00.000Z",17896071,9,"Isaiah Livers",0,1,2,1,2,2.7
"12336",796,1,0,0,1,0,3,2,0,0,5,0,0,4,0,0,0,7050283,"2023-12-08T00:00:00.000Z",56677792,9,"Marcus Sasser",0,4,5,5,1,5.5
"12337",797,0,0,0,0,0,0,0,0,0,0,0,0,0,0,0,0,7050283,"2023-12-08T00:00:00.000Z",56677729,9,"Malcolm Cazalon",0,0,0,0,0,0
"12338",798,0,0,0,0,0,0,0,0,0,0,0,0,0,0,0,0,7050283,"2023-12-08T00:00:00.000Z",38017694,9,"Jalen Duren",0,0,0,0,0,0
"12339",799,0,0,0,0,0,0,0,0,0,0,0,0,0,0,0,0,7050283,"2023-12-08T00:00:00.000Z",330,9,"Monte Morris",0,0,0,0,0,0
"12340",800,0,0,0,0,0,0,0,0,0,0,0,0,0,0,0,0,7050283,"2023-12-08T00:00:00.000Z",42097199,9,"Jared Rhoden",0,0,0,0,0,0
"12341",801,0,0,0,0,0,0,0,0,0,0,0,0,0,0,0,0,1037685,"2023-11-06T00:00:00.000Z",56677794,12,"Isaiah Wong",0,0,0,0,0,0
"12342",802,4,1,4,5,4,20,12,1,0,30,2,2,28,6,0,2,1037687,"2023-11-06T00:00:00.000Z",265,30,"Kyle Kuzma",1,34,38,32,10,42.2
"12343",803,3,5,4,0,0,7,6,0,0,30,3,5,12,7,0,4,1037687,"2023-11-06T00:00:00.000Z",666577,30,"Daniel Gafford",5,19,22,15,10,35.9
"12344",804,6,1,1,9,4,15,8,3,3,31,0,4,23,1,0,2,1037687,"2023-11-06T00:00:00.000Z",666848,30,"Jordan Poole",1,24,30,29,7,34.2
"12345",805,1,0,1,0,0,8,2,0,0,14,2,0,4,3,0,0,1037687,"2023-11-06T00:00:00.000Z",38017687,30,"Johnny Davis",0,7,8,5,4,9.1
"12346",806,2,0,2,2,0,8,4,2,2,22,1,2,10,3,1,1,1037685,"2023-11-06T00:00:00.000Z",38017686,12,"Bennedict Mathurin",1,13,15,12,5,18.6
"12347",807,2,0,3,4,1,10,6,3,3,38,4,2,16,7,4,1,1037684,"2023-11-06T00:00:00.000Z",56677826,9,"Ausar Thompson",4,23,25,18,9,38.4
"12348",808,4,1,9,5,3,9,5,4,4,39,2,3,17,11,0,3,1037684,"2023-11-06T00:00:00.000Z",3547267,9,"Isaiah Stewart",1,28,32,21,15,36.2
"12349",809,1,0,2,0,0,8,4,2,2,24,0,1,10,2,0,1,1037684,"2023-11-06T00:00:00.000Z",24,9,"Marvin Bagley III",0,12,13,11,3,12.9
"12350",810,5,0,4,6,1,18,7,7,6,40,0,2,21,4,2,5,1037684,"2023-11-06T00:00:00.000Z",17896075,9,"Cade Cunningham",2,25,30,26,9,34.3
"12351",811,7,1,4,4,3,12,8,2,2,34,0,3,21,4,1,0,1037684,"2023-11-06T00:00:00.000Z",3547241,9,"Killian Hayes",2,25,32,28,11,42.3
"12352",812,0,0,0,0,0,0,0,0,0,0,0,0,0,0,0,0,1037684,"2023-11-06T00:00:00.000Z",56677729,9,"Malcolm Cazalon",0,0,0,0,0,0
"12353",813,0,0,0,0,0,0,0,0,0,0,0,0,0,0,0,0,1037684,"2023-11-06T00:00:00.000Z",38017694,9,"Jalen Duren",0,0,0,0,0,0
"12354",814,0,0,0,0,0,0,0,0,0,0,0,0,0,0,0,0,1037684,"2023-11-06T00:00:00.000Z",197,9,"Joe Harris",0,0,0,0,0,0
"12355",815,0,0,1,2,1,2,1,0,0,14,0,1,3,1,0,0,1037686,"2023-11-06T00:00:00.000Z",38017724,22,"Caleb Houstan",0,4,4,3,1,4.2
"12356",816,0,0,0,0,0,0,0,0,0,0,0,0,0,0,0,0,1037686,"2023-11-06T00:00:00.000Z",56677839,22,"Jett Howard",0,0,0,0,0,0
"12357",817,0,0,0,0,0,0,0,0,0,0,0,0,0,0,0,0,1037686,"2023-11-06T00:00:00.000Z",666818,22,"Chuma Okeke",0,0,0,0,0,0
"12358",818,0,0,0,0,0,0,0,0,0,0,0,0,0,0,0,0,1037686,"2023-11-06T00:00:00.000Z",666885,22,"Admiral Schofield",0,0,0,0,0,0
"12359",819,0,0,0,1,0,4,0,4,2,12,1,1,2,1,1,1,1037687,"2023-11-06T00:00:00.000Z",17896025,23,"Jaden Springer",1,3,3,2,1,5.2
"12360",820,2,0,4,0,0,3,3,0,0,13,2,1,6,6,1,1,1037687,"2023-11-06T00:00:00.000Z",3547270,23,"Paul Reed",1,12,14,8,8,18.2
"12361",821,0,1,1,0,0,2,1,1,1,6,0,0,3,1,0,0,1037687,"2023-11-06T00:00:00.000Z",328,23,"Marcus Morris",1,4,4,3,1,7.2
"12362",822,1,0,1,0,0,1,0,0,0,4,0,0,0,1,0,0,1037687,"2023-11-06T00:00:00.000Z",3547294,23,"Kenyon Martin Jr.",0,1,2,1,2,2.7
"12363",823,0,0,1,2,0,2,0,1,1,4,0,0,1,1,0,0,1037687,"2023-11-06T00:00:00.000Z",167,30,"Danilo Gallinari",0,2,2,1,1,2.2
"12364",824,0,2,0,1,0,3,2,2,1,8,1,0,5,1,1,0,1037687,"2023-11-06T00:00:00.000Z",3547302,30,"Anthony Gill",3,6,6,5,1,15.2
"12365",825,4,0,5,4,1,13,5,2,1,33,0,3,12,5,1,1,1037686,"2023-11-06T00:00:00.000Z",17896026,22,"Franz Wagner",1,17,21,16,9,26
"12366",826,0,0,0,0,0,0,0,0,0,0,0,0,0,0,0,0,1038016,"2023-12-28T00:00:00.000Z",491,19,"Cody Zeller",0,0,0,0,0,0
"12367",827,0,0,0,0,0,0,0,0,0,0,0,0,0,0,0,0,1038016,"2023-12-28T00:00:00.000Z",56677837,19,"Jordan Hawkins",0,0,0,0,0,0
"12368",828,0,0,0,0,0,0,0,0,0,0,0,0,0,0,0,0,1038016,"2023-12-28T00:00:00.000Z",38017663,19,"E.J. Liddell",0,0,0,0,0,0
"12369",829,0,0,0,0,0,0,0,0,0,0,0,0,0,0,0,0,1038016,"2023-12-28T00:00:00.000Z",17896017,19,"Matt Ryan",0,0,0,0,0,0
"12370",830,0,0,0,0,0,0,0,0,0,0,0,0,0,0,0,0,1038016,"2023-12-28T00:00:00.000Z",38017726,19,"Dereon Seabron",0,0,0,0,0,0
"12371",831,2,0,7,4,1,7,1,2,2,30,4,3,5,11,0,0,1038017,"2023-12-28T00:00:00.000Z",38017731,15,"Vince Williams Jr.",0,16,18,7,13,21.2
"12372",832,2,0,3,3,1,14,5,4,3,28,1,1,14,4,2,0,1038017,"2023-12-28T00:00:00.000Z",231,15,"Jaren Jackson Jr.",2,18,20,16,6,27.8
"12373",833,1,1,4,0,0,4,1,0,0,22,0,3,2,4,0,2,1038017,"2023-12-28T00:00:00.000Z",48,15,"Bismack Biyombo",1,6,7,3,5,9.3
"12374",834,2,0,1,5,3,13,9,2,2,25,0,3,23,1,1,2,1038017,"2023-12-28T00:00:00.000Z",3547287,15,"Desmond Bane",1,24,26,25,3,28.2
"12375",835,5,0,2,6,2,14,6,4,3,23,1,1,17,3,1,3,1038017,"2023-12-28T00:00:00.000Z",420,15,"Marcus Smart",1,20,25,22,8,28.1
"12376",836,2,0,0,2,1,9,5,8,4,29,0,0,15,0,0,0,1038017,"2023-12-28T00:00:00.000Z",38017729,15,"David Roddy",0,15,17,17,2,18
"12377",837,3,1,4,5,1,8,4,1,1,25,2,1,10,6,2,1,1038017,"2023-12-28T00:00:00.000Z",666703,15,"John Konchar",3,16,19,13,9,29.7
"12378",838,5,0,4,12,3,19,7,7,7,35,6,1,24,10,1,3,1038016,"2023-12-28T00:00:00.000Z",297,29,"Lauri Markkanen",1,34,39,29,15,43.5
"12379",839,0,1,9,3,1,7,3,2,1,26,3,2,8,12,0,1,1038016,"2023-12-28T00:00:00.000Z",101,29,"John Collins",1,20,20,8,12,24.4
"12380",840,0,1,1,1,1,5,5,0,0,29,3,1,11,4,2,1,1038016,"2023-12-28T00:00:00.000Z",38017705,29,"Walker Kessler",3,15,15,11,4,23.8
"12381",841,3,1,0,3,1,5,3,0,0,19,0,2,7,0,0,0,1038016,"2023-12-28T00:00:00.000Z",139,29,"Kris Dunn",1,7,10,10,3,14.5
"12382",842,3,0,4,6,3,17,8,9,7,30,1,4,26,5,0,0,1038016,"2023-12-28T00:00:00.000Z",413,29,"Collin Sexton",0,31,34,29,8,36.5
"12383",843,6,0,2,5,1,11,3,3,3,24,0,0,10,2,0,6,1038016,"2023-12-28T00:00:00.000Z",100,29,"Jordan Clarkson",0,12,18,16,8,15.4
"12384",844,1,1,0,3,2,3,2,0,0,12,0,0,6,0,0,0,1038017,"2023-12-28T00:00:00.000Z",48248287,15,"Jacob Gilyard",1,6,7,7,1,10.5
"12385",845,0,0,0,0,0,0,0,0,0,0,0,0,0,0,0,0,1038017,"2023-12-28T00:00:00.000Z",17896067,15,"Santi Aldama",0,0,0,0,0,0
"12386",846,0,0,0,0,0,0,0,0,0,0,0,0,0,0,0,0,1038017,"2023-12-28T00:00:00.000Z",666786,15,"Ja Morant",0,0,0,0,0,0
"12387",847,0,1,7,0,0,4,2,2,2,30,2,4,6,9,1,1,1038019,"2023-12-28T00:00:00.000Z",38017711,25,"Jabari Walker",2,15,15,6,9,21.8
"12388",848,0,0,0,0,0,0,0,0,0,0,0,0,0,0,0,0,1038019,"2023-12-28T00:00:00.000Z",22,25,"Deandre Ayton",0,0,0,0,0,0
"12389",849,0,0,0,0,0,0,0,0,0,0,0,0,0,0,0,0,1038019,"2023-12-28T00:00:00.000Z",47957121,25,"Justin Minaya",0,0,0,0,0,0
"12390",850,0,0,0,0,0,0,0,0,0,0,0,0,0,0,0,0,1038019,"2023-12-28T00:00:00.000Z",56677791,25,"Kris Murray",0,0,0,0,0,0
"12391",851,0,0,0,0,0,0,0,0,0,0,0,0,0,0,0,0,1037829,"2023-11-26T00:00:00.000Z",666476,25,"Moses Brown",0,0,0,0,0,0
"12392",852,0,0,0,0,0,0,0,0,0,0,0,0,0,0,0,0,1037829,"2023-11-26T00:00:00.000Z",3547289,25,"Skylar Mays",0,0,0,0,0,0
"12393",853,0,0,0,0,0,0,0,0,0,0,0,0,0,0,0,0,1037829,"2023-11-26T00:00:00.000Z",47957121,25,"Justin Minaya",0,0,0,0,0,0
"12394",854,2,0,5,7,1,15,6,2,1,27,2,0,14,7,0,1,1037833,"2023-11-26T00:00:00.000Z",17896067,15,"Santi Aldama",0,21,23,16,9,24.4
"12395",855,3,3,4,6,2,14,4,10,8,37,0,3,18,4,1,2,1037833,"2023-11-26T00:00:00.000Z",231,15,"Jaren Jackson Jr.",4,22,25,21,7,37.3
"12396",856,12,1,6,6,2,23,7,3,2,34,2,4,18,8,2,2,1037829,"2023-11-26T00:00:00.000Z",65,25,"Malcolm Brogdon",3,26,38,30,20,52.6
"12397",857,0,0,3,1,0,3,2,0,0,16,0,4,4,3,0,1,1037829,"2023-11-26T00:00:00.000Z",38017711,25,"Jabari Walker",0,7,7,4,3,6.6
"12398",858,1,1,1,4,1,4,1,2,2,26,0,1,5,1,4,2,1037829,"2023-11-26T00:00:00.000Z",666923,25,"Matisse Thybulle",5,6,7,6,2,20.7
"12399",859,0,0,0,4,1,5,1,0,0,12,0,2,3,0,2,1,1037829,"2023-11-26T00:00:00.000Z",56783340,25,"Duop Reath",2,3,3,3,0,8
"12400",860,0,0,0,0,0,0,0,0,0,0,0,0,0,0,0,0,1037829,"2023-11-26T00:00:00.000Z",56677791,25,"Kris Murray",0,0,0,0,0,0
"12401",861,0,0,0,0,0,0,0,0,0,0,0,0,0,0,0,0,1037829,"2023-11-26T00:00:00.000Z",39613724,25,"Ibou Badji",0,0,0,0,0,0
"12402",862,0,0,0,0,0,0,0,0,0,0,0,0,0,0,0,0,1037829,"2023-11-26T00:00:00.000Z",56677829,25,"Rayan Rupert",0,0,0,0,0,0
"12403",863,0,0,0,0,0,0,0,0,0,0,0,0,0,0,0,0,1037829,"2023-11-26T00:00:00.000Z",419,25,"Anfernee Simons",0,0,0,0,0,0
"12404",864,0,0,0,0,0,0,0,0,0,0,0,0,0,0,0,0,1037829,"2023-11-26T00:00:00.000Z",17896120,25,"Ish Wainright",0,0,0,0,0,0
"12405",865,0,0,0,0,0,0,0,0,0,0,0,0,0,0,0,0,1037829,"2023-11-26T00:00:00.000Z",476,25,"Robert Williams III",0,0,0,0,0,0
"12406",866,3,0,3,0,0,3,2,10,6,30,2,1,10,5,1,1,1037833,"2023-11-26T00:00:00.000Z",48,15,"Bismack Biyombo",1,15,18,13,8,22.5
"12407",867,4,0,1,9,3,16,5,0,0,34,1,3,13,2,0,5,1037833,"2023-11-26T00:00:00.000Z",3547287,15,"Desmond Bane",0,15,19,17,6,16.4
"12408",868,1,0,0,2,0,2,0,0,0,16,0,0,0,0,0,0,1037833,"2023-11-26T00:00:00.000Z",48248287,15,"Jacob Gilyard",0,0,1,1,1,1.5
"12409",869,2,0,2,5,2,9,4,1,1,28,2,2,11,4,0,1,1037833,"2023-11-26T00:00:00.000Z",38017729,15,"David Roddy",0,15,17,13,6,17.8
"12410",870,3,0,4,1,0,4,2,0,0,14,1,1,4,5,0,0,1037833,"2023-11-26T00:00:00.000Z",666809,15,"Jaylen Nowell",0,9,12,7,8,14.5
"12411",871,0,1,1,0,0,2,1,0,0,2,0,0,2,1,0,0,1037833,"2023-11-26T00:00:00.000Z",199,15,"Shaquille Harrison",1,3,3,2,1,6.2
"12412",872,0,0,0,0,0,1,1,0,0,2,0,0,2,0,0,0,1037833,"2023-11-26T00:00:00.000Z",38017732,15,"Kenneth Lofton Jr.",0,2,2,2,0,2
"12413",873,0,0,0,0,0,0,0,0,0,2,0,0,0,0,0,0,1037833,"2023-11-26T00:00:00.000Z",666703,15,"John Konchar",0,0,0,0,0,0
"12414",874,1,1,2,2,0,11,3,4,3,31,0,3,9,2,0,0,1037831,"2023-11-26T00:00:00.000Z",666423,20,"RJ Barrett",1,11,12,10,3,15.9
"12415",875,2,0,2,4,1,21,10,8,7,36,3,2,28,5,0,2,1037831,"2023-11-26T00:00:00.000Z",387,20,"Julius Randle",0,33,35,30,7,35
"12416",876,2,0,2,3,0,7,3,1,1,18,0,1,7,2,1,1,1037605,"2023-10-25T00:00:00.000Z",38017692,27,"Malaki Branham",1,9,11,9,4,14.4
"12417",877,1,1,1,1,0,1,0,0,0,11,0,1,0,1,0,0,1037605,"2023-10-25T00:00:00.000Z",305,27,"Doug McDermott",1,1,2,1,2,5.7
"12418",878,0,0,0,0,0,0,0,0,0,0,0,0,0,0,0,0,1037605,"2023-10-25T00:00:00.000Z",38017730,27,"Dominick Barlow",0,0,0,0,0,0
"12419",879,0,0,0,0,0,0,0,0,0,0,0,0,0,0,0,0,1037605,"2023-10-25T00:00:00.000Z",17554004,7,"AJ Lawson",0,0,0,0,0,0
"12420",880,0,0,0,0,0,3,2,3,2,6,1,0,6,1,0,2,1037606,"2023-10-25T00:00:00.000Z",38017711,25,"Jabari Walker",0,7,7,6,1,5.2
"12421",881,0,0,1,0,0,0,0,0,0,5,0,0,0,1,0,0,1037606,"2023-10-25T00:00:00.000Z",56677791,25,"Kris Murray",0,1,1,0,1,1.2
"12422",882,0,0,0,0,0,0,0,0,0,2,0,0,0,0,0,0,1037606,"2023-10-25T00:00:00.000Z",56677829,25,"Rayan Rupert",0,0,0,0,0,0
"12423",883,4,0,3,3,1,5,2,2,1,16,0,0,6,3,2,2,1037607,"2023-10-26T00:00:00.000Z",315,17,"Khris Middleton",2,9,13,10,7,19.6
"12424",884,3,2,8,3,0,22,10,9,3,35,5,4,23,13,2,7,1037607,"2023-10-26T00:00:00.000Z",15,17,"Giannis Antetokounmpo",4,36,39,26,16,48.1
"12425",885,0,0,1,4,3,7,5,0,0,29,1,4,13,2,0,2,1037607,"2023-10-26T00:00:00.000Z",283,17,"Brook Lopez",0,15,15,13,2,13.4
"12426",886,3,0,4,1,1,4,2,0,0,31,0,1,5,4,2,2,1037607,"2023-10-26T00:00:00.000Z",38,17,"Malik Beasley",2,9,12,8,7,18.3
"12427",887,4,0,8,12,4,20,9,17,17,37,0,2,39,8,0,0,1037607,"2023-10-26T00:00:00.000Z",278,17,"Damian Lillard",0,47,51,43,12,54.6
"12428",888,2,0,4,1,1,4,3,2,2,27,0,3,9,4,2,1,1037607,"2023-10-26T00:00:00.000Z",112,17,"Jae Crowder",2,13,15,11,6,21.8
"12429",889,2,1,2,4,1,6,2,2,2,20,0,0,7,2,0,0,1037607,"2023-10-26T00:00:00.000Z",105,17,"Pat Connaughton",1,9,11,9,4,15.4
"12430",890,0,0,1,1,0,3,2,0,0,17,1,3,4,2,0,0,1037607,"2023-10-26T00:00:00.000Z",38017676,17,"MarJon Beauchamp",0,6,6,4,2,6.4
"12431",891,0,0,0,0,0,0,0,0,0,0,0,0,0,0,0,0,1037607,"2023-10-26T00:00:00.000Z",2148,17,"Thanasis Antetokounmpo",0,0,0,0,0,0
"12432",892,0,0,0,0,0,0,0,0,0,0,0,0,0,0,0,0,1037607,"2023-10-26T00:00:00.000Z",38017733,17,"A.J. Green",0,0,0,0,0,0
"12433",893,2,1,4,0,0,8,5,4,0,19,2,3,10,6,0,0,1037607,"2023-10-26T00:00:00.000Z",377,17,"Bobby Portis",1,16,18,12,8,23.2
"12434",894,0,0,0,1,0,3,1,0,0,9,0,3,2,0,1,0,1037607,"2023-10-26T00:00:00.000Z",368,17,"Cameron Payne",1,2,2,2,0,5
"12435",895,0,0,0,0,0,0,0,0,0,0,0,0,0,0,0,0,1037607,"2023-10-26T00:00:00.000Z",56677852,17,"Andre Jackson Jr.",0,0,0,0,0,0
"12436",896,0,0,0,0,0,0,0,0,0,0,0,0,0,0,0,0,1037607,"2023-10-26T00:00:00.000Z",56677854,17,"Chris Livingston",0,0,0,0,0,0
"12437",897,0,0,0,0,0,0,0,0,0,0,0,0,0,0,0,0,1037607,"2023-10-26T00:00:00.000Z",284,17,"Robin Lopez",0,0,0,0,0,0
"12438",898,0,0,0,0,0,0,0,0,0,0,0,0,0,0,0,0,1037607,"2023-10-26T00:00:00.000Z",666453,17,"Marques Bolden",0,0,0,0,0,0
"12439",899,0,0,0,0,0,0,0,0,0,0,0,0,0,0,0,0,1037607,"2023-10-26T00:00:00.000Z",38017691,17,"TyTy Washington Jr.",0,0,0,0,0,0
"12440",900,0,0,0,0,0,0,0,0,0,0,0,0,0,0,0,0,1037607,"2023-10-26T00:00:00.000Z",666960,17,"Lindell Wigginton",0,0,0,0,0,0
"12441",901,11,0,1,6,2,17,7,3,3,28,1,2,19,2,0,4,1037920,"2023-12-15T00:00:00.000Z",3547245,12,"Tyrese Haliburton",0,21,32,30,13,33.9
"12442",902,2,0,2,1,1,9,4,4,4,22,1,2,13,3,1,2,1037920,"2023-12-15T00:00:00.000Z",38017686,12,"Bennedict Mathurin",1,16,18,15,5,20.6
"12443",903,1,1,7,0,0,13,10,0,0,20,6,5,20,13,0,1,1037920,"2023-12-15T00:00:00.000Z",17896035,12,"Isaiah Jackson",1,33,34,21,14,39.1
"12444",904,1,1,1,8,3,10,4,3,1,24,2,5,12,3,2,0,1037920,"2023-12-15T00:00:00.000Z",3547250,12,"Aaron Nesmith",3,15,16,13,4,26.1
"12445",905,1,0,2,5,1,11,4,2,2,17,1,3,11,3,0,0,1037919,"2023-12-15T00:00:00.000Z",360,23,"Kelly Oubre Jr.",0,14,15,12,4,16.1
"12446",906,0,0,0,0,0,0,0,0,0,0,0,0,0,0,0,0,1037923,"2023-12-15T00:00:00.000Z",3547274,27,"Tre Jones",0,0,0,0,0,0
"12447",907,0,0,0,0,0,0,0,0,0,0,0,0,0,0,0,0,1037918,"2023-12-15T00:00:00.000Z",17896017,19,"Matt Ryan",0,0,0,0,0,0
"12448",908,0,0,0,0,0,0,0,0,0,0,0,0,0,0,0,0,1037918,"2023-12-15T00:00:00.000Z",38017726,19,"Dereon Seabron",0,0,0,0,0,0
"12449",909,1,0,2,5,5,8,5,0,0,15,0,1,15,2,1,1,1037919,"2023-12-15T00:00:00.000Z",328,23,"Marcus Morris",1,17,18,16,3,20.9
"12450",910,1,0,0,0,0,3,2,0,0,7,1,0,4,1,0,0,1037919,"2023-12-15T00:00:00.000Z",3547294,23,"Kenyon Martin Jr.",0,5,6,5,2,6.7
"12451",911,1,0,1,3,1,3,1,0,0,7,0,1,3,1,0,0,1037919,"2023-12-15T00:00:00.000Z",260,23,"Furkan Korkmaz",0,4,5,4,2,5.7
"12452",912,4,1,2,1,1,4,4,4,2,17,0,1,11,2,1,2,1037919,"2023-12-15T00:00:00.000Z",56677792,9,"Marcus Sasser",2,13,17,15,6,23.4
"12453",913,3,1,6,10,5,19,12,7,7,35,0,1,36,6,1,1,1037923,"2023-12-15T00:00:00.000Z",3547246,27,"Devin Vassell",2,42,45,39,9,52.7
"12454",914,6,0,1,8,3,16,6,2,2,31,1,1,17,2,0,2,1037923,"2023-12-15T00:00:00.000Z",666682,27,"Keldon Johnson",0,19,25,23,8,26.4
"12455",915,5,2,12,2,1,13,5,3,2,31,3,3,13,15,2,2,1037923,"2023-12-15T00:00:00.000Z",56677822,27,"Victor Wembanyama",4,28,33,18,20,48.5
"12456",916,8,1,4,3,2,8,5,0,0,32,0,3,12,4,1,0,1037923,"2023-12-15T00:00:00.000Z",38017692,27,"Malaki Branham",2,16,24,20,12,34.8
"12457",917,2,1,7,3,0,10,5,1,1,27,1,3,11,8,1,1,1037923,"2023-12-15T00:00:00.000Z",38017699,27,"Jeremy Sochan",2,19,21,13,10,28.6
"12458",918,6,0,2,6,3,11,6,0,0,25,0,2,15,2,0,0,1037923,"2023-12-15T00:00:00.000Z",359,27,"Cedi Osman",0,17,23,21,8,26.4
"12459",919,1,0,2,2,1,9,5,6,5,19,4,4,16,6,0,1,1037923,"2023-12-15T00:00:00.000Z",102,27,"Zach Collins",0,22,23,17,7,23.7
"12460",920,0,0,0,2,0,2,0,0,0,9,0,1,0,0,0,0,1037923,"2023-12-15T00:00:00.000Z",38017649,27,"Julian Champagnie",0,0,0,0,0,0
"12461",921,3,0,1,1,0,2,0,0,0,10,0,0,0,1,0,0,1037923,"2023-12-15T00:00:00.000Z",180,27,"Devonte' Graham",0,1,4,3,4,5.7
"12462",922,1,1,4,2,2,4,3,4,3,19,0,4,11,4,0,2,1037922,"2023-12-15T00:00:00.000Z",3547275,28,"Malachi Flynn",1,15,16,12,5,18.3
"12463",923,3,0,2,5,2,8,3,0,0,20,0,1,8,2,0,1,1037922,"2023-12-15T00:00:00.000Z",3089,28,"Gary Trent Jr.",0,10,13,11,5,13.9
"12464",924,0,0,0,3,1,3,1,0,0,3,0,0,3,0,0,0,1037922,"2023-12-15T00:00:00.000Z",56677828,28,"Gradey Dick",0,3,3,3,0,3
"12465",925,0,0,0,2,0,3,0,0,0,3,0,0,0,0,0,0,1037922,"2023-12-15T00:00:00.000Z",666762,28,"Jalen McDaniels",0,0,0,0,0,0
"12466",926,1,0,1,10,5,10,5,0,0,25,1,1,15,2,0,0,3277399,"2023-11-10T00:00:00.000Z",17896060,2,"Sam Hauser",0,17,18,16,3,18.9
"12467",927,1,1,3,0,0,5,3,1,1,18,6,1,7,9,0,0,3277399,"2023-11-10T00:00:00.000Z",261,2,"Luke Kornet",1,16,17,8,10,22.3
"12468",928,4,0,4,1,0,5,2,0,0,16,1,1,4,5,1,2,3277398,"2023-11-10T00:00:00.000Z",3547253,4,"Theo Maledon",1,9,13,8,9,17
"12469",929,0,1,4,0,0,5,5,8,5,18,2,4,15,6,0,1,3277398,"2023-11-10T00:00:00.000Z",3547282,4,"Nick Richards",1,21,21,15,6,24.2
"12470",930,1,0,2,1,0,2,1,0,0,13,1,3,2,3,0,1,3277398,"2023-11-10T00:00:00.000Z",38017708,4,"Bryce McGowens",0,5,6,3,4,6.1
"12471",931,0,0,0,0,0,0,0,0,0,0,0,0,0,0,0,0,3277398,"2023-11-10T00:00:00.000Z",56677866,4,"Leaky Black",0,0,0,0,0,0
"12472",932,0,0,0,0,0,0,0,0,0,0,0,0,0,0,0,0,3277398,"2023-11-10T00:00:00.000Z",422,4,"Ish Smith",0,0,0,0,0,0
"12473",933,0,0,0,0,0,0,0,0,0,0,0,0,0,0,0,0,3277398,"2023-11-10T00:00:00.000Z",403,4,"Terry Rozier",0,0,0,0,0,0
"12474",934,10,1,6,7,2,19,9,9,9,39,0,3,29,6,4,0,3277397,"2023-11-10T00:00:00.000Z",3547254,23,"Tyrese Maxey",5,35,45,39,16,66.2
"12475",935,1,0,0,0,0,1,0,0,0,5,0,0,0,0,0,0,3277397,"2023-11-10T00:00:00.000Z",45,23,"Patrick Beverley",0,0,1,1,1,1.5
"12476",936,3,0,2,2,1,2,1,0,0,27,1,4,3,3,1,0,3277397,"2023-11-10T00:00:00.000Z",33,23,"Nicolas Batum",1,6,9,6,6,14.1
"12477",937,0,0,0,3,1,3,1,0,0,14,0,0,3,0,4,0,3277397,"2023-11-10T00:00:00.000Z",108,23,"Robert Covington",4,3,3,3,0,15
"12478",938,0,0,1,0,0,0,0,0,0,6,0,2,0,1,0,0,3277397,"2023-11-10T00:00:00.000Z",328,23,"Marcus Morris",0,1,1,0,1,1.2
"12479",939,0,0,4,0,0,2,1,0,0,12,0,3,2,4,0,0,3277397,"2023-11-10T00:00:00.000Z",3547270,23,"Paul Reed",0,6,6,2,4,6.8
"12480",940,0,0,0,0,0,0,0,0,0,0,0,0,0,0,0,0,3277397,"2023-11-10T00:00:00.000Z",28,23,"Mo Bamba",0,0,0,0,0,0
"12481",941,0,0,0,0,0,0,0,0,0,0,0,0,0,0,0,0,3277397,"2023-11-10T00:00:00.000Z",2175,23,"Danuel House Jr.",0,0,0,0,0,0
"12482",942,5,0,6,8,2,19,7,11,9,38,3,4,25,9,0,3,1037736,"2023-11-13T00:00:00.000Z",387,20,"Julius Randle",0,34,39,30,14,40.3
"12483",943,1,2,3,0,0,2,2,2,0,33,3,2,4,6,1,1,1037736,"2023-11-13T00:00:00.000Z",399,20,"Mitchell Robinson",3,10,11,5,7,20.7
"12484",944,1,0,0,6,4,6,4,0,0,28,0,2,12,0,0,0,1037736,"2023-11-13T00:00:00.000Z",17895858,20,"Quentin Grimes",0,12,13,13,1,13.5
"12485",945,4,0,3,7,3,21,10,5,3,39,0,0,26,3,1,2,1037736,"2023-11-13T00:00:00.000Z",73,20,"Jalen Brunson",1,29,33,30,7,36.6
"12486",946,1,0,6,2,1,10,1,4,4,26,0,3,7,6,1,0,1037736,"2023-11-13T00:00:00.000Z",3547269,20,"Immanuel Quickley",1,13,14,8,7,18.7
"12487",947,1,0,0,4,1,6,2,0,0,16,1,1,5,1,0,0,1037736,"2023-11-13T00:00:00.000Z",131,20,"Donte DiVincenzo",0,6,7,6,2,7.7
"12488",948,1,0,0,1,1,2,1,0,0,15,3,0,3,3,1,0,1037736,"2023-11-13T00:00:00.000Z",201,20,"Isaiah Hartenstein",1,6,7,4,4,11.1
"12489",949,0,0,0,0,0,0,0,0,0,0,0,0,0,0,0,0,1037736,"2023-11-13T00:00:00.000Z",19,20,"Ryan Arcidiacono",0,0,0,0,0,0
"12490",950,2,1,8,6,3,10,7,2,2,25,2,3,19,10,0,0,1037738,"2023-11-13T00:00:00.000Z",377,17,"Bobby Portis",1,29,31,21,12,37
"12491",951,1,1,0,3,0,7,1,2,1,15,1,1,3,1,1,0,1038075,"2024-01-05T00:00:00.000Z",17896025,23,"Jaden Springer",2,4,5,4,2,11.7
"12492",952,0,0,1,0,0,5,3,0,0,12,0,2,6,1,0,0,1038075,"2024-01-05T00:00:00.000Z",3547270,23,"Paul Reed",0,7,7,6,1,7.2
"12493",953,0,0,0,0,0,0,0,0,0,7,0,2,0,0,0,0,1038075,"2024-01-05T00:00:00.000Z",3547294,23,"Kenyon Martin Jr.",0,0,0,0,0,0
"12494",954,0,0,0,0,0,0,0,0,0,0,0,0,0,0,0,0,1038075,"2024-01-05T00:00:00.000Z",56913527,23,"Ricky Council IV",0,0,0,0,0,0
"12495",955,0,0,0,0,0,0,0,0,0,0,0,0,0,0,0,0,1038075,"2024-01-05T00:00:00.000Z",108,23,"Robert Covington",0,0,0,0,0,0
"12496",956,0,0,0,0,0,0,0,0,0,0,0,0,0,0,0,0,1038075,"2024-01-05T00:00:00.000Z",260,23,"Furkan Korkmaz",0,0,0,0,0,0
"12497",957,0,0,0,0,0,0,0,0,0,0,0,0,0,0,0,0,1038075,"2024-01-05T00:00:00.000Z",38017732,23,"Kenneth Lofton Jr.",0,0,0,0,0,0
"12498",958,0,0,0,0,0,0,0,0,0,0,0,0,0,0,0,0,1038075,"2024-01-05T00:00:00.000Z",313,23,"De'Anthony Melton",0,0,0,0,0,0
"12499",959,0,0,0,0,0,0,0,0,0,0,0,0,0,0,0,0,1038075,"2024-01-05T00:00:00.000Z",56677788,23,"Terquavion Smith",0,0,0,0,0,0
"12500",960,0,0,1,3,1,11,3,4,4,37,1,3,11,2,1,0,1038075,"2024-01-05T00:00:00.000Z",18,20,"OG Anunoby",1,13,13,11,2,16.4
"12501",961,5,1,7,3,0,11,1,6,6,30,0,3,8,7,1,4,1038075,"2024-01-05T00:00:00.000Z",387,20,"Julius Randle",2,15,20,13,12,25.9
"12502",962,5,2,5,0,0,9,8,2,1,35,1,4,17,6,2,1,1038075,"2024-01-05T00:00:00.000Z",201,20,"Isaiah Hartenstein",4,23,28,22,11,42.7
"12503",963,3,0,1,6,4,6,4,2,2,17,1,4,14,2,1,2,1038075,"2024-01-05T00:00:00.000Z",131,20,"Donte DiVincenzo",1,16,19,17,5,21.9
"12504",964,2,1,3,9,4,20,11,3,3,32,0,1,29,3,1,0,1038075,"2024-01-05T00:00:00.000Z",73,20,"Jalen Brunson",2,32,34,31,5,41.6
"12505",965,11,0,4,2,1,7,3,4,4,27,0,0,11,4,2,2,1038074,"2024-01-05T00:00:00.000Z",277,6,"Caris LeVert",2,15,26,22,15,36.3
"12506",966,2,0,2,9,3,12,4,0,0,26,0,2,11,2,1,0,1038074,"2024-01-05T00:00:00.000Z",3547299,6,"Sam Merrill",1,13,15,13,4,19.4
"12507",967,1,0,9,8,4,9,5,0,0,25,0,2,14,9,0,1,1038074,"2024-01-05T00:00:00.000Z",344,6,"Georges Niang",0,23,24,15,10,25.3
"12508",968,2,0,2,0,0,5,4,2,0,17,2,6,8,4,0,2,1038074,"2024-01-05T00:00:00.000Z",444,6,"Tristan Thompson",0,12,14,10,6,13.8
"12509",969,4,0,3,0,0,6,3,1,1,12,1,2,7,4,1,5,1038074,"2024-01-05T00:00:00.000Z",56677872,6,"Craig Porter",1,11,15,11,8,15.8
"12510",970,1,1,0,2,0,4,0,2,2,23,0,4,2,0,0,0,1038074,"2024-01-05T00:00:00.000Z",666848,30,"Jordan Poole",1,2,3,3,1,6.5
"12511",971,5,0,1,6,4,10,6,0,0,26,0,0,16,1,2,1,1038074,"2024-01-05T00:00:00.000Z",249,30,"Tyus Jones",2,17,22,21,6,29.7
"12512",972,1,3,5,4,2,13,6,3,1,36,2,0,15,7,1,1,1038074,"2024-01-05T00:00:00.000Z",56677844,30,"Bilal Coulibaly",4,22,23,16,8,35.9
"12513",973,1,1,1,6,1,12,6,0,0,20,0,2,13,1,0,2,1038074,"2024-01-05T00:00:00.000Z",17896045,30,"Corey Kispert",1,14,15,14,2,16.7
"12514",974,0,0,5,2,0,3,0,0,0,18,1,2,0,6,0,1,1038074,"2024-01-05T00:00:00.000Z",337,30,"Mike Muscala",0,6,6,0,6,6.2
"12515",975,2,0,2,3,1,6,3,0,0,17,0,0,7,2,5,1,1038074,"2024-01-05T00:00:00.000Z",487,30,"Delon Wright",5,9,11,9,4,26.4
"12516",976,0,0,0,0,0,0,0,0,0,0,0,0,0,0,0,0,7050283,"2023-12-08T00:00:00.000Z",17553983,22,"Trevelin Queen",0,0,0,0,0,0
"12517",977,2,0,1,5,0,12,2,2,1,20,1,3,5,2,1,0,7050283,"2023-12-08T00:00:00.000Z",56677826,9,"Ausar Thompson",1,7,9,7,4,13.4
"12518",978,0,0,3,0,0,0,0,4,2,16,2,2,2,5,0,1,7050283,"2023-12-08T00:00:00.000Z",3547240,9,"James Wiseman",0,7,7,2,5,7
"12519",979,4,1,0,5,2,13,7,1,1,27,0,5,17,0,1,2,7981426,"2023-12-08T00:00:00.000Z",70,2,"Jaylen Brown",2,17,21,21,4,27
"12520",980,5,0,6,9,3,18,8,8,6,38,0,3,25,6,1,0,7981426,"2023-12-08T00:00:00.000Z",434,2,"Jayson Tatum",1,31,36,30,11,42.7
"12521",981,1,0,2,6,3,13,7,4,4,29,1,2,21,3,2,2,7981426,"2023-12-08T00:00:00.000Z",378,2,"Kristaps Porzingis",2,24,25,22,4,30.1
"12522",982,3,2,1,10,6,16,10,4,4,32,2,4,30,3,2,0,7981426,"2023-12-08T00:00:00.000Z",473,2,"Derrick White",4,33,36,33,6,50.1
"12523",983,5,1,6,3,1,11,7,1,1,35,0,1,16,6,2,1,7981426,"2023-12-08T00:00:00.000Z",214,2,"Jrue Holiday",3,22,27,21,11,38.7
"12524",984,1,1,2,5,0,5,0,2,1,21,1,1,1,3,0,0,7981426,"2023-12-08T00:00:00.000Z",17896060,2,"Sam Hauser",1,4,5,2,4,9.1
"12525",985,1,0,1,3,0,5,0,0,0,12,0,2,0,1,0,0,7050283,"2023-12-08T00:00:00.000Z",17896071,9,"Isaiah Livers",0,1,2,1,2,2.7
"12526",986,1,0,0,1,0,3,2,0,0,5,0,0,4,0,0,0,7050283,"2023-12-08T00:00:00.000Z",56677792,9,"Marcus Sasser",0,4,5,5,1,5.5
"12527",987,0,0,0,0,0,0,0,0,0,0,0,0,0,0,0,0,7050283,"2023-12-08T00:00:00.000Z",56677729,9,"Malcolm Cazalon",0,0,0,0,0,0
"12528",988,0,0,0,0,0,0,0,0,0,0,0,0,0,0,0,0,7050283,"2023-12-08T00:00:00.000Z",38017694,9,"Jalen Duren",0,0,0,0,0,0
"12529",989,0,0,0,0,0,0,0,0,0,0,0,0,0,0,0,0,7050283,"2023-12-08T00:00:00.000Z",330,9,"Monte Morris",0,0,0,0,0,0
"12530",990,0,0,0,0,0,0,0,0,0,0,0,0,0,0,0,0,7050283,"2023-12-08T00:00:00.000Z",42097199,9,"Jared Rhoden",0,0,0,0,0,0
"12531",991,0,0,0,0,0,0,0,0,0,0,0,0,0,0,0,0,7050283,"2023-12-08T00:00:00.000Z",44477024,9,"Stanley Umude",0,0,0,0,0,0
"12532",992,0,0,0,0,0,0,0,0,0,0,0,0,0,0,0,0,7981426,"2023-12-08T00:00:00.000Z",56677864,2,"Jordan Walsh",0,0,0,0,0,0
"12533",993,3,0,2,5,2,16,9,4,3,31,1,0,23,3,1,0,7981426,"2023-12-08T00:00:00.000Z",666423,20,"RJ Barrett",1,26,29,26,6,34.1
"12534",994,3,1,4,4,3,15,7,4,3,34,1,2,20,5,1,6,7981426,"2023-12-08T00:00:00.000Z",387,20,"Julius Randle",2,25,28,23,8,30.5
"12535",995,2,0,3,0,0,6,5,2,0,19,5,2,10,8,1,1,7981426,"2023-12-08T00:00:00.000Z",399,20,"Mitchell Robinson",1,18,20,12,10,24.6
"12536",996,2,0,4,5,2,6,2,0,0,22,0,2,6,4,0,1,7981426,"2023-12-08T00:00:00.000Z",131,20,"Donte DiVincenzo",0,10,12,8,6,12.8
"12537",997,4,0,1,5,0,17,8,9,7,34,0,3,23,1,1,1,7981426,"2023-12-08T00:00:00.000Z",73,20,"Jalen Brunson",1,24,28,27,5,32.2
"12538",998,0,0,0,0,0,0,0,0,0,0,0,0,0,0,0,0,7981426,"2023-12-08T00:00:00.000Z",19,20,"Ryan Arcidiacono",0,0,0,0,0,0
"12539",999,0,0,0,0,0,0,0,0,0,0,0,0,0,0,0,0,7981426,"2023-12-08T00:00:00.000Z",17896063,20,"Jericho Sims",0,0,0,0,0,0
"12540",1000,0,0,0,0,0,0,0,0,0,0,0,0,0,0,0,0,7981426,"2023-12-08T00:00:00.000Z",666474,20,"Charles Brown",0,0,0,0,0,0
"12541",1001,5,1,2,2,1,3,2,1,1,12,2,0,6,4,1,1,1037687,"2023-11-06T00:00:00.000Z",45,23,"Patrick Beverley",2,10,15,11,9,23.3
"12542",1002,2,0,2,2,0,2,0,2,1,14,1,1,1,3,0,1,1037687,"2023-11-06T00:00:00.000Z",260,23,"Furkan Korkmaz",0,4,6,3,5,6.6
"12543",1003,0,1,0,1,1,2,2,2,2,4,0,2,7,0,3,0,1037687,"2023-11-06T00:00:00.000Z",108,23,"Robert Covington",4,7,7,7,0,19
"12544",1004,0,0,0,1,0,2,1,1,1,7,0,0,3,0,0,2,1037687,"2023-11-06T00:00:00.000Z",2175,23,"Danuel House Jr.",0,3,3,3,0,1
"12545",1005,0,0,0,0,0,0,0,0,0,0,0,0,0,0,0,0,1037689,"2023-11-06T00:00:00.000Z",56677867,14,"Alex Fudge",0,0,0,0,0,0
"12546",1006,0,0,0,0,0,0,0,0,0,0,0,0,0,0,0,0,1037689,"2023-11-06T00:00:00.000Z",56677835,14,"Jalen Hood-Schifino",0,0,0,0,0,0
"12547",1007,0,0,0,0,0,0,0,0,0,0,0,0,0,0,0,0,1037689,"2023-11-06T00:00:00.000Z",56677836,14,"Maxwell Lewis",0,0,0,0,0,0
"12548",1008,0,0,0,0,0,0,0,0,0,0,0,0,0,0,0,0,1037689,"2023-11-06T00:00:00.000Z",666609,14,"Rui Hachimura",0,0,0,0,0,0
"12549",1009,0,0,0,0,0,0,0,0,0,0,0,0,0,0,0,0,1037689,"2023-11-06T00:00:00.000Z",666626,14,"Jaxson Hayes",0,0,0,0,0,0
"12550",1010,0,0,0,0,0,0,0,0,0,0,0,0,0,0,0,0,1037689,"2023-11-06T00:00:00.000Z",56677868,14,"D'Moi Hodge",0,0,0,0,0,0
"12551",1011,0,0,0,0,0,0,0,0,0,0,0,0,0,0,0,0,1037689,"2023-11-06T00:00:00.000Z",457,14,"Jarred Vanderbilt",0,0,0,0,0,0
"12552",1012,0,0,0,0,0,0,0,0,0,0,0,0,0,0,0,0,1037689,"2023-11-06T00:00:00.000Z",1603383,14,"Gabe Vincent",0,0,0,0,0,0
"12553",1013,7,0,3,4,1,9,4,1,1,32,0,2,10,3,2,2,1037690,"2023-11-06T00:00:00.000Z",202,20,"Josh Hart",2,13,20,17,10,28.1
"12554",1014,5,0,1,3,1,5,3,0,0,20,0,0,7,1,0,0,1037690,"2023-11-06T00:00:00.000Z",3547269,20,"Immanuel Quickley",0,8,13,12,6,15.7
"12555",1015,2,0,1,0,0,5,3,0,0,13,2,2,6,3,2,0,1037690,"2023-11-06T00:00:00.000Z",201,20,"Isaiah Hartenstein",2,9,11,8,5,18.6
"12556",1016,0,0,0,0,0,0,0,0,0,0,0,0,0,0,0,0,1037690,"2023-11-06T00:00:00.000Z",666675,20,"DaQuan Jeffries",0,0,0,0,0,0
"12557",1017,0,0,0,0,0,0,0,0,0,0,0,0,0,0,0,0,1037690,"2023-11-06T00:00:00.000Z",17896033,20,"Miles McBride",0,0,0,0,0,0
"12558",1018,0,0,0,0,0,0,0,0,0,0,0,0,0,0,0,0,1037690,"2023-11-06T00:00:00.000Z",17896063,20,"Jericho Sims",0,0,0,0,0,0
"12559",1019,0,0,0,0,0,0,0,0,0,0,0,0,0,0,0,0,1037690,"2023-11-06T00:00:00.000Z",666971,20,"Dylan Windler",0,0,0,0,0,0
"12560",1020,0,0,0,0,0,0,0,0,0,0,0,0,0,0,0,0,1037690,"2023-11-06T00:00:00.000Z",666474,20,"Charles Brown",0,0,0,0,0,0
"12561",1021,0,0,0,0,0,0,0,0,0,0,0,0,0,0,0,0,1037688,"2023-11-06T00:00:00.000Z",666508,3,"Nicolas Claxton",0,0,0,0,0,0
"12562",1022,0,0,0,0,0,0,0,0,0,0,0,0,0,0,0,0,1037688,"2023-11-06T00:00:00.000Z",56677843,3,"Noah Clowney",0,0,0,0,0,0
"12563",1023,0,0,0,0,0,0,0,0,0,0,0,0,0,0,0,0,1037688,"2023-11-06T00:00:00.000Z",666679,3,"Cameron Johnson",0,0,0,0,0,0
"12564",1024,0,0,0,0,0,0,0,0,0,0,0,0,0,0,0,0,1037688,"2023-11-06T00:00:00.000Z",17896041,3,"Keon Johnson",0,0,0,0,0,0
"12565",1025,0,0,0,0,0,0,0,0,0,0,0,0,0,0,0,0,1037688,"2023-11-06T00:00:00.000Z",56677841,3,"Dariq Whitehead",0,0,0,0,0,0
"12566",1026,4,0,2,11,5,25,10,0,0,37,2,4,25,4,0,3,1038006,"2023-12-26T00:00:00.000Z",172,13,"Paul George",0,29,33,29,8,32.8
"12567",1027,4,1,9,0,0,11,7,8,4,31,5,3,18,14,1,2,1038006,"2023-12-26T00:00:00.000Z",493,13,"Ivica Zubac",2,32,36,22,18,44.8
"12568",1028,0,0,0,1,0,4,1,2,2,21,1,2,4,1,0,1,1038006,"2023-12-26T00:00:00.000Z",666743,13,"Terance Mann",0,5,5,4,1,4.2
"12569",1029,8,1,6,12,6,16,8,8,7,40,0,2,29,6,2,4,1038006,"2023-12-26T00:00:00.000Z",192,13,"James Harden",3,35,43,37,14,53.2
"12570",1030,6,1,10,2,2,8,5,3,2,28,1,2,14,11,2,2,1038006,"2023-12-26T00:00:00.000Z",472,13,"Russell Westbrook",3,25,31,20,17,43.2
"12571",1031,0,0,3,5,1,7,2,2,2,28,0,1,7,3,0,0,1038006,"2023-12-26T00:00:00.000Z",380,13,"Norman Powell",0,10,10,7,3,10.6
"12572",1032,0,0,2,0,0,7,5,0,0,15,2,0,10,4,0,1,1038006,"2023-12-26T00:00:00.000Z",439,13,"Daniel Theis",0,14,14,10,4,13.8
"12573",1033,2,0,0,2,0,4,1,0,0,17,0,0,2,0,2,0,1038006,"2023-12-26T00:00:00.000Z",56677849,13,"Kobe Brown",2,2,4,4,2,11
"12574",1034,0,0,0,0,0,0,0,0,0,0,0,0,0,0,0,0,1038006,"2023-12-26T00:00:00.000Z",17896022,13,"Brandon Boston Jr.",0,0,0,0,0,0
"12575",1035,2,0,3,1,0,6,4,3,2,22,0,3,10,3,0,0,1038006,"2023-12-26T00:00:00.000Z",38017708,4,"Bryce McGowens",0,13,15,12,5,16.6
"12576",1036,7,0,4,8,1,23,8,3,1,39,0,2,18,4,1,4,1038006,"2023-12-26T00:00:00.000Z",403,4,"Terry Rozier",1,22,29,25,11,32.3
"12577",1037,2,1,2,2,1,8,3,0,0,25,0,2,7,2,4,0,1038006,"2023-12-26T00:00:00.000Z",666748,4,"Cody Martin",5,9,11,9,4,27.4
"12578",1038,1,0,0,4,1,5,2,0,0,12,0,3,5,0,0,0,1038006,"2023-12-26T00:00:00.000Z",56677846,4,"Nick Smith Jr.",0,5,6,6,1,6.5
"12579",1039,0,0,0,0,0,0,0,0,0,0,0,0,0,0,0,0,1038006,"2023-12-26T00:00:00.000Z",17896037,4,"James Bouknight",0,0,0,0,0,0
"12580",1040,1,0,0,3,0,3,0,0,0,9,1,1,0,1,0,0,1038005,"2023-12-26T00:00:00.000Z",4197162,26,"Aleksandar Vezenkov",0,1,2,1,2,2.7
"12581",1041,0,0,0,0,0,0,0,0,0,0,0,0,0,0,0,0,1038005,"2023-12-26T00:00:00.000Z",17895990,26,"Jordan Ford",0,0,0,0,0,0
"12582",1042,0,0,0,0,0,0,0,0,0,0,0,0,0,0,0,0,1038005,"2023-12-26T00:00:00.000Z",56677845,26,"Colby Jones",0,0,0,0,0,0
"12583",1043,0,0,0,0,0,0,0,0,0,0,0,0,0,0,0,0,1038005,"2023-12-26T00:00:00.000Z",56677862,26,"Jalen Slawson",0,0,0,0,0,0
"12584",1044,2,1,0,0,0,0,0,0,0,9,0,1,0,0,0,0,1038005,"2023-12-26T00:00:00.000Z",38017714,26,"Keon Ellis",1,0,2,2,2,6
"12585",1045,2,2,2,0,0,0,0,0,0,14,0,1,0,2,0,0,1038005,"2023-12-26T00:00:00.000Z",290,26,"Trey Lyles",2,2,4,2,4,11.4
"12586",1046,0,0,0,0,0,0,0,0,0,0,0,0,0,0,0,0,1038006,"2023-12-26T00:00:00.000Z",17896031,13,"Nah'Shon Hyland",0,0,0,0,0,0
"12587",1047,0,0,0,0,0,0,0,0,0,0,0,0,0,0,0,0,1038006,"2023-12-26T00:00:00.000Z",56677856,13,"Jordan Miller",0,0,0,0,0,0
"12588",1048,0,0,0,0,0,0,0,0,0,0,0,0,0,0,0,0,1038006,"2023-12-26T00:00:00.000Z",24417679,13,"Xavier Moon",0,0,0,0,0,0
"12589",1049,0,0,0,0,0,0,0,0,0,0,0,0,0,0,0,0,1038006,"2023-12-26T00:00:00.000Z",450,13,"PJ Tucker",0,0,0,0,0,0
"12590",1050,0,0,0,0,0,0,0,0,0,0,0,0,0,0,0,0,1038006,"2023-12-26T00:00:00.000Z",38017725,13,"Moussa Diabate",0,0,0,0,0,0
"12591",1051,4,0,3,3,1,5,2,0,0,22,0,1,5,3,0,2,1037827,"2023-11-25T00:00:00.000Z",666650,29,"Talen Horton-Tucker",0,8,12,9,7,12.6
"12592",1052,0,0,1,3,1,5,2,1,0,24,1,3,5,2,0,1,1037823,"2023-11-25T00:00:00.000Z",666541,21,"Luguentz Dort",0,7,7,5,2,6.4
"12593",1053,3,0,0,2,0,2,0,0,0,22,2,4,0,2,1,0,3277507,"2023-11-24T00:00:00.000Z",450,13,"PJ Tucker",1,2,5,3,5,9.9
"12594",1054,0,0,0,0,0,0,0,0,0,0,0,0,0,0,0,0,3277507,"2023-11-24T00:00:00.000Z",56677849,13,"Kobe Brown",0,0,0,0,0,0
"12595",1055,0,0,0,0,0,0,0,0,0,0,0,0,0,0,0,0,3277507,"2023-11-24T00:00:00.000Z",666511,13,"Amir Coffey",0,0,0,0,0,0
"12596",1056,0,0,0,0,0,0,0,0,0,0,0,0,0,0,0,0,3277507,"2023-11-24T00:00:00.000Z",38017725,13,"Moussa Diabate",0,0,0,0,0,0
"12597",1057,0,0,0,0,0,0,0,0,0,0,0,0,0,0,0,0,3277507,"2023-11-24T00:00:00.000Z",17896031,13,"Nah'Shon Hyland",0,0,0,0,0,0
"12598",1058,0,0,0,0,0,0,0,0,0,0,0,0,0,0,0,0,3277507,"2023-11-24T00:00:00.000Z",17896022,13,"Brandon Boston Jr.",0,0,0,0,0,0
"12599",1059,0,0,0,0,0,0,0,0,0,0,0,0,0,0,0,0,3277507,"2023-11-24T00:00:00.000Z",17896017,19,"Matt Ryan",0,0,0,0,0,0
"12600",1060,0,0,0,0,0,0,0,0,0,0,0,0,0,0,0,0,3277507,"2023-11-24T00:00:00.000Z",38017726,19,"Dereon Seabron",0,0,0,0,0,0
"12601",1061,1,0,0,0,0,2,0,0,0,14,1,1,0,1,0,0,1037823,"2023-11-25T00:00:00.000Z",56677833,21,"Cason Wallace",0,1,2,1,2,2.7
"12602",1062,2,3,5,11,5,21,13,2,2,31,1,3,33,6,0,1,1037823,"2023-11-25T00:00:00.000Z",38017685,21,"Chet Holmgren",3,39,41,35,8,51.2
"12603",1063,8,0,4,1,0,12,4,2,2,26,3,4,10,7,0,1,1037823,"2023-11-25T00:00:00.000Z",17896065,21,"Josh Giddey",0,17,25,18,15,29.4
"12604",1064,5,0,3,2,1,21,10,10,10,36,3,3,31,6,2,1,1037823,"2023-11-25T00:00:00.000Z",175,21,"Shai Gilgeous-Alexander",2,37,42,36,11,50.7
"12605",1065,2,0,0,1,0,2,0,0,0,8,1,1,0,1,0,0,1037823,"2023-11-25T00:00:00.000Z",38017716,21,"Ousmane Dieng",0,1,3,2,3,4.2
"12606",1066,1,0,1,2,1,3,1,3,2,10,0,2,5,1,0,0,1037823,"2023-11-25T00:00:00.000Z",44,21,"Davis Bertans",0,6,7,6,2,7.7
"12607",1067,3,0,1,7,2,8,3,1,1,22,0,1,9,1,3,1,1037827,"2023-11-25T00:00:00.000Z",38017620,29,"Ochai Agbaji",3,10,13,12,4,22.7
"12608",1068,3,1,5,3,3,6,4,2,2,24,1,0,13,6,1,3,1037827,"2023-11-25T00:00:00.000Z",358,29,"Kelly Olynyk",2,19,22,16,9,27.7
"12609",1069,0,0,0,0,0,0,0,0,0,0,0,0,0,0,0,0,1037827,"2023-11-25T00:00:00.000Z",666881,29,"Luka Samanic",0,0,0,0,0,0
"12610",1070,0,0,0,0,0,0,0,0,0,0,0,0,0,0,0,0,1037827,"2023-11-25T00:00:00.000Z",17896023,29,"Josh Christopher",0,0,0,0,0,0
"12611",1071,0,1,2,0,0,3,2,1,1,18,1,1,5,3,0,2,1037826,"2023-11-25T00:00:00.000Z",3547247,6,"Isaac Okoro",1,8,8,5,3,9.6
"12612",1072,1,0,1,1,1,7,5,0,0,17,0,2,11,1,0,1,1037826,"2023-11-25T00:00:00.000Z",56677872,6,"Craig Porter",0,12,13,12,2,12.7
"12613",1073,0,0,0,0,0,0,0,0,0,0,0,0,0,0,0,0,1037826,"2023-11-25T00:00:00.000Z",444,6,"Tristan Thompson",0,0,0,0,0,0
"12614",1074,0,0,0,0,0,0,0,0,0,0,0,0,0,0,0,0,1037826,"2023-11-25T00:00:00.000Z",56677847,6,"Emoni Bates",0,0,0,0,0,0
"12615",1075,0,0,0,0,0,0,0,0,0,0,0,0,0,0,0,0,1037826,"2023-11-25T00:00:00.000Z",666676,6,"Ty Jerome",0,0,0,0,0,0
"12616",1076,2,0,2,1,0,2,0,0,0,14,0,2,0,2,0,1,1037612,"2023-10-27T00:00:00.000Z",56677785,16,"Jaime Jaquez Jr.",0,2,4,2,4,4.4
"12617",1077,0,0,1,1,0,1,0,0,0,4,0,1,0,1,1,1,1037612,"2023-10-27T00:00:00.000Z",38017734,16,"Jamal Cain",1,1,1,0,1,3.2
"12618",1078,0,0,0,0,0,0,0,0,0,0,0,0,0,0,0,0,1037612,"2023-10-27T00:00:00.000Z",3547257,16,"R.J. Hampton",0,0,0,0,0,0
"12619",1079,0,0,0,0,0,0,0,0,0,0,0,0,0,0,0,0,1037612,"2023-10-27T00:00:00.000Z",38017696,16,"Nikola Jovic",0,0,0,0,0,0
"12620",1080,0,0,0,0,0,0,0,0,0,0,0,0,0,0,0,0,1037612,"2023-10-27T00:00:00.000Z",666747,16,"Caleb Martin",0,0,0,0,0,0
"12621",1081,0,0,1,1,1,4,3,2,2,19,1,0,9,2,0,0,1037613,"2023-10-27T00:00:00.000Z",56677833,21,"Cason Wallace",0,11,11,9,2,11.4
"12622",1082,2,0,3,7,1,10,2,1,0,22,0,1,5,3,0,1,1037613,"2023-10-27T00:00:00.000Z",3547272,21,"Isaiah Joe",0,8,10,7,5,10.6
"12623",1083,0,0,0,0,0,0,0,0,0,1,0,0,0,0,0,0,1037613,"2023-10-27T00:00:00.000Z",27924547,21,"Lindy Waters III",0,0,0,0,0,0
"12624",1084,1,1,0,0,0,0,0,0,0,12,0,0,0,0,0,1,1037613,"2023-10-27T00:00:00.000Z",17896078,21,"Aaron Wiggins",1,0,1,1,1,3.5
"12625",1085,1,0,0,1,1,1,1,0,0,6,0,0,3,0,0,2,1037613,"2023-10-27T00:00:00.000Z",4197029,21,"Vasilije Micic",0,3,4,4,1,2.5
"12626",1086,0,0,0,0,0,0,0,0,0,0,0,0,0,0,0,0,1037613,"2023-10-27T00:00:00.000Z",17896036,21,"Tre Mann",0,0,0,0,0,0
"12627",1087,0,0,0,0,0,0,0,0,0,0,0,0,0,0,0,0,1037613,"2023-10-27T00:00:00.000Z",3547271,21,"Aleksej Pokusevski",0,0,0,0,0,0
"12628",1088,0,0,0,0,0,0,0,0,0,0,0,0,0,0,0,0,1037613,"2023-10-27T00:00:00.000Z",24572055,21,"Olivier Sarr",0,0,0,0,0,0
"12629",1089,0,0,0,0,0,0,0,0,0,0,0,0,0,0,0,0,1037613,"2023-10-27T00:00:00.000Z",56677853,21,"Keyontae Johnson",0,0,0,0,0,0
"12630",1090,0,0,0,0,0,0,0,0,0,0,0,0,0,0,0,0,1037613,"2023-10-27T00:00:00.000Z",38017706,21,"Jaylin Williams",0,0,0,0,0,0
"12631",1091,0,0,0,0,0,0,0,0,0,0,0,0,0,0,0,0,1037613,"2023-10-27T00:00:00.000Z",480,21,"Kenrich Williams",0,0,0,0,0,0
"12632",1092,1,1,2,0,0,2,1,4,4,20,0,4,6,2,2,0,1037611,"2023-10-27T00:00:00.000Z",3547244,1,"Onyeka Okongwu",3,8,9,7,3,18.9
"12633",1093,2,2,4,0,0,24,10,9,7,35,3,1,27,7,1,3,1037612,"2023-10-27T00:00:00.000Z",4,16,"Bam Adebayo",3,34,36,29,9,44.4
"12634",1094,6,0,5,12,5,19,10,3,3,40,1,2,28,6,1,3,1037612,"2023-10-27T00:00:00.000Z",666633,16,"Tyler Herro",1,34,40,34,12,44.2
"12635",1095,5,1,7,4,3,7,5,0,0,32,1,3,13,8,0,1,1037612,"2023-10-27T00:00:00.000Z",286,16,"Kyle Lowry",1,21,26,18,13,32.1
"12636",1096,0,0,0,0,0,0,0,0,0,0,0,0,0,0,0,0,1037610,"2023-10-27T00:00:00.000Z",17896067,15,"Santi Aldama",0,0,0,0,0,0
"12637",1097,0,0,0,0,0,0,0,0,0,0,0,0,0,0,0,0,1037610,"2023-10-27T00:00:00.000Z",666505,15,"Brandon Clarke",0,0,0,0,0,0
"12638",1098,0,0,0,0,0,0,0,0,0,0,0,0,0,0,0,0,1037610,"2023-10-27T00:00:00.000Z",254,15,"Luke Kennard",0,0,0,0,0,0
"12639",1099,2,0,12,5,2,7,3,1,1,29,1,4,9,13,0,1,1037610,"2023-10-27T00:00:00.000Z",375,8,"Michael Porter Jr.",0,22,24,11,15,26.6
"12640",1100,3,1,1,1,0,11,5,1,0,30,1,3,10,2,3,1,1037610,"2023-10-27T00:00:00.000Z",177,8,"Aaron Gordon",4,12,15,13,5,27.9
"12641",1101,0,0,0,0,0,0,0,0,0,0,0,0,0,0,0,0,1037958,"2023-12-20T00:00:00.000Z",19465585,16,"Dru Smith",0,0,0,0,0,0
"12642",1102,0,0,0,0,0,0,0,0,0,0,0,0,0,0,0,0,1037958,"2023-12-20T00:00:00.000Z",38017736,16,"Cole Swider",0,0,0,0,0,0
"12643",1103,4,1,3,2,0,7,4,1,1,23,2,0,9,5,1,1,1037972,"2023-12-21T00:00:00.000Z",12,18,"Kyle Anderson",2,14,18,13,9,26
"12644",1104,0,0,1,1,0,1,0,2,2,6,0,2,2,1,0,0,1037972,"2023-12-21T00:00:00.000Z",68,18,"Troy Brown Jr.",0,3,3,2,1,3.2
"12645",1105,0,0,0,0,0,0,0,0,0,0,0,0,0,0,0,0,1037972,"2023-12-21T00:00:00.000Z",17896056,18,"Luka Garza",0,0,0,0,0,0
"12646",1106,3,0,1,4,2,8,5,2,2,36,0,2,14,1,1,2,1037972,"2023-12-21T00:00:00.000Z",3547259,18,"Jaden McDaniels",1,15,18,17,4,20.7
"12647",1107,4,0,6,6,2,16,7,6,5,34,0,3,21,6,1,0,1037972,"2023-12-21T00:00:00.000Z",447,18,"Karl-Anthony Towns",1,27,31,25,10,37.2
"12648",1108,3,3,8,0,0,12,6,6,3,37,5,3,15,13,1,2,1037972,"2023-12-21T00:00:00.000Z",176,18,"Rudy Gobert",4,28,31,18,16,45.1
"12649",1109,5,1,7,6,2,19,9,8,7,38,0,0,27,7,3,4,1037972,"2023-12-21T00:00:00.000Z",3547238,18,"Anthony Edwards",4,34,39,32,12,50.9
"12650",1110,8,1,1,6,4,9,6,0,0,30,0,1,16,1,2,1,1037972,"2023-12-21T00:00:00.000Z",104,18,"Mike Conley",3,17,25,24,9,37.2
"12651",1111,3,0,1,5,1,6,2,0,0,15,0,2,5,1,3,1,1037972,"2023-12-21T00:00:00.000Z",666400,18,"Nickeil Alexander-Walker",3,6,9,8,4,18.7
"12652",1112,0,0,3,6,2,8,3,2,2,24,0,2,10,3,0,1,1037960,"2023-12-20T00:00:00.000Z",158,3,"Dorian Finney-Smith",0,13,13,10,3,12.6
"12653",1113,0,0,1,2,1,4,2,0,0,25,0,2,5,1,1,0,1037959,"2023-12-20T00:00:00.000Z",328,23,"Marcus Morris",1,6,6,5,1,9.2
"12654",1114,3,1,4,0,0,5,3,2,2,12,4,3,8,8,3,2,1037959,"2023-12-20T00:00:00.000Z",3547270,23,"Paul Reed",4,16,19,11,11,32.1
"12655",1115,1,0,0,0,0,0,0,0,0,2,0,0,0,0,0,0,1037959,"2023-12-20T00:00:00.000Z",17896025,23,"Jaden Springer",0,0,1,1,1,1.5
"12656",1116,0,0,0,0,0,0,0,0,0,0,0,0,0,0,0,0,1037959,"2023-12-20T00:00:00.000Z",33,23,"Nicolas Batum",0,0,0,0,0,0
"12657",1117,4,0,3,5,1,9,4,3,3,29,0,0,12,3,0,1,1037961,"2023-12-20T00:00:00.000Z",3089,28,"Gary Trent Jr.",0,15,19,16,7,20.6
"12658",1118,0,0,0,0,0,0,0,0,0,0,0,0,0,0,0,0,1037961,"2023-12-20T00:00:00.000Z",376,28,"Otto Porter Jr.",0,0,0,0,0,0
"12659",1119,0,0,0,0,0,0,0,0,0,0,0,0,0,0,0,0,1037961,"2023-12-20T00:00:00.000Z",436,28,"Garrett Temple",0,0,0,0,0,0
"12660",1120,0,0,0,0,0,0,0,0,0,0,0,0,0,0,0,0,1037961,"2023-12-20T00:00:00.000Z",489,28,"Thaddeus Young",0,0,0,0,0,0
"12661",1121,0,0,0,0,0,0,0,0,0,0,0,0,0,0,0,0,1037961,"2023-12-20T00:00:00.000Z",56677805,28,"Javon Freeman-Liberty",0,0,0,0,0,0
"12662",1122,6,3,5,10,2,11,2,0,0,28,1,2,6,6,1,2,1037960,"2023-12-20T00:00:00.000Z",351,3,"Royce O'Neale",4,12,18,12,12,32.2
"12663",1123,0,1,0,0,0,1,0,0,0,4,0,1,0,0,0,1,1037960,"2023-12-20T00:00:00.000Z",174,3,"Harry Giles III",1,0,0,0,0,2
"12664",1124,0,0,0,0,0,0,0,0,0,0,0,0,0,0,0,0,1037961,"2023-12-20T00:00:00.000Z",38017710,28,"Christian Koloko",0,0,0,0,0,0
"12665",1125,0,0,0,0,0,0,0,0,0,0,0,0,0,0,0,0,1037961,"2023-12-20T00:00:00.000Z",56677869,28,"Markquis Nowell",0,0,0,0,0,0
"12666",1126,0,0,0,0,0,0,0,0,0,0,0,0,0,0,0,0,1037773,"2023-11-18T00:00:00.000Z",19465585,16,"Dru Smith",0,0,0,0,0,0
"12667",1127,1,0,1,1,0,2,0,0,0,16,1,2,0,2,0,0,1037771,"2023-11-18T00:00:00.000Z",38017708,4,"Bryce McGowens",0,2,3,1,3,3.9
"12668",1128,0,1,1,2,1,3,2,0,0,11,1,1,5,2,0,0,1037771,"2023-11-18T00:00:00.000Z",18678001,4,"JT Thor",1,7,7,5,2,10.4
"12669",1129,0,0,0,0,0,0,0,0,0,0,0,0,0,0,0,0,1037771,"2023-11-18T00:00:00.000Z",3547253,4,"Theo Maledon",0,0,0,0,0,0
"12670",1130,0,0,0,0,0,0,0,0,0,0,0,0,0,0,0,0,1037771,"2023-11-18T00:00:00.000Z",56677846,4,"Nick Smith Jr.",0,0,0,0,0,0
"12671",1131,0,0,0,0,0,0,0,0,0,0,0,0,0,0,0,0,1037771,"2023-11-18T00:00:00.000Z",56677848,4,"Amari Bailey",0,0,0,0,0,0
"12672",1132,0,0,0,0,0,0,0,0,0,0,0,0,0,0,0,0,1037771,"2023-11-18T00:00:00.000Z",56677866,4,"Leaky Black",0,0,0,0,0,0
"12673",1133,0,0,0,0,0,0,0,0,0,0,0,0,0,0,0,0,1037771,"2023-11-18T00:00:00.000Z",17896037,4,"James Bouknight",0,0,0,0,0,0
"12674",1134,0,0,0,0,0,0,0,0,0,0,0,0,0,0,0,0,1037771,"2023-11-18T00:00:00.000Z",666748,4,"Cody Martin",0,0,0,0,0,0
"12675",1135,0,0,0,0,0,0,0,0,0,0,0,0,0,0,0,0,1037771,"2023-11-18T00:00:00.000Z",347,4,"Frank Ntilikina",0,0,0,0,0,0
"12676",1136,0,0,0,0,0,0,0,0,0,0,0,0,0,0,0,0,1037771,"2023-11-18T00:00:00.000Z",3547282,4,"Nick Richards",0,0,0,0,0,0
"12677",1137,0,0,0,0,0,0,0,0,0,0,0,0,0,0,0,0,1037771,"2023-11-18T00:00:00.000Z",403,4,"Terry Rozier",0,0,0,0,0,0
"12678",1138,3,0,3,5,1,15,5,5,4,26,0,0,15,3,1,1,1037771,"2023-11-18T00:00:00.000Z",666423,20,"RJ Barrett",1,18,21,18,6,25.1
"12679",1139,0,0,1,4,1,9,2,0,0,15,1,1,5,2,1,1,1037773,"2023-11-18T00:00:00.000Z",666747,16,"Caleb Martin",1,7,7,5,2,9.4
"12680",1140,0,0,0,0,0,0,0,0,0,0,0,0,0,0,0,0,1037773,"2023-11-18T00:00:00.000Z",74,16,"Thomas Bryant",0,0,0,0,0,0
"12681",1141,2,0,0,0,0,1,0,0,0,12,0,1,0,0,0,0,1037774,"2023-11-18T00:00:00.000Z",56677852,17,"Andre Jackson Jr.",0,0,2,2,2,3
"12682",1142,7,1,12,3,1,26,18,5,3,38,2,3,40,14,2,3,1037774,"2023-11-18T00:00:00.000Z",15,17,"Giannis Antetokounmpo",3,54,61,47,21,73.3
"12683",1143,0,2,3,6,1,8,3,5,5,34,0,1,12,3,1,0,1037774,"2023-11-18T00:00:00.000Z",283,17,"Brook Lopez",3,15,15,12,3,24.6
"12684",1144,0,0,7,6,1,9,3,0,0,34,0,3,7,7,1,0,1037774,"2023-11-18T00:00:00.000Z",38,17,"Malik Beasley",1,14,14,7,7,18.4
"12685",1145,12,0,3,11,4,18,7,10,9,38,0,2,27,3,1,1,1037774,"2023-11-18T00:00:00.000Z",278,17,"Damian Lillard",1,30,42,39,15,50.6
"12686",1146,2,0,6,2,1,10,5,0,0,22,1,0,11,7,0,0,1037774,"2023-11-18T00:00:00.000Z",377,17,"Bobby Portis",0,18,20,13,9,22.4
"12687",1147,3,0,2,9,4,12,6,0,0,34,2,1,16,4,2,1,1037774,"2023-11-18T00:00:00.000Z",105,17,"Pat Connaughton",2,20,23,19,7,30.3
"12688",1148,2,0,2,4,3,5,4,0,0,17,0,4,11,2,1,0,1037774,"2023-11-18T00:00:00.000Z",368,17,"Cameron Payne",1,13,15,13,4,19.4
"12689",1149,1,0,0,4,2,5,3,0,0,11,0,1,8,0,0,0,1037774,"2023-11-18T00:00:00.000Z",38017733,17,"A.J. Green",0,8,9,9,1,9.5
"12690",1150,0,0,0,0,0,0,0,0,0,0,0,0,0,0,0,0,1037774,"2023-11-18T00:00:00.000Z",2148,17,"Thanasis Antetokounmpo",0,0,0,0,0,0
"12691",1151,6,1,3,3,0,9,4,2,1,27,0,2,9,3,1,0,1038130,"2024-01-12T00:00:00.000Z",3547238,18,"Anthony Edwards",2,12,18,15,9,27.6
"12692",1152,0,0,2,2,1,3,1,0,0,10,0,1,3,2,0,2,1038124,"2024-01-12T00:00:00.000Z",38017714,26,"Keon Ellis",0,5,5,3,2,3.4
"12693",1153,0,0,0,1,0,3,1,0,0,6,1,1,2,1,0,0,1038124,"2024-01-12T00:00:00.000Z",17896044,26,"Kessler Edwards",0,3,3,2,1,3.2
"12694",1154,2,0,1,0,0,2,1,0,0,8,0,0,2,1,1,0,1038126,"2024-01-12T00:00:00.000Z",56677825,11,"Amen Thompson",1,3,5,4,3,9.2
"12695",1155,0,0,1,5,1,7,1,0,0,15,0,2,3,1,0,0,1038126,"2024-01-12T00:00:00.000Z",56677831,11,"Cam Whitmore",0,4,4,3,1,4.2
"12696",1156,0,0,1,0,0,0,0,0,0,3,0,0,0,1,0,0,1038126,"2024-01-12T00:00:00.000Z",213,11,"Aaron Holiday",0,1,1,0,1,1.2
"12697",1157,0,0,2,0,0,2,2,2,2,13,0,2,6,2,0,1,1038126,"2024-01-12T00:00:00.000Z",188,11,"Jeff Green",0,8,8,6,2,7.4
"12698",1158,1,0,4,3,1,3,1,0,0,21,0,0,3,4,1,1,1038126,"2024-01-12T00:00:00.000Z",75,11,"Reggie Bullock",1,7,8,4,5,11.3
"12699",1159,0,0,0,0,0,0,0,0,0,0,0,0,0,0,0,0,1038126,"2024-01-12T00:00:00.000Z",19465326,11,"Jock Landale",0,0,0,0,0,0
"12700",1160,0,0,0,0,0,0,0,0,0,0,0,0,0,0,0,0,1038126,"2024-01-12T00:00:00.000Z",296,11,"Boban Marjanovic",0,0,0,0,0,0
"12701",1161,0,0,0,0,0,0,0,0,0,0,0,0,0,0,0,0,1038125,"2024-01-12T00:00:00.000Z",56677838,1,"Kobe Bufkin",0,0,0,0,0,0
"12702",1162,0,0,0,0,0,0,0,0,0,0,0,0,0,0,0,0,1038125,"2024-01-12T00:00:00.000Z",56677806,1,"Mouhamed Gueye",0,0,0,0,0,0
"12703",1163,0,0,0,0,0,0,0,0,0,0,0,0,0,0,0,0,1038125,"2024-01-12T00:00:00.000Z",666656,1,"De'Andre Hunter",0,0,0,0,0,0
"12704",1164,0,0,0,0,0,0,0,0,0,0,0,0,0,0,0,0,1038125,"2024-01-12T00:00:00.000Z",4197387,1,"Vit Krejci",0,0,0,0,0,0
"12705",1165,0,0,0,0,0,0,0,0,0,0,0,0,0,0,0,0,1038125,"2024-01-12T00:00:00.000Z",301,1,"Wesley Matthews",0,0,0,0,0,0
"12706",1166,0,0,3,3,3,6,5,0,0,21,1,3,13,4,1,1,1038125,"2024-01-12T00:00:00.000Z",3547250,12,"Aaron Nesmith",1,17,17,13,4,19.8
"12707",1167,0,0,4,0,0,7,3,0,0,19,3,1,6,7,0,0,1038125,"2024-01-12T00:00:00.000Z",3547264,12,"Jalen Smith",0,13,13,6,7,14.4
"12708",1168,4,2,5,3,0,9,5,3,2,26,2,2,12,7,2,3,1038125,"2024-01-12T00:00:00.000Z",452,12,"Myles Turner",4,19,23,16,11,35.4
"12709",1169,4,0,1,3,2,9,5,0,0,21,0,0,12,1,0,2,1038125,"2024-01-12T00:00:00.000Z",69,12,"Bruce Brown",0,13,17,16,5,17.2
"12710",1170,6,0,4,2,2,6,4,0,0,23,0,2,10,4,2,4,1038125,"2024-01-12T00:00:00.000Z",38017507,12,"Andrew Nembhard",2,14,20,16,10,25.8
"12711",1171,2,3,3,6,4,11,7,0,0,23,0,3,18,3,0,2,1038125,"2024-01-12T00:00:00.000Z",210,12,"Buddy Hield",3,21,23,20,5,31.6
"12712",1172,2,4,4,0,0,7,6,0,0,18,1,3,12,5,4,2,1038125,"2024-01-12T00:00:00.000Z",17896035,12,"Isaiah Jackson",8,17,19,14,7,43
"12713",1173,0,0,0,0,0,0,0,0,0,4,0,1,0,0,0,0,1038125,"2024-01-12T00:00:00.000Z",38017701,12,"Kendall Brown",0,0,0,0,0,0
"12714",1174,0,0,0,0,0,0,0,0,0,0,0,0,0,0,0,0,1038124,"2024-01-12T00:00:00.000Z",38017732,23,"Kenneth Lofton Jr.",0,0,0,0,0,0
"12715",1175,0,0,0,0,0,0,0,0,0,0,0,0,0,0,0,0,1038124,"2024-01-12T00:00:00.000Z",56677788,23,"Terquavion Smith",0,0,0,0,0,0
"12716",1176,0,0,0,0,0,3,1,0,0,5,3,0,2,3,0,0,1037917,"2023-12-14T00:00:00.000Z",56677799,10,"Trayce Jackson-Davis",0,5,5,2,3,5.6
"12717",1177,0,0,0,0,0,0,0,0,0,0,0,0,0,0,0,0,1037916,"2023-12-14T00:00:00.000Z",17895990,26,"Jordan Ford",0,0,0,0,0,0
"12718",1178,0,0,0,0,0,0,0,0,0,0,0,0,0,0,0,0,1037917,"2023-12-14T00:00:00.000Z",172,13,"Paul George",0,0,0,0,0,0
"12719",1179,0,0,0,0,0,0,0,0,0,0,0,0,0,0,0,0,1037916,"2023-12-14T00:00:00.000Z",56677845,26,"Colby Jones",0,0,0,0,0,0
"12720",1180,0,0,0,0,0,0,0,0,0,0,0,0,0,0,0,0,1037916,"2023-12-14T00:00:00.000Z",17553994,26,"Davion Mitchell",0,0,0,0,0,0
"12721",1181,0,0,0,0,0,0,0,0,0,0,0,0,0,0,0,0,1037916,"2023-12-14T00:00:00.000Z",273,26,"Alex Len",0,0,0,0,0,0
"12722",1182,0,1,3,6,3,11,6,0,0,13,2,1,15,5,1,0,1037915,"2023-12-14T00:00:00.000Z",56783340,25,"Duop Reath",2,20,20,15,5,27
"12723",1183,5,0,0,0,0,0,0,0,0,17,1,0,0,1,1,0,1037915,"2023-12-14T00:00:00.000Z",3547289,25,"Skylar Mays",1,1,6,5,6,11.7
"12724",1184,3,1,2,5,2,7,2,0,0,17,3,0,6,5,2,0,1037915,"2023-12-14T00:00:00.000Z",56677791,25,"Kris Murray",3,11,14,9,8,25.5
"12725",1185,0,0,0,0,0,0,0,0,0,0,0,0,0,0,0,0,1037915,"2023-12-14T00:00:00.000Z",39613724,25,"Ibou Badji",0,0,0,0,0,0
"12726",1186,0,0,0,0,0,0,0,0,0,0,0,0,0,0,0,0,1037915,"2023-12-14T00:00:00.000Z",182,25,"Jerami Grant",0,0,0,0,0,0
"12727",1187,0,0,0,0,0,0,0,0,0,0,0,0,0,0,0,0,1037915,"2023-12-14T00:00:00.000Z",47957121,25,"Justin Minaya",0,0,0,0,0,0
"12728",1188,0,0,0,0,0,0,0,0,0,0,0,0,0,0,0,0,1037915,"2023-12-14T00:00:00.000Z",56677829,25,"Rayan Rupert",0,0,0,0,0,0
"12729",1189,0,0,0,0,0,0,0,0,0,0,0,0,0,0,0,0,1037915,"2023-12-14T00:00:00.000Z",17896120,25,"Ish Wainright",0,0,0,0,0,0
"12730",1190,0,0,0,0,0,0,0,0,0,0,0,0,0,0,0,0,1037915,"2023-12-14T00:00:00.000Z",476,25,"Robert Williams III",0,0,0,0,0,0
"12731",1191,0,0,4,5,5,8,7,5,5,25,1,0,24,5,1,0,1037915,"2023-12-14T00:00:00.000Z",38017739,29,"Simone Fontecchio",1,29,29,24,5,33
"12732",1192,7,0,9,3,0,6,1,0,0,24,1,1,2,10,0,0,1037915,"2023-12-14T00:00:00.000Z",358,29,"Kelly Olynyk",0,12,19,9,17,24.5
"12733",1193,4,1,3,4,1,10,4,0,0,34,0,2,9,3,1,1,1037918,"2023-12-15T00:00:00.000Z",204,4,"Gordon Hayward",2,12,16,13,7,23.6
"12734",1194,2,0,8,8,2,24,10,6,5,39,2,5,27,10,1,3,1037918,"2023-12-15T00:00:00.000Z",62,4,"Miles Bridges",1,37,39,29,12,42
"12735",1195,1,1,5,0,0,7,7,2,2,30,1,5,16,6,0,0,1037918,"2023-12-15T00:00:00.000Z",3547282,4,"Nick Richards",1,22,23,17,7,27.7
"12736",1196,3,0,4,5,2,16,7,2,0,35,0,3,16,4,1,0,1037918,"2023-12-15T00:00:00.000Z",56677823,4,"Brandon Miller",1,20,23,19,7,28.3
"12737",1197,6,0,4,11,4,25,11,4,4,39,0,0,30,4,3,2,1037918,"2023-12-15T00:00:00.000Z",403,4,"Terry Rozier",3,34,40,36,10,50.8
"12738",1198,2,0,0,0,0,2,0,0,0,15,1,0,0,1,0,0,1037918,"2023-12-15T00:00:00.000Z",422,4,"Ish Smith",0,1,3,2,3,4.2
"12739",1199,0,2,1,1,0,2,0,0,0,14,1,1,0,2,0,0,1037918,"2023-12-15T00:00:00.000Z",18678001,4,"JT Thor",2,2,2,0,2,8.4
"12740",1201,2,0,1,5,2,10,7,0,0,28,1,3,16,2,2,2,1037751,"2023-11-15T00:00:00.000Z",3547256,1,"Saddiq Bey",2,18,20,18,4,25.4
"12741",1202,1,1,4,0,0,4,2,4,4,22,2,4,8,6,1,4,1037751,"2023-11-15T00:00:00.000Z",3547244,1,"Onyeka Okongwu",2,14,15,9,7,18.7
"12742",1203,1,0,2,1,1,1,1,0,0,10,1,2,3,3,1,0,1037751,"2023-11-15T00:00:00.000Z",301,1,"Wesley Matthews",1,6,7,4,4,11.1
"12743",1204,0,0,0,0,0,0,0,0,0,0,0,0,0,0,0,0,1037751,"2023-11-15T00:00:00.000Z",666564,1,"Bruno Fernando",0,0,0,0,0,0
"12744",1205,0,0,0,0,0,0,0,0,0,0,0,0,0,0,0,0,1037751,"2023-11-15T00:00:00.000Z",3547297,1,"Trent Forrest",0,0,0,0,0,0
"12745",1206,0,0,0,0,0,0,0,0,0,0,0,0,0,0,0,0,1037751,"2023-11-15T00:00:00.000Z",38017689,1,"AJ Griffin",0,0,0,0,0,0
"12746",1207,0,0,0,0,0,0,0,0,0,0,0,0,0,0,0,0,1037751,"2023-11-15T00:00:00.000Z",666754,1,"Garrison Mathews",0,0,0,0,0,0
"12747",1208,0,0,0,0,0,0,0,0,0,0,0,0,0,0,0,0,1037751,"2023-11-15T00:00:00.000Z",319,1,"Patty Mills",0,0,0,0,0,0
"12748",1209,0,0,0,0,0,0,0,0,0,0,0,0,0,0,0,0,1037751,"2023-11-15T00:00:00.000Z",56677838,1,"Kobe Bufkin",0,0,0,0,0,0
"12749",1210,0,0,4,11,8,14,11,0,0,31,0,2,30,4,1,0,1037753,"2023-11-15T00:00:00.000Z",38,17,"Malik Beasley",1,34,34,30,4,37.8
"12750",1211,13,0,4,10,4,18,9,16,15,31,0,1,37,4,2,4,1037753,"2023-11-15T00:00:00.000Z",278,17,"Damian Lillard",2,41,54,50,17,63.3
"12751",1212,0,2,6,3,2,11,7,2,2,31,1,5,18,7,0,0,1037753,"2023-11-15T00:00:00.000Z",377,17,"Bobby Portis",2,25,25,18,7,32.4
"12752",1213,0,0,6,3,1,3,1,0,0,23,1,2,3,7,0,1,1037753,"2023-11-15T00:00:00.000Z",105,17,"Pat Connaughton",0,10,10,3,7,10.4
"12753",1214,1,0,0,0,0,3,2,0,0,10,0,2,4,0,1,0,1037753,"2023-11-15T00:00:00.000Z",38017676,17,"MarJon Beauchamp",1,4,5,5,1,8.5
"12754",1215,0,0,0,0,0,5,1,0,0,15,2,3,2,2,0,0,1037753,"2023-11-15T00:00:00.000Z",2148,17,"Thanasis Antetokounmpo",0,4,4,2,2,4.4
"12755",1216,2,0,1,4,3,8,4,2,2,16,0,2,13,1,0,0,1037753,"2023-11-15T00:00:00.000Z",368,17,"Cameron Payne",0,14,16,15,3,17.2
"12756",1217,0,0,0,1,0,1,0,0,0,7,0,0,0,0,0,0,1037753,"2023-11-15T00:00:00.000Z",38017733,17,"A.J. Green",0,0,0,0,0,0
"12757",1218,0,0,1,1,0,1,0,0,0,2,0,0,0,1,1,1,1037753,"2023-11-15T00:00:00.000Z",38017691,17,"TyTy Washington Jr.",1,1,1,0,1,3.2
"12758",1219,0,0,0,1,0,1,0,0,0,2,0,1,0,0,0,1,1037753,"2023-11-15T00:00:00.000Z",666960,17,"Lindell Wigginton",0,0,0,0,0,-1
"12759",1220,0,0,0,0,0,0,0,0,0,2,0,0,0,0,0,0,1037753,"2023-11-15T00:00:00.000Z",284,17,"Robin Lopez",0,0,0,0,0,0
"12760",1221,0,0,0,0,0,0,0,0,0,0,0,0,0,0,0,0,1037753,"2023-11-15T00:00:00.000Z",15,17,"Giannis Antetokounmpo",0,0,0,0,0,0
"12761",1222,0,0,0,0,0,0,0,0,0,0,0,0,0,0,0,0,1037753,"2023-11-15T00:00:00.000Z",666453,17,"Marques Bolden",0,0,0,0,0,0
"12762",1223,0,0,0,0,0,0,0,0,0,0,0,0,0,0,0,0,1037753,"2023-11-15T00:00:00.000Z",112,17,"Jae Crowder",0,0,0,0,0,0
"12763",1224,0,0,0,0,0,0,0,0,0,0,0,0,0,0,0,0,1037753,"2023-11-15T00:00:00.000Z",56677854,17,"Chris Livingston",0,0,0,0,0,0
"12764",1225,3,0,3,2,0,8,3,0,0,22,1,1,6,4,2,4,1037751,"2023-11-15T00:00:00.000Z",131,20,"Donte DiVincenzo",2,10,13,9,7,17.3
"12765",1226,3,2,4,2,1,4,1,2,2,25,1,2,5,5,0,0,1038100,"2024-01-08T00:00:00.000Z",56677844,30,"Bilal Coulibaly",2,10,13,8,8,21.5
"12766",1227,0,1,2,1,0,3,0,0,0,23,1,1,0,3,0,0,1038107,"2024-01-09T00:00:00.000Z",3547258,7,"Josh Green",1,3,3,0,3,6.6
"12767",1228,2,1,4,1,0,9,5,1,1,36,0,1,11,4,0,0,1038107,"2024-01-09T00:00:00.000Z",247,7,"Derrick Jones Jr.",1,15,17,13,6,21.8
"12768",1229,3,1,3,0,0,3,2,0,0,22,1,3,4,4,2,2,1038107,"2024-01-09T00:00:00.000Z",379,7,"Dwight Powell",3,8,11,7,7,20.3
"12769",1230,0,1,1,1,0,1,0,0,0,12,0,0,0,1,1,0,1038106,"2024-01-09T00:00:00.000Z",666923,25,"Matisse Thybulle",2,1,1,0,1,7.2
"12770",1231,0,0,0,0,0,0,0,0,0,0,0,0,0,0,0,0,1038106,"2024-01-09T00:00:00.000Z",22,25,"Deandre Ayton",0,0,0,0,0,0
"12771",1232,0,0,0,0,0,0,0,0,0,0,0,0,0,0,0,0,1038106,"2024-01-09T00:00:00.000Z",666476,25,"Moses Brown",0,0,0,0,0,0
"12772",1233,0,0,0,0,0,0,0,0,0,0,0,0,0,0,0,0,1038106,"2024-01-09T00:00:00.000Z",38017711,25,"Jabari Walker",0,0,0,0,0,0
"12773",1234,0,0,0,0,0,0,0,0,0,0,0,0,0,0,0,0,1038106,"2024-01-09T00:00:00.000Z",476,25,"Robert Williams III",0,0,0,0,0,0
"12774",1235,4,1,4,7,2,25,11,10,9,40,4,3,33,8,4,3,1038107,"2024-01-09T00:00:00.000Z",228,7,"Kyrie Irving",5,41,45,37,12,60.6
"12775",1236,6,0,6,8,2,21,9,15,11,36,0,1,31,6,3,3,1038107,"2024-01-09T00:00:00.000Z",132,7,"Luka Doncic",3,37,43,37,12,53.2
"12776",1237,2,0,3,3,2,6,3,1,1,30,0,3,9,3,0,1,1038107,"2024-01-09T00:00:00.000Z",191,7,"Tim Hardaway Jr.",0,12,14,11,5,14.6
"12777",1238,0,0,0,1,0,2,1,0,0,10,0,1,2,0,0,1,1038107,"2024-01-09T00:00:00.000Z",114,7,"Seth Curry",0,2,2,2,0,1
"12778",1239,1,0,0,0,0,0,0,0,0,3,1,0,0,1,0,0,1038107,"2024-01-09T00:00:00.000Z",217,7,"Richaun Holmes",0,1,2,1,2,2.7
"12779",1240,1,0,1,4,2,7,4,0,0,19,0,2,10,1,0,1,1038107,"2024-01-09T00:00:00.000Z",38017679,7,"Jaden Hardy",0,11,12,11,2,11.7
"12780",1241,0,0,0,0,0,0,0,0,0,0,0,0,0,0,0,0,1038107,"2024-01-09T00:00:00.000Z",257,7,"Maxi Kleber",0,0,0,0,0,0
"12781",1242,0,0,0,0,0,0,0,0,0,0,0,0,0,0,0,0,1038105,"2024-01-09T00:00:00.000Z",38017700,18,"Wendell Moore Jr.",0,0,0,0,0,0
"12782",1243,0,0,0,0,0,0,0,0,0,0,0,0,0,0,0,0,1038105,"2024-01-09T00:00:00.000Z",17896056,18,"Luka Garza",0,0,0,0,0,0
"12783",1244,0,0,0,0,0,0,0,0,0,0,0,0,0,0,0,0,1038105,"2024-01-09T00:00:00.000Z",56677782,18,"Leonard Miller",0,0,0,0,0,0
"12784",1245,0,0,0,0,0,0,0,0,0,0,0,0,0,0,0,0,1038105,"2024-01-09T00:00:00.000Z",38017715,18,"Josh Minott",0,0,0,0,0,0
"12785",1246,0,0,0,0,0,0,0,0,0,0,0,0,0,0,0,0,1038105,"2024-01-09T00:00:00.000Z",17895968,18,"Daishen Nix",0,0,0,0,0,0
"12786",1247,0,0,0,0,0,0,0,0,0,0,0,0,0,0,0,0,1038107,"2024-01-09T00:00:00.000Z",17896067,15,"Santi Aldama",0,0,0,0,0,0
"12787",1248,3,1,2,4,0,5,0,0,0,18,0,1,0,2,0,2,1038105,"2024-01-09T00:00:00.000Z",666400,18,"Nickeil Alexander-Walker",1,2,5,3,5,7.9
"12788",1249,4,0,4,4,3,7,5,1,1,23,1,2,14,5,1,2,1038107,"2024-01-09T00:00:00.000Z",254,15,"Luke Kennard",1,19,23,18,9,27
"12789",1250,6,0,4,5,2,8,2,0,0,30,2,5,6,6,3,3,1038107,"2024-01-09T00:00:00.000Z",38017731,15,"Vince Williams Jr.",3,12,18,12,12,28.2
"12790",1251,0,0,0,0,0,0,0,0,0,0,0,0,0,0,0,0,1037899,"2023-12-12T00:00:00.000Z",56677871,8,"Hunter Tyson",0,0,0,0,0,0
"12791",1252,0,0,0,0,0,0,0,0,0,0,0,0,0,0,0,0,1037899,"2023-12-12T00:00:00.000Z",666489,8,"Vlatko Cancar",0,0,0,0,0,0
"12792",1253,0,0,0,0,0,0,0,0,0,0,0,0,0,0,0,0,1037899,"2023-12-12T00:00:00.000Z",38017727,8,"Collin Gillespie",0,0,0,0,0,0
"12793",1254,0,0,0,0,0,0,0,0,0,0,0,0,0,0,0,0,1037899,"2023-12-12T00:00:00.000Z",17896103,8,"Jay Huff",0,0,0,0,0,0
"12794",1255,0,0,0,0,0,0,0,0,0,0,0,0,0,0,0,0,1037899,"2023-12-12T00:00:00.000Z",17896007,8,"Braxton Key",0,0,0,0,0,0
"12795",1256,0,0,0,0,0,0,0,0,0,0,0,0,0,0,0,0,1037899,"2023-12-12T00:00:00.000Z",335,8,"Jamal Murray",0,0,0,0,0,0
"12796",1257,0,0,0,6,1,11,3,1,1,32,0,1,8,0,0,1,1037900,"2023-12-12T00:00:00.000Z",178,24,"Eric Gordon",0,8,8,8,0,7
"12797",1258,1,1,1,4,1,4,1,0,0,20,0,2,3,1,1,1,1037900,"2023-12-12T00:00:00.000Z",470,24,"Yuta Watanabe",2,4,5,4,2,10.7
"12798",1259,6,1,5,5,1,10,5,5,5,30,0,3,16,5,2,1,1037900,"2023-12-12T00:00:00.000Z",18678058,24,"Jordan Goodwin",3,21,27,22,11,39
"12799",1260,1,2,5,0,0,1,1,1,1,17,1,1,3,6,1,3,1037900,"2023-12-12T00:00:00.000Z",147,24,"Drew Eubanks",3,9,10,4,7,17.7
"12800",1261,0,0,0,0,0,0,0,0,0,0,0,0,0,0,0,0,1037900,"2023-12-12T00:00:00.000Z",8,24,"Grayson Allen",0,0,0,0,0,0
"12801",1262,0,0,0,0,0,0,0,0,0,0,0,0,0,0,0,0,1037900,"2023-12-12T00:00:00.000Z",3547095,24,"Udoka Azubuike",0,0,0,0,0,0
"12802",1263,0,0,0,0,0,0,0,0,0,0,0,0,0,0,0,0,1037900,"2023-12-12T00:00:00.000Z",140,24,"Kevin Durant",0,0,0,0,0,0
"12803",1264,0,0,0,0,0,0,0,0,0,0,0,0,0,0,0,0,1037900,"2023-12-12T00:00:00.000Z",272,24,"Damion Lee",0,0,0,0,0,0
"12804",1265,0,0,0,0,0,0,0,0,0,0,0,0,0,0,0,0,1037900,"2023-12-12T00:00:00.000Z",3547298,24,"Saben Lee",0,0,0,0,0,0
"12805",1266,0,0,0,0,0,0,0,0,0,0,0,0,0,0,0,0,1037900,"2023-12-12T00:00:00.000Z",666729,24,"Nassir Little",0,0,0,0,0,0
"12806",1267,1,0,2,3,1,7,1,0,0,15,2,1,3,4,0,3,1037900,"2023-12-12T00:00:00.000Z",475,10,"Andrew Wiggins",0,7,8,4,5,6.3
"12807",1268,3,1,4,3,2,14,11,7,7,31,0,0,31,4,1,1,1037901,"2023-12-12T00:00:00.000Z",274,13,"Kawhi Leonard",2,35,38,34,7,45.3
"12808",1269,1,0,6,5,2,7,3,1,1,16,0,0,9,6,2,3,1037901,"2023-12-12T00:00:00.000Z",172,13,"Paul George",2,15,16,10,7,20.7
"12809",1270,0,0,9,0,0,5,3,1,0,23,0,4,6,9,0,1,1037901,"2023-12-12T00:00:00.000Z",493,13,"Ivica Zubac",0,15,15,6,9,15.8
"12810",1271,2,0,4,3,2,6,3,2,2,30,1,1,10,5,1,1,1037901,"2023-12-12T00:00:00.000Z",666743,13,"Terance Mann",1,15,17,12,7,21
"12811",1272,7,0,6,4,0,9,4,7,7,28,0,3,15,6,2,2,1037901,"2023-12-12T00:00:00.000Z",192,13,"James Harden",2,21,28,22,13,36.7
"12812",1273,2,0,1,4,2,11,5,3,3,27,0,1,15,1,0,1,1037901,"2023-12-12T00:00:00.000Z",380,13,"Norman Powell",0,16,18,17,3,18.2
"12813",1274,0,1,5,3,1,5,3,0,0,24,1,5,7,6,0,1,1037901,"2023-12-12T00:00:00.000Z",56677849,13,"Kobe Brown",1,13,13,7,6,16.2
"12814",1275,0,0,2,1,0,8,4,0,0,16,1,2,8,3,1,0,1037901,"2023-12-12T00:00:00.000Z",439,13,"Daniel Theis",1,11,11,8,3,14.6
"12815",1276,0,0,0,0,0,0,0,0,0,0,0,0,0,0,0,0,3277405,"2023-11-10T00:00:00.000Z",17896078,21,"Aaron Wiggins",0,0,0,0,0,0
"12816",1277,0,0,0,0,0,0,0,0,0,0,0,0,0,0,0,0,3277405,"2023-11-10T00:00:00.000Z",56677853,21,"Keyontae Johnson",0,0,0,0,0,0
"12817",1278,0,0,0,0,0,0,0,0,0,0,0,0,0,0,0,0,3277403,"2023-11-10T00:00:00.000Z",17896051,13,"Joshua Primo",0,0,0,0,0,0
"12818",1279,4,1,7,0,0,14,5,8,8,36,4,3,18,11,0,1,3277404,"2023-11-10T00:00:00.000Z",117,14,"Anthony Davis",1,29,33,22,15,39.2
"12819",1280,0,2,1,4,0,8,3,2,1,33,0,4,7,1,0,0,3277404,"2023-11-10T00:00:00.000Z",383,14,"Taurean Prince",2,8,8,7,1,14.2
"12820",1281,9,1,3,3,0,12,6,9,7,29,0,4,19,3,0,1,3277404,"2023-11-10T00:00:00.000Z",405,14,"D'Angelo Russell",1,22,31,28,12,38.1
"12821",1282,0,0,0,0,0,0,0,0,0,0,0,0,0,0,0,0,3277401,"2023-11-10T00:00:00.000Z",139,29,"Kris Dunn",0,0,0,0,0,0
"12822",1283,0,0,0,0,0,0,0,0,0,0,0,0,0,0,0,0,3277401,"2023-11-10T00:00:00.000Z",666881,29,"Luka Samanic",0,0,0,0,0,0
"12823",1284,0,0,0,0,0,0,0,0,0,0,0,0,0,0,0,0,3277401,"2023-11-10T00:00:00.000Z",11891374,29,"Omer Yurtseven",0,0,0,0,0,0
"12824",1285,7,0,1,4,2,11,6,1,1,35,0,1,15,1,1,2,3277404,"2023-11-10T00:00:00.000Z",17553995,14,"Austin Reaves",1,16,23,22,8,27.7
"12825",1286,0,1,6,1,1,5,2,0,0,18,3,0,5,9,0,1,3277404,"2023-11-10T00:00:00.000Z",486,14,"Christian Wood",1,14,14,5,9,17.8
"12826",1287,1,1,3,3,1,6,3,1,0,20,0,3,7,3,4,1,3277404,"2023-11-10T00:00:00.000Z",666609,14,"Rui Hachimura",5,10,11,8,4,26.1
"12827",1288,0,0,1,0,0,1,1,0,0,5,0,1,2,1,0,1,3277404,"2023-11-10T00:00:00.000Z",666626,14,"Jaxson Hayes",0,3,3,2,1,2.2
"12828",1289,0,0,0,0,0,0,0,0,0,0,0,0,0,0,0,0,3277404,"2023-11-10T00:00:00.000Z",38017697,14,"Max Christie",0,0,0,0,0,0
"12829",1290,0,0,0,0,0,0,0,0,0,0,0,0,0,0,0,0,3277404,"2023-11-10T00:00:00.000Z",56677835,14,"Jalen Hood-Schifino",0,0,0,0,0,0
"12830",1291,0,0,0,0,0,0,0,0,0,0,0,0,0,0,0,0,3277404,"2023-11-10T00:00:00.000Z",56677836,14,"Maxwell Lewis",0,0,0,0,0,0
"12831",1292,0,0,0,0,0,0,0,0,0,0,0,0,0,0,0,0,3277404,"2023-11-10T00:00:00.000Z",56677738,14,"Colin Castleton",0,0,0,0,0,0
"12832",1293,0,0,0,0,0,0,0,0,0,0,0,0,0,0,0,0,3277401,"2023-11-10T00:00:00.000Z",17896023,29,"Josh Christopher",0,0,0,0,0,0
"12833",1294,0,0,0,0,0,0,0,0,0,0,0,0,0,0,0,0,3277401,"2023-11-10T00:00:00.000Z",56677824,29,"Taylor Hendricks",0,0,0,0,0,0
"12834",1295,0,0,0,0,0,0,0,0,0,0,0,0,0,0,0,0,3277401,"2023-11-10T00:00:00.000Z",38017630,29,"Johnny Juzang",0,0,0,0,0,0
"12835",1296,0,0,0,0,0,0,0,0,0,0,0,0,0,0,0,0,3277401,"2023-11-10T00:00:00.000Z",38017705,29,"Walker Kessler",0,0,0,0,0,0
"12836",1297,0,0,0,0,0,0,0,0,0,0,0,0,0,0,0,0,3277401,"2023-11-10T00:00:00.000Z",19465584,29,"Micah Potter",0,0,0,0,0,0
"12837",1298,0,0,0,0,0,0,0,0,0,0,0,0,0,0,0,0,3277401,"2023-11-10T00:00:00.000Z",56677842,29,"Brice Sensabaugh",0,0,0,0,0,0
"12838",1299,0,0,0,0,0,0,0,0,0,0,0,0,0,0,0,0,3277405,"2023-11-10T00:00:00.000Z",24572055,21,"Olivier Sarr",0,0,0,0,0,0
"12839",1300,0,0,0,0,0,0,0,0,0,0,0,0,0,0,0,0,3277405,"2023-11-10T00:00:00.000Z",480,21,"Kenrich Williams",0,0,0,0,0,0
"12840",1301,0,0,0,0,0,0,0,0,0,0,0,0,0,0,0,0,1038045,"2024-01-01T00:00:00.000Z",44477024,9,"Stanley Umude",0,0,0,0,0,0
"12841",1302,0,0,0,0,0,0,0,0,0,0,0,0,0,0,0,0,1038046,"2024-01-01T00:00:00.000Z",56677832,12,"Jarace Walker",0,0,0,0,0,0
"12842",1303,0,0,0,0,0,0,0,0,0,0,0,0,0,0,0,0,1038046,"2024-01-01T00:00:00.000Z",69,12,"Bruce Brown",0,0,0,0,0,0
"12843",1304,0,0,0,0,0,0,0,0,0,0,0,0,0,0,0,0,1038046,"2024-01-01T00:00:00.000Z",38017701,12,"Kendall Brown",0,0,0,0,0,0
"12844",1305,0,0,0,0,0,0,0,0,0,0,0,0,0,0,0,0,1038046,"2024-01-01T00:00:00.000Z",56677778,12,"Oscar Tshiebwe",0,0,0,0,0,0
"12845",1306,0,0,0,0,0,0,0,0,0,0,0,0,0,0,0,0,1038046,"2024-01-01T00:00:00.000Z",56677794,12,"Isaiah Wong",0,0,0,0,0,0
"12846",1307,1,0,7,11,4,17,8,2,2,31,1,1,22,8,0,1,1038047,"2024-01-01T00:00:00.000Z",375,8,"Michael Porter Jr.",0,30,31,23,9,32.1
"12847",1308,0,1,1,1,1,5,4,2,1,25,1,0,10,2,1,0,1038047,"2024-01-01T00:00:00.000Z",177,8,"Aaron Gordon",2,12,12,10,2,18.4
"12848",1309,6,1,11,0,0,7,6,1,1,27,0,2,13,11,1,3,1038047,"2024-01-01T00:00:00.000Z",246,8,"Nikola Jokic",2,24,30,19,17,38.2
"12849",1310,4,0,3,3,0,6,2,1,1,29,0,3,5,3,1,0,1038047,"2024-01-01T00:00:00.000Z",81,8,"Kentavious Caldwell-Pope",1,8,12,9,7,17.6
"12850",1311,7,1,3,9,5,16,7,7,6,27,0,1,25,3,2,2,1038047,"2024-01-01T00:00:00.000Z",335,8,"Jamal Murray",3,28,35,32,10,46.1
"12851",1312,2,2,3,3,1,6,3,3,2,24,1,1,9,4,1,1,1038047,"2024-01-01T00:00:00.000Z",38017709,8,"Christian Braun",3,13,15,11,6,24.8
"12852",1313,4,0,4,3,2,11,6,2,1,17,0,2,15,4,1,0,1038047,"2024-01-01T00:00:00.000Z",236,8,"Reggie Jackson",1,19,23,19,8,28.8
"12853",1314,1,3,2,2,0,5,1,0,0,20,1,2,2,3,0,2,1038047,"2024-01-01T00:00:00.000Z",3547268,8,"Zeke Nnaji",3,5,6,3,4,14.1
"12854",1315,0,0,1,0,0,1,0,0,0,4,0,0,0,1,1,0,1038047,"2024-01-01T00:00:00.000Z",17896007,8,"Braxton Key",1,1,1,0,1,4.2
"12855",1316,0,0,0,0,0,0,0,0,0,0,0,0,0,0,0,0,1038047,"2024-01-01T00:00:00.000Z",215,8,"Justin Holiday",0,0,0,0,0,0
"12856",1317,0,0,0,0,0,0,0,0,0,0,0,0,0,0,0,0,1038047,"2024-01-01T00:00:00.000Z",250,8,"DeAndre Jordan",0,0,0,0,0,0
"12857",1318,6,0,3,1,1,6,5,1,1,28,1,3,12,4,2,2,1038045,"2024-01-01T00:00:00.000Z",56677825,11,"Amen Thompson",2,16,22,18,10,29.8
"12858",1319,0,0,3,1,1,5,4,0,0,8,1,0,9,4,0,0,1038045,"2024-01-01T00:00:00.000Z",56677831,11,"Cam Whitmore",0,13,13,9,4,13.8
"12859",1320,0,0,0,0,0,0,0,0,0,7,0,0,0,0,0,0,1038045,"2024-01-01T00:00:00.000Z",19465326,11,"Jock Landale",0,0,0,0,0,0
"12860",1321,1,0,1,1,0,2,0,0,0,6,0,1,0,1,0,0,1038045,"2024-01-01T00:00:00.000Z",296,11,"Boban Marjanovic",0,1,2,1,2,2.7
"12861",1322,0,0,0,0,0,0,0,0,0,0,0,0,0,0,0,0,1038045,"2024-01-01T00:00:00.000Z",3547281,11,"Nate Hinton",0,0,0,0,0,0
"12862",1323,0,0,0,0,0,0,0,0,0,0,0,0,0,0,0,0,1038045,"2024-01-01T00:00:00.000Z",357,11,"Victor Oladipo",0,0,0,0,0,0
"12863",1324,0,0,0,0,0,0,0,0,0,0,0,0,0,0,0,0,1038045,"2024-01-01T00:00:00.000Z",56677809,11,"Jermaine Samuels Jr.",0,0,0,0,0,0
"12864",1325,0,0,0,0,0,0,0,0,0,0,0,0,0,0,0,0,1038045,"2024-01-01T00:00:00.000Z",47738533,11,"Jeenathan Williams",0,0,0,0,0,0
"12865",1326,0,0,4,1,0,3,1,0,0,20,2,1,2,6,0,0,1037871,"2023-12-01T00:00:00.000Z",18678058,24,"Jordan Goodwin",0,8,8,2,6,9.2
"12866",1327,0,0,2,0,0,1,1,0,0,19,0,0,2,2,0,0,1037871,"2023-12-01T00:00:00.000Z",666729,24,"Nassir Little",0,4,4,2,2,4.4
"12867",1328,1,0,6,0,0,1,0,0,0,15,0,2,0,6,0,0,1037871,"2023-12-01T00:00:00.000Z",147,24,"Drew Eubanks",0,6,7,1,7,8.7
"12868",1329,0,0,0,0,0,0,0,0,0,0,0,0,0,0,0,0,1037871,"2023-12-01T00:00:00.000Z",3547095,24,"Udoka Azubuike",0,0,0,0,0,0
"12869",1330,0,0,0,0,0,0,0,0,0,0,0,0,0,0,0,0,1037871,"2023-12-01T00:00:00.000Z",666451,24,"Bol Bol",0,0,0,0,0,0
"12870",1331,0,0,0,0,0,0,0,0,0,0,0,0,0,0,0,0,1037871,"2023-12-01T00:00:00.000Z",3547298,24,"Saben Lee",0,0,0,0,0,0
"12871",1332,1,0,1,1,0,2,0,0,0,4,0,0,0,1,0,0,1037871,"2023-12-01T00:00:00.000Z",314,24,"Chimezie Metu",0,1,2,1,2,2.7
"12872",1333,0,0,0,0,0,0,0,0,0,0,0,0,0,0,0,0,1037871,"2023-12-01T00:00:00.000Z",470,24,"Yuta Watanabe",0,0,0,0,0,0
"12873",1334,0,0,0,0,0,0,0,0,0,0,0,0,0,0,0,0,1037871,"2023-12-01T00:00:00.000Z",37,24,"Bradley Beal",0,0,0,0,0,0
"12874",1335,0,0,0,0,0,0,0,0,0,0,0,0,0,0,0,0,1037871,"2023-12-01T00:00:00.000Z",57,24,"Devin Booker",0,0,0,0,0,0
"12875",1336,0,0,0,0,0,0,0,0,0,0,0,0,0,0,0,0,1037871,"2023-12-01T00:00:00.000Z",272,24,"Damion Lee",0,0,0,0,0,0
"12876",1337,5,0,1,5,3,8,6,0,0,26,1,2,15,2,1,0,1037871,"2023-12-01T00:00:00.000Z",215,8,"Justin Holiday",1,17,22,20,7,27.9
"12877",1338,4,1,9,4,0,16,8,3,3,37,1,1,19,10,2,2,1037871,"2023-12-01T00:00:00.000Z",375,8,"Michael Porter Jr.",3,29,33,23,14,44
"12878",1339,16,2,4,3,0,18,9,6,3,35,1,4,21,5,1,3,1037871,"2023-12-01T00:00:00.000Z",246,8,"Nikola Jokic",3,26,42,37,21,57
"12879",1340,0,0,0,0,0,0,0,0,0,0,0,0,0,0,0,0,1037871,"2023-12-01T00:00:00.000Z",177,8,"Aaron Gordon",0,0,0,0,0,0
"12880",1341,0,0,0,0,0,0,0,0,0,0,0,0,0,0,0,0,1037871,"2023-12-01T00:00:00.000Z",17896103,8,"Jay Huff",0,0,0,0,0,0
"12881",1342,0,0,0,0,0,0,0,0,0,0,0,0,0,0,0,0,1037871,"2023-12-01T00:00:00.000Z",335,8,"Jamal Murray",0,0,0,0,0,0
"12882",1343,0,0,0,0,0,0,0,0,0,0,0,0,0,0,0,0,1037871,"2023-12-01T00:00:00.000Z",56677582,8,"Jalen Pickett",0,0,0,0,0,0
"12883",1344,0,0,0,0,0,0,0,0,0,0,0,0,0,0,0,0,1037871,"2023-12-01T00:00:00.000Z",56677871,8,"Hunter Tyson",0,0,0,0,0,0
"12884",1345,7,0,8,5,2,16,9,0,0,39,0,2,20,8,1,3,1037872,"2023-12-02T00:00:00.000Z",274,13,"Kawhi Leonard",1,28,35,27,15,40.1
"12885",1346,6,0,6,8,4,17,8,5,5,38,0,5,25,6,1,1,1037872,"2023-12-02T00:00:00.000Z",172,13,"Paul George",1,31,37,31,12,43.2
"12886",1347,1,3,6,0,0,6,6,0,0,23,1,4,12,7,0,3,1037872,"2023-12-02T00:00:00.000Z",493,13,"Ivica Zubac",3,19,20,13,8,27.9
"12887",1348,2,0,1,5,1,6,1,0,0,24,1,1,3,2,1,0,1037872,"2023-12-02T00:00:00.000Z",666743,13,"Terance Mann",1,5,7,5,4,11.4
"12888",1349,9,0,5,7,2,14,7,5,5,35,0,4,21,5,1,1,1037872,"2023-12-02T00:00:00.000Z",192,13,"James Harden",1,26,35,30,14,42.5
"12889",1350,2,1,6,4,2,5,2,4,2,19,0,0,8,6,0,0,1037872,"2023-12-02T00:00:00.000Z",472,13,"Russell Westbrook",1,14,16,10,8,21.2
"12890",1351,11,0,2,7,2,22,8,5,4,34,0,4,22,2,1,6,1037661,"2023-11-02T00:00:00.000Z",17896075,9,"Cade Cunningham",1,24,35,33,13,37.9
"12891",1352,2,0,2,8,6,10,7,0,0,35,0,0,20,2,0,3,1037661,"2023-11-02T00:00:00.000Z",17896017,19,"Matt Ryan",0,22,24,22,4,22.4
"12892",1353,3,4,5,1,0,7,6,9,9,34,0,4,21,5,3,0,1037661,"2023-11-02T00:00:00.000Z",17896024,19,"Herbert Jones",7,26,29,24,8,52.5
"12893",1354,5,3,9,3,2,16,9,4,3,33,4,5,23,13,0,2,1037661,"2023-11-02T00:00:00.000Z",455,19,"Jonas Valanciunas",3,36,41,28,18,53.1
"12894",1355,0,0,1,5,1,7,1,3,3,29,0,0,6,1,0,1,1037661,"2023-11-02T00:00:00.000Z",56677837,19,"Jordan Hawkins",0,7,7,6,1,6.2
"12895",1356,5,0,3,10,3,23,10,11,10,35,1,3,33,4,0,4,1037661,"2023-11-02T00:00:00.000Z",303,19,"CJ McCollum",0,37,42,38,9,41.3
"12896",1357,6,0,6,2,2,4,3,2,2,25,1,2,10,7,1,1,1037661,"2023-11-02T00:00:00.000Z",38017677,19,"Dyson Daniels",1,17,23,16,13,29.4
"12897",1358,4,0,3,1,0,5,1,4,4,20,0,1,6,3,1,1,1037661,"2023-11-02T00:00:00.000Z",3547260,19,"Kira Lewis Jr.",1,9,13,10,7,17.6
"12898",1359,1,0,0,2,0,6,2,0,0,16,1,2,4,1,0,0,1037661,"2023-11-02T00:00:00.000Z",340,19,"Larry Nance Jr.",0,5,6,5,2,6.7
"12899",1360,0,0,0,0,0,0,0,0,0,0,0,0,0,0,0,0,1037660,"2023-11-02T00:00:00.000Z",38017717,28,"Ron Harper Jr.",0,0,0,0,0,0
"12900",1361,0,0,0,0,0,0,0,0,0,0,0,0,0,0,0,0,1037660,"2023-11-02T00:00:00.000Z",38017710,28,"Christian Koloko",0,0,0,0,0,0
"12901",1362,0,0,0,0,0,0,0,0,0,0,0,0,0,0,0,0,1037660,"2023-11-02T00:00:00.000Z",56677869,28,"Markquis Nowell",0,0,0,0,0,0
"12902",1363,0,0,0,0,0,0,0,0,0,0,0,0,0,0,0,0,1037660,"2023-11-02T00:00:00.000Z",376,28,"Otto Porter Jr.",0,0,0,0,0,0
"12903",1364,0,2,6,3,1,7,3,6,4,35,2,3,11,8,0,2,1037661,"2023-11-02T00:00:00.000Z",3547267,9,"Isaiah Stewart",2,19,19,11,8,24.6
"12904",1365,1,0,5,0,0,8,5,2,2,25,0,5,12,5,0,1,1037661,"2023-11-02T00:00:00.000Z",38017694,9,"Jalen Duren",0,17,18,13,6,18.5
"12905",1366,0,0,0,0,0,0,0,0,0,0,0,0,0,0,0,0,1037661,"2023-11-02T00:00:00.000Z",54,9,"Bojan Bogdanovic",0,0,0,0,0,0
"12906",1367,0,0,0,0,0,0,0,0,0,0,0,0,0,0,0,0,1037661,"2023-11-02T00:00:00.000Z",77,9,"Alec Burks",0,0,0,0,0,0
"12907",1368,0,0,0,0,0,0,0,0,0,0,0,0,0,0,0,0,1037661,"2023-11-02T00:00:00.000Z",17896071,9,"Isaiah Livers",0,0,0,0,0,0
"12908",1369,0,0,0,0,0,0,0,0,0,0,0,0,0,0,0,0,1037661,"2023-11-02T00:00:00.000Z",330,9,"Monte Morris",0,0,0,0,0,0
"12909",1370,1,0,6,10,4,17,9,2,0,33,1,4,22,7,2,3,1037662,"2023-11-02T00:00:00.000Z",297,29,"Lauri Markkanen",2,29,30,23,8,34.9
"12910",1371,0,1,7,4,3,10,7,4,3,33,3,5,20,10,0,2,1037662,"2023-11-02T00:00:00.000Z",101,29,"John Collins",1,30,30,20,10,33
"12911",1372,1,5,7,0,0,6,2,0,0,25,3,2,4,10,0,1,1037662,"2023-11-02T00:00:00.000Z",38017705,29,"Walker Kessler",5,14,15,5,11,31.5
"12912",1373,6,0,3,8,2,20,5,9,9,37,3,1,21,6,1,6,1037662,"2023-11-02T00:00:00.000Z",100,29,"Jordan Clarkson",1,27,33,27,12,34.2
"12913",1374,8,1,3,4,1,14,7,0,0,31,0,4,15,3,3,2,1037662,"2023-11-02T00:00:00.000Z",666650,29,"Talen Horton-Tucker",4,18,26,23,11,40.6
"12914",1375,3,0,1,1,0,4,2,0,0,19,1,5,4,2,3,2,1037662,"2023-11-02T00:00:00.000Z",358,29,"Kelly Olynyk",3,6,9,7,5,17.9
"12915",1376,0,0,0,0,0,0,0,0,0,0,0,0,0,0,0,0,1038013,"2023-12-28T00:00:00.000Z",56677792,9,"Marcus Sasser",0,0,0,0,0,0
"12916",1377,0,0,0,0,0,0,0,0,0,0,0,0,0,0,0,0,1038013,"2023-12-28T00:00:00.000Z",56677729,9,"Malcolm Cazalon",0,0,0,0,0,0
"12917",1378,0,0,0,0,0,0,0,0,0,0,0,0,0,0,0,0,1038013,"2023-12-28T00:00:00.000Z",330,9,"Monte Morris",0,0,0,0,0,0
"12918",1379,0,0,0,0,0,0,0,0,0,0,0,0,0,0,0,0,1038013,"2023-12-28T00:00:00.000Z",42097199,9,"Jared Rhoden",0,0,0,0,0,0
"12919",1380,0,0,0,0,0,0,0,0,0,0,0,0,0,0,0,0,1038013,"2023-12-28T00:00:00.000Z",3547267,9,"Isaiah Stewart",0,0,0,0,0,0
"12920",1381,0,0,0,0,0,0,0,0,0,0,0,0,0,0,0,0,1038013,"2023-12-28T00:00:00.000Z",44477024,9,"Stanley Umude",0,0,0,0,0,0
"12921",1382,2,0,4,5,3,5,3,0,0,18,0,4,9,4,0,3,1038015,"2023-12-28T00:00:00.000Z",667378,18,"Naz Reid",0,13,15,11,6,13.8
"12922",1383,0,0,0,0,0,0,0,0,0,0,0,0,0,0,0,0,1038015,"2023-12-28T00:00:00.000Z",17895968,18,"Daishen Nix",0,0,0,0,0,0
"12923",1384,0,0,0,0,0,0,0,0,0,0,0,0,0,0,0,0,1038015,"2023-12-28T00:00:00.000Z",56677851,18,"Jaylen Clark",0,0,0,0,0,0
"12924",1385,0,0,0,0,0,0,0,0,0,0,0,0,0,0,0,0,1038015,"2023-12-28T00:00:00.000Z",17896056,18,"Luka Garza",0,0,0,0,0,0
"12925",1386,0,0,0,0,0,0,0,0,0,0,0,0,0,0,0,0,1038015,"2023-12-28T00:00:00.000Z",56677782,18,"Leonard Miller",0,0,0,0,0,0
"12926",1387,0,0,0,0,0,0,0,0,0,0,0,0,0,0,0,0,1038015,"2023-12-28T00:00:00.000Z",38017700,18,"Wendell Moore Jr.",0,0,0,0,0,0
"12927",1388,0,1,6,3,1,9,3,8,8,30,3,5,15,9,3,1,1038015,"2023-12-28T00:00:00.000Z",247,7,"Derrick Jones Jr.",4,24,24,15,9,36.8
"12928",1389,2,0,2,6,1,11,4,0,0,23,2,0,9,4,1,1,1038013,"2023-12-28T00:00:00.000Z",3547276,2,"Payton Pritchard",1,13,15,11,6,18.8
"12929",1390,1,0,2,4,1,6,2,0,0,18,1,0,5,3,0,1,1038013,"2023-12-28T00:00:00.000Z",17896060,2,"Sam Hauser",0,8,9,6,4,9.1
"12930",1391,0,0,2,0,0,2,2,2,1,20,0,4,5,2,1,0,1038013,"2023-12-28T00:00:00.000Z",17553967,2,"Neemias Queta",1,7,7,5,2,10.4
"12931",1392,0,0,0,0,0,0,0,0,0,0,0,0,0,0,0,0,1038013,"2023-12-28T00:00:00.000Z",261,2,"Luke Kornet",0,0,0,0,0,0
"12932",1393,0,0,0,0,0,0,0,0,0,0,0,0,0,0,0,0,1038013,"2023-12-28T00:00:00.000Z",338,2,"Svi Mykhailiuk",0,0,0,0,0,0
"12933",1394,0,0,0,0,0,0,0,0,0,0,0,0,0,0,0,0,1038013,"2023-12-28T00:00:00.000Z",3547279,2,"Lamar Stevens",0,0,0,0,0,0
"12934",1395,0,0,0,0,0,0,0,0,0,0,0,0,0,0,0,0,1038013,"2023-12-28T00:00:00.000Z",70,2,"Jaylen Brown",0,0,0,0,0,0
"12935",1396,0,0,0,0,0,0,0,0,0,0,0,0,0,0,0,0,1038013,"2023-12-28T00:00:00.000Z",38017707,2,"JD Davison",0,0,0,0,0,0
"12936",1398,0,0,0,0,0,0,0,0,0,0,0,0,0,0,0,0,1038013,"2023-12-28T00:00:00.000Z",56677864,2,"Jordan Walsh",0,0,0,0,0,0
"12937",1399,6,0,10,7,1,21,8,0,0,44,2,3,17,12,0,2,1038013,"2023-12-28T00:00:00.000Z",54,9,"Bojan Bogdanovic",0,29,35,23,18,38.4
"12938",1400,1,1,2,8,3,18,7,0,0,31,0,2,17,2,1,0,1038015,"2023-12-28T00:00:00.000Z",38017679,7,"Jaden Hardy",2,19,20,18,3,26.9
"12939",1401,3,0,1,7,4,13,7,1,1,26,0,1,19,1,1,0,1037836,"2023-11-26T00:00:00.000Z",3547246,27,"Devin Vassell",1,20,23,22,4,27.7
"12940",1402,6,0,4,1,0,8,4,2,2,22,0,2,10,4,0,1,1037836,"2023-11-26T00:00:00.000Z",3547274,27,"Tre Jones",0,14,20,16,10,22.8
"12941",1403,3,0,2,3,1,5,1,4,4,16,1,2,7,3,0,3,1037836,"2023-11-26T00:00:00.000Z",359,27,"Cedi Osman",0,10,13,10,6,12.1
"12942",1404,2,1,4,0,0,5,3,3,3,15,2,3,9,6,0,1,1037836,"2023-11-26T00:00:00.000Z",17895854,27,"Charles Bassey",1,15,17,11,8,21.2
"12943",1405,1,1,1,6,3,8,4,4,2,17,0,1,13,1,0,0,1037836,"2023-11-26T00:00:00.000Z",38017649,27,"Julian Champagnie",1,14,15,14,2,18.7
"12944",1406,1,0,0,2,0,2,0,0,0,12,0,0,0,0,0,0,1037836,"2023-11-26T00:00:00.000Z",305,27,"Doug McDermott",0,0,1,1,1,1.5
"12945",1407,3,0,0,1,0,2,1,0,0,7,0,0,2,0,0,0,1037836,"2023-11-26T00:00:00.000Z",180,27,"Devonte' Graham",0,2,5,5,3,6.5
"12946",1408,4,0,2,5,2,11,5,3,3,29,0,5,15,2,2,1,1037835,"2023-11-26T00:00:00.000Z",409,28,"Dennis Schroder",2,17,21,19,6,28.4
"12947",1409,0,0,1,7,1,13,5,2,2,26,0,0,13,1,1,1,1037835,"2023-11-26T00:00:00.000Z",3089,28,"Gary Trent Jr.",1,14,14,13,1,16.2
"12948",1410,0,0,0,0,0,0,0,0,0,0,0,0,0,0,0,0,1037835,"2023-11-26T00:00:00.000Z",56677828,28,"Gradey Dick",0,0,0,0,0,0
"12949",1411,0,0,0,0,0,0,0,0,0,0,0,0,0,0,0,0,1037835,"2023-11-26T00:00:00.000Z",56677805,28,"Javon Freeman-Liberty",0,0,0,0,0,0
"12950",1412,0,0,0,0,0,0,0,0,0,0,0,0,0,0,0,0,1037835,"2023-11-26T00:00:00.000Z",38017717,28,"Ron Harper Jr.",0,0,0,0,0,0
"12951",1413,2,0,0,0,0,0,0,0,0,6,0,1,0,0,1,0,1037836,"2023-11-26T00:00:00.000Z",17896059,27,"Sandro Mamukelashvili",1,0,2,2,2,6
"12952",1414,0,0,0,0,0,0,0,0,0,0,0,0,0,0,0,0,1037836,"2023-11-26T00:00:00.000Z",38017730,27,"Dominick Barlow",0,0,0,0,0,0
"12953",1415,0,0,0,0,0,0,0,0,0,0,0,0,0,0,0,0,1037836,"2023-11-26T00:00:00.000Z",56677865,27,"Charles Bediako",0,0,0,0,0,0
"12954",1416,0,0,0,0,0,0,0,0,0,0,0,0,0,0,0,0,1037834,"2023-11-26T00:00:00.000Z",666508,3,"Nicolas Claxton",0,0,0,0,0,0
"12955",1417,0,0,0,0,0,0,0,0,0,0,0,0,0,0,0,0,1037834,"2023-11-26T00:00:00.000Z",56677843,3,"Noah Clowney",0,0,0,0,0,0
"12956",1418,0,0,0,0,0,0,0,0,0,0,0,0,0,0,0,0,1037836,"2023-11-26T00:00:00.000Z",56677817,27,"Sidy Cissoko",0,0,0,0,0,0
"12957",1419,0,0,0,0,0,0,0,0,0,0,0,0,0,0,0,0,1037836,"2023-11-26T00:00:00.000Z",56677870,27,"Sir'Jabari Rice",0,0,0,0,0,0
"12958",1420,0,0,0,0,0,0,0,0,0,0,0,0,0,0,0,0,1037836,"2023-11-26T00:00:00.000Z",38017693,27,"Blake Wesley",0,0,0,0,0,0
"12959",1421,4,0,4,3,2,7,4,0,0,29,3,3,10,7,3,0,1037839,"2023-11-27T00:00:00.000Z",33,23,"Nicolas Batum",3,17,21,14,11,33.4
"12960",1422,0,0,5,4,0,12,3,2,2,23,0,1,8,5,0,1,1037839,"2023-11-27T00:00:00.000Z",200,23,"Tobias Harris",0,13,13,8,5,13
"12961",1423,11,1,7,3,2,15,9,12,10,31,4,2,30,11,1,3,1037839,"2023-11-27T00:00:00.000Z",145,23,"Joel Embiid",2,41,52,41,22,62.7
"12962",1424,3,1,1,6,1,10,3,2,2,24,0,1,9,1,1,2,1037838,"2023-11-27T00:00:00.000Z",210,12,"Buddy Hield",2,10,13,12,4,18.7
"12963",1425,2,1,2,4,1,9,3,2,2,19,2,0,9,4,0,1,1037838,"2023-11-27T00:00:00.000Z",3547243,12,"Obi Toppin",1,13,15,11,6,18.8
"12964",1426,0,0,0,0,0,0,0,0,0,0,0,0,0,0,0,0,1037632,"2023-10-29T00:00:00.000Z",56677836,14,"Maxwell Lewis",0,0,0,0,0,0
"12965",1427,0,1,6,0,0,7,6,6,4,22,2,4,16,8,0,1,1037631,"2023-10-29T00:00:00.000Z",493,13,"Ivica Zubac",1,24,24,16,8,27.6
"12966",1428,5,0,3,7,2,17,8,1,1,28,1,1,19,4,5,1,1037631,"2023-10-29T00:00:00.000Z",172,13,"Paul George",5,23,28,24,9,45.3
"12967",1429,3,1,7,5,3,13,8,3,0,27,1,3,19,8,1,2,1037631,"2023-10-29T00:00:00.000Z",472,13,"Russell Westbrook",2,27,30,22,11,37.1
"12968",1430,1,0,3,8,4,14,7,0,0,21,0,1,18,3,1,4,1037631,"2023-10-29T00:00:00.000Z",17896031,13,"Nah'Shon Hyland",1,21,22,19,4,22.1
"12969",1431,1,0,4,0,0,3,2,0,0,21,2,0,4,6,0,0,1037631,"2023-10-29T00:00:00.000Z",371,13,"Mason Plumlee",0,10,11,5,7,12.7
"12970",1432,0,1,2,3,1,6,4,2,1,18,0,1,10,2,1,2,1037631,"2023-10-29T00:00:00.000Z",3547294,13,"Kenyon Martin Jr.",2,12,12,10,2,16.4
"12971",1433,1,0,2,4,0,4,0,0,0,15,0,1,0,2,1,1,1037631,"2023-10-29T00:00:00.000Z",33,13,"Nicolas Batum",1,2,3,1,3,5.9
"12972",1434,1,0,1,0,0,0,0,0,0,5,0,0,0,1,0,1,1037631,"2023-10-29T00:00:00.000Z",666511,13,"Amir Coffey",0,1,2,1,2,1.7
"12973",1435,1,0,4,2,1,2,1,0,0,5,0,1,3,4,1,0,1037631,"2023-10-29T00:00:00.000Z",56677849,13,"Kobe Brown",1,7,8,4,5,12.3
"12974",1436,2,0,0,0,0,0,0,0,0,5,1,0,0,1,0,1,1037631,"2023-10-29T00:00:00.000Z",38017725,13,"Moussa Diabate",0,1,3,2,3,3.2
"12975",1437,0,0,0,0,0,0,0,0,0,0,0,0,0,0,0,0,1037631,"2023-10-29T00:00:00.000Z",56677856,13,"Jordan Miller",0,0,0,0,0,0
"12976",1438,5,1,0,2,2,11,6,1,1,31,0,4,15,0,2,0,1037633,"2023-10-30T00:00:00.000Z",204,4,"Gordon Hayward",3,15,20,20,5,31.5
"12977",1439,2,0,9,3,1,14,7,1,0,35,3,4,15,12,0,1,1037633,"2023-10-30T00:00:00.000Z",666950,4,"P.J. Washington",0,27,29,17,14,31.4
"12978",1440,9,0,3,5,1,13,5,7,6,41,0,4,17,3,0,0,1037632,"2023-10-29T00:00:00.000Z",405,14,"D'Angelo Russell",0,20,29,26,12,34.1
"12979",1441,1,0,6,0,0,8,8,2,2,23,1,1,18,7,0,1,1037633,"2023-10-30T00:00:00.000Z",38017698,4,"Mark Williams",0,25,26,19,8,26.9
"12980",1442,1,1,1,4,2,7,4,2,2,17,0,1,12,1,1,0,1037631,"2023-10-29T00:00:00.000Z",359,27,"Cedi Osman",2,13,14,13,2,20.7
"12981",1443,2,0,1,4,2,12,3,1,1,21,0,1,9,1,1,3,1037631,"2023-10-29T00:00:00.000Z",38017692,27,"Malaki Branham",1,10,12,11,3,13.2
"12982",1444,4,0,2,2,1,4,1,2,2,20,0,3,5,2,1,4,1037631,"2023-10-29T00:00:00.000Z",3547274,27,"Tre Jones",1,7,11,9,6,12.4
"12983",1445,2,0,3,4,2,6,3,0,0,15,0,3,8,3,0,0,1037631,"2023-10-29T00:00:00.000Z",305,27,"Doug McDermott",0,11,13,10,5,14.6
"12984",1446,1,1,0,1,0,1,0,2,1,7,0,0,1,0,0,1,1037631,"2023-10-29T00:00:00.000Z",38017693,27,"Blake Wesley",1,1,2,2,1,4.5
"12985",1447,0,1,2,2,1,4,1,0,0,7,0,0,3,2,0,1,1037631,"2023-10-29T00:00:00.000Z",38017649,27,"Julian Champagnie",1,5,5,3,2,7.4
"12986",1448,0,0,1,0,0,0,0,0,0,7,1,1,0,2,1,0,1037631,"2023-10-29T00:00:00.000Z",17896059,27,"Sandro Mamukelashvili",1,2,2,0,2,5.4
"12987",1449,0,0,0,0,0,0,0,0,0,0,0,0,0,0,0,0,1037631,"2023-10-29T00:00:00.000Z",180,27,"Devonte' Graham",0,0,0,0,0,0
"12988",1450,0,0,0,0,0,0,0,0,0,0,0,0,0,0,0,0,1037631,"2023-10-29T00:00:00.000Z",56677865,27,"Charles Bediako",0,0,0,0,0,0
"12989",1451,0,0,0,0,0,0,0,0,0,0,0,0,0,0,0,0,1037989,"2023-12-23T00:00:00.000Z",56677867,14,"Alex Fudge",0,0,0,0,0,0
"12990",1452,0,0,0,0,0,0,0,0,0,0,0,0,0,0,0,0,1037989,"2023-12-23T00:00:00.000Z",56677868,14,"D'Moi Hodge",0,0,0,0,0,0
"12991",1453,0,0,0,0,0,0,0,0,0,0,0,0,0,0,0,0,1037989,"2023-12-23T00:00:00.000Z",1603383,14,"Gabe Vincent",0,0,0,0,0,0
"12992",1454,0,0,0,0,0,0,0,0,0,0,0,0,0,0,0,0,1037985,"2023-12-23T00:00:00.000Z",420,15,"Marcus Smart",0,0,0,0,0,0
"12993",1455,4,2,4,4,2,10,6,0,0,28,1,3,14,5,2,2,1037990,"2023-12-23T00:00:00.000Z",102,27,"Zach Collins",4,19,23,18,9,36
"12994",1456,5,0,0,6,0,13,3,3,3,30,0,1,9,0,0,0,1037990,"2023-12-23T00:00:00.000Z",3547246,27,"Devin Vassell",0,9,14,14,5,16.5
"12995",1457,4,0,3,4,1,11,5,1,1,24,0,2,12,3,0,1,1037990,"2023-12-23T00:00:00.000Z",38017692,27,"Malaki Branham",0,15,19,16,7,20.6
"12996",1458,2,0,3,8,2,16,6,4,2,23,2,2,16,5,0,2,1037990,"2023-12-23T00:00:00.000Z",666682,27,"Keldon Johnson",0,21,23,18,7,23
"12997",1459,3,1,2,3,1,6,4,6,5,15,3,1,14,5,0,1,1037990,"2023-12-23T00:00:00.000Z",17896059,27,"Sandro Mamukelashvili",1,19,22,17,8,26.5
"12998",1460,4,0,1,4,1,8,4,0,0,18,0,1,9,1,1,1,1037990,"2023-12-23T00:00:00.000Z",3547274,27,"Tre Jones",1,10,14,13,5,18.2
"12999",1461,2,0,0,2,1,3,1,0,0,10,0,1,3,0,0,0,1037990,"2023-12-23T00:00:00.000Z",359,27,"Cedi Osman",0,3,5,5,2,6
"13000",1462,0,0,0,0,0,0,0,2,0,6,0,0,0,0,0,0,1037990,"2023-12-23T00:00:00.000Z",305,27,"Doug McDermott",0,0,0,0,0,0
"13001",1463,3,0,1,0,0,3,2,2,1,12,0,1,5,1,3,0,1037990,"2023-12-23T00:00:00.000Z",38017693,27,"Blake Wesley",3,6,9,8,4,19.7
"13002",1464,0,0,5,2,0,3,0,0,0,8,0,0,0,5,0,0,1037990,"2023-12-23T00:00:00.000Z",180,27,"Devonte' Graham",0,5,5,0,5,6
"13003",1465,0,0,0,0,0,0,0,0,0,0,0,0,0,0,0,0,1037990,"2023-12-23T00:00:00.000Z",56677822,27,"Victor Wembanyama",0,0,0,0,0,0
"13004",1466,0,0,0,0,0,0,0,0,0,0,0,0,0,0,0,0,1037990,"2023-12-23T00:00:00.000Z",38017730,27,"Dominick Barlow",0,0,0,0,0,0
"13005",1467,0,0,0,0,0,0,0,0,0,0,0,0,0,0,0,0,1037985,"2023-12-23T00:00:00.000Z",56677830,15,"GG Jackson",0,0,0,0,0,0
"13006",1468,0,0,0,0,0,0,0,0,0,0,0,0,0,0,0,0,1037985,"2023-12-23T00:00:00.000Z",38017728,15,"Jake LaRavia",0,0,0,0,0,0
"13007",1469,0,0,0,0,0,0,0,0,0,0,0,0,0,0,0,0,1037990,"2023-12-23T00:00:00.000Z",17895854,27,"Charles Bassey",0,0,0,0,0,0
"13008",1470,0,0,0,0,0,0,0,0,0,0,0,0,0,0,0,0,1037985,"2023-12-23T00:00:00.000Z",38017729,15,"David Roddy",0,0,0,0,0,0
"13009",1471,0,0,0,0,0,0,0,0,0,0,0,0,0,0,0,0,1037985,"2023-12-23T00:00:00.000Z",3,15,"Steven Adams",0,0,0,0,0,0
"13010",1472,0,0,0,0,0,0,0,0,0,0,0,0,0,0,0,0,1037985,"2023-12-23T00:00:00.000Z",666505,15,"Brandon Clarke",0,0,0,0,0,0
"13011",1473,0,0,0,0,0,0,0,0,0,0,0,0,0,0,0,0,1037990,"2023-12-23T00:00:00.000Z",56677865,27,"Charles Bediako",0,0,0,0,0,0
"13012",1474,0,0,0,0,0,0,0,0,0,0,0,0,0,0,0,0,1037990,"2023-12-23T00:00:00.000Z",17896049,27,"David Duke Jr.",0,0,0,0,0,0
"13013",1475,1,0,3,2,0,6,3,6,6,31,0,3,12,3,0,0,1037992,"2023-12-23T00:00:00.000Z",30,26,"Harrison Barnes",0,15,16,13,4,17.1
"13014",1476,5,0,8,2,1,8,4,0,0,36,0,3,9,8,1,1,3277501,"2023-11-24T00:00:00.000Z",460,5,"Nikola Vucevic",1,17,22,14,13,28.1
"13015",1477,3,0,4,8,4,23,16,0,0,38,0,4,36,4,1,5,3277501,"2023-11-24T00:00:00.000Z",268,5,"Zach LaVine",1,40,43,39,7,43.3
"13016",1478,3,0,2,7,4,9,5,0,0,34,1,4,14,3,0,3,3277501,"2023-11-24T00:00:00.000Z",666956,5,"Coby White",0,17,20,17,6,19.1
"13017",1479,1,1,3,1,0,3,1,4,3,19,2,2,5,5,0,1,3277501,"2023-11-24T00:00:00.000Z",110,5,"Torrey Craig",1,10,11,6,6,14.5
"13018",1480,0,0,2,0,0,4,1,0,0,6,3,2,2,5,0,0,3277501,"2023-11-24T00:00:00.000Z",137,5,"Andre Drummond",0,7,7,2,5,8
"13019",1481,1,0,1,2,0,4,1,0,0,13,0,1,2,1,1,0,3277501,"2023-11-24T00:00:00.000Z",17895983,5,"Ayo Dosunmu",1,3,4,3,2,7.7
"13020",1482,1,0,1,1,0,2,0,0,0,11,0,0,0,1,0,0,3277501,"2023-11-24T00:00:00.000Z",87,5,"Jevon Carter",0,1,2,1,2,2.7
"13021",1483,0,0,0,0,0,0,0,0,0,0,0,0,0,0,0,0,3277500,"2023-11-24T00:00:00.000Z",666971,20,"Dylan Windler",0,0,0,0,0,0
"13022",1484,3,0,2,5,3,14,7,6,6,37,0,1,23,2,1,2,3277500,"2023-11-24T00:00:00.000Z",79,16,"Jimmy Butler",1,25,28,26,5,30.9
"13023",1485,3,0,3,5,1,6,1,2,2,24,0,1,5,3,2,2,3277500,"2023-11-24T00:00:00.000Z",3092,16,"Haywood Highsmith",2,8,11,8,6,17.1
"13024",1486,2,0,10,1,0,16,8,6,5,35,2,4,21,12,2,2,3277500,"2023-11-24T00:00:00.000Z",4,16,"Bam Adebayo",2,33,35,23,14,42.4
"13025",1487,2,0,5,5,2,9,4,0,0,33,3,3,10,8,2,1,3277500,"2023-11-24T00:00:00.000Z",286,16,"Kyle Lowry",2,18,20,12,10,27.6
"13026",1488,2,0,1,4,2,10,5,3,3,34,1,3,15,2,2,2,3277500,"2023-11-24T00:00:00.000Z",391,16,"Josh Richardson",2,17,19,17,4,24.4
"13027",1489,0,0,0,0,0,0,0,0,0,0,0,0,0,0,0,0,3277500,"2023-11-24T00:00:00.000Z",74,16,"Thomas Bryant",0,0,0,0,0,0
"13028",1490,0,0,0,0,0,0,0,0,0,0,0,0,0,0,0,0,3277500,"2023-11-24T00:00:00.000Z",38017734,16,"Jamal Cain",0,0,0,0,0,0
"13029",1491,2,0,1,9,4,13,6,0,0,20,0,3,16,1,1,0,3277501,"2023-11-24T00:00:00.000Z",3089,28,"Gary Trent Jr.",1,17,19,18,3,23.2
"13030",1492,1,0,1,2,0,2,0,2,2,14,0,1,2,1,1,1,3277501,"2023-11-24T00:00:00.000Z",3547275,28,"Malachi Flynn",1,3,4,3,2,6.7
"13031",1493,0,0,1,0,0,0,0,2,2,9,0,1,2,1,0,1,3277501,"2023-11-24T00:00:00.000Z",56677828,28,"Gradey Dick",0,3,3,2,1,2.2
"13032",1494,0,1,4,5,1,8,4,2,1,25,3,1,10,7,0,0,3277505,"2023-11-24T00:00:00.000Z",68,18,"Troy Brown Jr.",1,17,17,10,7,21.4
"13033",1495,0,0,0,0,0,0,0,0,0,0,0,0,0,0,0,0,3277505,"2023-11-24T00:00:00.000Z",56677782,18,"Leonard Miller",0,0,0,0,0,0
"13034",1496,0,0,4,6,3,10,6,3,3,28,0,2,18,4,0,0,3277502,"2023-11-24T00:00:00.000Z",210,12,"Buddy Hield",0,22,22,18,4,22.8
"13035",1497,2,0,2,5,3,8,6,0,0,24,1,1,15,3,0,0,3277502,"2023-11-24T00:00:00.000Z",3547243,12,"Obi Toppin",0,18,20,17,5,21.6
"13036",1498,2,5,5,3,1,14,8,6,6,27,5,5,23,10,1,2,3277502,"2023-11-24T00:00:00.000Z",452,12,"Myles Turner",6,33,35,25,12,54
"13037",1499,5,0,4,3,0,10,3,5,4,37,0,3,10,4,3,0,3277502,"2023-11-24T00:00:00.000Z",69,12,"Bruce Brown",3,14,19,15,9,31.3
"13038",1500,10,0,2,13,5,23,9,3,3,32,0,0,26,2,0,1,3277502,"2023-11-24T00:00:00.000Z",3547245,12,"Tyrese Haliburton",0,28,38,36,12,42.4
"13039",1501,0,0,0,0,0,0,0,0,0,0,0,0,0,0,0,0,1037606,"2023-10-25T00:00:00.000Z",17896022,13,"Brandon Boston Jr.",0,0,0,0,0,0
"13040",1502,0,0,0,0,0,0,0,0,0,0,0,0,0,0,0,0,1037606,"2023-10-25T00:00:00.000Z",666743,13,"Terance Mann",0,0,0,0,0,0
"13041",1503,0,0,0,0,0,0,0,0,0,0,0,0,0,0,0,0,1037606,"2023-10-25T00:00:00.000Z",328,13,"Marcus Morris",0,0,0,0,0,0
"13042",1504,0,0,0,0,0,0,0,0,0,0,0,0,0,0,0,0,1037606,"2023-10-25T00:00:00.000Z",17896051,13,"Joshua Primo",0,0,0,0,0,0
"13043",1505,1,0,0,6,2,7,3,0,0,20,1,0,8,1,1,2,1037606,"2023-10-25T00:00:00.000Z",666923,25,"Matisse Thybulle",1,9,10,9,2,11.7
"13044",1506,1,1,1,4,0,12,5,4,3,30,2,1,13,3,0,3,1037606,"2023-10-25T00:00:00.000Z",182,25,"Jerami Grant",1,16,17,14,4,18.1
"13045",1507,0,0,0,0,0,0,0,0,0,0,0,0,0,0,0,0,1037606,"2023-10-25T00:00:00.000Z",3547289,25,"Skylar Mays",0,0,0,0,0,0
"13046",1508,0,0,0,0,0,0,0,0,0,0,0,0,0,0,0,0,1037606,"2023-10-25T00:00:00.000Z",47957121,25,"Justin Minaya",0,0,0,0,0,0
"13047",1509,0,0,0,0,0,0,0,0,0,0,0,0,0,0,0,0,1037606,"2023-10-25T00:00:00.000Z",56783340,25,"Duop Reath",0,0,0,0,0,0
"13048",1510,0,0,0,0,0,0,0,0,0,0,0,0,0,0,0,0,1037606,"2023-10-25T00:00:00.000Z",17896120,25,"Ish Wainright",0,0,0,0,0,0
"13049",1511,6,0,4,3,2,7,5,4,4,25,1,0,16,5,0,1,1037605,"2023-10-25T00:00:00.000Z",3547274,27,"Tre Jones",0,21,27,22,11,30
"13050",1512,2,0,2,3,0,7,3,1,1,18,0,1,7,2,1,1,1037605,"2023-10-25T00:00:00.000Z",38017692,27,"Malaki Branham",1,9,11,9,4,14.4
"13051",1513,1,1,1,1,0,1,0,0,0,11,0,1,0,1,0,0,1037605,"2023-10-25T00:00:00.000Z",305,27,"Doug McDermott",1,1,2,1,2,5.7
"13052",1514,0,0,0,0,0,0,0,0,0,0,0,0,0,0,0,0,1037605,"2023-10-25T00:00:00.000Z",38017730,27,"Dominick Barlow",0,0,0,0,0,0
"13053",1515,0,0,0,0,0,0,0,0,0,0,0,0,0,0,0,0,1037605,"2023-10-25T00:00:00.000Z",17554004,7,"AJ Lawson",0,0,0,0,0,0
"13054",1516,0,0,0,0,0,3,2,3,2,6,1,0,6,1,0,2,1037606,"2023-10-25T00:00:00.000Z",38017711,25,"Jabari Walker",0,7,7,6,1,5.2
"13055",1517,0,0,1,0,0,0,0,0,0,5,0,0,0,1,0,0,1037606,"2023-10-25T00:00:00.000Z",56677791,25,"Kris Murray",0,1,1,0,1,1.2
"13056",1518,0,0,0,0,0,0,0,0,0,2,0,0,0,0,0,0,1037606,"2023-10-25T00:00:00.000Z",56677829,25,"Rayan Rupert",0,0,0,0,0,0
"13057",1519,4,0,3,3,1,5,2,2,1,16,0,0,6,3,2,2,1037607,"2023-10-26T00:00:00.000Z",315,17,"Khris Middleton",2,9,13,10,7,19.6
"13058",1520,3,2,8,3,0,22,10,9,3,35,5,4,23,13,2,7,1037607,"2023-10-26T00:00:00.000Z",15,17,"Giannis Antetokounmpo",4,36,39,26,16,48.1
"13059",1521,0,0,1,4,3,7,5,0,0,29,1,4,13,2,0,2,1037607,"2023-10-26T00:00:00.000Z",283,17,"Brook Lopez",0,15,15,13,2,13.4
"13060",1522,3,0,4,1,1,4,2,0,0,31,0,1,5,4,2,2,1037607,"2023-10-26T00:00:00.000Z",38,17,"Malik Beasley",2,9,12,8,7,18.3
"13061",1523,4,0,8,12,4,20,9,17,17,37,0,2,39,8,0,0,1037607,"2023-10-26T00:00:00.000Z",278,17,"Damian Lillard",0,47,51,43,12,54.6
"13062",1524,2,0,4,1,1,4,3,2,2,27,0,3,9,4,2,1,1037607,"2023-10-26T00:00:00.000Z",112,17,"Jae Crowder",2,13,15,11,6,21.8
"13063",1525,2,1,2,4,1,6,2,2,2,20,0,0,7,2,0,0,1037607,"2023-10-26T00:00:00.000Z",105,17,"Pat Connaughton",1,9,11,9,4,15.4
"13064",1526,3,0,3,8,2,15,6,3,2,34,1,2,16,4,0,0,1037985,"2023-12-23T00:00:00.000Z",53,1,"Bogdan Bogdanovic",0,20,23,19,7,25.3
"13065",1527,4,2,3,2,0,10,5,0,0,28,4,4,10,7,2,3,1037985,"2023-12-23T00:00:00.000Z",3547244,1,"Onyeka Okongwu",4,17,21,14,11,33.4
"13066",1528,0,0,1,6,1,7,1,0,0,19,1,2,3,2,0,0,1037985,"2023-12-23T00:00:00.000Z",56677855,1,"Seth Lundy",0,5,5,3,2,5.4
"13067",1529,0,0,0,0,0,0,0,0,0,0,0,0,0,0,0,0,1037985,"2023-12-23T00:00:00.000Z",56677838,1,"Kobe Bufkin",0,0,0,0,0,0
"13068",1530,0,0,0,0,0,0,0,0,0,0,0,0,0,0,0,0,1037985,"2023-12-23T00:00:00.000Z",666564,1,"Bruno Fernando",0,0,0,0,0,0
"13069",1531,0,0,0,3,1,9,3,0,0,25,0,5,7,0,0,1,1037981,"2023-12-23T00:00:00.000Z",380,13,"Norman Powell",0,7,7,7,0,6
"13070",1532,1,0,1,2,2,5,5,3,3,21,0,2,15,1,1,0,1037981,"2023-12-23T00:00:00.000Z",439,13,"Daniel Theis",1,16,17,16,2,20.7
"13071",1533,4,0,2,2,2,2,2,0,0,25,0,3,6,2,1,0,1037981,"2023-12-23T00:00:00.000Z",56677849,13,"Kobe Brown",1,8,12,10,6,17.4
"13072",1534,0,0,2,4,1,6,3,6,6,13,1,1,13,3,0,0,1037981,"2023-12-23T00:00:00.000Z",17896022,13,"Brandon Boston Jr.",0,16,16,13,3,16.6
"13073",1535,0,0,0,2,0,4,1,0,0,8,0,0,2,0,0,0,1037981,"2023-12-23T00:00:00.000Z",17896031,13,"Nah'Shon Hyland",0,2,2,2,0,2
"13074",1536,1,0,0,0,0,0,0,0,0,2,0,0,0,0,0,0,1037971,"2023-12-21T00:00:00.000Z",17896036,21,"Tre Mann",0,0,1,1,1,1.5
"13075",1537,0,0,0,0,0,0,0,0,0,0,0,0,0,0,0,0,1037971,"2023-12-21T00:00:00.000Z",44,21,"Davis Bertans",0,0,0,0,0,0
"13076",1538,0,0,0,0,0,0,0,0,0,0,0,0,0,0,0,0,1037971,"2023-12-21T00:00:00.000Z",4197029,21,"Vasilije Micic",0,0,0,0,0,0
"13077",1539,0,0,0,0,0,0,0,0,0,0,0,0,0,0,0,0,1037971,"2023-12-21T00:00:00.000Z",24572055,21,"Olivier Sarr",0,0,0,0,0,0
"13078",1540,0,0,0,0,0,0,0,0,0,0,0,0,0,0,0,0,1037971,"2023-12-21T00:00:00.000Z",17896051,13,"Joshua Primo",0,0,0,0,0,0
"13079",1541,1,0,2,1,0,3,1,0,0,17,0,0,2,2,0,1,1037981,"2023-12-23T00:00:00.000Z",666511,13,"Amir Coffey",0,4,5,3,3,4.9
"13080",1542,2,2,2,7,3,17,9,0,0,30,1,1,21,3,1,1,1037981,"2023-12-23T00:00:00.000Z",172,13,"Paul George",3,24,26,23,5,35.6
"13081",1543,0,1,5,0,0,9,7,2,2,27,5,3,16,10,0,2,1037981,"2023-12-23T00:00:00.000Z",493,13,"Ivica Zubac",1,26,26,16,10,29
"13082",1544,3,0,3,6,0,10,0,0,0,24,1,2,0,4,0,0,1037981,"2023-12-23T00:00:00.000Z",666743,13,"Terance Mann",0,4,7,3,7,9.3
"13083",1545,9,0,4,5,2,13,6,0,0,29,0,4,14,4,1,4,1037981,"2023-12-23T00:00:00.000Z",192,13,"James Harden",1,18,27,23,13,31.3
"13084",1546,1,0,6,4,2,6,4,0,0,27,0,1,10,6,2,0,1037986,"2023-12-23T00:00:00.000Z",158,3,"Dorian Finney-Smith",2,16,17,11,7,24.7
"13085",1547,4,0,2,5,1,5,1,0,0,19,0,3,3,2,0,0,1037981,"2023-12-23T00:00:00.000Z",17896060,2,"Sam Hauser",0,5,9,7,6,11.4
"13086",1548,3,0,6,0,0,7,4,8,6,23,6,5,14,12,0,1,1037981,"2023-12-23T00:00:00.000Z",17553967,2,"Neemias Queta",0,26,29,17,15,31.9
"13087",1549,3,0,3,5,3,8,3,0,0,23,1,3,9,4,0,0,1037981,"2023-12-23T00:00:00.000Z",3547276,2,"Payton Pritchard",0,13,16,12,7,18.3
"13088",1550,1,0,1,0,0,3,2,0,0,5,1,0,4,2,0,0,1037981,"2023-12-23T00:00:00.000Z",3547279,2,"Lamar Stevens",0,6,7,5,3,7.9
"13089",1551,1,0,0,2,1,6,1,0,0,21,0,1,3,0,0,0,3277479,"2023-11-21T00:00:00.000Z",3089,28,"Gary Trent Jr.",0,3,4,4,1,4.5
"13090",1552,1,1,3,2,1,4,2,2,1,19,0,1,6,3,1,1,3277479,"2023-11-21T00:00:00.000Z",3547275,28,"Malachi Flynn",2,9,10,7,4,16.1
"13091",1553,4,0,4,1,0,4,2,2,1,15,2,3,5,6,1,3,3277479,"2023-11-21T00:00:00.000Z",3547249,28,"Precious Achiuwa",1,11,15,9,10,18.2
"13092",1554,0,1,2,3,1,4,1,0,0,18,0,3,3,2,0,0,3277479,"2023-11-21T00:00:00.000Z",58,28,"Chris Boucher",1,5,5,3,2,8.4
"13093",1555,2,0,2,3,1,4,1,0,0,12,0,0,3,2,0,0,3277479,"2023-11-21T00:00:00.000Z",56677828,28,"Gradey Dick",0,5,7,5,4,8.4
"13094",1556,1,0,0,1,1,1,1,2,2,7,1,1,5,1,0,1,3277479,"2023-11-21T00:00:00.000Z",666762,28,"Jalen McDaniels",0,6,7,6,2,6.7
"13095",1557,0,0,1,1,1,2,2,0,0,4,1,1,5,2,0,1,3277479,"2023-11-21T00:00:00.000Z",376,28,"Otto Porter Jr.",0,7,7,5,2,6.4
"13096",1558,2,0,0,0,0,1,1,0,0,4,0,0,2,0,0,0,3277479,"2023-11-21T00:00:00.000Z",436,28,"Garrett Temple",0,2,4,4,2,5
"13097",1559,0,0,0,0,0,0,0,0,0,0,0,0,0,0,0,0,3277479,"2023-11-21T00:00:00.000Z",56677805,28,"Javon Freeman-Liberty",0,0,0,0,0,0
"13098",1560,0,0,0,0,0,0,0,0,0,0,0,0,0,0,0,0,3277479,"2023-11-21T00:00:00.000Z",38017717,28,"Ron Harper Jr.",0,0,0,0,0,0
"13099",1561,0,0,0,0,0,0,0,0,0,0,0,0,0,0,0,0,3277481,"2023-11-21T00:00:00.000Z",360,23,"Kelly Oubre Jr.",0,0,0,0,0,0
"13100",1562,0,0,0,0,0,0,0,0,0,0,0,0,0,0,0,0,3277481,"2023-11-21T00:00:00.000Z",17554001,23,"Javonte Smart",0,0,0,0,0,0
"13101",1563,0,0,0,0,0,0,0,0,0,0,0,0,0,0,0,0,3277481,"2023-11-21T00:00:00.000Z",56677788,23,"Terquavion Smith",0,0,0,0,0,0
"13102",1564,2,0,4,4,0,4,0,0,0,31,4,5,0,8,3,1,3277481,"2023-11-21T00:00:00.000Z",666940,6,"Dean Wade",3,8,10,2,10,20.6
"13103",1565,3,1,12,0,0,10,6,6,6,38,0,4,18,12,0,4,3277481,"2023-11-21T00:00:00.000Z",17896076,6,"Evan Mobley",1,30,33,21,15,35.9
"13104",1566,3,0,7,0,0,20,12,2,2,35,6,4,26,13,0,2,3277481,"2023-11-21T00:00:00.000Z",9,6,"Jarrett Allen",0,39,42,29,16,44.1
"13105",1567,6,1,3,10,5,15,7,2,1,44,2,5,20,5,2,2,3277481,"2023-11-21T00:00:00.000Z",666908,6,"Max Strus",3,25,31,26,11,42
"13106",1568,8,0,4,6,2,25,10,11,10,43,1,1,32,5,3,4,3277481,"2023-11-21T00:00:00.000Z",666581,6,"Darius Garland",3,37,45,40,13,55
"13107",1569,0,0,7,4,2,9,5,0,0,26,0,2,12,7,0,1,3277481,"2023-11-21T00:00:00.000Z",344,6,"Georges Niang",0,19,19,12,7,19.4
"13108",1570,9,1,3,0,0,9,5,2,2,27,0,0,12,3,0,1,3277481,"2023-11-21T00:00:00.000Z",56677872,6,"Craig Porter",1,15,24,21,12,31.1
"13109",1571,0,0,0,1,0,1,0,0,0,6,0,0,0,0,0,0,3277481,"2023-11-21T00:00:00.000Z",3547299,6,"Sam Merrill",0,0,0,0,0,0
"13110",1572,2,1,2,0,0,1,1,2,0,15,1,0,2,3,1,0,3277481,"2023-11-21T00:00:00.000Z",444,6,"Tristan Thompson",2,5,7,4,5,14.6
"13111",1573,0,0,0,0,0,0,0,0,0,0,0,0,0,0,0,0,3277481,"2023-11-21T00:00:00.000Z",56677847,6,"Emoni Bates",0,0,0,0,0,0
"13112",1574,0,0,0,0,0,0,0,0,0,0,0,0,0,0,0,0,3277481,"2023-11-21T00:00:00.000Z",248,6,"Damian Jones",0,0,0,0,0,0
"13113",1575,0,0,0,0,0,0,0,0,0,0,0,0,0,0,0,0,3277481,"2023-11-21T00:00:00.000Z",277,6,"Caris LeVert",0,0,0,0,0,0
"13114",1576,0,0,3,1,0,5,0,0,0,6,1,1,0,4,1,0,1037596,"2023-10-25T00:00:00.000Z",56677832,12,"Jarace Walker",1,4,4,0,4,7.8
"13115",1577,1,0,3,5,2,9,4,1,1,19,1,0,11,4,1,0,1037596,"2023-10-25T00:00:00.000Z",3547243,12,"Obi Toppin",1,15,16,12,5,20.3
"13116",1578,1,3,8,2,0,8,5,2,1,23,0,4,11,8,0,2,1037596,"2023-10-25T00:00:00.000Z",452,12,"Myles Turner",3,19,20,12,9,29.1
"13117",1579,1,0,2,8,6,11,8,2,2,27,1,3,24,3,1,1,1037596,"2023-10-25T00:00:00.000Z",69,12,"Bruce Brown",1,27,28,25,4,31.1
"13118",1580,11,2,3,6,2,16,9,0,0,27,0,1,20,3,1,3,1037596,"2023-10-25T00:00:00.000Z",3547245,12,"Tyrese Haliburton",3,23,34,31,14,46.1
"13119",1581,10,0,3,1,0,9,6,0,0,22,1,4,12,4,0,2,1037596,"2023-10-25T00:00:00.000Z",38017507,12,"Andrew Nembhard",0,16,26,22,14,29.8
"13120",1582,5,1,2,7,4,9,5,0,0,25,0,0,14,2,1,1,1037596,"2023-10-25T00:00:00.000Z",210,12,"Buddy Hield",2,16,21,19,7,28.9
"13121",1583,1,1,4,3,1,5,2,2,2,23,1,3,7,5,0,1,1037596,"2023-10-25T00:00:00.000Z",3547250,12,"Aaron Nesmith",1,12,13,8,6,16.5
"13122",1584,0,0,3,0,0,4,2,0,0,11,1,2,4,4,0,0,1037596,"2023-10-25T00:00:00.000Z",17896035,12,"Isaiah Jackson",0,8,8,4,4,8.8
"13123",1585,2,0,1,0,0,2,2,0,0,6,0,0,4,1,2,0,1037596,"2023-10-25T00:00:00.000Z",304,12,"T.J. McConnell",2,5,7,6,3,14.2
"13124",1586,2,0,1,7,3,11,5,4,4,27,2,1,17,3,1,3,1037598,"2023-10-25T00:00:00.000Z",17896026,22,"Franz Wagner",1,20,22,19,5,23.6
"13125",1587,5,0,5,1,0,6,3,7,6,28,0,2,12,5,1,1,1037598,"2023-10-25T00:00:00.000Z",38017683,22,"Paolo Banchero",1,17,22,17,10,27.5
"13126",1588,1,0,4,2,0,10,4,0,0,27,4,3,8,8,2,2,1037598,"2023-10-25T00:00:00.000Z",85,22,"Wendell Carter Jr.",2,16,17,9,9,23.1
"13127",1589,0,0,3,7,2,12,3,0,0,21,1,2,8,4,0,0,1037598,"2023-10-25T00:00:00.000Z",17896073,22,"Jalen Suggs",0,12,12,8,4,12.8
"13128",1590,2,0,1,0,0,9,5,0,0,24,3,0,10,4,3,1,1037598,"2023-10-25T00:00:00.000Z",165,22,"Markelle Fultz",3,14,16,12,6,25.8
"13129",1591,2,0,7,2,1,12,8,3,3,24,1,2,20,8,0,0,1037598,"2023-10-25T00:00:00.000Z",3547251,22,"Cole Anthony",0,28,30,22,10,32.6
"13130",1592,0,0,0,0,0,0,0,0,0,0,0,0,0,0,0,0,1037596,"2023-10-25T00:00:00.000Z",56677778,12,"Oscar Tshiebwe",0,0,0,0,0,0
"13131",1593,0,0,0,0,0,0,0,0,0,0,0,0,0,0,0,0,1037596,"2023-10-25T00:00:00.000Z",56677794,12,"Isaiah Wong",0,0,0,0,0,0
"13132",1594,0,2,1,4,1,18,9,6,6,25,1,0,25,2,0,0,1037596,"2023-10-25T00:00:00.000Z",265,30,"Kyle Kuzma",2,27,27,25,2,33.4
"13133",1595,5,0,5,0,0,8,4,2,1,21,2,0,9,7,1,2,1037596,"2023-10-25T00:00:00.000Z",3547242,30,"Deni Avdija",1,16,21,14,12,25.9
"13134",1596,0,2,4,0,0,2,2,4,2,21,1,5,6,5,0,0,1037596,"2023-10-25T00:00:00.000Z",666577,30,"Daniel Gafford",2,11,11,6,5,18
"13135",1597,5,1,2,6,0,18,7,5,4,26,0,1,18,2,1,4,1037596,"2023-10-25T00:00:00.000Z",666848,30,"Jordan Poole",2,20,25,23,7,29.9
"13136",1598,6,1,2,4,2,12,7,1,0,28,1,1,16,3,1,2,1037596,"2023-10-25T00:00:00.000Z",249,30,"Tyus Jones",2,19,25,22,9,32.6
"13137",1599,0,0,0,0,0,1,0,0,0,3,0,0,0,0,0,0,1037596,"2023-10-25T00:00:00.000Z",38017704,30,"Patrick Baldwin Jr.",0,0,0,0,0,0
"13138",1600,5,0,4,3,0,3,0,0,0,18,0,3,0,4,0,1,1037598,"2023-10-25T00:00:00.000Z",226,22,"Joe Ingles",0,4,9,5,9,11.3
"13139",1601,4,0,0,2,0,8,2,2,2,19,1,0,6,1,0,1,1037936,"2023-12-17T00:00:00.000Z",3547251,22,"Cole Anthony",0,7,11,10,5,12.2
"13140",1602,2,0,1,0,0,4,2,0,0,11,0,2,4,1,2,0,1037935,"2023-12-16T00:00:00.000Z",17896033,20,"Miles McBride",2,5,7,6,3,14.2
"13141",1603,0,0,0,0,0,0,0,0,0,0,0,0,0,0,0,0,1037935,"2023-12-16T00:00:00.000Z",666474,20,"Charles Brown",0,0,0,0,0,0
"13142",1604,0,0,0,0,0,0,0,0,0,0,0,0,0,0,0,0,1037935,"2023-12-16T00:00:00.000Z",59421201,20,"Jaylen Martin",0,0,0,0,0,0
"13143",1605,0,0,0,0,0,0,0,0,0,0,0,0,0,0,0,0,1037935,"2023-12-16T00:00:00.000Z",399,20,"Mitchell Robinson",0,0,0,0,0,0
"13144",1606,0,0,0,0,0,0,0,0,0,0,0,0,0,0,0,0,1037935,"2023-12-16T00:00:00.000Z",56677795,20,"Jacob Toppin",0,0,0,0,0,0
"13145",1607,0,1,2,4,2,5,2,2,2,17,0,0,8,2,1,0,1037936,"2023-12-17T00:00:00.000Z",229,22,"Jonathan Isaac",2,10,10,8,2,16.4
"13146",1608,0,0,1,0,0,0,0,0,0,2,0,0,0,1,0,0,1037936,"2023-12-17T00:00:00.000Z",666818,22,"Chuma Okeke",0,1,1,0,1,1.2
"13147",1609,0,0,0,1,1,2,1,0,0,2,0,0,3,0,0,0,1037936,"2023-12-17T00:00:00.000Z",56677839,22,"Jett Howard",0,3,3,3,0,3
"13148",1610,0,0,0,0,0,0,0,0,0,0,0,0,0,0,0,0,1037936,"2023-12-17T00:00:00.000Z",226,22,"Joe Ingles",0,0,0,0,0,0
"13149",1611,3,0,2,7,3,13,5,1,0,30,0,2,13,2,0,1,1037937,"2023-12-17T00:00:00.000Z",3547246,27,"Devin Vassell",0,15,18,16,5,18.9
"13150",1612,0,1,2,4,2,14,7,1,1,26,3,1,17,5,0,0,1037930,"2023-12-16T00:00:00.000Z",3547250,12,"Aaron Nesmith",1,22,22,17,5,26
"13151",1613,3,0,2,2,1,3,2,0,0,24,0,2,5,2,2,1,1037930,"2023-12-16T00:00:00.000Z",56677832,12,"Jarace Walker",2,7,10,8,5,16.9
"13152",1614,3,0,1,1,0,4,3,1,1,10,0,0,7,1,0,1,1037930,"2023-12-16T00:00:00.000Z",3547207,12,"Jordan Nwora",0,8,11,10,4,11.7
"13153",1615,1,0,2,0,0,6,3,2,2,7,2,0,8,4,0,0,1037930,"2023-12-16T00:00:00.000Z",56677778,12,"Oscar Tshiebwe",0,12,13,9,5,14.3
"13154",1616,0,0,2,0,0,0,0,0,0,3,0,1,0,2,0,0,1037930,"2023-12-16T00:00:00.000Z",242,12,"James Johnson",0,2,2,0,2,2.4
"13155",1617,0,0,0,0,0,0,0,0,0,0,0,0,0,0,0,0,1037930,"2023-12-16T00:00:00.000Z",38017701,12,"Kendall Brown",0,0,0,0,0,0
"13156",1618,0,0,0,0,0,0,0,0,0,0,0,0,0,0,0,0,1037930,"2023-12-16T00:00:00.000Z",3547245,12,"Tyrese Haliburton",0,0,0,0,0,0
"13157",1619,4,0,3,1,0,7,4,4,2,15,3,1,10,6,1,0,1037935,"2023-12-16T00:00:00.000Z",472,13,"Russell Westbrook",1,16,20,14,10,26.2
"13158",1620,0,0,0,0,0,0,0,0,0,0,0,0,0,0,0,0,1037935,"2023-12-16T00:00:00.000Z",450,13,"PJ Tucker",0,0,0,0,0,0
"13159",1621,0,0,0,0,0,0,0,0,0,0,0,0,0,0,0,0,1037935,"2023-12-16T00:00:00.000Z",38017725,13,"Moussa Diabate",0,0,0,0,0,0
"13160",1622,0,0,0,0,0,0,0,0,0,0,0,0,0,0,0,0,1037935,"2023-12-16T00:00:00.000Z",17896031,13,"Nah'Shon Hyland",0,0,0,0,0,0
"13161",1623,1,0,2,5,2,8,3,5,4,22,1,0,12,3,1,0,1037934,"2023-12-16T00:00:00.000Z",56677824,29,"Taylor Hendricks",1,15,16,13,4,20.1
"13162",1624,0,0,4,1,0,1,0,0,0,4,0,0,0,4,0,0,1037934,"2023-12-16T00:00:00.000Z",19465584,29,"Micah Potter",0,4,4,0,4,4.8
"13163",1625,1,0,0,2,0,2,0,0,0,4,0,0,0,0,0,0,1037934,"2023-12-16T00:00:00.000Z",38017630,29,"Johnny Juzang",0,0,1,1,1,1.5
"13164",1626,0,0,0,0,0,0,0,0,0,0,0,0,0,0,0,0,3277450,"2023-11-17T00:00:00.000Z",290,26,"Trey Lyles",0,0,0,0,0,0
"13165",1627,0,1,1,0,0,0,0,0,0,1,0,0,0,1,0,0,3277452,"2023-11-17T00:00:00.000Z",491,19,"Cody Zeller",1,1,1,0,1,4.2
"13166",1628,0,0,0,0,0,0,0,0,0,0,0,0,0,0,0,0,3277452,"2023-11-17T00:00:00.000Z",38017663,19,"E.J. Liddell",0,0,0,0,0,0
"13167",1629,0,0,0,0,0,0,0,0,0,0,0,0,0,0,0,0,3277452,"2023-11-17T00:00:00.000Z",303,19,"CJ McCollum",0,0,0,0,0,0
"13168",1630,0,0,0,0,0,0,0,0,0,0,0,0,0,0,0,0,3277452,"2023-11-17T00:00:00.000Z",18677986,19,"Trey Murphy III",0,0,0,0,0,0
"13169",1631,0,0,0,0,0,0,0,0,0,0,0,0,0,0,0,0,3277452,"2023-11-17T00:00:00.000Z",340,19,"Larry Nance Jr.",0,0,0,0,0,0
"13170",1632,0,0,0,0,0,0,0,0,0,0,0,0,0,0,0,0,3277452,"2023-11-17T00:00:00.000Z",38017726,19,"Dereon Seabron",0,0,0,0,0,0
"13171",1633,0,0,8,6,2,14,8,1,0,33,3,3,18,11,0,0,3277452,"2023-11-17T00:00:00.000Z",375,8,"Michael Porter Jr.",0,29,29,18,11,31.2
"13172",1634,0,0,0,0,0,0,0,0,0,0,0,0,0,0,0,0,3277449,"2023-11-17T00:00:00.000Z",489,28,"Thaddeus Young",0,0,0,0,0,0
"13173",1635,4,1,3,5,3,14,9,3,2,36,0,2,23,3,1,3,3277449,"2023-11-17T00:00:00.000Z",70,2,"Jaylen Brown",2,26,30,27,7,35.6
"13174",1636,2,0,6,11,1,22,8,0,0,37,1,3,17,7,1,3,3277449,"2023-11-17T00:00:00.000Z",434,2,"Jayson Tatum",1,24,26,19,9,28.4
"13175",1637,5,3,10,3,0,13,6,2,2,35,2,3,14,12,1,2,3277449,"2023-11-17T00:00:00.000Z",378,2,"Kristaps Porzingis",4,26,31,19,17,45.9
"13176",1638,5,0,4,8,3,10,4,2,2,34,0,1,13,4,0,1,3277449,"2023-11-17T00:00:00.000Z",473,2,"Derrick White",0,17,22,18,9,24.3
"13177",1639,5,0,6,4,2,14,5,2,2,35,2,2,14,8,0,1,3277449,"2023-11-17T00:00:00.000Z",214,2,"Jrue Holiday",0,22,27,19,13,30.1
"13178",1640,3,0,2,6,3,7,4,0,0,23,1,0,11,3,1,0,3277449,"2023-11-17T00:00:00.000Z",17896060,2,"Sam Hauser",1,14,17,14,6,22.1
"13179",1641,2,0,3,4,3,5,4,0,0,23,1,1,11,4,0,0,3277449,"2023-11-17T00:00:00.000Z",219,2,"Al Horford",0,15,17,13,6,18.8
"13180",1642,3,0,2,5,1,7,2,0,0,17,1,1,5,3,1,0,3277449,"2023-11-17T00:00:00.000Z",3547276,2,"Payton Pritchard",1,8,11,8,6,16.1
"13181",1643,0,0,0,0,0,0,0,0,0,0,0,0,0,0,0,0,3277449,"2023-11-17T00:00:00.000Z",17896094,2,"Dalano Banton",0,0,0,0,0,0
"13182",1644,0,0,0,0,0,0,0,0,0,0,0,0,0,0,0,0,3277449,"2023-11-17T00:00:00.000Z",666468,2,"Oshae Brissett",0,0,0,0,0,0
"13183",1645,0,0,0,0,0,0,0,0,0,0,0,0,0,0,0,0,3277449,"2023-11-17T00:00:00.000Z",261,2,"Luke Kornet",0,0,0,0,0,0
"13184",1646,0,0,0,0,0,0,0,0,0,0,0,0,0,0,0,0,3277448,"2023-11-17T00:00:00.000Z",666676,6,"Ty Jerome",0,0,0,0,0,0
"13185",1647,0,0,0,0,0,0,0,0,0,0,0,0,0,0,0,0,3277448,"2023-11-17T00:00:00.000Z",322,6,"Donovan Mitchell",0,0,0,0,0,0
"13186",1648,0,0,0,0,0,0,0,0,0,0,0,0,0,0,0,0,3277448,"2023-11-17T00:00:00.000Z",38017662,6,"Isaiah Mobley",0,0,0,0,0,0
"13187",1649,0,0,0,0,0,0,0,0,0,0,0,0,0,0,0,0,3277446,"2023-11-17T00:00:00.000Z",17896089,20,"Duane Washington Jr.",0,0,0,0,0,0
"13188",1650,0,0,0,0,0,0,0,0,0,0,0,0,0,0,0,0,3277446,"2023-11-17T00:00:00.000Z",666971,20,"Dylan Windler",0,0,0,0,0,0
"13189",1651,0,0,0,0,0,0,0,0,0,0,0,0,0,0,0,0,1038107,"2024-01-09T00:00:00.000Z",666786,15,"Ja Morant",0,0,0,0,0,0
"13190",1652,5,0,9,3,1,13,10,3,2,35,1,4,23,10,2,3,1038108,"2024-01-09T00:00:00.000Z",666423,28,"RJ Barrett",2,33,38,28,15,45.5
"13191",1653,3,1,4,5,3,17,10,3,2,32,0,2,25,4,0,1,1038108,"2024-01-09T00:00:00.000Z",416,28,"Pascal Siakam",1,29,32,28,7,36.3
"13192",1654,4,1,4,1,0,9,5,0,0,29,1,4,10,5,3,0,1038108,"2024-01-09T00:00:00.000Z",489,28,"Thaddeus Young",4,15,19,14,9,34
"13193",1655,6,2,2,7,3,20,11,2,1,40,1,6,26,3,0,2,1038108,"2024-01-09T00:00:00.000Z",17896055,28,"Scottie Barnes",2,29,35,32,9,42.6
"13194",1656,5,0,4,6,4,14,8,3,1,26,1,6,21,5,0,1,1038108,"2024-01-09T00:00:00.000Z",3547269,28,"Immanuel Quickley",0,26,31,26,10,33.5
"13195",1657,3,0,0,2,0,2,0,0,0,10,0,0,0,0,1,0,1038108,"2024-01-09T00:00:00.000Z",2309958,28,"Jontay Porter",1,0,3,3,3,7.5
"13196",1658,6,0,1,3,2,6,3,2,2,30,1,2,10,2,0,2,1038108,"2024-01-09T00:00:00.000Z",409,28,"Dennis Schroder",0,12,18,16,8,19.4
"13197",1659,1,0,7,2,0,3,1,0,0,14,0,1,2,7,2,3,1038108,"2024-01-09T00:00:00.000Z",58,28,"Chris Boucher",2,9,10,3,8,14.9
"13198",1660,0,0,0,0,0,0,0,0,0,0,0,0,0,0,0,0,1038108,"2024-01-09T00:00:00.000Z",666762,28,"Jalen McDaniels",0,0,0,0,0,0
"13199",1661,0,0,0,0,0,0,0,0,0,0,0,0,0,0,0,0,1038108,"2024-01-09T00:00:00.000Z",376,28,"Otto Porter Jr.",0,0,0,0,0,0
"13200",1662,3,1,10,7,4,16,9,13,13,43,1,1,35,11,2,2,1038109,"2024-01-10T00:00:00.000Z",70,2,"Jaylen Brown",3,46,49,38,14,59.7
"13201",1663,2,0,4,11,6,26,13,14,13,42,0,3,45,4,1,1,1038109,"2024-01-10T00:00:00.000Z",434,2,"Jayson Tatum",1,49,51,47,6,54.8
"13202",1664,5,0,7,6,3,8,3,0,0,38,1,3,9,8,0,1,1038109,"2024-01-10T00:00:00.000Z",219,2,"Al Horford",0,17,22,14,13,25.1
"13203",1665,6,0,4,5,1,11,3,2,2,44,2,5,9,6,0,2,1038109,"2024-01-10T00:00:00.000Z",473,2,"Derrick White",0,15,21,15,12,23.2
"13204",1666,4,1,4,10,2,15,5,0,0,40,1,3,12,5,2,2,1038109,"2024-01-10T00:00:00.000Z",214,2,"Jrue Holiday",3,17,21,16,9,31
"13205",1667,0,1,4,5,2,6,2,0,0,18,0,2,6,4,0,0,1038109,"2024-01-10T00:00:00.000Z",17896060,2,"Sam Hauser",1,10,10,6,4,13.8
"13206",1668,0,0,0,0,0,0,0,0,0,0,0,0,0,0,0,0,1038108,"2024-01-09T00:00:00.000Z",666626,14,"Jaxson Hayes",0,0,0,0,0,0
"13207",1669,0,0,0,0,0,0,0,0,0,0,0,0,0,0,0,0,1038108,"2024-01-09T00:00:00.000Z",56677835,14,"Jalen Hood-Schifino",0,0,0,0,0,0
"13208",1670,0,0,0,0,0,0,0,0,0,0,0,0,0,0,0,0,1038108,"2024-01-09T00:00:00.000Z",56677836,14,"Maxwell Lewis",0,0,0,0,0,0
"13209",1671,0,0,0,0,0,0,0,0,0,0,0,0,0,0,0,0,1038108,"2024-01-09T00:00:00.000Z",3547289,14,"Skylar Mays",0,0,0,0,0,0
"13210",1672,0,0,0,0,0,0,0,0,0,0,0,0,0,0,0,0,1038108,"2024-01-09T00:00:00.000Z",666971,14,"Dylan Windler",0,0,0,0,0,0
"13211",1673,0,0,0,0,0,0,0,0,0,0,0,0,0,0,0,0,1038108,"2024-01-09T00:00:00.000Z",56677738,14,"Colin Castleton",0,0,0,0,0,0
"13212",1674,1,0,1,6,4,10,5,0,0,24,0,1,14,1,0,0,1038108,"2024-01-09T00:00:00.000Z",3089,28,"Gary Trent Jr.",0,15,16,15,2,16.7
"13213",1675,0,0,0,0,0,0,0,0,0,0,0,0,0,0,0,0,1038108,"2024-01-09T00:00:00.000Z",436,28,"Garrett Temple",0,0,0,0,0,0
"13214",1676,3,3,8,10,3,22,9,8,6,36,3,1,27,11,0,3,1037911,"2023-12-14T00:00:00.000Z",434,2,"Jayson Tatum",3,38,41,30,14,50.7
"13215",1677,0,2,5,6,1,11,5,8,7,31,1,2,18,6,1,3,1037911,"2023-12-14T00:00:00.000Z",378,2,"Kristaps Porzingis",3,24,24,18,6,31.2
"13216",1678,3,0,3,4,2,10,5,2,2,35,2,0,14,5,3,3,1037911,"2023-12-14T00:00:00.000Z",473,2,"Derrick White",3,19,22,17,8,30.5
"13217",1679,4,0,1,3,1,11,7,0,0,37,2,2,15,3,0,2,1037911,"2023-12-14T00:00:00.000Z",214,2,"Jrue Holiday",0,18,22,19,7,22.6
"13218",1680,1,0,0,3,3,3,3,0,0,18,0,2,9,0,0,0,1037911,"2023-12-14T00:00:00.000Z",17896060,2,"Sam Hauser",0,9,10,10,1,10.5
"13219",1681,3,1,7,2,1,4,3,0,0,24,3,1,7,10,0,0,1037911,"2023-12-14T00:00:00.000Z",219,2,"Al Horford",1,17,20,10,13,26.5
"13220",1682,7,0,5,3,1,8,4,4,4,30,1,1,13,6,0,2,1037903,"2023-12-13T00:00:00.000Z",3547242,30,"Deni Avdija",0,19,26,20,13,28.7
"13221",1683,4,1,7,8,4,19,10,4,3,29,0,1,27,7,1,1,1037903,"2023-12-13T00:00:00.000Z",265,30,"Kyle Kuzma",2,34,38,31,11,46.4
"13222",1684,3,0,6,1,0,7,5,0,0,30,2,3,10,8,1,0,1037902,"2023-12-13T00:00:00.000Z",56677826,9,"Ausar Thompson",1,18,21,13,11,27.1
"13223",1685,2,0,1,9,5,19,11,8,6,34,0,1,33,1,1,1,1037902,"2023-12-13T00:00:00.000Z",54,9,"Bojan Bogdanovic",1,34,36,35,3,39.2
"13224",1686,2,0,2,1,0,3,1,2,2,22,2,3,4,4,0,2,1037902,"2023-12-13T00:00:00.000Z",3547267,9,"Isaiah Stewart",0,8,10,6,6,9.8
"13225",1687,7,0,5,8,1,17,5,12,10,30,1,3,21,6,0,1,1037902,"2023-12-13T00:00:00.000Z",17896075,9,"Cade Cunningham",0,27,34,28,13,37.7
"13226",1688,6,0,3,0,0,8,3,0,0,32,0,2,6,3,1,1,1037902,"2023-12-13T00:00:00.000Z",3547241,9,"Killian Hayes",1,9,15,12,9,20.6
"13227",1689,0,1,3,0,0,7,5,0,0,16,0,6,10,3,1,1,1037902,"2023-12-13T00:00:00.000Z",3547240,9,"James Wiseman",2,13,13,10,3,18.6
"13228",1690,0,0,3,2,0,4,1,0,0,27,0,1,2,3,1,0,1037902,"2023-12-13T00:00:00.000Z",17896071,9,"Isaiah Livers",1,5,5,2,3,8.6
"13229",1691,1,0,3,4,2,9,5,4,3,20,1,5,15,4,0,0,1037900,"2023-12-12T00:00:00.000Z",407,10,"Dario Saric",0,19,20,16,5,21.3
"13230",1692,5,0,6,4,2,14,9,1,0,29,5,2,20,11,1,3,1037900,"2023-12-12T00:00:00.000Z",56677858,10,"Brandin Podziemski",1,31,36,25,16,40.7
"13231",1693,0,1,0,0,0,1,1,0,0,7,0,1,2,0,1,0,1037900,"2023-12-12T00:00:00.000Z",56677799,10,"Trayce Jackson-Davis",2,2,2,2,0,8
"13232",1694,0,0,0,0,0,0,0,0,0,0,0,0,0,0,0,0,1037900,"2023-12-12T00:00:00.000Z",251,10,"Cory Joseph",0,0,0,0,0,0
"13233",1695,0,0,0,0,0,0,0,0,0,0,0,0,0,0,0,0,1037900,"2023-12-12T00:00:00.000Z",2189,10,"Gary Payton II",0,0,0,0,0,0
"13234",1696,0,0,0,0,0,0,0,0,0,0,0,0,0,0,0,0,1037900,"2023-12-12T00:00:00.000Z",17896070,10,"Usman Garuba",0,0,0,0,0,0
"13235",1697,0,0,0,0,0,0,0,0,0,0,0,0,0,0,0,0,1037900,"2023-12-12T00:00:00.000Z",45658838,10,"Lester Quinones",0,0,0,0,0,0
"13236",1698,0,0,0,0,0,0,0,0,0,0,0,0,0,0,0,0,1037900,"2023-12-12T00:00:00.000Z",398,10,"Jerome Robinson",0,0,0,0,0,0
"13237",1699,0,0,0,0,0,0,0,0,0,0,0,0,0,0,0,0,1037900,"2023-12-12T00:00:00.000Z",57875092,10,"Gui Santos",0,0,0,0,0,0
"13238",1700,1,1,2,3,0,8,2,6,3,21,0,2,7,2,0,0,1037902,"2023-12-13T00:00:00.000Z",38017682,9,"Jaden Ivey",1,9,10,8,3,13.9
"13239",1701,0,0,0,0,0,0,0,0,0,0,0,0,0,0,0,0,1037738,"2023-11-13T00:00:00.000Z",27,5,"Lonzo Ball",0,0,0,0,0,0
"13240",1702,0,0,0,0,0,0,0,0,0,0,0,0,0,0,0,0,1037738,"2023-11-13T00:00:00.000Z",56677874,5,"Onuralp Bitim",0,0,0,0,0,0
"13241",1703,0,0,0,0,0,0,0,0,0,0,0,0,0,0,0,0,1037738,"2023-11-13T00:00:00.000Z",45969255,5,"Justin Lewis",0,0,0,0,0,0
"13242",1704,0,0,0,0,0,0,0,0,0,0,0,0,0,0,0,0,1037738,"2023-11-13T00:00:00.000Z",56677860,5,"Adama Sanogo",0,0,0,0,0,0
"13243",1705,0,0,0,0,0,0,0,0,0,0,0,0,0,0,0,0,1037738,"2023-11-13T00:00:00.000Z",38017719,5,"Dalen Terry",0,0,0,0,0,0
"13244",1706,0,0,0,1,0,1,0,0,0,1,0,0,0,0,0,0,1037736,"2023-11-13T00:00:00.000Z",17896033,20,"Miles McBride",0,0,0,0,0,0
"13245",1707,0,0,0,0,0,0,0,0,0,1,0,0,0,0,0,0,1037736,"2023-11-13T00:00:00.000Z",17896063,20,"Jericho Sims",0,0,0,0,0,0
"13246",1708,0,0,0,0,0,0,0,0,0,0,0,0,0,0,0,0,1037736,"2023-11-13T00:00:00.000Z",666423,20,"RJ Barrett",0,0,0,0,0,0
"13247",1709,0,0,0,0,0,0,0,0,0,0,0,0,0,0,0,0,1037736,"2023-11-13T00:00:00.000Z",666675,20,"DaQuan Jeffries",0,0,0,0,0,0
"13248",1710,0,0,0,0,0,0,0,0,0,0,0,0,0,0,0,0,1037736,"2023-11-13T00:00:00.000Z",666474,20,"Charles Brown",0,0,0,0,0,0
"13249",1711,0,0,0,0,0,0,0,0,0,0,0,0,0,0,0,0,1037736,"2023-11-13T00:00:00.000Z",160,20,"Evan Fournier",0,0,0,0,0,0
"13250",1712,0,0,0,0,0,0,0,0,0,0,0,0,0,0,0,0,1037736,"2023-11-13T00:00:00.000Z",56677795,20,"Jacob Toppin",0,0,0,0,0,0
"13251",1713,0,0,0,0,0,0,0,0,0,0,0,0,0,0,0,0,1037736,"2023-11-13T00:00:00.000Z",17896089,20,"Duane Washington Jr.",0,0,0,0,0,0
"13252",1714,0,0,0,0,0,0,0,0,0,0,0,0,0,0,0,0,1037736,"2023-11-13T00:00:00.000Z",666971,20,"Dylan Windler",0,0,0,0,0,0
"13253",1715,1,0,4,11,6,23,12,2,2,36,2,1,32,6,0,1,3277425,"2023-11-14T00:00:00.000Z",666950,4,"P.J. Washington",0,38,39,33,7,39.7
"13254",1716,1,0,1,2,1,6,2,0,0,28,3,1,5,4,0,0,3277425,"2023-11-14T00:00:00.000Z",18678001,4,"JT Thor",0,9,10,6,5,11.3
"13255",1717,0,0,3,0,0,5,5,4,1,23,4,2,11,7,1,0,3277425,"2023-11-14T00:00:00.000Z",38017698,4,"Mark Williams",1,18,18,11,7,22.4
"13256",1718,3,0,3,2,0,5,0,2,2,23,0,1,2,3,0,2,3277425,"2023-11-14T00:00:00.000Z",3547253,4,"Theo Maledon",0,5,8,5,6,8.1
"13257",1719,11,0,4,10,4,26,9,6,6,39,2,5,28,6,3,8,3277425,"2023-11-14T00:00:00.000Z",3547239,4,"LaMelo Ball",3,34,45,39,17,52.7
"13258",1720,1,0,4,5,3,7,4,2,1,29,0,4,12,4,1,1,3277425,"2023-11-14T00:00:00.000Z",38017708,4,"Bryce McGowens",1,16,17,13,5,20.3
"13259",1721,0,0,0,1,0,2,0,0,0,3,0,0,0,0,0,0,3277425,"2023-11-14T00:00:00.000Z",56677866,4,"Leaky Black",0,0,0,0,0,0
"13260",1722,0,0,0,0,0,0,0,0,0,0,0,0,0,0,0,0,3277425,"2023-11-14T00:00:00.000Z",56677848,4,"Amari Bailey",0,0,0,0,0,0
"13261",1723,1,1,1,2,0,3,1,0,0,16,0,2,2,1,0,0,3277427,"2023-11-14T00:00:00.000Z",108,23,"Robert Covington",1,3,4,3,2,7.7
"13262",1724,3,0,7,1,0,17,11,1,0,37,0,3,22,7,1,1,3277427,"2023-11-14T00:00:00.000Z",200,23,"Tobias Harris",1,29,32,25,10,36.9
"13263",1725,6,0,9,4,0,22,11,17,17,38,3,4,39,12,3,5,3277427,"2023-11-14T00:00:00.000Z",145,23,"Joel Embiid",3,51,57,45,18,66.4
"13264",1726,0,0,0,0,0,0,0,0,0,0,0,0,0,0,0,0,1038081,"2024-01-05T00:00:00.000Z",666747,16,"Caleb Martin",0,0,0,0,0,0
"13265",1727,0,0,0,0,0,0,0,0,0,0,0,0,0,0,0,0,1038081,"2024-01-05T00:00:00.000Z",39398582,16,"Orlando Robinson",0,0,0,0,0,0
"13266",1728,3,1,1,3,2,11,6,5,4,22,0,1,18,1,3,1,1038079,"2024-01-05T00:00:00.000Z",182,25,"Jerami Grant",4,19,22,21,4,34.7
"13267",1729,1,0,6,7,2,10,4,1,0,24,1,2,10,7,1,2,1038079,"2024-01-05T00:00:00.000Z",56677850,25,"Toumani Camara",1,17,18,11,8,20.9
"13268",1730,2,0,3,3,1,12,7,2,1,27,4,3,16,7,0,3,1038079,"2024-01-05T00:00:00.000Z",56783340,25,"Duop Reath",0,23,25,18,9,24.4
"13269",1731,4,0,5,4,1,8,1,3,3,23,0,1,6,5,0,2,1038079,"2024-01-05T00:00:00.000Z",419,25,"Anfernee Simons",0,11,15,10,9,16
"13270",1732,10,0,2,7,3,15,7,0,0,33,1,0,17,3,1,1,1038079,"2024-01-05T00:00:00.000Z",56677747,25,"Scoot Henderson",1,20,30,27,13,37.6
"13271",1733,0,1,2,1,0,2,0,0,0,14,0,0,0,2,1,0,1038079,"2024-01-05T00:00:00.000Z",666923,25,"Matisse Thybulle",2,2,2,0,2,8.4
"13272",1734,1,0,2,0,0,1,0,0,0,18,0,3,0,2,0,1,1038079,"2024-01-05T00:00:00.000Z",39613724,25,"Ibou Badji",0,2,3,1,3,2.9
"13273",1735,3,0,3,4,0,8,2,2,0,16,0,0,4,3,1,3,1038079,"2024-01-05T00:00:00.000Z",65,25,"Malcolm Brogdon",1,7,10,7,6,12.1
"13274",1736,2,1,4,6,1,15,5,4,4,24,1,2,15,5,1,2,1038079,"2024-01-05T00:00:00.000Z",38017690,25,"Shaedon Sharpe",2,20,22,17,7,28
"13275",1737,1,0,2,3,2,8,4,0,0,20,2,0,10,4,1,1,1038079,"2024-01-05T00:00:00.000Z",56677791,25,"Kris Murray",1,14,15,11,5,18.3
"13276",1738,0,0,0,0,0,0,0,0,0,0,0,0,0,0,0,0,1038079,"2024-01-05T00:00:00.000Z",3547289,25,"Skylar Mays",0,0,0,0,0,0
"13277",1739,0,0,0,0,0,0,0,0,0,0,0,0,0,0,0,0,1038081,"2024-01-05T00:00:00.000Z",19465585,16,"Dru Smith",0,0,0,0,0,0
"13278",1740,0,0,0,0,0,0,0,0,0,0,0,0,0,0,0,0,1038076,"2024-01-05T00:00:00.000Z",56677848,4,"Amari Bailey",0,0,0,0,0,0
"13279",1741,0,0,0,0,0,0,0,0,0,0,0,0,0,0,0,0,1038076,"2024-01-05T00:00:00.000Z",3547239,4,"LaMelo Ball",0,0,0,0,0,0
"13280",1742,0,0,0,0,0,0,0,0,0,0,0,0,0,0,0,0,1038076,"2024-01-05T00:00:00.000Z",56677866,4,"Leaky Black",0,0,0,0,0,0
"13281",1743,0,0,0,0,0,0,0,0,0,0,0,0,0,0,0,0,1038076,"2024-01-05T00:00:00.000Z",204,4,"Gordon Hayward",0,0,0,0,0,0
"13282",1744,0,0,0,0,0,0,0,0,0,0,0,0,0,0,0,0,1038076,"2024-01-05T00:00:00.000Z",347,4,"Frank Ntilikina",0,0,0,0,0,0
"13283",1745,0,0,0,0,0,0,0,0,0,0,0,0,0,0,0,0,1038076,"2024-01-05T00:00:00.000Z",38017698,4,"Mark Williams",0,0,0,0,0,0
"13284",1746,0,1,2,0,0,9,4,2,1,20,5,2,9,7,0,1,1038072,"2024-01-05T00:00:00.000Z",83,1,"Clint Capela",1,16,16,9,7,19.4
"13285",1747,2,0,1,3,2,19,13,2,2,34,0,0,30,1,0,1,1038072,"2024-01-05T00:00:00.000Z",334,1,"Dejounte Murray",0,31,33,32,3,33.2
"13286",1748,6,0,2,11,1,18,4,5,4,28,0,2,13,2,2,3,1038072,"2024-01-05T00:00:00.000Z",490,1,"Trae Young",2,15,21,19,8,27.4
"13287",1749,2,1,0,1,1,3,2,3,2,10,0,0,7,0,0,1,1038079,"2024-01-05T00:00:00.000Z",24489167,7,"Brandon Williams",1,7,9,9,2,12
"13288",1750,0,0,2,2,1,5,3,0,0,19,1,3,7,3,0,2,1038079,"2024-01-05T00:00:00.000Z",56677829,25,"Rayan Rupert",0,10,10,7,3,8.6
"13289",1751,5,0,5,9,3,23,11,12,11,39,1,0,36,6,2,3,1037886,"2023-12-11T00:00:00.000Z",666581,6,"Darius Garland",2,42,47,41,11,53.7
"13290",1752,0,0,0,0,0,0,0,0,0,0,0,0,0,0,0,0,1037885,"2023-12-11T00:00:00.000Z",56677792,9,"Marcus Sasser",0,0,0,0,0,0
"13291",1753,3,0,4,3,1,8,3,2,2,26,2,1,9,6,1,3,1037887,"2023-12-11T00:00:00.000Z",3547242,30,"Deni Avdija",1,15,18,12,9,20.7
"13292",1754,1,0,7,2,1,17,9,4,2,28,2,0,21,9,0,2,1037887,"2023-12-11T00:00:00.000Z",265,30,"Kyle Kuzma",0,30,31,22,10,31.3
"13293",1755,1,0,1,3,0,4,0,2,0,20,3,3,0,4,0,0,1037887,"2023-12-11T00:00:00.000Z",337,30,"Mike Muscala",0,4,5,1,5,6.3
"13294",1756,3,0,0,3,1,11,3,4,4,26,0,1,11,0,0,3,1037887,"2023-12-11T00:00:00.000Z",666848,30,"Jordan Poole",0,11,14,14,3,12.5
"13295",1757,3,0,5,5,1,9,4,0,0,21,0,0,9,5,1,2,1037887,"2023-12-11T00:00:00.000Z",249,30,"Tyus Jones",1,14,17,12,8,20.5
"13296",1758,0,0,1,0,0,0,0,2,2,11,0,2,2,1,0,2,1037887,"2023-12-11T00:00:00.000Z",167,30,"Danilo Gallinari",0,3,3,2,1,1.2
"13297",1759,1,0,1,3,1,6,3,4,2,23,1,4,9,2,0,3,1037887,"2023-12-11T00:00:00.000Z",17896045,30,"Corey Kispert",0,11,12,10,3,9.9
"13298",1760,4,1,5,7,2,11,4,6,3,31,3,0,13,8,1,3,1037887,"2023-12-11T00:00:00.000Z",56677844,30,"Bilal Coulibaly",2,21,25,17,12,31.6
"13299",1761,4,0,0,0,0,7,5,3,2,19,0,2,12,0,2,1,1037887,"2023-12-11T00:00:00.000Z",18677954,30,"Jared Butler",2,12,16,16,4,23
"13300",1762,0,0,0,0,0,1,0,0,0,2,0,1,0,0,0,0,1037887,"2023-12-11T00:00:00.000Z",17896106,30,"Eugene Omoruyi",0,0,0,0,0,0
"13301",1763,1,0,4,3,2,5,3,2,2,17,0,2,10,4,0,0,1037887,"2023-12-11T00:00:00.000Z",38017704,30,"Patrick Baldwin Jr.",0,14,15,11,5,16.3
"13302",1764,0,1,3,0,0,2,1,2,1,10,1,2,3,4,0,2,1037887,"2023-12-11T00:00:00.000Z",3547302,30,"Anthony Gill",1,7,7,3,4,8.8
"13303",1766,0,0,0,0,0,0,0,0,0,0,0,0,0,0,0,0,1037887,"2023-12-11T00:00:00.000Z",38017687,30,"Johnny Davis",0,0,0,0,0,0
"13304",1767,0,0,0,0,0,0,0,0,0,0,0,0,0,0,0,0,1037887,"2023-12-11T00:00:00.000Z",666577,30,"Daniel Gafford",0,0,0,0,0,0
"13305",1768,0,0,0,0,0,0,0,0,0,0,0,0,0,0,0,0,1037887,"2023-12-11T00:00:00.000Z",38017712,30,"Ryan Rollins",0,0,0,0,0,0
"13306",1769,0,0,0,0,0,0,0,0,0,0,0,0,0,0,0,0,1037887,"2023-12-11T00:00:00.000Z",414,30,"Landry Shamet",0,0,0,0,0,0
"13307",1770,0,0,0,0,0,0,0,0,0,0,0,0,0,0,0,0,1037887,"2023-12-11T00:00:00.000Z",487,30,"Delon Wright",0,0,0,0,0,0
"13308",1771,0,0,0,0,0,0,0,0,0,0,0,0,0,0,0,0,1037886,"2023-12-11T00:00:00.000Z",404,6,"Ricky Rubio",0,0,0,0,0,0
"13309",1772,7,0,6,3,1,12,7,4,2,32,0,4,17,6,1,0,1037884,"2023-12-11T00:00:00.000Z",204,4,"Gordon Hayward",1,23,30,24,13,37.7
"13310",1773,1,0,3,6,2,14,7,2,2,34,1,3,18,4,0,2,1037884,"2023-12-11T00:00:00.000Z",62,4,"Miles Bridges",0,22,23,19,5,22.3
"13311",1774,1,0,3,0,0,6,2,2,2,26,3,1,6,6,0,0,1037884,"2023-12-11T00:00:00.000Z",3547282,4,"Nick Richards",0,12,13,7,7,14.7
"13312",1775,2,0,4,8,3,14,6,1,1,30,0,5,16,4,0,2,1037884,"2023-12-11T00:00:00.000Z",56677823,4,"Brandon Miller",0,20,22,18,6,21.8
"13313",1776,0,0,0,2,0,2,0,0,0,5,0,0,0,0,0,1,1037722,"2023-11-11T00:00:00.000Z",338,2,"Svi Mykhailiuk",0,0,0,0,0,-1
"13314",1777,0,0,0,0,0,0,0,0,0,0,0,0,0,0,0,0,1037722,"2023-11-11T00:00:00.000Z",3547279,2,"Lamar Stevens",0,0,0,0,0,0
"13315",1778,0,0,0,0,0,0,0,0,0,0,0,0,0,0,0,0,1037722,"2023-11-11T00:00:00.000Z",38017707,2,"JD Davison",0,0,0,0,0,0
"13316",1779,0,0,0,0,0,0,0,0,0,0,0,0,0,0,0,0,1037722,"2023-11-11T00:00:00.000Z",3547295,2,"Nathan Knight",0,0,0,0,0,0
"13317",1780,0,0,0,0,0,0,0,0,0,0,0,0,0,0,0,0,1037722,"2023-11-11T00:00:00.000Z",17553967,2,"Neemias Queta",0,0,0,0,0,0
"13318",1781,0,0,0,0,0,0,0,0,0,0,0,0,0,0,0,0,1037722,"2023-11-11T00:00:00.000Z",56677864,2,"Jordan Walsh",0,0,0,0,0,0
"13319",1782,2,0,2,8,2,13,3,0,0,28,1,0,8,3,1,0,1037722,"2023-11-11T00:00:00.000Z",18,28,"OG Anunoby",1,11,13,10,5,17.6
"13320",1783,3,0,5,4,0,17,6,6,5,28,2,0,17,7,3,3,1037722,"2023-11-11T00:00:00.000Z",416,28,"Pascal Siakam",3,24,27,20,10,35.9
"13321",1784,2,0,1,0,0,10,6,0,0,21,2,3,12,3,0,1,1037722,"2023-11-11T00:00:00.000Z",373,28,"Jakob Poeltl",0,15,17,14,5,17.6
"13322",1785,4,1,4,9,2,15,4,0,0,29,1,1,10,5,1,1,1037722,"2023-11-11T00:00:00.000Z",17896055,28,"Scottie Barnes",2,15,19,14,9,27
"13323",1786,4,0,1,3,1,7,3,7,7,25,0,3,14,1,1,1,1037722,"2023-11-11T00:00:00.000Z",409,28,"Dennis Schroder",1,15,19,18,5,23.2
"13324",1787,0,0,0,0,0,0,0,0,0,0,0,0,0,0,0,0,1037732,"2023-11-12T00:00:00.000Z",56677870,27,"Sir'Jabari Rice",0,0,0,0,0,0
"13325",1788,4,1,4,3,1,14,5,9,8,37,2,1,19,6,0,2,1037732,"2023-11-12T00:00:00.000Z",79,16,"Jimmy Butler",1,25,29,23,10,33.2
"13326",1789,1,0,3,3,0,4,0,0,0,26,1,3,0,4,0,0,1037732,"2023-11-12T00:00:00.000Z",3092,16,"Haywood Highsmith",0,4,5,1,5,6.3
"13327",1790,6,0,7,0,0,20,10,5,4,34,4,0,24,11,3,0,1037732,"2023-11-12T00:00:00.000Z",4,16,"Bam Adebayo",3,35,41,30,17,55.2
"13328",1791,4,1,4,7,4,16,8,6,6,39,1,1,26,5,0,0,1037732,"2023-11-12T00:00:00.000Z",397,16,"Duncan Robinson",1,31,35,30,9,41
"13329",1792,4,0,3,4,2,7,4,2,2,26,0,2,12,3,1,0,1037732,"2023-11-12T00:00:00.000Z",391,16,"Josh Richardson",1,15,19,16,7,24.6
"13330",1793,3,1,5,2,1,10,4,2,2,32,1,1,11,6,4,1,1037732,"2023-11-12T00:00:00.000Z",56677785,16,"Jaime Jaquez Jr.",5,17,20,14,9,36.7
"13331",1794,0,0,2,7,2,8,3,4,4,14,0,2,12,2,0,0,1037732,"2023-11-12T00:00:00.000Z",285,16,"Kevin Love",0,14,14,12,2,14.4
"13332",1795,0,0,0,0,0,0,0,0,0,0,0,0,0,0,0,0,1037723,"2023-11-11T00:00:00.000Z",56677806,1,"Mouhamed Gueye",0,0,0,0,0,0
"13333",1796,0,0,0,0,0,0,0,0,0,0,0,0,0,0,0,0,1037723,"2023-11-11T00:00:00.000Z",56677855,1,"Seth Lundy",0,0,0,0,0,0
"13334",1797,0,0,0,0,0,0,0,0,0,0,0,0,0,0,0,0,1037723,"2023-11-11T00:00:00.000Z",56677875,1,"Miles Norris",0,0,0,0,0,0
"13335",1798,4,0,2,7,2,17,8,2,2,38,1,3,20,3,1,3,1037723,"2023-11-11T00:00:00.000Z",56677785,16,"Jaime Jaquez Jr.",1,23,27,24,7,29.6
"13336",1799,5,1,5,5,0,13,3,7,5,34,1,2,11,6,2,1,1037723,"2023-11-11T00:00:00.000Z",3092,16,"Haywood Highsmith",3,17,22,16,11,33.7
"13337",1800,4,2,12,0,0,12,9,8,8,39,4,2,26,16,2,3,1037723,"2023-11-11T00:00:00.000Z",4,16,"Bam Adebayo",4,42,46,30,20,60.2
"13338",1801,0,0,0,0,0,0,0,0,0,0,0,0,0,0,0,0,1038068,"2024-01-03T00:00:00.000Z",165,22,"Markelle Fultz",0,0,0,0,0,0
"13339",1802,0,0,0,0,0,0,0,0,0,0,0,0,0,0,0,0,1038064,"2024-01-03T00:00:00.000Z",151,7,"Dante Exum",0,0,0,0,0,0
"13340",1803,0,0,0,2,0,2,0,0,0,7,0,0,0,0,0,0,1038062,"2024-01-03T00:00:00.000Z",38017729,15,"David Roddy",0,0,0,0,0,0
"13341",1804,0,0,0,0,0,0,0,0,0,0,0,0,0,0,0,0,1038062,"2024-01-03T00:00:00.000Z",376,28,"Otto Porter Jr.",0,0,0,0,0,0
"13342",1805,0,0,2,0,0,3,2,0,0,15,0,0,4,2,0,2,1038067,"2024-01-03T00:00:00.000Z",457,14,"Jarred Vanderbilt",0,6,6,4,2,4.4
"13343",1806,3,1,4,2,0,10,5,3,3,24,4,1,13,8,0,2,1038067,"2024-01-03T00:00:00.000Z",486,14,"Christian Wood",1,21,24,16,11,28.1
"13344",1807,0,0,1,0,0,4,0,0,0,6,1,1,0,2,0,0,1038067,"2024-01-03T00:00:00.000Z",56677835,14,"Jalen Hood-Schifino",0,2,2,0,2,2.4
"13345",1808,0,0,0,0,0,0,0,0,0,1,0,0,0,0,0,0,1038067,"2024-01-03T00:00:00.000Z",666626,14,"Jaxson Hayes",0,0,0,0,0,0
"13346",1809,0,0,0,0,0,0,0,0,0,0,0,0,0,0,0,0,1038066,"2024-01-03T00:00:00.000Z",666881,29,"Luka Samanic",0,0,0,0,0,0
"13347",1810,0,0,0,0,0,0,0,0,0,0,0,0,0,0,0,0,1038068,"2024-01-03T00:00:00.000Z",38017607,22,"Kevon Harris",0,0,0,0,0,0
"13348",1811,0,0,0,0,0,0,0,0,0,0,0,0,0,0,0,0,1038068,"2024-01-03T00:00:00.000Z",56677839,22,"Jett Howard",0,0,0,0,0,0
"13349",1812,0,0,0,0,0,0,0,0,0,0,0,0,0,0,0,0,1038068,"2024-01-03T00:00:00.000Z",226,22,"Joe Ingles",0,0,0,0,0,0
"13350",1813,0,0,0,0,0,0,0,0,0,0,0,0,0,0,0,0,1038068,"2024-01-03T00:00:00.000Z",229,22,"Jonathan Isaac",0,0,0,0,0,0
"13351",1814,0,0,0,0,0,0,0,0,0,0,0,0,0,0,0,0,1038087,"2024-01-06T00:00:00.000Z",313,23,"De'Anthony Melton",0,0,0,0,0,0
"13352",1815,2,0,6,6,1,9,3,0,0,33,1,1,7,7,1,4,1038087,"2024-01-06T00:00:00.000Z",38017739,29,"Simone Fontecchio",1,14,16,9,9,17.4
"13353",1816,1,1,9,9,5,19,12,5,4,35,4,2,33,13,0,1,1038087,"2024-01-06T00:00:00.000Z",297,29,"Lauri Markkanen",1,46,47,34,14,52.1
"13354",1817,2,1,4,0,0,10,9,2,1,28,1,1,19,5,0,1,1038087,"2024-01-06T00:00:00.000Z",101,29,"John Collins",1,24,26,21,7,30
"13355",1818,10,0,2,3,1,14,9,4,3,27,1,3,22,3,0,5,1038087,"2024-01-06T00:00:00.000Z",413,29,"Collin Sexton",0,25,35,32,13,35.6
"13356",1819,1,2,5,1,0,1,0,0,0,23,0,3,0,5,1,1,1038087,"2024-01-06T00:00:00.000Z",139,29,"Kris Dunn",3,5,6,1,6,15.5
"13357",1820,0,0,3,0,0,4,4,2,2,19,1,2,10,4,1,0,1038087,"2024-01-06T00:00:00.000Z",38017705,29,"Walker Kessler",1,14,14,10,4,17.8
"13358",1821,6,0,5,6,0,14,5,9,8,31,0,0,18,5,1,5,1038087,"2024-01-06T00:00:00.000Z",100,29,"Jordan Clarkson",1,23,29,24,11,31
"13359",1822,3,0,2,2,0,4,2,2,2,16,0,2,6,2,0,2,1038087,"2024-01-06T00:00:00.000Z",56677834,29,"Keyonte George",0,8,11,9,5,10.9
"13360",1823,1,0,2,2,0,2,0,0,0,13,1,1,0,3,0,1,1038087,"2024-01-06T00:00:00.000Z",38017620,29,"Ochai Agbaji",0,3,4,1,4,4.1
"13361",1824,4,0,1,1,1,3,2,0,0,15,0,3,5,1,0,3,1038087,"2024-01-06T00:00:00.000Z",358,29,"Kelly Olynyk",0,6,10,9,5,9.2
"13362",1825,0,0,0,0,0,0,0,0,0,0,0,0,0,0,0,0,1038087,"2024-01-06T00:00:00.000Z",666650,29,"Talen Horton-Tucker",0,0,0,0,0,0
"13363",1826,0,0,0,0,0,0,0,0,0,4,0,1,0,0,0,0,7050290,"2023-12-08T00:00:00.000Z",56677776,8,"Julian Strawther",0,0,0,0,0,0
"13364",1827,6,0,2,4,0,8,2,2,2,25,1,2,6,3,0,0,7050290,"2023-12-08T00:00:00.000Z",236,8,"Reggie Jackson",0,9,15,12,9,18.6
"13365",1828,2,0,3,1,0,9,4,5,5,26,1,3,13,4,0,1,7050290,"2023-12-08T00:00:00.000Z",38017721,8,"Peyton Watson",0,17,19,15,6,19.8
"13366",1829,0,0,0,0,0,0,0,0,0,0,0,0,0,0,0,0,7050287,"2023-12-08T00:00:00.000Z",3547259,18,"Jaden McDaniels",0,0,0,0,0,0
"13367",1830,0,0,0,0,0,0,0,0,0,0,0,0,0,0,0,0,7050287,"2023-12-08T00:00:00.000Z",56677782,18,"Leonard Miller",0,0,0,0,0,0
"13368",1831,0,0,0,0,0,0,0,0,0,0,0,0,0,0,0,0,7050287,"2023-12-08T00:00:00.000Z",38017715,18,"Josh Minott",0,0,0,0,0,0
"13369",1832,0,0,0,0,0,0,0,0,0,0,0,0,0,0,0,0,7050287,"2023-12-08T00:00:00.000Z",17895968,18,"Daishen Nix",0,0,0,0,0,0
"13370",1833,2,0,3,0,0,2,1,0,0,12,1,2,2,4,1,1,7050290,"2023-12-08T00:00:00.000Z",250,8,"DeAndre Jordan",1,6,8,4,6,11.8
"13371",1834,0,0,0,0,0,1,1,0,0,6,0,1,2,0,1,0,7050290,"2023-12-08T00:00:00.000Z",215,8,"Justin Holiday",1,2,2,2,0,5
"13372",1835,0,0,0,0,0,0,0,0,0,0,0,0,0,0,0,0,7050290,"2023-12-08T00:00:00.000Z",3547268,8,"Zeke Nnaji",0,0,0,0,0,0
"13373",1836,0,0,0,0,0,0,0,0,0,0,0,0,0,0,0,0,7050290,"2023-12-08T00:00:00.000Z",56677582,8,"Jalen Pickett",0,0,0,0,0,0
"13374",1837,0,0,0,0,0,0,0,0,0,0,0,0,0,0,0,0,7050290,"2023-12-08T00:00:00.000Z",56677871,8,"Hunter Tyson",0,0,0,0,0,0
"13375",1838,0,0,0,0,0,0,0,0,0,0,0,0,0,0,0,0,7050290,"2023-12-08T00:00:00.000Z",666489,8,"Vlatko Cancar",0,0,0,0,0,0
"13376",1839,0,0,0,0,0,0,0,0,0,0,0,0,0,0,0,0,7050290,"2023-12-08T00:00:00.000Z",38017727,8,"Collin Gillespie",0,0,0,0,0,0
"13377",1840,0,0,0,0,0,0,0,0,0,0,0,0,0,0,0,0,7050289,"2023-12-08T00:00:00.000Z",17896116,5,"Terry Taylor",0,0,0,0,0,0
"13378",1841,0,0,0,0,0,0,0,0,0,0,0,0,0,0,0,0,7050289,"2023-12-08T00:00:00.000Z",38017719,5,"Dalen Terry",0,0,0,0,0,0
"13379",1842,0,0,0,0,0,0,0,0,0,0,0,0,0,0,0,0,7050289,"2023-12-08T00:00:00.000Z",27,5,"Lonzo Ball",0,0,0,0,0,0
"13380",1843,0,0,0,0,0,0,0,0,0,0,0,0,0,0,0,0,7050289,"2023-12-08T00:00:00.000Z",56677874,5,"Onuralp Bitim",0,0,0,0,0,0
"13381",1844,0,0,0,0,0,0,0,0,0,0,0,0,0,0,0,0,7050289,"2023-12-08T00:00:00.000Z",268,5,"Zach LaVine",0,0,0,0,0,0
"13382",1845,0,0,0,0,0,0,0,0,0,0,0,0,0,0,0,0,7050289,"2023-12-08T00:00:00.000Z",45969255,5,"Justin Lewis",0,0,0,0,0,0
"13383",1846,0,0,0,0,0,0,0,0,0,0,0,0,0,0,0,0,7050289,"2023-12-08T00:00:00.000Z",56677860,5,"Adama Sanogo",0,0,0,0,0,0
"13384",1847,3,2,0,3,0,5,0,0,0,29,2,3,0,2,2,1,7996365,"2023-12-08T00:00:00.000Z",356,24,"Josh Okogie",4,2,5,3,5,17.9
"13385",1848,2,0,3,3,1,6,2,2,0,17,1,0,5,4,0,0,7996365,"2023-12-08T00:00:00.000Z",32,24,"Keita Bates-Diop",0,9,11,7,6,12.8
"13386",1849,3,0,8,4,2,13,6,4,1,30,1,3,15,9,1,0,7996365,"2023-12-08T00:00:00.000Z",349,24,"Jusuf Nurkic",1,24,27,18,12,33.3
"13387",1850,3,1,0,7,3,13,7,2,2,38,0,3,19,0,2,4,7996365,"2023-12-08T00:00:00.000Z",178,24,"Eric Gordon",3,19,22,22,3,28.5
"13388",1851,2,0,0,3,1,5,1,2,2,14,0,0,5,0,1,0,3277400,"2023-11-10T00:00:00.000Z",213,11,"Aaron Holiday",1,5,7,7,2,11
"13389",1852,0,0,0,0,0,0,0,0,0,0,0,0,0,0,0,0,3277397,"2023-11-10T00:00:00.000Z",197,9,"Joe Harris",0,0,0,0,0,0
"13390",1853,0,0,0,0,0,0,0,0,0,0,0,0,0,0,0,0,3277397,"2023-11-10T00:00:00.000Z",17896071,9,"Isaiah Livers",0,0,0,0,0,0
"13391",1854,0,0,0,0,0,0,0,0,0,0,0,0,0,0,0,0,3277397,"2023-11-10T00:00:00.000Z",330,9,"Monte Morris",0,0,0,0,0,0
"13392",1855,1,0,6,3,0,9,3,3,2,26,2,3,8,8,2,0,3277397,"2023-11-10T00:00:00.000Z",360,23,"Kelly Oubre Jr.",2,16,17,9,9,25.1
"13393",1856,2,1,4,3,2,15,8,6,6,38,1,1,24,5,0,3,3277397,"2023-11-10T00:00:00.000Z",200,23,"Tobias Harris",1,29,31,26,7,33
"13394",1857,0,0,0,0,0,0,0,0,0,0,0,0,0,0,0,0,3277399,"2023-11-10T00:00:00.000Z",219,2,"Al Horford",0,0,0,0,0,0
"13395",1858,0,0,0,0,0,0,0,0,0,0,0,0,0,0,0,0,3277399,"2023-11-10T00:00:00.000Z",3547295,2,"Nathan Knight",0,0,0,0,0,0
"13396",1859,0,0,0,0,0,0,0,0,0,0,0,0,0,0,0,0,3277399,"2023-11-10T00:00:00.000Z",17553967,2,"Neemias Queta",0,0,0,0,0,0
"13397",1860,4,0,3,7,1,13,3,2,2,35,0,4,9,3,0,0,3277397,"2023-11-10T00:00:00.000Z",56677792,9,"Marcus Sasser",0,12,16,13,7,18.6
"13398",1861,0,0,0,2,1,3,2,0,0,7,0,1,5,0,0,1,3277397,"2023-11-10T00:00:00.000Z",42097199,9,"Jared Rhoden",0,5,5,5,0,4
"13399",1862,0,0,1,0,0,3,3,0,0,6,2,1,6,3,0,0,3277397,"2023-11-10T00:00:00.000Z",3547240,9,"James Wiseman",0,9,9,6,3,9.6
"13400",1863,0,0,0,0,0,0,0,0,0,0,0,0,0,0,0,0,3277399,"2023-11-10T00:00:00.000Z",56677864,2,"Jordan Walsh",0,0,0,0,0,0
"13401",1864,0,0,3,6,3,13,4,0,0,25,2,3,11,5,0,1,3277399,"2023-11-10T00:00:00.000Z",666679,3,"Cameron Johnson",0,16,16,11,5,16
"13402",1865,4,0,3,3,1,3,1,0,0,27,0,3,3,3,0,1,3277399,"2023-11-10T00:00:00.000Z",351,3,"Royce O'Neale",0,6,10,7,7,11.6
"13403",1866,2,1,1,5,3,6,3,0,0,28,2,4,9,3,0,0,3277399,"2023-11-10T00:00:00.000Z",158,3,"Dorian Finney-Smith",1,12,14,11,5,18.6
"13404",1867,1,0,5,6,1,11,4,3,3,28,0,2,12,5,0,2,3277399,"2023-11-10T00:00:00.000Z",61,3,"Mikal Bridges",0,17,18,13,6,17.5
"13405",1868,2,0,0,1,0,2,1,0,0,16,0,1,2,0,1,0,3277402,"2023-11-10T00:00:00.000Z",359,27,"Cedi Osman",1,2,4,4,2,8
"13406",1869,1,0,0,3,1,4,1,0,0,14,0,2,3,0,0,0,3277402,"2023-11-10T00:00:00.000Z",305,27,"Doug McDermott",0,3,4,4,1,4.5
"13407",1870,0,0,0,0,0,0,0,0,0,0,0,0,0,0,0,0,3277402,"2023-11-10T00:00:00.000Z",38017693,27,"Blake Wesley",0,0,0,0,0,0
"13408",1871,0,0,0,0,0,0,0,0,0,0,0,0,0,0,0,0,3277402,"2023-11-10T00:00:00.000Z",56677865,27,"Charles Bediako",0,0,0,0,0,0
"13409",1872,0,0,0,0,0,0,0,0,0,0,0,0,0,0,0,0,3277402,"2023-11-10T00:00:00.000Z",56677817,27,"Sidy Cissoko",0,0,0,0,0,0
"13410",1873,0,0,0,0,0,0,0,0,0,0,0,0,0,0,0,0,3277402,"2023-11-10T00:00:00.000Z",56677870,27,"Sir'Jabari Rice",0,0,0,0,0,0
"13411",1874,8,2,4,13,7,28,14,3,2,38,0,3,37,4,1,3,3277401,"2023-11-10T00:00:00.000Z",3547287,15,"Desmond Bane",3,41,49,45,12,59.8
"13412",1875,2,0,2,2,0,13,7,0,0,23,2,2,14,4,0,2,3277401,"2023-11-10T00:00:00.000Z",231,15,"Jaren Jackson Jr.",0,18,20,16,6,19.8
"13413",1876,1,1,2,0,0,2,2,1,0,10,1,1,4,3,0,0,1038081,"2024-01-05T00:00:00.000Z",666451,24,"Bol Bol",1,7,8,5,4,12.1
"13414",1877,0,0,4,1,1,8,4,4,2,22,2,1,11,6,1,0,1038081,"2024-01-05T00:00:00.000Z",147,24,"Drew Eubanks",1,17,17,11,6,21.2
"13415",1878,0,0,0,1,0,3,1,0,0,9,1,0,2,1,0,0,1038081,"2024-01-05T00:00:00.000Z",470,24,"Yuta Watanabe",0,3,3,2,1,3.2
"13416",1879,0,0,3,3,0,6,0,0,0,19,1,1,0,4,3,0,1038081,"2024-01-05T00:00:00.000Z",32,24,"Keita Bates-Diop",3,4,4,0,4,13.8
"13417",1880,0,0,0,1,0,1,0,0,0,2,0,0,0,0,0,0,1038081,"2024-01-05T00:00:00.000Z",18678058,24,"Jordan Goodwin",0,0,0,0,0,0
"13418",1881,0,0,2,0,0,0,0,0,0,2,0,0,0,2,0,0,1038081,"2024-01-05T00:00:00.000Z",74,16,"Thomas Bryant",0,2,2,0,2,2.4
"13419",1882,0,0,0,0,0,0,0,0,0,0,0,0,0,0,0,0,1038089,"2024-01-07T00:00:00.000Z",17895854,27,"Charles Bassey",0,0,0,0,0,0
"13420",1883,0,0,0,0,0,0,0,0,0,0,0,0,0,0,0,0,1038089,"2024-01-07T00:00:00.000Z",56677817,27,"Sidy Cissoko",0,0,0,0,0,0
"13421",1884,0,0,0,0,0,0,0,0,0,0,0,0,0,0,0,0,1038089,"2024-01-07T00:00:00.000Z",102,27,"Zach Collins",0,0,0,0,0,0
"13422",1885,0,0,0,0,0,0,0,0,0,0,0,0,0,0,0,0,1038089,"2024-01-07T00:00:00.000Z",17896049,27,"David Duke Jr.",0,0,0,0,0,0
"13423",1886,0,0,3,3,1,4,2,2,1,16,1,0,6,4,0,1,1038080,"2024-01-05T00:00:00.000Z",38017709,8,"Christian Braun",0,10,10,6,4,9.8
"13424",1887,3,0,2,5,1,12,5,0,0,17,1,0,11,3,0,1,1038080,"2024-01-05T00:00:00.000Z",236,8,"Reggie Jackson",0,14,17,14,6,18.1
"13425",1888,0,0,1,0,0,1,1,2,1,11,1,4,3,2,1,2,1038080,"2024-01-05T00:00:00.000Z",3547268,8,"Zeke Nnaji",1,5,5,3,2,6.4
"13426",1889,1,0,1,1,0,1,0,0,0,10,0,1,0,1,0,0,1038080,"2024-01-05T00:00:00.000Z",215,8,"Justin Holiday",0,1,2,1,2,2.7
"13427",1890,1,0,2,2,1,3,1,0,0,6,0,1,3,2,0,0,1038080,"2024-01-05T00:00:00.000Z",17896007,8,"Braxton Key",0,5,6,4,3,6.9
"13428",1891,0,0,0,0,0,0,0,0,0,0,0,0,0,0,0,0,1038080,"2024-01-05T00:00:00.000Z",38017727,8,"Collin Gillespie",0,0,0,0,0,0
"13429",1892,0,0,0,0,0,0,0,0,0,0,0,0,0,0,0,0,1038080,"2024-01-05T00:00:00.000Z",17896103,8,"Jay Huff",0,0,0,0,0,0
"13430",1893,0,0,0,0,0,0,0,0,0,0,0,0,0,0,0,0,1038080,"2024-01-05T00:00:00.000Z",250,8,"DeAndre Jordan",0,0,0,0,0,0
"13431",1894,0,0,0,0,0,0,0,0,0,0,0,0,0,0,0,0,1038076,"2024-01-05T00:00:00.000Z",17896037,4,"James Bouknight",0,0,0,0,0,0
"13432",1895,0,0,0,0,0,0,0,0,0,0,0,0,0,0,0,0,1038079,"2024-01-05T00:00:00.000Z",476,25,"Robert Williams III",0,0,0,0,0,0
"13433",1896,0,0,0,0,0,0,0,0,0,0,0,0,0,0,0,0,1038088,"2024-01-06T00:00:00.000Z",666453,17,"Marques Bolden",0,0,0,0,0,0
"13434",1897,0,0,0,0,0,0,0,0,0,0,0,0,0,0,0,0,1038088,"2024-01-06T00:00:00.000Z",112,17,"Jae Crowder",0,0,0,0,0,0
"13435",1898,0,0,0,0,0,0,0,0,0,0,0,0,0,0,0,0,1038088,"2024-01-06T00:00:00.000Z",56677854,17,"Chris Livingston",0,0,0,0,0,0
"13436",1899,0,0,0,0,0,0,0,0,0,0,0,0,0,0,0,0,1038088,"2024-01-06T00:00:00.000Z",38017691,17,"TyTy Washington Jr.",0,0,0,0,0,0
"13437",1900,0,0,0,0,0,0,0,0,0,0,0,0,0,0,0,0,1038088,"2024-01-06T00:00:00.000Z",666960,17,"Lindell Wigginton",0,0,0,0,0,0
"13438",1901,0,0,0,1,0,3,1,2,1,8,3,0,3,3,0,0,1037909,"2023-12-13T00:00:00.000Z",17896038,3,"Day'Ron Sharpe",0,6,6,3,3,6.6
"13439",1902,7,0,3,8,3,18,10,3,3,30,1,4,26,4,0,2,1037910,"2023-12-13T00:00:00.000Z",413,29,"Collin Sexton",0,30,37,33,11,39.3
"13440",1903,4,2,5,5,1,18,9,10,8,38,1,3,27,6,1,2,1037909,"2023-12-13T00:00:00.000Z",140,24,"Kevin Durant",3,33,37,31,10,47.2
"13441",1904,0,0,1,3,2,8,3,0,0,20,3,2,8,4,2,1,1037909,"2023-12-13T00:00:00.000Z",314,24,"Chimezie Metu",2,12,12,8,4,17.8
"13442",1905,3,2,16,2,0,15,7,2,1,31,6,3,15,22,0,0,1037909,"2023-12-13T00:00:00.000Z",349,24,"Jusuf Nurkic",2,37,40,18,25,51.9
"13443",1906,4,0,1,2,2,9,6,0,0,34,0,1,14,1,1,2,1037909,"2023-12-13T00:00:00.000Z",37,24,"Bradley Beal",1,15,19,18,5,22.2
"13444",1907,12,0,5,6,2,15,9,15,14,40,1,5,34,6,0,2,1037909,"2023-12-13T00:00:00.000Z",57,24,"Devin Booker",0,40,52,46,18,57.2
"13445",1908,3,0,5,5,2,7,4,0,0,27,2,2,10,7,0,2,1037909,"2023-12-13T00:00:00.000Z",666729,24,"Nassir Little",0,17,20,13,10,20.9
"13446",1909,0,0,0,2,0,2,0,0,0,7,1,2,0,1,0,0,1037909,"2023-12-13T00:00:00.000Z",470,24,"Yuta Watanabe",0,1,1,0,1,1.2
"13447",1910,3,0,4,3,1,14,7,2,0,24,0,2,15,4,0,1,1037910,"2023-12-13T00:00:00.000Z",666650,29,"Talen Horton-Tucker",0,19,22,18,7,23.3
"13448",1911,1,3,5,0,0,7,4,3,1,23,3,3,9,8,0,2,1037910,"2023-12-13T00:00:00.000Z",38017705,29,"Walker Kessler",3,17,18,10,9,27.1
"13449",1912,0,0,2,0,0,1,0,0,0,5,1,0,0,3,0,0,1037910,"2023-12-13T00:00:00.000Z",11891374,29,"Omer Yurtseven",0,3,3,0,3,3.6
"13450",1913,0,0,0,0,0,0,0,0,0,0,0,0,0,0,0,0,1037910,"2023-12-13T00:00:00.000Z",19465584,29,"Micah Potter",0,0,0,0,0,0
"13451",1914,0,0,0,0,0,0,0,0,0,0,0,0,0,0,0,0,1037910,"2023-12-13T00:00:00.000Z",56677842,29,"Brice Sensabaugh",0,0,0,0,0,0
"13452",1915,0,0,0,0,0,0,0,0,0,0,0,0,0,0,0,0,1037910,"2023-12-13T00:00:00.000Z",17896023,29,"Josh Christopher",0,0,0,0,0,0
"13453",1916,0,0,0,0,0,0,0,0,0,0,0,0,0,0,0,0,1037910,"2023-12-13T00:00:00.000Z",100,29,"Jordan Clarkson",0,0,0,0,0,0
"13454",1917,0,0,0,0,0,0,0,0,0,0,0,0,0,0,0,0,1037910,"2023-12-13T00:00:00.000Z",101,29,"John Collins",0,0,0,0,0,0
"13455",1918,0,0,0,0,0,0,0,0,0,0,0,0,0,0,0,0,1037910,"2023-12-13T00:00:00.000Z",38017630,29,"Johnny Juzang",0,0,0,0,0,0
"13456",1919,0,0,0,0,0,0,0,0,0,0,0,0,0,0,0,0,1037910,"2023-12-13T00:00:00.000Z",666881,29,"Luka Samanic",0,0,0,0,0,0
"13457",1920,0,0,0,0,0,0,0,0,0,0,0,0,0,0,0,0,1037909,"2023-12-13T00:00:00.000Z",178,24,"Eric Gordon",0,0,0,0,0,0
"13458",1921,0,0,0,0,0,0,0,0,0,0,0,0,0,0,0,0,1037909,"2023-12-13T00:00:00.000Z",272,24,"Damion Lee",0,0,0,0,0,0
"13459",1922,0,0,0,0,0,0,0,0,0,0,0,0,0,0,0,0,1037909,"2023-12-13T00:00:00.000Z",356,24,"Josh Okogie",0,0,0,0,0,0
"13460",1923,0,0,0,0,0,0,0,0,0,0,0,0,0,0,0,0,1037909,"2023-12-13T00:00:00.000Z",421,3,"Dennis Smith Jr.",0,0,0,0,0,0
"13461",1924,0,0,0,0,0,0,0,0,0,0,0,0,0,0,0,0,1037909,"2023-12-13T00:00:00.000Z",464,3,"Lonnie Walker IV",0,0,0,0,0,0
"13462",1925,0,0,0,0,0,0,0,0,0,0,0,0,0,0,0,0,1037909,"2023-12-13T00:00:00.000Z",56677841,3,"Dariq Whitehead",0,0,0,0,0,0
"13463",1926,2,0,3,4,0,4,0,3,3,13,0,1,3,3,3,1,3277430,"2023-11-14T00:00:00.000Z",114,7,"Seth Curry",3,6,8,5,5,17.6
"13464",1927,0,0,0,0,0,0,0,0,0,3,1,0,0,1,0,0,3277431,"2023-11-14T00:00:00.000Z",47957121,25,"Justin Minaya",0,1,1,0,1,1.2
"13465",1928,0,0,0,0,0,0,0,0,0,0,0,0,0,0,0,0,3277431,"2023-11-14T00:00:00.000Z",666476,25,"Moses Brown",0,0,0,0,0,0
"13466",1929,1,0,10,0,0,2,2,6,6,25,1,5,10,11,1,3,3277425,"2023-11-14T00:00:00.000Z",3547282,4,"Nick Richards",1,21,22,11,12,24.7
"13467",1930,0,1,5,7,1,15,4,0,0,27,2,5,9,7,3,4,3277433,"2023-11-14T00:00:00.000Z",475,10,"Andrew Wiggins",4,16,16,9,7,25.4
"13468",1931,0,0,2,0,0,0,0,0,0,2,0,1,0,2,0,1,3277433,"2023-11-14T00:00:00.000Z",185,10,"Draymond Green",0,2,2,0,2,1.4
"13469",1932,4,0,3,11,3,15,6,6,6,32,1,4,21,4,2,2,3277433,"2023-11-14T00:00:00.000Z",407,10,"Dario Saric",2,25,29,25,8,35.8
"13470",1933,0,0,0,1,0,1,0,0,0,2,0,0,0,0,0,0,3277433,"2023-11-14T00:00:00.000Z",443,10,"Klay Thompson",0,0,0,0,0,0
"13471",1934,4,1,5,3,2,14,6,1,1,36,0,0,15,5,3,4,3277433,"2023-11-14T00:00:00.000Z",367,10,"Chris Paul",4,20,24,19,9,35
"13472",1935,5,0,6,8,3,18,9,2,2,39,1,4,23,7,1,3,3277433,"2023-11-14T00:00:00.000Z",56677858,10,"Brandin Podziemski",1,30,35,28,12,38.9
"13473",1936,3,0,6,0,0,4,1,0,0,31,6,2,2,12,1,0,3277433,"2023-11-14T00:00:00.000Z",282,10,"Kevon Looney",1,14,17,5,15,23.9
"13474",1937,1,0,1,1,0,3,2,2,1,16,1,2,5,2,0,1,3277433,"2023-11-14T00:00:00.000Z",17553979,10,"Jonathan Kuminga",0,7,8,6,3,7.9
"13475",1938,2,0,2,3,1,5,3,0,0,16,1,1,7,3,0,0,3277433,"2023-11-14T00:00:00.000Z",2189,10,"Gary Payton II",0,10,12,9,5,13.6
"13476",1939,4,0,0,3,2,6,2,1,0,13,0,1,6,0,0,2,3277433,"2023-11-14T00:00:00.000Z",251,10,"Cory Joseph",0,6,10,10,4,10
"13477",1940,3,0,2,0,0,1,0,2,2,12,0,2,2,2,0,2,3277433,"2023-11-14T00:00:00.000Z",56677799,10,"Trayce Jackson-Davis",0,4,7,5,5,6.9
"13478",1941,2,0,1,2,1,6,4,2,2,14,1,0,11,2,1,0,3277433,"2023-11-14T00:00:00.000Z",17553992,10,"Moses Moody",1,13,15,13,4,19.4
"13479",1942,0,0,0,0,0,0,0,0,0,0,0,0,0,0,0,0,3277433,"2023-11-14T00:00:00.000Z",57875092,10,"Gui Santos",0,0,0,0,0,0
"13480",1943,0,0,0,0,0,0,0,0,0,0,0,0,0,0,0,0,3277433,"2023-11-14T00:00:00.000Z",115,10,"Stephen Curry",0,0,0,0,0,0
"13481",1944,0,0,0,0,0,0,0,0,0,0,0,0,0,0,0,0,3277433,"2023-11-14T00:00:00.000Z",17896070,10,"Usman Garuba",0,0,0,0,0,0
"13482",1945,0,0,0,0,0,0,0,0,0,0,0,0,0,0,0,0,3277433,"2023-11-14T00:00:00.000Z",45658838,10,"Lester Quinones",0,0,0,0,0,0
"13483",1946,0,0,0,0,0,0,0,0,0,0,0,0,0,0,0,0,3277433,"2023-11-14T00:00:00.000Z",398,10,"Jerome Robinson",0,0,0,0,0,0
"13484",1947,0,0,0,1,0,1,0,0,0,2,0,0,0,0,0,0,3277433,"2023-11-14T00:00:00.000Z",3547259,18,"Jaden McDaniels",0,0,0,0,0,0
"13485",1948,2,0,10,12,5,26,12,4,4,42,1,1,33,11,2,5,3277433,"2023-11-14T00:00:00.000Z",447,18,"Karl-Anthony Towns",2,44,46,35,13,50.2
"13486",1949,2,3,7,0,0,8,2,6,5,35,6,4,9,13,0,2,3277433,"2023-11-14T00:00:00.000Z",176,18,"Rudy Gobert",3,22,24,11,15,34.6
"13487",1950,4,0,4,6,3,16,7,5,3,36,0,1,20,4,3,5,3277433,"2023-11-14T00:00:00.000Z",3547238,18,"Anthony Edwards",3,24,28,24,8,34.8
"13488",1951,1,2,1,1,1,3,2,2,1,16,1,1,6,2,0,0,1038101,"2024-01-08T00:00:00.000Z",286,16,"Kyle Lowry",2,8,9,7,3,15.9
"13489",1952,4,0,4,3,1,7,4,7,6,23,3,2,15,7,1,1,1038101,"2024-01-08T00:00:00.000Z",285,16,"Kevin Love",1,22,26,19,11,31.4
"13490",1953,2,1,2,3,2,6,4,2,2,29,0,2,12,2,0,0,1038101,"2024-01-08T00:00:00.000Z",391,16,"Josh Richardson",1,14,16,14,4,20.4
"13491",1954,5,0,6,7,3,19,10,5,4,42,0,3,27,6,0,1,1038098,"2024-01-08T00:00:00.000Z",666956,5,"Coby White",0,33,38,32,11,40.7
"13492",1955,1,0,0,4,3,5,4,2,2,20,0,2,13,0,0,0,1038099,"2024-01-08T00:00:00.000Z",3547243,12,"Obi Toppin",0,13,14,14,1,14.5
"13493",1956,0,0,0,0,0,0,0,0,0,0,0,0,0,0,0,0,1038099,"2024-01-08T00:00:00.000Z",3547207,12,"Jordan Nwora",0,0,0,0,0,0
"13494",1957,0,0,0,0,0,0,0,0,0,0,0,0,0,0,0,0,1038099,"2024-01-08T00:00:00.000Z",56677861,12,"Ben Sheppard",0,0,0,0,0,0
"13495",1958,0,0,0,0,0,0,0,0,0,0,0,0,0,0,0,0,1038099,"2024-01-08T00:00:00.000Z",56677832,12,"Jarace Walker",0,0,0,0,0,0
"13496",1959,0,0,0,0,0,0,0,0,0,0,0,0,0,0,0,0,1038099,"2024-01-08T00:00:00.000Z",38017701,12,"Kendall Brown",0,0,0,0,0,0
"13497",1960,0,0,0,0,0,0,0,0,0,0,0,0,0,0,0,0,1038099,"2024-01-08T00:00:00.000Z",56677778,12,"Oscar Tshiebwe",0,0,0,0,0,0
"13498",1961,0,0,0,0,0,0,0,0,0,0,0,0,0,0,0,0,1038099,"2024-01-08T00:00:00.000Z",56677794,12,"Isaiah Wong",0,0,0,0,0,0
"13499",1962,2,0,4,4,3,26,17,5,3,38,1,2,40,5,0,5,1038099,"2024-01-08T00:00:00.000Z",70,2,"Jaylen Brown",0,45,47,42,7,44
"13500",1963,0,1,6,4,3,5,4,0,0,32,0,1,11,6,0,1,1038099,"2024-01-08T00:00:00.000Z",219,2,"Al Horford",1,17,17,11,6,20.2
"13501",1964,7,3,3,4,1,13,6,7,6,38,2,2,19,5,0,1,1038099,"2024-01-08T00:00:00.000Z",378,2,"Kristaps Porzingis",3,24,31,26,12,43.5
"13502",1965,6,2,4,8,2,16,4,3,3,36,0,3,13,4,0,1,1038099,"2024-01-08T00:00:00.000Z",473,2,"Derrick White",2,17,23,19,10,31.8
"13503",1966,6,0,5,6,3,16,9,0,0,38,1,2,21,6,1,3,1038099,"2024-01-08T00:00:00.000Z",214,2,"Jrue Holiday",1,27,33,27,12,37.2
"13504",1967,3,0,3,5,4,6,5,0,0,23,4,2,14,7,0,1,1038099,"2024-01-08T00:00:00.000Z",3547276,2,"Payton Pritchard",0,21,24,17,10,25.9
"13505",1968,0,0,4,4,1,4,1,6,3,16,2,3,6,6,2,0,1038099,"2024-01-08T00:00:00.000Z",666468,2,"Oshae Brissett",2,12,12,6,6,19.2
"13506",1969,0,0,0,0,0,0,0,0,0,4,0,3,0,0,0,1,1038099,"2024-01-08T00:00:00.000Z",17896094,2,"Dalano Banton",0,0,0,0,0,-1
"13507",1970,2,2,0,0,0,4,1,4,3,10,2,2,5,2,0,1,1038099,"2024-01-08T00:00:00.000Z",261,2,"Luke Kornet",2,7,9,7,4,15.4
"13508",1971,0,0,0,0,0,0,0,4,2,5,1,0,2,1,0,1,1038099,"2024-01-08T00:00:00.000Z",338,2,"Svi Mykhailiuk",0,3,3,2,1,2.2
"13509",1972,2,1,0,1,0,4,2,2,1,20,0,3,5,0,0,1,1038101,"2024-01-08T00:00:00.000Z",188,11,"Jeff Green",1,5,7,7,2,10
"13510",1973,1,0,4,5,1,6,2,3,3,23,0,2,8,4,1,0,1038101,"2024-01-08T00:00:00.000Z",213,11,"Aaron Holiday",1,12,13,9,5,17.3
"13511",1974,1,1,2,0,0,2,1,3,3,11,0,3,5,2,1,2,1038101,"2024-01-08T00:00:00.000Z",56677825,11,"Amen Thompson",2,7,8,6,3,12.9
"13512",1975,0,0,5,2,1,8,5,0,0,17,1,4,11,6,1,1,1038101,"2024-01-08T00:00:00.000Z",56677831,11,"Cam Whitmore",1,17,17,11,6,20.2
"13513",1976,4,0,1,3,1,11,7,0,0,37,2,2,15,3,0,2,1037911,"2023-12-14T00:00:00.000Z",214,2,"Jrue Holiday",0,18,22,19,7,22.6
"13514",1977,0,0,0,0,0,0,0,0,0,0,0,0,0,0,0,0,1037912,"2023-12-14T00:00:00.000Z",56677857,5,"Julian Phillips",0,0,0,0,0,0
"13515",1978,0,0,0,0,0,0,0,0,0,0,0,0,0,0,0,0,1037912,"2023-12-14T00:00:00.000Z",17896116,5,"Terry Taylor",0,0,0,0,0,0
"13516",1979,0,0,0,0,0,0,0,0,0,0,0,0,0,0,0,0,1037912,"2023-12-14T00:00:00.000Z",27,5,"Lonzo Ball",0,0,0,0,0,0
"13517",1980,0,0,0,0,0,0,0,0,0,0,0,0,0,0,0,0,1037912,"2023-12-14T00:00:00.000Z",56677874,5,"Onuralp Bitim",0,0,0,0,0,0
"13518",1981,0,0,0,0,0,0,0,0,0,0,0,0,0,0,0,0,1037912,"2023-12-14T00:00:00.000Z",268,5,"Zach LaVine",0,0,0,0,0,0
"13519",1982,0,0,0,0,0,0,0,0,0,0,0,0,0,0,0,0,1037911,"2023-12-14T00:00:00.000Z",38017707,2,"JD Davison",0,0,0,0,0,0
"13520",1984,0,0,0,0,0,0,0,0,0,0,0,0,0,0,0,0,1037911,"2023-12-14T00:00:00.000Z",17553967,2,"Neemias Queta",0,0,0,0,0,0
"13521",1985,0,0,0,0,0,0,0,0,0,0,0,0,0,0,0,0,1037911,"2023-12-14T00:00:00.000Z",56677864,2,"Jordan Walsh",0,0,0,0,0,0
"13522",1986,2,0,2,4,1,5,2,0,0,31,2,5,5,4,0,1,1037911,"2023-12-14T00:00:00.000Z",666908,6,"Max Strus",0,9,11,7,6,11.8
"13523",1987,0,0,3,5,1,5,1,2,2,16,1,0,5,4,0,0,1037911,"2023-12-14T00:00:00.000Z",666940,6,"Dean Wade",0,9,9,5,4,9.8
"13524",1988,3,0,9,0,0,7,4,0,0,39,1,1,8,10,0,3,1037911,"2023-12-14T00:00:00.000Z",9,6,"Jarrett Allen",0,18,21,11,13,21.5
"13525",1989,0,0,0,0,0,0,0,0,0,0,0,0,0,0,0,0,1037912,"2023-12-14T00:00:00.000Z",45969255,5,"Justin Lewis",0,0,0,0,0,0
"13526",1990,0,0,0,0,0,0,0,0,0,0,0,0,0,0,0,0,1037912,"2023-12-14T00:00:00.000Z",56677860,5,"Adama Sanogo",0,0,0,0,0,0
"13527",1991,6,0,7,8,2,24,12,5,5,40,1,2,31,8,1,3,1037911,"2023-12-14T00:00:00.000Z",322,6,"Donovan Mitchell",1,39,45,37,14,49.6
"13528",1992,0,0,0,0,0,0,0,0,0,0,0,0,0,0,0,0,1037912,"2023-12-14T00:00:00.000Z",3092,16,"Haywood Highsmith",0,0,0,0,0,0
"13529",1993,0,0,0,0,0,0,0,0,0,0,0,0,0,0,0,0,1037912,"2023-12-14T00:00:00.000Z",38017696,16,"Nikola Jovic",0,0,0,0,0,0
"13530",1994,0,0,0,0,0,0,0,0,0,0,0,0,0,0,0,0,1037912,"2023-12-14T00:00:00.000Z",391,16,"Josh Richardson",0,0,0,0,0,0
"13531",1995,0,0,0,0,0,0,0,0,0,0,0,0,0,0,0,0,1037912,"2023-12-14T00:00:00.000Z",19465585,16,"Dru Smith",0,0,0,0,0,0
"13532",1996,4,0,3,3,1,14,6,11,10,41,2,2,23,5,0,3,1037912,"2023-12-14T00:00:00.000Z",125,5,"DeMar DeRozan",0,28,32,27,9,32
"13533",1997,3,0,1,7,3,19,8,0,0,36,1,2,19,2,2,5,1037911,"2023-12-14T00:00:00.000Z",666581,6,"Darius Garland",2,21,24,22,5,26.9
"13534",1998,5,1,2,6,3,16,9,6,5,35,1,2,26,3,3,1,1037911,"2023-12-14T00:00:00.000Z",277,6,"Caris LeVert",4,29,34,31,8,48.1
"13535",1999,2,0,3,1,1,2,2,2,2,18,1,3,7,4,1,1,1037911,"2023-12-14T00:00:00.000Z",3547247,6,"Isaac Okoro",1,11,13,9,6,16.8
"13536",2000,0,0,2,2,0,4,1,2,2,22,0,2,4,2,0,1,1037911,"2023-12-14T00:00:00.000Z",344,6,"Georges Niang",0,6,6,4,2,5.4
"13537",2001,5,0,9,0,0,12,8,8,8,36,1,3,24,10,0,3,1037773,"2023-11-18T00:00:00.000Z",4,16,"Bam Adebayo",0,34,39,29,15,40.5
"13538",2002,1,0,2,0,0,0,0,0,0,6,0,0,0,2,0,2,1037776,"2023-11-18T00:00:00.000Z",17896078,21,"Aaron Wiggins",0,2,3,1,3,1.9
"13539",2003,1,0,0,0,0,1,1,0,0,8,0,0,2,0,0,0,1037776,"2023-11-18T00:00:00.000Z",4197029,21,"Vasilije Micic",0,2,3,3,1,3.5
"13540",2004,2,0,1,1,0,3,1,0,0,12,0,3,2,1,0,1,1037775,"2023-11-18T00:00:00.000Z",38017732,15,"Kenneth Lofton Jr.",0,3,5,4,3,5.2
"13541",2005,5,0,6,3,2,8,4,8,7,25,1,1,17,7,1,1,1037775,"2023-11-18T00:00:00.000Z",17896027,15,"Ziaire Williams",1,24,29,22,12,34.9
"13542",2006,0,0,0,0,0,0,0,0,0,0,0,0,0,0,0,0,1037775,"2023-11-18T00:00:00.000Z",38017728,15,"Jake LaRavia",0,0,0,0,0,0
"13543",2007,0,0,0,0,0,0,0,0,0,0,0,0,0,0,0,0,1037775,"2023-11-18T00:00:00.000Z",38017731,15,"Vince Williams Jr.",0,0,0,0,0,0
"13544",2008,0,0,0,0,0,0,0,0,0,0,0,0,0,0,0,0,1037775,"2023-11-18T00:00:00.000Z",3,15,"Steven Adams",0,0,0,0,0,0
"13545",2009,0,0,0,0,0,0,0,0,0,0,0,0,0,0,0,0,1037775,"2023-11-18T00:00:00.000Z",666505,15,"Brandon Clarke",0,0,0,0,0,0
"13546",2010,0,0,0,0,0,0,0,0,0,0,0,0,0,0,0,0,1037775,"2023-11-18T00:00:00.000Z",56677830,15,"GG Jackson",0,0,0,0,0,0
"13547",2011,0,0,0,0,0,0,0,0,0,0,0,0,0,0,0,0,1037775,"2023-11-18T00:00:00.000Z",254,15,"Luke Kennard",0,0,0,0,0,0
"13548",2012,0,0,0,0,0,0,0,0,0,0,0,0,0,0,0,0,1037775,"2023-11-18T00:00:00.000Z",666786,15,"Ja Morant",0,0,0,0,0,0
"13549",2013,0,0,0,0,0,0,0,0,0,0,0,0,0,0,0,0,1037774,"2023-11-18T00:00:00.000Z",666453,17,"Marques Bolden",0,0,0,0,0,0
"13550",2014,0,0,0,0,0,0,0,0,0,0,0,0,0,0,0,0,1037774,"2023-11-18T00:00:00.000Z",284,17,"Robin Lopez",0,0,0,0,0,0
"13551",2015,1,0,2,3,0,4,1,4,4,18,2,2,6,4,1,2,1037776,"2023-11-18T00:00:00.000Z",17553992,10,"Moses Moody",1,10,11,7,5,13.3
"13552",2016,0,0,0,0,0,0,0,0,0,0,0,0,0,0,0,0,1037776,"2023-11-18T00:00:00.000Z",185,10,"Draymond Green",0,0,0,0,0,0
"13553",2017,0,0,0,0,0,0,0,0,0,0,0,0,0,0,0,0,1037776,"2023-11-18T00:00:00.000Z",251,10,"Cory Joseph",0,0,0,0,0,0
"13554",2018,0,0,0,0,0,0,0,0,0,0,0,0,0,0,0,0,1037776,"2023-11-18T00:00:00.000Z",45658838,10,"Lester Quinones",0,0,0,0,0,0
"13555",2019,0,0,0,0,0,0,0,0,0,0,0,0,0,0,0,0,1037776,"2023-11-18T00:00:00.000Z",57875092,10,"Gui Santos",0,0,0,0,0,0
"13556",2020,0,0,0,0,0,0,0,0,0,0,0,0,0,0,0,0,1037776,"2023-11-18T00:00:00.000Z",17896070,10,"Usman Garuba",0,0,0,0,0,0
"13557",2021,0,0,0,0,0,0,0,0,0,0,0,0,0,0,0,0,1037776,"2023-11-18T00:00:00.000Z",56677799,10,"Trayce Jackson-Davis",0,0,0,0,0,0
"13558",2022,0,0,0,0,0,0,0,0,0,0,0,0,0,0,0,0,1037776,"2023-11-18T00:00:00.000Z",2189,10,"Gary Payton II",0,0,0,0,0,0
"13559",2023,0,0,2,0,0,1,1,0,0,6,0,0,2,2,0,0,1037776,"2023-11-18T00:00:00.000Z",38017706,21,"Jaylin Williams",0,4,4,2,2,4.4
"13560",2024,0,0,0,0,0,0,0,0,0,0,0,0,0,0,0,0,1037776,"2023-11-18T00:00:00.000Z",38017716,21,"Ousmane Dieng",0,0,0,0,0,0
"13561",2025,0,0,0,0,0,0,0,0,0,0,0,0,0,0,0,0,1037776,"2023-11-18T00:00:00.000Z",56677853,21,"Keyontae Johnson",0,0,0,0,0,0
"13562",2026,0,0,0,0,0,0,0,0,0,0,0,0,0,0,0,0,1038130,"2024-01-12T00:00:00.000Z",17896056,18,"Luka Garza",0,0,0,0,0,0
"13563",2027,0,1,3,3,1,8,5,4,3,25,2,1,14,5,0,3,1038130,"2024-01-12T00:00:00.000Z",56677850,25,"Toumani Camara",1,19,19,14,5,20
"13564",2028,1,0,0,7,2,15,4,3,3,31,0,3,13,0,2,0,1038130,"2024-01-12T00:00:00.000Z",182,25,"Jerami Grant",2,13,14,14,1,20.5
"13565",2029,0,1,3,6,2,14,6,3,0,24,3,4,14,6,1,1,1038130,"2024-01-12T00:00:00.000Z",56783340,25,"Duop Reath",2,20,20,14,6,26.2
"13566",2030,4,0,2,0,0,4,3,7,2,25,0,2,8,2,0,6,1038130,"2024-01-12T00:00:00.000Z",56677747,25,"Scoot Henderson",0,10,14,12,6,10.4
"13567",2031,0,0,0,0,0,0,0,0,0,0,0,0,0,0,0,0,1038127,"2024-01-12T00:00:00.000Z",85,22,"Wendell Carter Jr.",0,0,0,0,0,0
"13568",2032,3,1,2,2,0,10,0,5,5,29,0,0,5,2,0,3,1038130,"2024-01-12T00:00:00.000Z",419,25,"Anfernee Simons",1,7,10,8,5,11.9
"13569",2033,3,0,2,5,2,7,2,4,3,26,0,1,9,2,0,1,1038130,"2024-01-12T00:00:00.000Z",65,25,"Malcolm Brogdon",0,11,14,12,5,14.9
"13570",2034,0,1,3,0,0,1,1,0,0,9,3,3,2,6,0,1,1038130,"2024-01-12T00:00:00.000Z",39613724,25,"Ibou Badji",1,8,8,2,6,11.2
"13571",2035,0,0,0,0,0,0,0,0,0,0,0,0,0,0,0,0,1038129,"2024-01-12T00:00:00.000Z",3,15,"Steven Adams",0,0,0,0,0,0
"13572",2036,0,2,7,0,0,5,2,2,2,22,4,3,6,11,0,0,1038129,"2024-01-12T00:00:00.000Z",493,13,"Ivica Zubac",2,17,17,6,11,25.2
"13573",2037,0,0,0,0,0,0,0,0,0,0,0,0,0,0,0,0,1038126,"2024-01-12T00:00:00.000Z",66,11,"Dillon Brooks",0,0,0,0,0,0
"13574",2038,0,0,0,0,0,0,0,0,0,0,0,0,0,0,0,0,1038126,"2024-01-12T00:00:00.000Z",38017695,11,"Tari Eason",0,0,0,0,0,0
"13575",2039,0,0,0,0,0,0,0,0,0,0,0,0,0,0,0,0,1038126,"2024-01-12T00:00:00.000Z",3547281,11,"Nate Hinton",0,0,0,0,0,0
"13576",2040,0,0,3,4,1,8,3,0,0,26,2,0,7,5,0,1,1038129,"2024-01-12T00:00:00.000Z",666743,13,"Terance Mann",0,12,12,7,5,12
"13577",2041,0,0,0,0,0,0,0,0,0,0,0,0,0,0,0,0,1038126,"2024-01-12T00:00:00.000Z",357,11,"Victor Oladipo",0,0,0,0,0,0
"13578",2042,0,0,0,0,0,0,0,0,0,0,0,0,0,0,0,0,1038130,"2024-01-12T00:00:00.000Z",666476,25,"Moses Brown",0,0,0,0,0,0
"13579",2043,0,0,0,0,0,0,0,0,0,0,0,0,0,0,0,0,1038130,"2024-01-12T00:00:00.000Z",38017690,25,"Shaedon Sharpe",0,0,0,0,0,0
"13580",2044,0,0,0,0,0,0,0,0,0,0,0,0,0,0,0,0,1038130,"2024-01-12T00:00:00.000Z",476,25,"Robert Williams III",0,0,0,0,0,0
"13581",2045,9,0,1,4,2,7,3,3,3,28,0,0,11,1,1,3,1038129,"2024-01-12T00:00:00.000Z",192,13,"James Harden",1,12,21,20,10,25.7
"13582",2046,2,0,1,3,1,11,5,3,1,16,1,1,12,2,0,1,1038129,"2024-01-12T00:00:00.000Z",472,13,"Russell Westbrook",0,14,16,14,4,16.4
"13583",2047,1,0,2,1,1,6,6,1,0,26,0,0,13,2,2,1,1038129,"2024-01-12T00:00:00.000Z",666511,13,"Amir Coffey",2,15,16,14,3,21.9
"13584",2048,0,0,5,2,0,8,5,1,1,24,0,2,11,5,0,1,1038129,"2024-01-12T00:00:00.000Z",380,13,"Norman Powell",0,16,16,11,5,16
"13585",2049,0,0,0,0,0,0,0,0,0,0,0,0,0,0,0,0,1038133,"2024-01-12T00:00:00.000Z",204,4,"Gordon Hayward",0,0,0,0,0,0
"13586",2050,0,0,0,0,0,0,0,0,0,0,0,0,0,0,0,0,1038133,"2024-01-12T00:00:00.000Z",347,4,"Frank Ntilikina",0,0,0,0,0,0
"13587",2051,0,0,4,4,1,7,2,0,0,23,3,4,5,7,0,2,1037941,"2023-12-18T00:00:00.000Z",38017684,11,"Jabari Smith Jr.",0,12,12,5,7,11.4
"13588",2052,2,2,4,0,0,7,3,7,4,29,2,5,10,6,0,1,1037941,"2023-12-18T00:00:00.000Z",9,6,"Jarrett Allen",2,16,18,12,8,25.2
"13589",2053,2,0,3,9,3,13,5,5,4,34,0,3,17,3,0,0,1037941,"2023-12-18T00:00:00.000Z",666908,6,"Max Strus",0,20,22,19,5,23.6
"13590",2054,6,2,1,11,4,27,14,5,5,45,0,5,37,1,0,2,1037941,"2023-12-18T00:00:00.000Z",322,6,"Donovan Mitchell",2,38,44,43,7,51.2
"13591",2055,5,0,6,6,1,13,5,2,1,27,1,0,12,7,2,3,1037941,"2023-12-18T00:00:00.000Z",277,6,"Caris LeVert",2,19,24,17,12,30.9
"13592",2056,3,0,0,1,1,2,1,0,0,9,0,0,3,0,1,0,1037941,"2023-12-18T00:00:00.000Z",56677872,6,"Craig Porter",1,3,6,6,3,10.5
"13593",2057,3,1,3,10,5,11,6,2,2,24,1,1,19,4,1,0,1037941,"2023-12-18T00:00:00.000Z",3547299,6,"Sam Merrill",2,23,26,22,7,34.3
"13594",2058,0,0,0,0,0,0,0,0,0,0,0,0,0,0,0,0,1037941,"2023-12-18T00:00:00.000Z",56677847,6,"Emoni Bates",0,0,0,0,0,0
"13595",2059,0,0,0,0,0,0,0,0,0,0,0,0,0,0,0,0,1037941,"2023-12-18T00:00:00.000Z",248,6,"Damian Jones",0,0,0,0,0,0
"13596",2060,2,0,0,0,0,1,0,0,0,6,1,1,0,1,1,1,1037942,"2023-12-18T00:00:00.000Z",242,12,"James Johnson",1,1,3,2,3,6.2
"13597",2061,0,0,0,0,0,0,0,0,0,0,0,0,0,0,0,0,1037942,"2023-12-18T00:00:00.000Z",452,12,"Myles Turner",0,0,0,0,0,0
"13598",2062,0,0,0,0,0,0,0,0,0,0,0,0,0,0,0,0,1037943,"2023-12-18T00:00:00.000Z",56677874,5,"Onuralp Bitim",0,0,0,0,0,0
"13599",2064,0,0,0,0,0,0,0,0,0,0,0,0,0,0,0,0,1037943,"2023-12-18T00:00:00.000Z",268,5,"Zach LaVine",0,0,0,0,0,0
"13600",2065,0,0,0,0,0,0,0,0,0,0,0,0,0,0,0,0,1037943,"2023-12-18T00:00:00.000Z",56677860,5,"Adama Sanogo",0,0,0,0,0,0
"13601",2066,0,0,0,0,0,0,0,0,0,0,0,0,0,0,0,0,1037945,"2023-12-18T00:00:00.000Z",74,16,"Thomas Bryant",0,0,0,0,0,0
"13602",2067,0,0,0,0,0,0,0,0,0,0,0,0,0,0,0,0,1037945,"2023-12-18T00:00:00.000Z",3547257,16,"R.J. Hampton",0,0,0,0,0,0
"13603",2068,17,1,8,8,4,19,9,5,5,45,0,4,27,8,2,2,1037941,"2023-12-18T00:00:00.000Z",458,11,"Fred VanVleet",3,35,52,44,25,69.1
"13604",2069,3,1,1,0,0,6,6,3,3,24,0,3,15,1,0,1,1037941,"2023-12-18T00:00:00.000Z",188,11,"Jeff Green",1,16,19,18,4,22.7
"13605",2070,0,0,1,5,2,9,5,2,2,17,1,4,14,2,0,0,1037941,"2023-12-18T00:00:00.000Z",213,11,"Aaron Holiday",0,16,16,14,2,16.4
"13606",2071,1,0,1,0,0,4,1,1,1,16,2,2,3,3,0,0,1037941,"2023-12-18T00:00:00.000Z",3547301,11,"Jae'Sean Tate",0,6,7,4,4,8.1
"13607",2072,2,1,4,2,0,13,5,5,4,33,4,4,14,8,4,2,1037941,"2023-12-18T00:00:00.000Z",38017695,11,"Tari Eason",5,22,24,16,10,39.6
"13608",2073,0,0,1,0,0,0,0,0,0,4,0,1,0,1,1,0,1037941,"2023-12-18T00:00:00.000Z",19465326,11,"Jock Landale",1,1,1,0,1,4.2
"13609",2074,0,0,0,0,0,0,0,0,0,0,0,0,0,0,0,0,1037941,"2023-12-18T00:00:00.000Z",75,11,"Reggie Bullock",0,0,0,0,0,0
"13610",2075,5,0,3,3,1,12,5,6,4,34,2,1,15,5,0,1,1037945,"2023-12-18T00:00:00.000Z",79,16,"Jimmy Butler",0,20,25,20,10,27.5
"13611",2076,0,0,0,0,0,0,0,0,0,0,0,0,0,0,0,0,3277480,"2023-11-21T00:00:00.000Z",56677875,1,"Miles Norris",0,0,0,0,0,0
"13612",2077,1,1,1,6,6,11,9,0,0,31,1,3,24,2,0,1,3277480,"2023-11-21T00:00:00.000Z",210,12,"Buddy Hield",1,26,27,25,3,29.9
"13613",2078,1,1,0,3,1,9,6,5,4,25,1,4,17,1,1,0,3277480,"2023-11-21T00:00:00.000Z",3547250,12,"Aaron Nesmith",2,18,19,18,2,25.7
"13614",2079,1,0,2,4,2,7,4,0,0,21,0,0,10,2,0,2,1037802,"2023-11-22T00:00:00.000Z",3547276,2,"Payton Pritchard",0,12,13,11,3,11.9
"13615",2080,0,0,0,0,0,0,0,0,0,0,0,0,0,0,0,0,1037802,"2023-11-22T00:00:00.000Z",3547279,2,"Lamar Stevens",0,0,0,0,0,0
"13616",2081,0,0,0,0,0,0,0,0,0,0,0,0,0,0,0,0,1037802,"2023-11-22T00:00:00.000Z",38017707,2,"JD Davison",0,0,0,0,0,0
"13617",2082,0,0,0,0,0,0,0,0,0,0,0,0,0,0,0,0,1037802,"2023-11-22T00:00:00.000Z",3547295,2,"Nathan Knight",0,0,0,0,0,0
"13618",2083,0,0,0,0,0,0,0,0,0,0,0,0,0,0,0,0,1037802,"2023-11-22T00:00:00.000Z",17553967,2,"Neemias Queta",0,0,0,0,0,0
"13619",2084,0,0,0,0,0,0,0,0,0,0,0,0,0,0,0,0,1037802,"2023-11-22T00:00:00.000Z",56677864,2,"Jordan Walsh",0,0,0,0,0,0
"13620",2085,7,0,3,5,2,14,4,2,2,29,2,4,12,5,1,0,1037802,"2023-11-22T00:00:00.000Z",315,17,"Khris Middleton",1,17,24,19,12,31.5
"13621",2086,5,0,10,3,0,20,7,10,7,36,3,4,21,13,2,3,1037802,"2023-11-22T00:00:00.000Z",15,17,"Giannis Antetokounmpo",2,34,39,26,18,47.1
"13622",2087,0,2,8,7,2,16,8,7,7,39,3,3,25,11,1,1,1037801,"2023-11-22T00:00:00.000Z",666656,1,"De'Andre Hunter",3,36,36,25,11,46.2
"13623",2088,3,1,6,2,1,7,3,0,0,40,0,3,7,6,2,5,1037801,"2023-11-22T00:00:00.000Z",17896040,1,"Jalen Johnson",3,13,16,10,9,22.7
"13624",2089,0,3,6,0,0,8,7,0,0,28,9,1,14,15,0,0,1037801,"2023-11-22T00:00:00.000Z",83,1,"Clint Capela",3,29,29,14,15,41
"13625",2090,8,0,3,8,3,21,6,5,5,39,3,4,20,6,2,1,1037801,"2023-11-22T00:00:00.000Z",334,1,"Dejounte Murray",2,26,34,28,14,44.2
"13626",2091,9,0,2,16,8,31,12,13,11,40,2,0,43,4,2,4,1037801,"2023-11-22T00:00:00.000Z",490,1,"Trae Young",2,47,56,52,13,63.3
"13627",2092,3,1,3,11,3,15,5,1,1,26,1,4,14,4,1,1,1037801,"2023-11-22T00:00:00.000Z",53,1,"Bogdan Bogdanovic",2,18,21,17,7,28.3
"13628",2093,1,0,2,3,1,8,4,3,3,25,0,2,12,2,2,2,1037801,"2023-11-22T00:00:00.000Z",3547256,1,"Saddiq Bey",2,14,15,13,3,19.9
"13629",2094,0,0,0,0,0,0,0,0,0,3,0,0,0,0,0,0,1037801,"2023-11-22T00:00:00.000Z",38017689,1,"AJ Griffin",0,0,0,0,0,0
"13630",2095,0,0,0,0,0,0,0,0,0,0,0,0,0,0,0,0,1037801,"2023-11-22T00:00:00.000Z",666564,1,"Bruno Fernando",0,0,0,0,0,0
"13631",2096,0,0,0,0,0,0,0,0,0,0,0,0,0,0,0,0,1037801,"2023-11-22T00:00:00.000Z",3547297,1,"Trent Forrest",0,0,0,0,0,0
"13632",2097,0,0,0,0,0,0,0,0,0,0,0,0,0,0,0,0,1037801,"2023-11-22T00:00:00.000Z",666754,1,"Garrison Mathews",0,0,0,0,0,0
"13633",2098,0,0,0,0,0,0,0,0,0,0,0,0,0,0,0,0,1037801,"2023-11-22T00:00:00.000Z",301,1,"Wesley Matthews",0,0,0,0,0,0
"13634",2099,0,0,0,0,0,0,0,0,0,0,0,0,0,0,0,0,1037801,"2023-11-22T00:00:00.000Z",319,1,"Patty Mills",0,0,0,0,0,0
"13635",2100,0,0,2,3,0,5,0,0,0,17,1,2,0,3,0,1,3277483,"2023-11-21T00:00:00.000Z",38017620,29,"Ochai Agbaji",0,3,3,0,3,2.6
"13636",2101,1,0,4,1,0,9,5,5,4,13,0,0,14,4,0,0,1037609,"2023-10-27T00:00:00.000Z",24,9,"Marvin Bagley III",0,18,19,15,5,20.3
"13637",2102,1,0,1,1,0,1,0,0,0,8,0,1,0,1,0,1,1037609,"2023-10-27T00:00:00.000Z",56677792,9,"Marcus Sasser",0,1,2,1,2,1.7
"13638",2103,0,0,0,0,0,0,0,0,0,0,0,0,0,0,0,0,1037609,"2023-10-27T00:00:00.000Z",56677729,9,"Malcolm Cazalon",0,0,0,0,0,0
"13639",2104,0,0,0,0,0,0,0,0,0,0,0,0,0,0,0,0,1037609,"2023-10-27T00:00:00.000Z",42097199,9,"Jared Rhoden",0,0,0,0,0,0
"13640",2105,0,0,0,0,0,0,0,0,0,0,0,0,0,0,0,0,1037609,"2023-10-27T00:00:00.000Z",44477024,9,"Stanley Umude",0,0,0,0,0,0
"13641",2106,0,0,0,0,0,0,0,0,0,0,0,0,0,0,0,0,1037609,"2023-10-27T00:00:00.000Z",3547240,9,"James Wiseman",0,0,0,0,0,0
"13642",2107,0,0,0,0,0,0,0,0,0,0,0,0,0,0,0,0,1037609,"2023-10-27T00:00:00.000Z",54,9,"Bojan Bogdanovic",0,0,0,0,0,0
"13643",2108,0,0,0,0,0,0,0,0,0,0,0,0,0,0,0,0,1037609,"2023-10-27T00:00:00.000Z",17896071,9,"Isaiah Livers",0,0,0,0,0,0
"13644",2109,0,0,0,0,0,0,0,0,0,0,0,0,0,0,0,0,1037609,"2023-10-27T00:00:00.000Z",330,9,"Monte Morris",0,0,0,0,0,0
"13645",2110,0,0,0,0,0,0,0,0,0,0,0,0,0,0,0,0,1037610,"2023-10-27T00:00:00.000Z",38017731,15,"Vince Williams Jr.",0,0,0,0,0,0
"13646",2111,0,0,0,0,0,0,0,0,0,0,0,0,0,0,0,0,1037610,"2023-10-27T00:00:00.000Z",3,15,"Steven Adams",0,0,0,0,0,0
"13647",2112,0,0,0,0,0,0,0,0,0,0,0,0,0,0,0,0,1037613,"2023-10-27T00:00:00.000Z",56677872,6,"Craig Porter",0,0,0,0,0,0
"13648",2113,0,0,0,0,0,0,0,0,0,0,0,0,0,0,0,0,1037613,"2023-10-27T00:00:00.000Z",444,6,"Tristan Thompson",0,0,0,0,0,0
"13649",2114,0,0,0,0,0,0,0,0,0,0,0,0,0,0,0,0,1037613,"2023-10-27T00:00:00.000Z",9,6,"Jarrett Allen",0,0,0,0,0,0
"13650",2115,0,0,0,0,0,0,0,0,0,0,0,0,0,0,0,0,1037613,"2023-10-27T00:00:00.000Z",666581,6,"Darius Garland",0,0,0,0,0,0
"13651",2116,0,0,0,0,0,0,0,0,0,0,0,0,0,0,0,0,1037613,"2023-10-27T00:00:00.000Z",404,6,"Ricky Rubio",0,0,0,0,0,0
"13652",2117,2,0,5,4,2,14,4,4,4,35,0,2,14,5,1,4,1037613,"2023-10-27T00:00:00.000Z",38017703,21,"Jalen Williams",1,19,21,16,7,22
"13653",2118,2,1,3,4,3,13,9,6,4,39,3,5,25,6,1,1,1037613,"2023-10-27T00:00:00.000Z",666541,21,"Luguentz Dort",2,31,33,27,8,40.2
"13654",2119,2,7,12,4,3,9,5,4,3,31,1,3,16,13,1,1,1037613,"2023-10-27T00:00:00.000Z",38017685,21,"Chet Holmgren",8,29,31,18,15,57.6
"13655",2120,6,0,6,1,0,8,1,0,0,28,0,1,2,6,0,3,1037613,"2023-10-27T00:00:00.000Z",17896065,21,"Josh Giddey",0,8,14,8,12,15.2
"13656",2121,0,0,0,0,0,0,0,0,0,0,0,0,0,0,0,0,1037613,"2023-10-27T00:00:00.000Z",44,21,"Davis Bertans",0,0,0,0,0,0
"13657",2122,12,0,2,5,2,16,4,10,8,35,1,2,18,3,3,6,1037611,"2023-10-27T00:00:00.000Z",490,1,"Trae Young",3,21,33,30,15,42.6
"13658",2123,3,0,1,9,4,11,6,0,0,26,0,3,16,1,1,2,1037611,"2023-10-27T00:00:00.000Z",53,1,"Bogdan Bogdanovic",1,17,20,19,4,22.7
"13659",2124,2,1,9,2,0,8,5,3,1,30,0,2,11,9,1,3,1037611,"2023-10-27T00:00:00.000Z",17896040,1,"Jalen Johnson",2,20,22,13,11,27.8
"13660",2125,0,0,2,4,2,4,2,0,0,8,0,0,6,2,0,0,1037611,"2023-10-27T00:00:00.000Z",38017689,1,"AJ Griffin",0,8,8,6,2,8.4
"13661",2126,0,0,3,1,0,12,10,2,2,31,2,3,22,5,0,0,1037966,"2023-12-21T00:00:00.000Z",24,9,"Marvin Bagley III",0,27,27,22,5,28
"13662",2127,7,2,3,5,2,16,9,4,4,35,2,4,24,5,3,5,1037966,"2023-12-21T00:00:00.000Z",38017682,9,"Jaden Ivey",5,29,36,31,12,50.5
"13663",2128,10,1,6,6,2,22,10,7,6,39,1,2,28,7,2,6,1037966,"2023-12-21T00:00:00.000Z",17896075,9,"Cade Cunningham",3,35,45,38,17,54.4
"13664",2129,1,2,1,0,0,3,3,2,1,19,1,2,7,2,1,3,1037966,"2023-12-21T00:00:00.000Z",56677826,9,"Ausar Thompson",3,9,10,8,3,16.9
"13665",2130,0,1,3,0,0,2,1,0,0,15,2,1,2,5,0,2,1037966,"2023-12-21T00:00:00.000Z",3547240,9,"James Wiseman",1,7,7,2,5,9
"13666",2131,0,0,0,0,0,0,0,0,0,0,0,0,0,0,0,0,1037962,"2023-12-20T00:00:00.000Z",268,5,"Zach LaVine",0,0,0,0,0,0
"13667",2132,14,0,4,8,5,18,10,7,5,36,0,4,30,4,1,4,1037963,"2023-12-20T00:00:00.000Z",490,1,"Trae Young",1,34,48,44,18,54.8
"13668",2133,2,0,10,1,0,11,8,4,3,33,1,1,19,11,0,0,1037963,"2023-12-20T00:00:00.000Z",3547244,1,"Onyeka Okongwu",0,30,32,21,13,35.2
"13669",2134,5,1,4,8,4,14,8,2,2,30,0,3,22,4,1,0,1037963,"2023-12-20T00:00:00.000Z",53,1,"Bogdan Bogdanovic",2,26,31,27,9,40.3
"13670",2135,0,0,2,1,0,2,0,2,1,8,0,1,1,2,0,0,1037963,"2023-12-20T00:00:00.000Z",301,1,"Wesley Matthews",0,3,3,1,2,3.4
"13671",2136,0,0,4,0,0,8,3,0,0,19,4,5,6,8,1,1,1037965,"2023-12-20T00:00:00.000Z",17553967,2,"Neemias Queta",1,14,14,6,8,17.6
"13672",2137,3,0,2,4,0,6,1,0,0,16,2,1,2,4,1,0,1037965,"2023-12-20T00:00:00.000Z",338,2,"Svi Mykhailiuk",1,6,9,5,7,14.3
"13673",2138,0,0,0,0,0,1,1,0,0,2,0,0,2,0,0,0,1037965,"2023-12-20T00:00:00.000Z",3547279,2,"Lamar Stevens",0,2,2,2,0,2
"13674",2139,0,0,0,0,0,0,0,0,0,0,0,0,0,0,0,0,1037965,"2023-12-20T00:00:00.000Z",17896094,2,"Dalano Banton",0,0,0,0,0,0
"13675",2140,0,0,0,0,0,0,0,0,0,0,0,0,0,0,0,0,1037965,"2023-12-20T00:00:00.000Z",38017707,2,"JD Davison",0,0,0,0,0,0
"13676",2141,0,0,0,0,0,0,0,0,0,0,0,0,0,0,0,0,1037965,"2023-12-20T00:00:00.000Z",219,2,"Al Horford",0,0,0,0,0,0
"13677",2142,0,0,0,0,0,0,0,0,0,0,0,0,0,0,0,0,1037965,"2023-12-20T00:00:00.000Z",261,2,"Luke Kornet",0,0,0,0,0,0
"13678",2143,0,0,0,0,0,0,0,0,0,0,0,0,0,0,0,0,1037972,"2023-12-21T00:00:00.000Z",56677782,18,"Leonard Miller",0,0,0,0,0,0
"13679",2144,0,0,0,0,0,0,0,0,0,0,0,0,0,0,0,0,1037972,"2023-12-21T00:00:00.000Z",38017715,18,"Josh Minott",0,0,0,0,0,0
"13680",2145,0,0,0,0,0,0,0,0,0,0,0,0,0,0,0,0,1037972,"2023-12-21T00:00:00.000Z",17895968,18,"Daishen Nix",0,0,0,0,0,0
"13681",2146,2,0,0,2,0,8,3,2,2,37,1,1,8,1,1,1,1037972,"2023-12-21T00:00:00.000Z",666860,14,"Cameron Reddish",1,9,11,10,3,14.2
"13682",2147,0,0,4,5,2,12,7,6,2,34,1,3,18,5,1,2,1037972,"2023-12-21T00:00:00.000Z",666609,14,"Rui Hachimura",1,23,23,18,5,25
"13683",2148,4,3,7,1,1,20,11,9,8,39,1,2,31,8,0,1,1037972,"2023-12-21T00:00:00.000Z",117,14,"Anthony Davis",3,39,43,35,12,54.6
"13684",2149,1,0,5,4,4,6,5,0,0,37,0,4,14,5,0,3,1037972,"2023-12-21T00:00:00.000Z",383,14,"Taurean Prince",0,19,20,15,6,18.5
"13685",2150,8,3,4,6,2,19,7,1,1,38,0,1,17,4,2,4,1037972,"2023-12-21T00:00:00.000Z",405,14,"D'Angelo Russell",5,21,29,25,12,44.8
"13686",2151,2,0,4,1,1,3,2,0,0,21,1,1,5,5,0,2,3277498,"2023-11-24T00:00:00.000Z",226,22,"Joe Ingles",0,10,12,7,7,12
"13687",2152,0,0,4,1,0,2,1,4,3,16,3,3,5,7,0,0,3277498,"2023-11-24T00:00:00.000Z",229,22,"Jonathan Isaac",0,12,12,5,7,13.4
"13688",2153,0,0,1,3,1,13,9,9,8,24,2,5,27,3,0,1,3277498,"2023-11-24T00:00:00.000Z",462,22,"Moritz Wagner",0,30,30,27,3,29.6
"13689",2154,0,0,1,0,0,0,0,0,0,9,1,0,0,2,1,0,3277498,"2023-11-24T00:00:00.000Z",38017724,22,"Caleb Houstan",1,2,2,0,2,5.4
"13690",2155,0,0,0,0,0,0,0,0,0,0,0,0,0,0,0,0,3277498,"2023-11-24T00:00:00.000Z",56677839,22,"Jett Howard",0,0,0,0,0,0
"13691",2156,0,0,0,0,0,0,0,0,0,0,0,0,0,0,0,0,3277498,"2023-11-24T00:00:00.000Z",666818,22,"Chuma Okeke",0,0,0,0,0,0
"13692",2157,0,0,0,0,0,0,0,0,0,0,0,0,0,0,0,0,3277498,"2023-11-24T00:00:00.000Z",666885,22,"Admiral Schofield",0,0,0,0,0,0
"13693",2158,0,0,0,0,0,0,0,0,0,0,0,0,0,0,0,0,3277498,"2023-11-24T00:00:00.000Z",85,22,"Wendell Carter Jr.",0,0,0,0,0,0
"13694",2159,0,0,0,0,0,0,0,0,0,0,0,0,0,0,0,0,3277498,"2023-11-24T00:00:00.000Z",165,22,"Markelle Fultz",0,0,0,0,0,0
"13695",2160,0,0,0,0,0,0,0,0,0,0,0,0,0,0,0,0,3277498,"2023-11-24T00:00:00.000Z",38017607,22,"Kevon Harris",0,0,0,0,0,0
"13696",2161,0,0,0,0,0,0,0,0,0,0,0,0,0,0,0,0,3277498,"2023-11-24T00:00:00.000Z",17553983,22,"Trevelin Queen",0,0,0,0,0,0
"13697",2162,3,0,5,3,0,16,7,13,12,39,0,3,26,5,2,2,3277498,"2023-11-24T00:00:00.000Z",434,2,"Jayson Tatum",2,31,34,29,8,40.5
"13698",2163,3,0,5,5,1,5,1,0,0,33,0,4,3,5,0,1,3277498,"2023-11-24T00:00:00.000Z",219,2,"Al Horford",0,8,11,6,8,12.5
"13699",2164,2,0,3,4,1,9,4,1,0,22,1,3,9,4,2,2,3277498,"2023-11-24T00:00:00.000Z",378,2,"Kristaps Porzingis",2,13,15,11,6,20.8
"13700",2165,2,1,3,8,2,22,6,7,4,39,0,3,18,3,3,3,3277498,"2023-11-24T00:00:00.000Z",70,2,"Jaylen Brown",4,21,23,20,5,33.6
"13701",2166,4,1,5,5,1,9,3,12,9,37,0,1,16,5,1,3,3277498,"2023-11-24T00:00:00.000Z",473,2,"Derrick White",2,21,25,20,9,31
"13702",2167,0,0,1,4,2,6,4,0,0,25,1,0,10,2,0,1,3277498,"2023-11-24T00:00:00.000Z",17896060,2,"Sam Hauser",0,12,12,10,2,11.4
"13703",2168,1,2,4,0,0,6,5,2,2,25,2,2,12,6,2,1,3277498,"2023-11-24T00:00:00.000Z",261,2,"Luke Kornet",4,18,19,13,7,31.7
"13704",2169,0,0,0,0,0,0,0,0,0,0,0,0,0,0,0,0,3277498,"2023-11-24T00:00:00.000Z",38017707,2,"JD Davison",0,0,0,0,0,0
"13705",2170,0,0,0,0,0,0,0,0,0,0,0,0,0,0,0,0,3277498,"2023-11-24T00:00:00.000Z",214,2,"Jrue Holiday",0,0,0,0,0,0
"13706",2171,0,0,0,0,0,0,0,0,0,0,0,0,0,0,0,0,3277498,"2023-11-24T00:00:00.000Z",3547295,2,"Nathan Knight",0,0,0,0,0,0
"13707",2172,0,0,0,0,0,0,0,0,0,0,0,0,0,0,0,0,3277498,"2023-11-24T00:00:00.000Z",17553967,2,"Neemias Queta",0,0,0,0,0,0
"13708",2173,0,0,0,0,0,0,0,0,0,0,0,0,0,0,0,0,3277498,"2023-11-24T00:00:00.000Z",56677864,2,"Jordan Walsh",0,0,0,0,0,0
"13709",2174,0,0,4,10,3,20,9,0,0,36,1,2,21,5,0,0,3277499,"2023-11-24T00:00:00.000Z",17896067,15,"Santi Aldama",0,26,26,21,5,27
"13710",2175,2,0,3,4,1,13,5,4,2,29,4,5,13,7,1,3,3277499,"2023-11-24T00:00:00.000Z",231,15,"Jaren Jackson Jr.",1,20,22,15,9,24.4
"13711",2176,2,1,2,4,1,10,3,0,0,19,1,3,7,3,0,1,1037623,"2023-10-28T00:00:00.000Z",344,6,"Georges Niang",1,10,12,9,5,15.6
"13712",2177,1,0,0,0,0,0,0,0,0,4,0,0,0,0,0,0,1037623,"2023-10-28T00:00:00.000Z",56677872,6,"Craig Porter",0,0,1,1,1,1.5
"13713",2178,2,0,1,0,0,3,2,0,0,8,4,0,4,5,0,0,1037623,"2023-10-28T00:00:00.000Z",444,6,"Tristan Thompson",0,9,11,6,7,13
"13714",2179,0,0,0,0,0,0,0,0,0,0,0,0,0,0,0,0,1037623,"2023-10-28T00:00:00.000Z",9,6,"Jarrett Allen",0,0,0,0,0,0
"13715",2180,0,0,0,0,0,0,0,0,0,0,0,0,0,0,0,0,1037623,"2023-10-28T00:00:00.000Z",666581,6,"Darius Garland",0,0,0,0,0,0
"13716",2181,0,0,0,0,0,0,0,0,0,0,0,0,0,0,0,0,1037623,"2023-10-28T00:00:00.000Z",666676,6,"Ty Jerome",0,0,0,0,0,0
"13717",2182,0,0,0,0,0,0,0,0,0,0,0,0,0,0,0,0,1037623,"2023-10-28T00:00:00.000Z",322,6,"Donovan Mitchell",0,0,0,0,0,0
"13718",2183,0,0,0,0,0,0,0,0,0,0,0,0,0,0,0,0,1037623,"2023-10-28T00:00:00.000Z",404,6,"Ricky Rubio",0,0,0,0,0,0
"13719",2184,1,0,0,3,1,10,5,3,2,17,0,0,13,0,0,0,1037623,"2023-10-28T00:00:00.000Z",38017686,12,"Bennedict Mathurin",0,13,14,14,1,14.5
"13720",2185,0,1,2,1,0,5,2,0,0,18,2,1,4,4,0,1,1037623,"2023-10-28T00:00:00.000Z",3547243,12,"Obi Toppin",1,8,8,4,4,10.8
"13721",2186,1,2,11,5,1,14,7,5,5,29,1,5,20,12,0,2,1037623,"2023-10-28T00:00:00.000Z",452,12,"Myles Turner",2,32,33,21,13,39.9
"13722",2187,2,0,4,1,0,8,3,0,0,32,0,3,6,4,1,0,1037623,"2023-10-28T00:00:00.000Z",69,12,"Bruce Brown",1,10,12,8,6,16.8
"13723",2188,13,0,7,7,4,16,7,3,3,32,1,2,21,8,0,1,1037623,"2023-10-28T00:00:00.000Z",3547245,12,"Tyrese Haliburton",0,29,42,34,21,49.1
"13724",2189,4,0,2,2,0,5,2,0,0,25,0,4,4,2,2,1,1037623,"2023-10-28T00:00:00.000Z",38017507,12,"Andrew Nembhard",2,6,10,8,6,17.4
"13725",2190,1,0,0,1,1,1,1,0,0,3,0,1,3,0,0,0,1037622,"2023-10-28T00:00:00.000Z",666971,20,"Dylan Windler",0,3,4,4,1,4.5
"13726",2191,0,0,0,0,0,0,0,0,0,0,0,0,0,0,0,0,1037622,"2023-10-28T00:00:00.000Z",19,20,"Ryan Arcidiacono",0,0,0,0,0,0
"13727",2192,0,0,0,0,0,0,0,0,0,0,0,0,0,0,0,0,1037622,"2023-10-28T00:00:00.000Z",160,20,"Evan Fournier",0,0,0,0,0,0
"13728",2193,0,0,0,0,0,0,0,0,0,0,0,0,0,0,0,0,1037622,"2023-10-28T00:00:00.000Z",666474,20,"Charles Brown",0,0,0,0,0,0
"13729",2194,0,0,0,0,0,0,0,0,0,0,0,0,0,0,0,0,1037622,"2023-10-28T00:00:00.000Z",56677795,20,"Jacob Toppin",0,0,0,0,0,0
"13730",2195,0,0,0,0,0,0,0,0,0,0,0,0,0,0,0,0,1037622,"2023-10-28T00:00:00.000Z",17896089,20,"Duane Washington Jr.",0,0,0,0,0,0
"13731",2196,2,0,0,2,2,4,2,1,1,13,0,1,7,0,1,3,1037624,"2023-10-28T00:00:00.000Z",3547275,28,"Malachi Flynn",1,7,9,9,2,10
"13732",2197,0,0,0,0,0,0,0,0,0,0,0,0,0,0,0,0,1037622,"2023-10-28T00:00:00.000Z",18677986,19,"Trey Murphy III",0,0,0,0,0,0
"13733",2198,0,0,0,0,0,0,0,0,0,0,0,0,0,0,0,0,1037622,"2023-10-28T00:00:00.000Z",38017726,19,"Dereon Seabron",0,0,0,0,0,0
"13734",2199,2,1,3,6,1,16,7,4,3,30,0,0,18,3,1,3,1037622,"2023-10-28T00:00:00.000Z",666423,20,"RJ Barrett",2,21,23,20,5,27.6
"13735",2200,4,0,12,5,0,15,4,2,2,34,0,4,10,12,0,8,1037622,"2023-10-28T00:00:00.000Z",387,20,"Julius Randle",0,22,26,14,16,22.4
"13736",2201,0,0,0,9,4,12,6,0,0,28,0,0,16,0,1,2,1037987,"2023-12-23T00:00:00.000Z",3089,28,"Gary Trent Jr.",1,16,16,16,0,17
"13737",2202,11,0,10,2,0,15,12,5,4,35,1,3,28,11,0,3,1037979,"2023-12-22T00:00:00.000Z",406,26,"Domantas Sabonis",0,39,50,39,22,54.7
"13738",2203,5,0,1,6,2,9,5,1,1,27,1,1,13,2,1,1,1037979,"2023-12-22T00:00:00.000Z",221,26,"Kevin Huerter",1,15,20,18,7,24.9
"13739",2204,7,2,6,6,2,17,9,4,3,32,0,2,23,6,3,2,1037979,"2023-12-22T00:00:00.000Z",161,26,"De'Aaron Fox",5,29,36,30,13,53.7
"13740",2205,1,1,2,2,0,3,0,2,1,17,1,3,1,3,1,0,1037979,"2023-12-22T00:00:00.000Z",38017714,26,"Keon Ellis",2,4,5,2,4,12.1
"13741",2206,0,0,1,0,0,2,1,4,3,11,0,3,5,1,0,1,1037979,"2023-12-22T00:00:00.000Z",306,26,"JaVale McGee",0,6,6,5,1,5.2
"13742",2207,0,0,3,0,0,1,0,0,0,12,1,1,0,4,0,1,1037979,"2023-12-22T00:00:00.000Z",290,26,"Trey Lyles",0,4,4,0,4,3.8
"13743",2208,0,0,0,0,0,0,0,0,0,0,0,0,0,0,0,0,1037979,"2023-12-22T00:00:00.000Z",349,24,"Jusuf Nurkic",0,0,0,0,0,0
"13744",2209,0,0,0,0,0,0,0,0,0,0,0,0,0,0,0,0,1037979,"2023-12-22T00:00:00.000Z",356,24,"Josh Okogie",0,0,0,0,0,0
"13745",2210,1,0,3,4,1,11,5,2,2,20,0,1,13,3,0,0,1037978,"2023-12-22T00:00:00.000Z",407,10,"Dario Saric",0,16,17,14,4,18.1
"13746",2211,0,0,1,2,1,3,2,2,2,6,1,1,7,2,0,0,1037978,"2023-12-22T00:00:00.000Z",57875092,10,"Gui Santos",0,9,9,7,2,9.4
"13747",2212,1,0,3,2,1,3,1,0,0,6,0,1,3,3,0,1,1037978,"2023-12-22T00:00:00.000Z",45658838,10,"Lester Quinones",0,6,7,4,4,7.1
"13748",2213,0,0,0,0,0,0,0,0,0,2,0,0,0,0,0,0,1037978,"2023-12-22T00:00:00.000Z",398,10,"Jerome Robinson",0,0,0,0,0,0
"13749",2214,0,0,0,0,0,0,0,0,0,0,0,0,0,0,0,0,1037978,"2023-12-22T00:00:00.000Z",185,10,"Draymond Green",0,0,0,0,0,0
"13750",2215,0,0,0,0,0,0,0,0,0,0,0,0,0,0,0,0,1037978,"2023-12-22T00:00:00.000Z",2189,10,"Gary Payton II",0,0,0,0,0,0
"13751",2216,0,0,0,0,0,0,0,0,0,0,0,0,0,0,0,0,1037976,"2023-12-22T00:00:00.000Z",38017736,16,"Cole Swider",0,0,0,0,0,0
"13752",2217,1,0,1,3,0,3,0,0,0,18,0,4,0,1,0,0,1037976,"2023-12-22T00:00:00.000Z",666754,1,"Garrison Mathews",0,1,2,1,2,2.7
"13753",2218,2,0,8,8,2,14,6,2,2,40,2,2,16,10,2,2,1037976,"2023-12-22T00:00:00.000Z",3547256,1,"Saddiq Bey",2,26,28,18,12,35
"13754",2219,0,0,7,0,0,3,3,2,2,28,3,5,8,10,0,2,1037976,"2023-12-22T00:00:00.000Z",83,1,"Clint Capela",0,18,18,8,10,18
"13755",2220,6,0,7,9,3,20,10,3,1,34,1,0,24,8,3,2,1037976,"2023-12-22T00:00:00.000Z",334,1,"Dejounte Murray",3,32,38,30,14,49.6
"13756",2221,13,0,3,13,7,22,10,3,3,40,0,1,30,3,2,6,1037976,"2023-12-22T00:00:00.000Z",490,1,"Trae Young",2,33,46,43,16,53.1
"13757",2222,1,0,0,1,1,2,1,0,0,12,1,4,3,1,0,1,1037976,"2023-12-22T00:00:00.000Z",319,1,"Patty Mills",0,4,5,4,2,4.7
"13758",2223,5,0,1,18,6,24,8,2,1,35,1,3,23,2,1,0,1037976,"2023-12-22T00:00:00.000Z",53,1,"Bogdan Bogdanovic",1,25,30,28,7,35.9
"13759",2224,0,0,0,0,0,0,0,0,0,0,0,0,0,0,0,0,1037977,"2023-12-22T00:00:00.000Z",47738533,11,"Jeenathan Williams",0,0,0,0,0,0
"13760",2225,1,0,2,1,0,4,1,2,1,22,2,3,3,4,0,1,1037977,"2023-12-22T00:00:00.000Z",247,7,"Derrick Jones Jr.",0,7,8,4,5,8.3
"13761",2226,0,0,0,0,0,0,0,0,0,0,0,0,0,0,0,0,1037825,"2023-11-25T00:00:00.000Z",56677855,1,"Seth Lundy",0,0,0,0,0,0
"13762",2227,0,0,0,0,0,0,0,0,0,0,0,0,0,0,0,0,1037825,"2023-11-25T00:00:00.000Z",56677875,1,"Miles Norris",0,0,0,0,0,0
"13763",2228,2,3,4,9,3,10,3,6,4,28,0,5,13,4,0,1,1037832,"2023-11-26T00:00:00.000Z",666950,4,"P.J. Washington",3,17,19,15,6,28.8
"13764",2229,4,0,2,0,0,3,2,0,0,17,0,2,4,2,1,1,1037832,"2023-11-26T00:00:00.000Z",422,4,"Ish Smith",1,6,10,8,6,14.4
"13765",2230,0,0,0,3,2,4,2,0,0,9,0,1,6,0,0,0,1037832,"2023-11-26T00:00:00.000Z",18678001,4,"JT Thor",0,6,6,6,0,6
"13766",2231,0,0,0,0,0,0,0,0,0,0,0,0,0,0,0,0,1037832,"2023-11-26T00:00:00.000Z",56677846,4,"Nick Smith Jr.",0,0,0,0,0,0
"13767",2232,0,0,0,0,0,0,0,0,0,0,0,0,0,0,0,0,1037832,"2023-11-26T00:00:00.000Z",56677848,4,"Amari Bailey",0,0,0,0,0,0
"13768",2233,0,0,0,0,0,0,0,0,0,0,0,0,0,0,0,0,1037832,"2023-11-26T00:00:00.000Z",17896037,4,"James Bouknight",0,0,0,0,0,0
"13769",2234,2,0,1,5,2,9,5,0,0,17,0,1,12,1,0,1,1037825,"2023-11-25T00:00:00.000Z",414,30,"Landry Shamet",0,13,15,14,3,15.2
"13770",2235,0,0,0,0,0,0,0,0,0,0,0,0,0,0,0,0,1037825,"2023-11-25T00:00:00.000Z",666848,30,"Jordan Poole",0,0,0,0,0,0
"13771",2236,0,0,0,0,0,0,0,0,0,0,0,0,0,0,0,0,1037825,"2023-11-25T00:00:00.000Z",38017704,30,"Patrick Baldwin Jr.",0,0,0,0,0,0
"13772",2237,0,0,0,0,0,0,0,0,0,0,0,0,0,0,0,0,1037825,"2023-11-25T00:00:00.000Z",38124126,30,"John Butler Jr.",0,0,0,0,0,0
"13773",2238,0,0,0,0,0,0,0,0,0,0,0,0,0,0,0,0,1037825,"2023-11-25T00:00:00.000Z",167,30,"Danilo Gallinari",0,0,0,0,0,0
"13774",2239,0,0,0,0,0,0,0,0,0,0,0,0,0,0,0,0,1037825,"2023-11-25T00:00:00.000Z",38017712,30,"Ryan Rollins",0,0,0,0,0,0
"13775",2240,0,0,0,0,0,0,0,0,0,0,0,0,0,0,0,0,1037825,"2023-11-25T00:00:00.000Z",487,30,"Delon Wright",0,0,0,0,0,0
"13776",2241,0,0,3,5,3,11,7,3,3,31,1,4,20,4,2,2,1037825,"2023-11-25T00:00:00.000Z",666656,1,"De'Andre Hunter",2,24,24,20,4,28.8
"13777",2242,1,1,0,2,1,4,3,2,1,9,1,0,8,1,2,0,1037825,"2023-11-25T00:00:00.000Z",17896040,1,"Jalen Johnson",3,9,10,9,2,19.7
"13778",2243,1,0,4,0,0,14,6,2,0,18,7,2,12,11,0,0,1037825,"2023-11-25T00:00:00.000Z",83,1,"Clint Capela",0,23,24,13,12,26.7
"13779",2244,10,0,5,6,1,14,4,2,2,27,0,0,11,5,4,0,1037825,"2023-11-25T00:00:00.000Z",334,1,"Dejounte Murray",4,16,26,21,15,44
"13780",2245,0,0,0,0,0,0,0,0,0,0,0,0,0,0,0,0,1037833,"2023-11-26T00:00:00.000Z",666505,15,"Brandon Clarke",0,0,0,0,0,0
"13781",2246,0,0,0,0,0,0,0,0,0,0,0,0,0,0,0,0,1037833,"2023-11-26T00:00:00.000Z",56677830,15,"GG Jackson",0,0,0,0,0,0
"13782",2247,0,0,0,0,0,0,0,0,0,0,0,0,0,0,0,0,1037833,"2023-11-26T00:00:00.000Z",254,15,"Luke Kennard",0,0,0,0,0,0
"13783",2248,0,0,0,0,0,0,0,0,0,0,0,0,0,0,0,0,1037833,"2023-11-26T00:00:00.000Z",38017728,15,"Jake LaRavia",0,0,0,0,0,0
"13784",2249,0,0,0,0,0,0,0,0,0,0,0,0,0,0,0,0,1037833,"2023-11-26T00:00:00.000Z",666786,15,"Ja Morant",0,0,0,0,0,0
"13785",2250,0,0,0,0,0,0,0,0,0,0,0,0,0,0,0,0,1037833,"2023-11-26T00:00:00.000Z",420,15,"Marcus Smart",0,0,0,0,0,0
"13786",2251,0,0,0,0,0,0,0,0,0,0,0,0,0,0,0,0,1037633,"2023-10-30T00:00:00.000Z",38017708,4,"Bryce McGowens",0,0,0,0,0,0
"13787",2252,0,0,0,0,0,0,0,0,0,0,0,0,0,0,0,0,1037634,"2023-10-30T00:00:00.000Z",38017701,12,"Kendall Brown",0,0,0,0,0,0
"13788",2253,0,0,0,0,0,0,0,0,0,0,0,0,0,0,0,0,1037634,"2023-10-30T00:00:00.000Z",56677778,12,"Oscar Tshiebwe",0,0,0,0,0,0
"13789",2254,0,0,0,0,0,0,0,0,0,0,0,0,0,0,0,0,1037634,"2023-10-30T00:00:00.000Z",56677794,12,"Isaiah Wong",0,0,0,0,0,0
"13790",2255,4,1,1,1,0,19,6,8,8,35,1,2,20,2,0,0,1037634,"2023-10-30T00:00:00.000Z",125,5,"DeMar DeRozan",1,22,26,24,6,31.4
"13791",2256,0,1,4,2,1,6,3,2,2,22,0,0,9,4,1,1,1037634,"2023-10-30T00:00:00.000Z",3547248,5,"Patrick Williams",2,13,13,9,4,18.8
"13792",2257,3,0,12,1,0,19,10,6,4,34,5,3,24,17,1,1,1037634,"2023-10-30T00:00:00.000Z",460,5,"Nikola Vucevic",1,41,44,27,20,50.9
"13793",2258,1,0,5,6,1,17,6,11,10,36,0,1,23,5,0,1,1037634,"2023-10-30T00:00:00.000Z",268,5,"Zach LaVine",0,28,29,24,6,29.5
"13794",2259,3,0,2,2,1,6,3,0,0,25,0,4,7,2,1,1,1037634,"2023-10-30T00:00:00.000Z",666956,5,"Coby White",1,9,12,10,5,15.9
"13795",2260,3,1,3,2,1,5,3,2,1,26,1,1,8,4,0,3,1037634,"2023-10-30T00:00:00.000Z",89,5,"Alex Caruso",1,12,15,11,7,17.3
"13796",2261,2,1,2,1,1,7,5,0,0,18,0,1,11,2,1,3,1037634,"2023-10-30T00:00:00.000Z",87,5,"Jevon Carter",2,13,15,13,4,19.4
"13797",2262,2,0,1,0,0,4,2,2,1,14,2,0,5,3,1,1,1037634,"2023-10-30T00:00:00.000Z",137,5,"Andre Drummond",1,8,10,7,5,13.6
"13798",2263,1,1,3,1,1,3,2,0,0,20,1,3,5,4,2,2,1037634,"2023-10-30T00:00:00.000Z",110,5,"Torrey Craig",3,9,10,6,5,18.3
"13799",2264,0,1,1,1,0,1,0,0,0,10,0,2,0,1,1,0,1037634,"2023-10-30T00:00:00.000Z",17895983,5,"Ayo Dosunmu",2,1,1,0,1,7.2
"13800",2265,0,0,0,0,0,0,0,0,0,0,0,0,0,0,0,0,1037635,"2023-10-30T00:00:00.000Z",666577,30,"Daniel Gafford",0,0,0,0,0,0
"13801",2266,0,0,0,0,0,0,0,0,0,0,0,0,0,0,0,0,1037635,"2023-10-30T00:00:00.000Z",414,30,"Landry Shamet",0,0,0,0,0,0
"13802",2267,2,1,6,13,8,24,13,4,2,31,0,3,36,6,3,0,1037635,"2023-10-30T00:00:00.000Z",70,2,"Jaylen Brown",4,42,44,38,8,58.2
"13803",2268,3,0,6,9,4,21,14,1,1,28,0,2,33,6,0,2,1037635,"2023-10-30T00:00:00.000Z",434,2,"Jayson Tatum",0,39,42,36,9,42.7
"13804",2269,3,1,6,2,1,9,7,0,0,24,0,2,15,6,0,2,1037635,"2023-10-30T00:00:00.000Z",378,2,"Kristaps Porzingis",1,21,24,18,9,27.7
"13805",2270,8,1,0,2,1,3,2,0,0,24,1,1,5,1,2,2,1037635,"2023-10-30T00:00:00.000Z",473,2,"Derrick White",3,6,14,13,9,25.2
"13806",2271,3,2,4,3,1,7,4,2,2,27,1,1,11,5,1,1,1037635,"2023-10-30T00:00:00.000Z",214,2,"Jrue Holiday",3,16,19,14,8,29.5
"13807",2272,6,0,6,6,0,8,0,0,0,25,1,3,0,7,1,4,1037635,"2023-10-30T00:00:00.000Z",3547276,2,"Payton Pritchard",1,7,13,6,13,16.4
"13808",2273,1,0,1,3,0,9,4,0,0,15,4,1,8,5,2,0,1037635,"2023-10-30T00:00:00.000Z",219,2,"Al Horford",2,13,14,9,6,21.5
"13809",2274,1,1,5,9,2,10,3,0,0,25,3,3,8,8,0,1,1037635,"2023-10-30T00:00:00.000Z",17896060,2,"Sam Hauser",1,16,17,9,9,21.1
"13810",2275,1,0,1,2,0,4,0,0,0,10,1,2,0,2,1,0,1037635,"2023-10-30T00:00:00.000Z",666468,2,"Oshae Brissett",1,2,3,1,3,6.9
"13811",2276,7,1,2,5,1,19,9,5,5,37,2,4,24,4,2,5,1038011,"2023-12-27T00:00:00.000Z",73,20,"Jalen Brunson",3,28,35,31,11,43.3
"13812",2277,0,0,0,0,0,0,0,0,0,0,0,0,0,0,0,0,1038013,"2023-12-28T00:00:00.000Z",56677792,9,"Marcus Sasser",0,0,0,0,0,0
"13813",2278,0,0,0,0,0,0,0,0,0,0,0,0,0,0,0,0,1038013,"2023-12-28T00:00:00.000Z",56677729,9,"Malcolm Cazalon",0,0,0,0,0,0
"13814",2279,0,0,0,0,0,0,0,0,0,0,0,0,0,0,0,0,1038013,"2023-12-28T00:00:00.000Z",330,9,"Monte Morris",0,0,0,0,0,0
"13815",2280,0,0,0,0,0,0,0,0,0,0,0,0,0,0,0,0,1038013,"2023-12-28T00:00:00.000Z",42097199,9,"Jared Rhoden",0,0,0,0,0,0
"13816",2281,0,0,0,0,0,0,0,0,0,0,0,0,0,0,0,0,1038013,"2023-12-28T00:00:00.000Z",3547267,9,"Isaiah Stewart",0,0,0,0,0,0
"13817",2282,0,0,0,0,0,0,0,0,0,0,0,0,0,0,0,0,1038013,"2023-12-28T00:00:00.000Z",44477024,9,"Stanley Umude",0,0,0,0,0,0
"13818",2283,2,0,4,5,3,5,3,0,0,18,0,4,9,4,0,3,1038015,"2023-12-28T00:00:00.000Z",667378,18,"Naz Reid",0,13,15,11,6,13.8
"13819",2284,0,0,0,0,0,0,0,0,0,0,0,0,0,0,0,0,1038015,"2023-12-28T00:00:00.000Z",17895968,18,"Daishen Nix",0,0,0,0,0,0
"13820",2285,0,0,0,0,0,0,0,0,0,0,0,0,0,0,0,0,1038015,"2023-12-28T00:00:00.000Z",56677851,18,"Jaylen Clark",0,0,0,0,0,0
"13821",2286,0,0,0,0,0,0,0,0,0,0,0,0,0,0,0,0,1038015,"2023-12-28T00:00:00.000Z",17896056,18,"Luka Garza",0,0,0,0,0,0
"13822",2287,0,0,0,0,0,0,0,0,0,0,0,0,0,0,0,0,1038015,"2023-12-28T00:00:00.000Z",56677782,18,"Leonard Miller",0,0,0,0,0,0
"13823",2288,0,0,0,0,0,0,0,0,0,0,0,0,0,0,0,0,1038015,"2023-12-28T00:00:00.000Z",38017700,18,"Wendell Moore Jr.",0,0,0,0,0,0
"13824",2289,0,1,6,3,1,9,3,8,8,30,3,5,15,9,3,1,1038015,"2023-12-28T00:00:00.000Z",247,7,"Derrick Jones Jr.",4,24,24,15,9,36.8
"13825",2290,2,0,2,6,1,11,4,0,0,23,2,0,9,4,1,1,1038013,"2023-12-28T00:00:00.000Z",3547276,2,"Payton Pritchard",1,13,15,11,6,18.8
"13826",2291,1,0,2,4,1,6,2,0,0,18,1,0,5,3,0,1,1038013,"2023-12-28T00:00:00.000Z",17896060,2,"Sam Hauser",0,8,9,6,4,9.1
"13827",2292,0,0,2,0,0,2,2,2,1,20,0,4,5,2,1,0,1038013,"2023-12-28T00:00:00.000Z",17553967,2,"Neemias Queta",1,7,7,5,2,10.4
"13828",2293,0,0,0,0,0,0,0,0,0,0,0,0,0,0,0,0,1038013,"2023-12-28T00:00:00.000Z",261,2,"Luke Kornet",0,0,0,0,0,0
"13829",2294,0,0,0,0,0,0,0,0,0,0,0,0,0,0,0,0,1038013,"2023-12-28T00:00:00.000Z",338,2,"Svi Mykhailiuk",0,0,0,0,0,0
"13830",2295,0,0,0,0,0,0,0,0,0,0,0,0,0,0,0,0,1038013,"2023-12-28T00:00:00.000Z",3547279,2,"Lamar Stevens",0,0,0,0,0,0
"13831",2296,0,0,0,0,0,0,0,0,0,0,0,0,0,0,0,0,1038013,"2023-12-28T00:00:00.000Z",70,2,"Jaylen Brown",0,0,0,0,0,0
"13832",2297,0,0,0,0,0,0,0,0,0,0,0,0,0,0,0,0,1038013,"2023-12-28T00:00:00.000Z",38017707,2,"JD Davison",0,0,0,0,0,0
"13833",2299,0,0,0,0,0,0,0,0,0,0,0,0,0,0,0,0,1038013,"2023-12-28T00:00:00.000Z",56677864,2,"Jordan Walsh",0,0,0,0,0,0
"13834",2300,6,0,10,7,1,21,8,0,0,44,2,3,17,12,0,2,1038013,"2023-12-28T00:00:00.000Z",54,9,"Bojan Bogdanovic",0,29,35,23,18,38.4
"13835",2301,1,0,1,4,1,5,2,0,0,12,0,3,5,1,0,0,1037863,"2023-11-30T00:00:00.000Z",27924547,21,"Lindy Waters III",0,6,7,6,2,7.7
"13836",2302,0,0,0,0,0,0,0,0,0,0,0,0,0,0,0,0,1037864,"2023-11-30T00:00:00.000Z",56677865,27,"Charles Bediako",0,0,0,0,0,0
"13837",2303,0,0,0,0,0,0,0,0,0,0,0,0,0,0,0,0,1037864,"2023-11-30T00:00:00.000Z",56677817,27,"Sidy Cissoko",0,0,0,0,0,0
"13838",2304,0,0,0,0,0,0,0,0,0,0,0,0,0,0,0,0,1037864,"2023-11-30T00:00:00.000Z",56677870,27,"Sir'Jabari Rice",0,0,0,0,0,0
"13839",2305,2,0,6,4,2,8,3,4,4,22,0,6,12,6,1,3,1037864,"2023-11-30T00:00:00.000Z",666656,1,"De'Andre Hunter",1,18,20,14,8,22.2
"13840",2306,0,0,2,4,3,8,5,0,0,34,2,3,13,4,3,1,1037864,"2023-11-30T00:00:00.000Z",3547256,1,"Saddiq Bey",3,17,17,13,4,25.8
"13841",2307,1,1,5,0,0,9,6,0,0,23,4,4,12,9,0,2,1037864,"2023-11-30T00:00:00.000Z",83,1,"Clint Capela",1,21,22,13,10,25.3
"13842",2308,2,0,3,4,2,21,10,2,2,35,0,1,24,3,5,0,1037864,"2023-11-30T00:00:00.000Z",334,1,"Dejounte Murray",5,27,29,26,5,45.6
"13843",2309,1,1,1,4,0,14,6,0,0,36,1,1,12,2,2,1,1037861,"2023-11-30T00:00:00.000Z",3547248,5,"Patrick Williams",3,14,15,13,3,23.9
"13844",2310,5,1,1,5,3,9,4,0,0,29,0,1,11,1,2,7,1037861,"2023-11-30T00:00:00.000Z",89,5,"Alex Caruso",3,12,17,16,6,21.7
"13845",2311,6,0,9,4,2,21,11,6,5,40,1,2,29,10,1,4,1037861,"2023-11-30T00:00:00.000Z",460,5,"Nikola Vucevic",1,39,45,35,16,49
"13846",2312,6,0,5,3,1,8,6,2,1,39,1,2,14,6,3,2,1037861,"2023-11-30T00:00:00.000Z",17895983,5,"Ayo Dosunmu",3,20,26,20,12,37.2
"13847",2313,7,1,4,11,4,20,7,6,5,45,0,3,23,4,1,3,1037861,"2023-11-30T00:00:00.000Z",666956,5,"Coby White",2,27,34,30,11,41.3
"13848",2314,2,1,5,6,2,10,4,0,0,27,3,4,10,8,1,2,1037861,"2023-11-30T00:00:00.000Z",110,5,"Torrey Craig",2,18,20,12,10,26.6
"13849",2315,1,0,1,2,1,10,5,0,0,18,1,1,11,2,3,0,1037861,"2023-11-30T00:00:00.000Z",87,5,"Jevon Carter",3,13,14,12,3,23.9
"13850",2316,0,0,0,0,0,0,0,0,0,0,0,0,0,0,0,0,1037861,"2023-11-30T00:00:00.000Z",56677874,5,"Onuralp Bitim",0,0,0,0,0,0
"13851",2317,0,0,0,0,0,0,0,0,0,0,0,0,0,0,0,0,1037860,"2023-11-30T00:00:00.000Z",330,9,"Monte Morris",0,0,0,0,0,0
"13852",2318,0,0,0,0,0,0,0,0,0,0,0,0,0,0,0,0,1037860,"2023-11-30T00:00:00.000Z",42097199,9,"Jared Rhoden",0,0,0,0,0,0
"13853",2319,0,0,1,3,0,6,1,2,1,19,0,3,3,1,0,1,1037863,"2023-11-30T00:00:00.000Z",56677835,14,"Jalen Hood-Schifino",0,4,4,3,1,3.2
"13854",2320,0,1,2,0,0,1,0,2,2,4,1,0,2,3,0,0,1037863,"2023-11-30T00:00:00.000Z",56677738,14,"Colin Castleton",1,5,5,2,3,8.6
"13855",2321,0,0,0,1,0,1,0,2,2,4,1,0,2,1,0,0,1037863,"2023-11-30T00:00:00.000Z",56677867,14,"Alex Fudge",0,3,3,2,1,3.2
"13856",2322,0,0,0,0,0,0,0,0,0,4,0,0,0,0,0,0,1037863,"2023-11-30T00:00:00.000Z",56677836,14,"Maxwell Lewis",0,0,0,0,0,0
"13857",2323,0,0,0,1,0,1,0,0,0,4,0,0,0,0,0,0,1037863,"2023-11-30T00:00:00.000Z",56677868,14,"D'Moi Hodge",0,0,0,0,0,0
"13858",2324,0,0,0,0,0,0,0,0,0,0,0,0,0,0,0,0,1037863,"2023-11-30T00:00:00.000Z",666860,14,"Cameron Reddish",0,0,0,0,0,0
"13859",2325,0,0,0,0,0,0,0,0,0,0,0,0,0,0,0,0,1037861,"2023-11-30T00:00:00.000Z",2148,17,"Thanasis Antetokounmpo",0,0,0,0,0,0
"13860",2326,0,0,0,1,0,1,0,0,0,1,0,1,0,0,1,0,1037676,"2023-11-04T00:00:00.000Z",38017714,26,"Keon Ellis",1,0,0,0,0,3
"13861",2327,0,0,0,0,0,0,0,0,0,1,0,0,0,0,0,0,1037676,"2023-11-04T00:00:00.000Z",3547281,11,"Nate Hinton",0,0,0,0,0,0
"13862",2328,0,0,0,0,0,0,0,0,0,0,0,0,0,0,0,0,1037676,"2023-11-04T00:00:00.000Z",75,11,"Reggie Bullock",0,0,0,0,0,0
"13863",2329,0,0,0,0,0,0,0,0,0,0,0,0,0,0,0,0,1037676,"2023-11-04T00:00:00.000Z",296,11,"Boban Marjanovic",0,0,0,0,0,0
"13864",2330,0,0,0,0,0,0,0,0,0,0,0,0,0,0,0,0,1037676,"2023-11-04T00:00:00.000Z",38017695,11,"Tari Eason",0,0,0,0,0,0
"13865",2331,0,0,0,0,0,0,0,0,0,0,0,0,0,0,0,0,1037676,"2023-11-04T00:00:00.000Z",357,11,"Victor Oladipo",0,0,0,0,0,0
"13866",2332,0,0,0,0,0,0,0,0,0,0,0,0,0,0,0,0,1037676,"2023-11-04T00:00:00.000Z",56677825,11,"Amen Thompson",0,0,0,0,0,0
"13867",2333,0,0,0,0,0,0,0,0,0,0,0,0,0,0,0,0,1037676,"2023-11-04T00:00:00.000Z",47738533,11,"Jeenathan Williams",0,0,0,0,0,0
"13868",2334,4,4,4,3,2,14,6,0,0,38,5,3,14,9,4,1,1037679,"2023-11-05T00:00:00.000Z",56677826,9,"Ausar Thompson",8,23,27,18,13,53.8
"13869",2335,1,0,2,2,1,6,3,2,1,34,0,0,8,2,0,3,1037679,"2023-11-05T00:00:00.000Z",3547267,9,"Isaiah Stewart",0,10,11,9,3,8.9
"13870",2336,3,0,8,0,0,10,6,0,0,31,3,4,12,11,2,5,1037679,"2023-11-05T00:00:00.000Z",38017694,9,"Jalen Duren",2,23,26,15,14,30.7
"13871",2337,6,1,2,6,0,24,12,3,2,39,1,2,26,3,0,6,1037679,"2023-11-05T00:00:00.000Z",17896075,9,"Cade Cunningham",1,29,35,32,9,35.6
"13872",2338,5,1,2,3,1,8,4,4,4,34,0,4,13,2,0,0,1037679,"2023-11-05T00:00:00.000Z",3547241,9,"Killian Hayes",1,15,20,18,7,25.9
"13873",2339,4,0,3,6,4,16,9,0,0,30,0,3,22,3,1,0,1037679,"2023-11-05T00:00:00.000Z",56677792,9,"Marcus Sasser",1,25,29,26,7,34.6
"13874",2340,1,0,1,0,0,5,3,5,5,11,1,5,11,2,0,1,1037679,"2023-11-05T00:00:00.000Z",24,9,"Marvin Bagley III",0,13,14,12,3,13.9
"13875",2341,1,0,1,2,0,2,0,0,0,13,0,1,0,1,0,0,1037679,"2023-11-05T00:00:00.000Z",197,9,"Joe Harris",0,1,2,1,2,2.7
"13876",2342,0,0,0,1,0,2,0,0,0,4,0,1,0,0,0,0,1037679,"2023-11-05T00:00:00.000Z",44477024,9,"Stanley Umude",0,0,0,0,0,0
"13877",2343,0,0,0,0,0,0,0,0,0,3,0,0,0,0,0,0,1037679,"2023-11-05T00:00:00.000Z",42097199,9,"Jared Rhoden",0,0,0,0,0,0
"13878",2344,0,0,0,0,0,0,0,0,0,3,0,0,0,0,0,0,1037679,"2023-11-05T00:00:00.000Z",56677729,9,"Malcolm Cazalon",0,0,0,0,0,0
"13879",2345,0,0,0,0,0,0,0,0,0,0,0,0,0,0,0,0,1037679,"2023-11-05T00:00:00.000Z",38017682,9,"Jaden Ivey",0,0,0,0,0,0
"13880",2346,0,0,0,0,0,0,0,0,0,0,0,0,0,0,0,0,1037676,"2023-11-04T00:00:00.000Z",161,26,"De'Aaron Fox",0,0,0,0,0,0
"13881",2347,0,0,0,0,0,0,0,0,0,0,0,0,0,0,0,0,1037676,"2023-11-04T00:00:00.000Z",290,26,"Trey Lyles",0,0,0,0,0,0
"13882",2348,0,0,0,0,0,0,0,0,0,0,0,0,0,0,0,0,1037678,"2023-11-04T00:00:00.000Z",666489,8,"Vlatko Cancar",0,0,0,0,0,0
"13883",2349,0,0,0,0,0,0,0,0,0,0,0,0,0,0,0,0,1037678,"2023-11-04T00:00:00.000Z",17896103,8,"Jay Huff",0,0,0,0,0,0
"13884",2350,0,0,0,0,0,0,0,0,0,0,0,0,0,0,0,0,1037678,"2023-11-04T00:00:00.000Z",17896007,8,"Braxton Key",0,0,0,0,0,0
"13885",2351,0,0,0,0,0,0,0,0,0,1,0,0,0,0,0,0,1038033,"2023-12-30T00:00:00.000Z",19,20,"Ryan Arcidiacono",0,0,0,0,0,0
"13886",2352,1,0,0,2,1,3,2,0,0,18,0,3,5,0,0,0,1038033,"2023-12-30T00:00:00.000Z",17896033,20,"Miles McBride",0,5,6,6,1,6.5
"13887",2353,1,0,0,0,0,0,0,0,0,1,0,0,0,0,0,0,1038033,"2023-12-30T00:00:00.000Z",56677795,20,"Jacob Toppin",0,0,1,1,1,1.5
"13888",2355,0,0,0,0,0,0,0,0,0,0,0,0,0,0,0,0,1038033,"2023-12-30T00:00:00.000Z",17896063,20,"Jericho Sims",0,0,0,0,0,0
"13889",2356,0,0,0,0,0,0,0,0,0,0,0,0,0,0,0,0,1038033,"2023-12-30T00:00:00.000Z",3547249,20,"Precious Achiuwa",0,0,0,0,0,0
"13890",2357,0,0,0,0,0,0,0,0,0,0,0,0,0,0,0,0,1038033,"2023-12-30T00:00:00.000Z",18,20,"OG Anunoby",0,0,0,0,0,0
"13891",2358,0,0,0,0,0,0,0,0,0,0,0,0,0,0,0,0,1038033,"2023-12-30T00:00:00.000Z",3547275,20,"Malachi Flynn",0,0,0,0,0,0
"13892",2359,0,0,0,0,0,0,0,0,0,0,0,0,0,0,0,0,1038033,"2023-12-30T00:00:00.000Z",17895858,20,"Quentin Grimes",0,0,0,0,0,0
"13893",2360,0,0,0,0,0,0,0,0,0,0,0,0,0,0,0,0,1038033,"2023-12-30T00:00:00.000Z",666675,20,"DaQuan Jeffries",0,0,0,0,0,0
"13894",2361,0,0,0,0,0,0,0,0,0,0,0,0,0,0,0,0,1038033,"2023-12-30T00:00:00.000Z",399,20,"Mitchell Robinson",0,0,0,0,0,0
"13895",2362,2,1,3,1,0,6,2,2,2,26,0,6,6,3,1,1,1038035,"2023-12-30T00:00:00.000Z",3547259,18,"Jaden McDaniels",2,9,11,8,5,17.6
"13896",2363,2,0,7,4,1,7,3,2,2,29,2,5,9,9,0,5,1038035,"2023-12-30T00:00:00.000Z",447,18,"Karl-Anthony Towns",0,18,20,11,11,17.8
"13897",2364,0,1,9,0,0,7,6,1,1,38,4,3,13,13,2,4,1038035,"2023-12-30T00:00:00.000Z",176,18,"Rudy Gobert",3,26,26,13,13,33.6
"13898",2365,3,3,3,8,2,23,10,11,9,38,0,3,31,3,0,3,1038035,"2023-12-30T00:00:00.000Z",3547238,18,"Anthony Edwards",3,34,37,34,6,45.1
"13899",2366,7,0,3,9,4,11,4,4,3,33,1,2,15,4,1,1,1038035,"2023-12-30T00:00:00.000Z",104,18,"Mike Conley",1,19,26,22,11,32.3
"13900",2367,7,1,3,1,0,4,2,0,0,25,0,0,4,3,0,1,1038035,"2023-12-30T00:00:00.000Z",12,18,"Kyle Anderson",1,7,14,11,10,20.1
"13901",2368,2,0,2,4,2,4,2,0,0,16,0,4,6,2,1,2,1038035,"2023-12-30T00:00:00.000Z",666400,18,"Nickeil Alexander-Walker",1,8,10,8,4,12.4
"13902",2369,0,0,3,2,1,3,1,0,0,8,0,0,3,3,1,0,1038035,"2023-12-30T00:00:00.000Z",68,18,"Troy Brown Jr.",1,6,6,3,3,9.6
"13903",2370,0,0,0,0,0,0,0,0,0,0,0,0,0,0,0,0,1038035,"2023-12-30T00:00:00.000Z",666767,18,"Jordan McLaughlin",0,0,0,0,0,0
"13904",2371,0,0,0,0,0,0,0,0,0,0,0,0,0,0,0,0,1038035,"2023-12-30T00:00:00.000Z",320,18,"Shake Milton",0,0,0,0,0,0
"13905",2372,3,0,1,1,0,4,1,4,3,20,0,1,5,1,0,1,1038035,"2023-12-30T00:00:00.000Z",405,14,"D'Angelo Russell",0,6,9,8,4,9.7
"13906",2373,0,0,1,5,0,11,2,6,5,29,1,2,9,2,0,1,1038035,"2023-12-30T00:00:00.000Z",17553995,14,"Austin Reaves",0,11,11,9,2,10.4
"13907",2374,0,1,5,2,2,4,2,2,1,13,0,1,7,5,0,2,1038035,"2023-12-30T00:00:00.000Z",486,14,"Christian Wood",1,12,12,7,5,14
"13908",2375,0,0,0,0,0,0,0,0,0,0,0,0,0,0,0,0,1038035,"2023-12-30T00:00:00.000Z",666626,14,"Jaxson Hayes",0,0,0,0,0,0
"13909",2376,0,0,1,0,0,0,0,0,0,7,0,3,0,1,1,1,7049317,"2023-12-06T00:00:00.000Z",666754,1,"Garrison Mathews",1,1,1,0,1,3.2
"13910",2377,3,1,6,3,1,20,8,14,12,36,0,1,29,6,0,2,7049319,"2023-12-06T00:00:00.000Z",125,5,"DeMar DeRozan",1,35,38,32,9,41.7
"13911",2378,1,2,6,2,1,6,3,2,1,29,3,2,8,9,2,3,7049319,"2023-12-06T00:00:00.000Z",3547248,5,"Patrick Williams",4,17,18,9,10,29.3
"13912",2379,3,1,6,3,2,17,8,2,2,34,6,0,20,12,0,2,7049319,"2023-12-06T00:00:00.000Z",460,5,"Nikola Vucevic",1,32,35,23,15,39.9
"13913",2380,2,2,2,2,1,7,4,4,3,30,4,2,12,6,0,1,7049319,"2023-12-06T00:00:00.000Z",89,5,"Alex Caruso",2,18,20,14,8,27.2
"13914",2381,5,0,9,7,3,16,6,5,4,38,0,3,19,9,0,0,7049319,"2023-12-06T00:00:00.000Z",666956,5,"Coby White",0,28,33,24,14,37.3
"13915",2382,2,0,2,4,2,9,3,0,0,22,0,2,8,2,1,4,7049319,"2023-12-06T00:00:00.000Z",17895983,5,"Ayo Dosunmu",1,10,12,10,4,12.4
"13916",2383,2,0,1,2,2,4,2,0,0,17,3,2,6,4,1,0,7049319,"2023-12-06T00:00:00.000Z",110,5,"Torrey Craig",1,10,12,8,6,16.8
"13917",2384,1,0,0,1,0,2,1,0,0,6,0,0,2,0,0,0,7049319,"2023-12-06T00:00:00.000Z",56677857,5,"Julian Phillips",0,2,3,3,1,3.5
"13918",2385,1,0,4,0,0,8,3,2,1,14,5,3,7,9,1,3,7049319,"2023-12-06T00:00:00.000Z",137,5,"Andre Drummond",1,16,17,8,10,19.3
"13919",2386,0,0,0,0,0,0,0,0,0,3,0,0,0,0,0,0,7049319,"2023-12-06T00:00:00.000Z",38017719,5,"Dalen Terry",0,0,0,0,0,0
"13920",2387,3,0,0,1,0,1,0,0,0,11,0,1,0,0,1,1,7049319,"2023-12-06T00:00:00.000Z",87,5,"Jevon Carter",1,0,3,3,3,6.5
"13921",2388,0,0,0,0,0,0,0,0,0,0,0,0,0,0,0,0,7049319,"2023-12-06T00:00:00.000Z",17896116,5,"Terry Taylor",0,0,0,0,0,0
"13922",2389,0,0,0,0,0,0,0,0,0,0,0,0,0,0,0,0,7049319,"2023-12-06T00:00:00.000Z",27,5,"Lonzo Ball",0,0,0,0,0,0
"13923",2390,0,0,0,0,0,0,0,0,0,0,0,0,0,0,0,0,7049319,"2023-12-06T00:00:00.000Z",56677874,5,"Onuralp Bitim",0,0,0,0,0,0
"13924",2391,0,0,0,0,0,0,0,0,0,0,0,0,0,0,0,0,7049319,"2023-12-06T00:00:00.000Z",268,5,"Zach LaVine",0,0,0,0,0,0
"13925",2392,0,0,0,0,0,0,0,0,0,0,0,0,0,0,0,0,7049319,"2023-12-06T00:00:00.000Z",45969255,5,"Justin Lewis",0,0,0,0,0,0
"13926",2393,0,0,0,0,0,0,0,0,0,0,0,0,0,0,0,0,7049319,"2023-12-06T00:00:00.000Z",56677860,5,"Adama Sanogo",0,0,0,0,0,0
"13927",2394,4,1,2,4,2,18,10,5,5,35,2,2,27,4,2,5,7049319,"2023-12-06T00:00:00.000Z",204,4,"Gordon Hayward",3,31,35,31,8,41.8
"13928",2395,2,0,6,8,2,15,7,0,0,40,2,3,16,8,3,1,7049319,"2023-12-06T00:00:00.000Z",62,4,"Miles Bridges",3,24,26,18,10,36.6
"13929",2396,0,3,5,0,0,4,2,2,2,28,6,3,6,11,1,2,7049319,"2023-12-06T00:00:00.000Z",3547282,4,"Nick Richards",4,17,17,6,11,29.2
"13930",2397,4,1,6,6,3,14,4,1,1,39,0,3,12,6,1,2,7049319,"2023-12-06T00:00:00.000Z",56677823,4,"Brandon Miller",2,18,22,16,10,29.2
"13931",2398,7,2,4,11,1,24,10,4,4,40,1,4,25,5,1,2,7049319,"2023-12-06T00:00:00.000Z",403,4,"Terry Rozier",3,30,37,32,12,48.5
"13932",2399,3,0,1,0,0,0,0,0,0,14,0,1,0,1,0,2,7049319,"2023-12-06T00:00:00.000Z",422,4,"Ish Smith",0,1,4,3,4,3.7
"13933",2400,4,2,5,7,1,13,4,0,0,28,1,5,9,6,1,1,7049319,"2023-12-06T00:00:00.000Z",666950,4,"P.J. Washington",3,15,19,13,10,30.2
"13934",2401,0,0,0,0,0,0,0,0,0,0,0,0,0,0,0,0,1037711,"2023-11-09T00:00:00.000Z",85,22,"Wendell Carter Jr.",0,0,0,0,0,0
"13935",2402,5,1,5,4,1,9,5,0,0,31,1,2,11,6,1,3,3277398,"2023-11-10T00:00:00.000Z",3547242,30,"Deni Avdija",2,17,22,16,11,28.7
"13936",2403,1,0,5,5,2,17,7,1,1,29,1,1,17,6,0,3,3277398,"2023-11-10T00:00:00.000Z",265,30,"Kyle Kuzma",0,23,24,18,7,22.7
"13937",2404,1,4,5,0,0,7,4,3,2,30,4,4,10,9,2,2,3277398,"2023-11-10T00:00:00.000Z",666577,30,"Daniel Gafford",6,19,20,11,10,38.3
"13938",2405,6,0,2,5,1,14,6,1,1,31,0,4,14,2,0,3,3277398,"2023-11-10T00:00:00.000Z",666848,30,"Jordan Poole",0,16,22,20,8,22.4
"13939",2406,4,1,4,4,2,12,6,3,2,34,0,2,16,4,0,0,3277398,"2023-11-10T00:00:00.000Z",249,30,"Tyus Jones",1,20,24,20,8,29.8
"13940",2407,0,0,4,3,3,6,5,2,2,16,0,2,15,4,0,0,3277398,"2023-11-10T00:00:00.000Z",17896045,30,"Corey Kispert",0,19,19,15,4,19.8
"13941",2408,4,0,0,4,1,6,3,2,2,18,1,1,9,1,0,1,3277398,"2023-11-10T00:00:00.000Z",167,30,"Danilo Gallinari",0,10,14,13,5,15.2
"13942",2409,6,0,2,2,0,3,1,3,2,14,0,3,4,2,1,0,3277398,"2023-11-10T00:00:00.000Z",487,30,"Delon Wright",1,6,12,10,8,18.4
"13943",2410,1,0,2,4,2,4,2,4,4,20,0,1,10,2,0,2,3277398,"2023-11-10T00:00:00.000Z",56677844,30,"Bilal Coulibaly",0,12,13,11,3,11.9
"13944",2411,0,0,0,7,2,10,4,1,1,17,0,3,11,0,0,1,3277398,"2023-11-10T00:00:00.000Z",414,30,"Landry Shamet",0,11,11,11,0,10
"13945",2412,0,0,0,0,0,0,0,0,0,0,0,0,0,0,0,0,3277398,"2023-11-10T00:00:00.000Z",38017704,30,"Patrick Baldwin Jr.",0,0,0,0,0,0
"13946",2413,0,0,0,0,0,0,0,0,0,0,0,0,0,0,0,0,3277398,"2023-11-10T00:00:00.000Z",38017687,30,"Johnny Davis",0,0,0,0,0,0
"13947",2414,1,1,1,2,1,4,3,2,2,17,2,3,9,3,1,1,1037711,"2023-11-09T00:00:00.000Z",56677827,22,"Anthony Black",2,12,13,10,4,19.1
"13948",2415,0,2,6,4,1,8,3,7,5,16,1,1,12,7,0,0,1037711,"2023-11-09T00:00:00.000Z",229,22,"Jonathan Isaac",2,19,19,12,7,26.4
"13949",2416,8,0,3,15,5,27,12,13,12,34,2,1,41,5,2,3,1037711,"2023-11-09T00:00:00.000Z",490,1,"Trae Young",2,46,54,49,13,62
"13950",2417,3,0,4,6,3,11,6,0,0,29,0,3,15,4,3,1,1037711,"2023-11-09T00:00:00.000Z",53,1,"Bogdan Bogdanovic",3,19,22,18,7,32.3
"13951",2418,0,0,2,0,0,4,1,0,0,29,1,3,2,3,1,1,1037711,"2023-11-09T00:00:00.000Z",3547256,1,"Saddiq Bey",1,5,5,2,3,7.6
"13952",2419,2,4,1,1,0,4,3,2,1,21,1,4,7,2,3,1,1037711,"2023-11-09T00:00:00.000Z",3547244,1,"Onyeka Okongwu",7,9,11,9,4,32.4
"13953",2420,0,0,0,0,0,0,0,0,0,0,0,0,0,0,0,0,1037711,"2023-11-09T00:00:00.000Z",319,1,"Patty Mills",0,0,0,0,0,0
"13954",2421,0,0,0,0,0,0,0,0,0,0,0,0,0,0,0,0,1037711,"2023-11-09T00:00:00.000Z",56677838,1,"Kobe Bufkin",0,0,0,0,0,0
"13955",2422,0,0,0,0,0,0,0,0,0,0,0,0,0,0,0,0,1037711,"2023-11-09T00:00:00.000Z",3547297,1,"Trent Forrest",0,0,0,0,0,0
"13956",2423,0,0,0,0,0,0,0,0,0,0,0,0,0,0,0,0,1037711,"2023-11-09T00:00:00.000Z",56677806,1,"Mouhamed Gueye",0,0,0,0,0,0
"13957",2424,0,0,0,0,0,0,0,0,0,0,0,0,0,0,0,0,1037711,"2023-11-09T00:00:00.000Z",301,1,"Wesley Matthews",0,0,0,0,0,0
"13958",2425,0,0,0,0,0,0,0,0,0,0,0,0,0,0,0,0,1037711,"2023-11-09T00:00:00.000Z",56677875,1,"Miles Norris",0,0,0,0,0,0
"13959",2426,4,1,5,1,0,8,5,4,3,26,0,4,13,5,2,3,1038074,"2024-01-05T00:00:00.000Z",3547242,30,"Deni Avdija",3,18,22,17,9,31
"13960",2427,1,1,3,1,0,2,0,0,0,21,1,2,0,4,0,2,1038075,"2024-01-05T00:00:00.000Z",33,23,"Nicolas Batum",1,4,5,1,5,7.3
"13961",2428,4,0,3,2,1,6,2,1,0,24,0,2,5,3,0,0,1038075,"2024-01-05T00:00:00.000Z",200,23,"Tobias Harris",0,8,12,9,7,14.6
"13962",2429,3,3,7,1,1,23,10,12,9,36,3,3,30,10,1,6,1038075,"2024-01-05T00:00:00.000Z",145,23,"Joel Embiid",4,40,43,33,13,52.5
"13963",2430,1,3,5,6,3,12,6,0,0,31,2,2,15,7,0,3,1038075,"2024-01-05T00:00:00.000Z",360,23,"Kelly Oubre Jr.",3,22,23,16,8,30.9
"13964",2431,9,1,3,7,1,20,9,10,8,37,1,1,27,4,2,1,1038075,"2024-01-05T00:00:00.000Z",3547254,23,"Tyrese Maxey",3,31,40,36,13,53.3
"13965",2432,0,0,1,0,0,0,0,0,0,1,0,0,0,1,0,0,1038075,"2024-01-05T00:00:00.000Z",3547275,20,"Malachi Flynn",0,1,1,0,1,1.2
"13966",2433,2,0,3,1,0,1,0,0,0,21,0,1,0,3,1,0,1038077,"2024-01-05T00:00:00.000Z",3547301,11,"Jae'Sean Tate",1,3,5,2,5,9.6
"13967",2434,2,0,8,5,3,13,6,2,1,32,1,3,16,9,0,4,1038077,"2024-01-05T00:00:00.000Z",38017684,11,"Jabari Smith Jr.",0,25,27,18,11,25.8
"13968",2435,1,0,4,1,0,17,8,3,3,33,1,3,19,5,0,2,1038077,"2024-01-05T00:00:00.000Z",17896062,11,"Alperen Sengun",0,24,25,20,6,24.5
"13969",2436,2,0,4,8,4,16,7,4,2,31,1,1,20,5,0,2,1038077,"2024-01-05T00:00:00.000Z",17895966,11,"Jalen Green",0,25,27,22,7,27
"13970",2437,8,1,1,5,2,9,2,1,1,31,0,0,7,1,1,1,1038077,"2024-01-05T00:00:00.000Z",458,11,"Fred VanVleet",2,8,16,15,9,25.2
"13971",2438,0,0,0,2,0,4,2,0,0,21,1,2,4,1,0,0,1038077,"2024-01-05T00:00:00.000Z",188,11,"Jeff Green",0,5,5,4,1,5.2
"13972",2439,0,0,1,2,1,4,2,0,0,8,0,1,5,1,0,0,1038077,"2024-01-05T00:00:00.000Z",75,11,"Reggie Bullock",0,6,6,5,1,6.2
"13973",2440,5,0,1,7,2,16,7,2,1,23,4,1,17,5,0,0,1038071,"2024-01-05T00:00:00.000Z",297,29,"Lauri Markkanen",0,22,27,22,10,30.5
"13974",2441,2,1,11,1,0,9,5,3,2,22,0,5,12,11,0,2,1038071,"2024-01-05T00:00:00.000Z",101,29,"John Collins",1,23,25,14,13,29.2
"13975",2442,5,1,3,1,0,7,1,0,0,26,2,4,2,5,3,1,1038071,"2024-01-05T00:00:00.000Z",139,29,"Kris Dunn",4,7,12,7,10,26.5
"13976",2443,3,0,1,3,0,11,5,3,3,21,0,1,13,1,3,3,1038071,"2024-01-05T00:00:00.000Z",413,29,"Collin Sexton",3,14,17,16,4,24.7
"13977",2444,0,0,6,0,0,3,2,0,0,14,1,2,4,7,0,0,1038071,"2024-01-05T00:00:00.000Z",38017705,29,"Walker Kessler",0,11,11,4,7,12.4
"13978",2445,2,0,1,2,0,7,1,0,0,17,1,0,2,2,1,4,1038071,"2024-01-05T00:00:00.000Z",100,29,"Jordan Clarkson",1,4,6,4,4,6.4
"13979",2446,1,0,3,7,2,10,4,2,2,20,1,0,12,4,0,1,1038071,"2024-01-05T00:00:00.000Z",56677834,29,"Keyonte George",0,16,17,13,5,17.3
"13980",2447,1,0,3,3,0,5,2,1,1,22,1,4,5,4,0,2,1038071,"2024-01-05T00:00:00.000Z",38017620,29,"Ochai Agbaji",0,9,10,6,5,9.3
"13981",2448,0,0,0,0,0,0,0,0,0,0,0,0,0,0,0,0,1038073,"2024-01-05T00:00:00.000Z",38017716,21,"Ousmane Dieng",0,0,0,0,0,0
"13982",2449,0,0,0,0,0,0,0,0,0,0,0,0,0,0,0,0,1038073,"2024-01-05T00:00:00.000Z",56677853,21,"Keyontae Johnson",0,0,0,0,0,0
"13983",2450,0,0,0,0,0,0,0,0,0,0,0,0,0,0,0,0,1038073,"2024-01-05T00:00:00.000Z",24572055,21,"Olivier Sarr",0,0,0,0,0,0
"13984",2451,0,0,0,0,0,0,0,0,0,0,0,0,0,0,0,0,1037904,"2023-12-13T00:00:00.000Z",56677846,4,"Nick Smith Jr.",0,0,0,0,0,0
"13985",2452,0,0,0,0,0,0,0,0,0,0,0,0,0,0,0,0,1037904,"2023-12-13T00:00:00.000Z",38017698,4,"Mark Williams",0,0,0,0,0,0
"13986",2453,6,1,9,4,3,14,11,3,2,34,1,3,27,10,0,3,1037905,"2023-12-13T00:00:00.000Z",17896055,28,"Scottie Barnes",1,37,43,33,16,48
"13987",2454,7,1,3,4,3,11,5,4,4,37,0,5,17,3,1,2,1037905,"2023-12-13T00:00:00.000Z",409,28,"Dennis Schroder",2,20,27,24,10,35.1
"13988",2455,1,0,0,8,4,11,4,0,0,20,0,0,12,0,0,0,1037905,"2023-12-13T00:00:00.000Z",3089,28,"Gary Trent Jr.",0,12,13,13,1,13.5
"13989",2456,1,2,6,3,1,5,2,2,2,17,1,0,7,7,1,2,1037905,"2023-12-13T00:00:00.000Z",3547249,28,"Precious Achiuwa",3,14,15,8,8,23.9
"13990",2457,8,0,2,3,0,4,0,0,0,17,0,2,0,2,0,2,1037905,"2023-12-13T00:00:00.000Z",3547275,28,"Malachi Flynn",0,2,10,8,10,12.4
"13991",2458,0,2,0,1,0,2,1,0,0,10,0,0,2,0,0,0,1037905,"2023-12-13T00:00:00.000Z",58,28,"Chris Boucher",2,2,2,2,0,8
"13992",2459,0,0,0,0,0,0,0,0,0,0,0,0,0,0,0,0,1037905,"2023-12-13T00:00:00.000Z",56677828,28,"Gradey Dick",0,0,0,0,0,0
"13993",2460,0,0,0,0,0,0,0,0,0,0,0,0,0,0,0,0,1037905,"2023-12-13T00:00:00.000Z",666762,28,"Jalen McDaniels",0,0,0,0,0,0
"13994",2461,0,0,0,0,0,0,0,0,0,0,0,0,0,0,0,0,1037905,"2023-12-13T00:00:00.000Z",376,28,"Otto Porter Jr.",0,0,0,0,0,0
"13995",2462,0,0,0,0,0,0,0,0,0,0,0,0,0,0,0,0,1037905,"2023-12-13T00:00:00.000Z",436,28,"Garrett Temple",0,0,0,0,0,0
"13996",2463,0,0,0,0,0,0,0,0,0,0,0,0,0,0,0,0,1037905,"2023-12-13T00:00:00.000Z",489,28,"Thaddeus Young",0,0,0,0,0,0
"13997",2464,0,0,0,0,0,0,0,0,0,0,0,0,0,0,0,0,1037905,"2023-12-13T00:00:00.000Z",56677805,28,"Javon Freeman-Liberty",0,0,0,0,0,0
"13998",2465,0,0,0,0,0,0,0,0,0,0,0,0,0,0,0,0,1037905,"2023-12-13T00:00:00.000Z",38017710,28,"Christian Koloko",0,0,0,0,0,0
"13999",2466,0,0,0,0,0,0,0,0,0,0,0,0,0,0,0,0,1037905,"2023-12-13T00:00:00.000Z",56677869,28,"Markquis Nowell",0,0,0,0,0,0
"14000",2467,0,0,0,0,0,0,0,0,0,0,0,0,0,0,0,0,1037905,"2023-12-13T00:00:00.000Z",2309958,28,"Jontay Porter",0,0,0,0,0,0
"14001",2468,1,0,1,4,1,6,1,2,2,14,1,3,5,2,2,0,1037905,"2023-12-13T00:00:00.000Z",301,1,"Wesley Matthews",2,7,8,6,3,14.9
"14002",2469,2,0,7,5,0,14,5,3,2,38,3,1,12,10,2,1,1037905,"2023-12-13T00:00:00.000Z",3547256,1,"Saddiq Bey",2,22,24,14,12,32
"14003",2470,1,3,4,0,0,12,7,4,3,34,6,3,17,10,0,0,1037905,"2023-12-13T00:00:00.000Z",83,1,"Clint Capela",3,27,28,18,11,39.5
"14004",2471,5,2,3,9,4,17,8,1,0,34,0,2,20,3,0,0,1037905,"2023-12-13T00:00:00.000Z",334,1,"Dejounte Murray",2,23,28,25,8,37.1
"14005",2472,17,1,4,9,4,27,13,6,5,39,0,3,35,4,0,5,1037905,"2023-12-13T00:00:00.000Z",490,1,"Trae Young",1,39,56,52,21,63.3
"14006",2473,5,0,2,7,4,13,7,3,2,32,1,4,20,3,3,1,1037905,"2023-12-13T00:00:00.000Z",53,1,"Bogdan Bogdanovic",3,23,28,25,8,39.1
"14007",2474,0,0,2,2,2,2,2,0,0,19,0,2,6,2,1,0,1037905,"2023-12-13T00:00:00.000Z",666754,1,"Garrison Mathews",1,8,8,6,2,11.4
"14008",2475,0,0,0,0,0,0,0,0,0,0,0,0,0,0,0,0,1037905,"2023-12-13T00:00:00.000Z",666564,1,"Bruno Fernando",0,0,0,0,0,0
"14009",2476,0,0,0,0,0,0,0,0,0,0,0,0,0,0,0,0,3277446,"2023-11-17T00:00:00.000Z",38017712,30,"Ryan Rollins",0,0,0,0,0,0
"14010",2477,3,0,2,8,3,12,4,3,2,24,0,3,13,2,3,3,3277447,"2023-11-17T00:00:00.000Z",53,1,"Bogdan Bogdanovic",3,15,18,16,5,25.9
"14011",2478,1,0,4,4,2,9,6,4,3,31,3,1,17,7,1,2,3277447,"2023-11-17T00:00:00.000Z",3547256,1,"Saddiq Bey",1,24,25,18,8,27.9
"14012",2479,0,0,0,2,0,2,0,4,2,11,0,2,2,0,0,0,3277447,"2023-11-17T00:00:00.000Z",301,1,"Wesley Matthews",0,2,2,2,0,2
"14013",2480,0,0,3,2,1,6,2,0,0,19,2,3,5,5,0,1,3277447,"2023-11-17T00:00:00.000Z",3547244,1,"Onyeka Okongwu",0,10,10,5,5,10
"14014",2481,0,0,0,0,0,0,0,0,0,0,0,0,0,0,0,0,3277447,"2023-11-17T00:00:00.000Z",666564,1,"Bruno Fernando",0,0,0,0,0,0
"14015",2482,0,0,0,0,0,0,0,0,0,0,0,0,0,0,0,0,3277447,"2023-11-17T00:00:00.000Z",3547297,1,"Trent Forrest",0,0,0,0,0,0
"14016",2483,0,0,0,0,0,0,0,0,0,0,0,0,0,0,0,0,3277447,"2023-11-17T00:00:00.000Z",38017689,1,"AJ Griffin",0,0,0,0,0,0
"14017",2484,0,0,0,0,0,0,0,0,0,0,0,0,0,0,0,0,3277447,"2023-11-17T00:00:00.000Z",666754,1,"Garrison Mathews",0,0,0,0,0,0
"14018",2485,0,0,0,0,0,0,0,0,0,0,0,0,0,0,0,0,3277447,"2023-11-17T00:00:00.000Z",319,1,"Patty Mills",0,0,0,0,0,0
"14019",2486,0,0,0,0,0,0,0,0,0,0,0,0,0,0,0,0,3277447,"2023-11-17T00:00:00.000Z",56677838,1,"Kobe Bufkin",0,0,0,0,0,0
"14020",2487,0,0,0,0,0,0,0,0,0,0,0,0,0,0,0,0,3277447,"2023-11-17T00:00:00.000Z",56677806,1,"Mouhamed Gueye",0,0,0,0,0,0
"14021",2488,0,0,0,0,0,0,0,0,0,0,0,0,0,0,0,0,3277447,"2023-11-17T00:00:00.000Z",56677855,1,"Seth Lundy",0,0,0,0,0,0
"14022",2489,0,0,0,0,0,0,0,0,0,0,0,0,0,0,0,0,3277447,"2023-11-17T00:00:00.000Z",56677875,1,"Miles Norris",0,0,0,0,0,0
"14023",2490,3,1,3,2,2,4,2,0,0,21,4,4,6,7,1,1,3277447,"2023-11-17T00:00:00.000Z",108,23,"Robert Covington",2,13,16,9,10,23.9
"14024",2491,3,0,9,5,3,20,12,2,2,38,1,1,29,10,1,1,3277447,"2023-11-17T00:00:00.000Z",200,23,"Tobias Harris",1,39,42,32,13,47.5
"14025",2492,8,1,5,3,1,19,10,11,11,37,2,3,32,7,2,4,3277447,"2023-11-17T00:00:00.000Z",145,23,"Joel Embiid",3,39,47,40,15,57.4
"14026",2493,5,1,3,7,3,13,5,2,1,36,1,2,14,4,1,3,3277447,"2023-11-17T00:00:00.000Z",313,23,"De'Anthony Melton",2,18,23,19,9,29.3
"14027",2494,8,0,4,6,3,13,5,6,6,40,0,1,19,4,2,2,3277447,"2023-11-17T00:00:00.000Z",3547254,23,"Tyrese Maxey",2,23,31,27,12,39.8
"14028",2495,1,0,2,1,0,1,0,2,2,14,0,3,2,2,0,0,3277447,"2023-11-17T00:00:00.000Z",45,23,"Patrick Beverley",0,4,5,3,3,5.9
"14029",2496,1,0,2,4,1,8,5,3,3,18,1,1,14,3,0,1,3277447,"2023-11-17T00:00:00.000Z",2175,23,"Danuel House Jr.",0,17,18,15,4,18.1
"14030",2497,0,0,1,0,0,0,0,0,0,2,0,1,0,1,0,0,3277447,"2023-11-17T00:00:00.000Z",328,23,"Marcus Morris",0,1,1,0,1,1.2
"14031",2498,2,2,0,2,0,7,3,2,2,22,3,3,8,3,2,3,3277447,"2023-11-17T00:00:00.000Z",17896025,23,"Jaden Springer",4,11,13,10,5,23.6
"14032",2499,0,0,1,0,0,3,1,0,0,12,1,1,2,2,0,0,3277447,"2023-11-17T00:00:00.000Z",3547270,23,"Paul Reed",0,4,4,2,2,4.4
"14033",2500,0,0,0,0,0,0,0,0,0,0,0,0,0,0,0,0,3277447,"2023-11-17T00:00:00.000Z",28,23,"Mo Bamba",0,0,0,0,0,0
"14034",2501,0,0,0,0,0,0,0,0,0,0,0,0,0,0,0,0,1038121,"2024-01-11T00:00:00.000Z",3547271,21,"Aleksej Pokusevski",0,0,0,0,0,0
"14035",2502,0,0,0,0,0,0,0,0,0,0,0,0,0,0,0,0,1038121,"2024-01-11T00:00:00.000Z",24572055,21,"Olivier Sarr",0,0,0,0,0,0
"14036",2503,1,0,0,0,0,1,0,0,0,5,0,1,0,0,1,1,1038123,"2024-01-11T00:00:00.000Z",18678058,24,"Jordan Goodwin",1,0,1,1,1,3.5
"14037",2504,0,0,0,1,0,3,1,0,0,5,0,0,2,0,0,0,1038123,"2024-01-11T00:00:00.000Z",32,24,"Keita Bates-Diop",0,2,2,2,0,2
"14038",2505,0,0,0,0,0,0,0,0,0,0,0,0,0,0,0,0,1038122,"2024-01-11T00:00:00.000Z",257,7,"Maxi Kleber",0,0,0,0,0,0
"14039",2506,0,0,0,0,0,0,0,0,0,0,0,0,0,0,0,0,1038122,"2024-01-11T00:00:00.000Z",56677840,7,"Dereck Lively II",0,0,0,0,0,0
"14040",2507,0,0,0,0,0,0,0,0,0,0,0,0,0,0,0,0,1038122,"2024-01-11T00:00:00.000Z",56677859,7,"Olivier-Maxence Prosper",0,0,0,0,0,0
"14041",2508,2,2,5,6,1,10,4,1,1,39,1,1,10,6,0,1,1038122,"2024-01-11T00:00:00.000Z",18,20,"OG Anunoby",2,16,18,12,8,25.2
"14042",2509,2,0,8,0,0,6,3,4,3,28,4,2,9,12,1,2,1038123,"2024-01-11T00:00:00.000Z",349,24,"Jusuf Nurkic",1,21,23,11,14,27.4
"14043",2510,4,0,4,10,8,21,14,1,1,32,2,3,37,6,1,3,1038123,"2024-01-11T00:00:00.000Z",37,24,"Bradley Beal",1,43,47,41,10,50.2
"14044",2511,5,0,5,6,2,22,11,7,7,34,0,2,31,5,3,3,1038123,"2024-01-11T00:00:00.000Z",57,24,"Devin Booker",3,36,41,36,10,50.5
"14045",2512,0,0,1,9,1,11,2,0,0,23,2,0,5,3,0,0,1038123,"2024-01-11T00:00:00.000Z",178,24,"Eric Gordon",0,8,8,5,3,8.6
"14046",2513,2,2,4,0,0,3,2,2,2,17,2,1,6,6,2,0,1038123,"2024-01-11T00:00:00.000Z",666451,24,"Bol Bol",4,12,14,8,8,28.2
"14047",2514,0,0,0,0,0,1,1,0,0,5,1,2,2,1,0,0,1038123,"2024-01-11T00:00:00.000Z",3547095,24,"Udoka Azubuike",0,3,3,2,1,3.2
"14048",2515,0,0,0,2,0,4,2,2,1,12,0,1,5,0,1,0,1038123,"2024-01-11T00:00:00.000Z",356,24,"Josh Okogie",1,5,5,5,0,8
"14049",2516,2,2,7,4,2,9,7,3,3,35,0,1,19,7,1,1,1038126,"2024-01-12T00:00:00.000Z",259,9,"Kevin Knox",3,26,28,21,9,38.4
"14050",2517,1,0,7,8,3,13,6,2,1,29,0,1,16,7,0,3,1038126,"2024-01-12T00:00:00.000Z",3547267,9,"Isaiah Stewart",0,23,24,17,8,22.9
"14051",2518,3,1,6,0,0,12,7,2,1,32,2,3,15,8,2,2,1038126,"2024-01-12T00:00:00.000Z",38017694,9,"Jalen Duren",3,23,26,18,11,36.1
"14052",2519,8,1,2,6,1,19,8,4,1,28,4,3,18,6,0,2,1038126,"2024-01-12T00:00:00.000Z",38017682,9,"Jaden Ivey",1,24,32,26,14,38.2
"14053",2520,8,1,4,2,0,6,2,1,1,29,0,1,5,4,1,1,1038126,"2024-01-12T00:00:00.000Z",3547241,9,"Killian Hayes",2,9,17,13,12,26.8
"14054",2521,1,2,0,4,1,4,1,0,0,16,0,3,3,0,0,0,1038126,"2024-01-12T00:00:00.000Z",17896071,9,"Isaiah Livers",2,3,4,4,1,10.5
"14055",2522,1,2,0,9,5,14,7,0,0,30,0,3,19,0,0,2,1038126,"2024-01-12T00:00:00.000Z",77,9,"Alec Burks",2,19,20,20,1,24.5
"14056",2523,0,0,1,1,0,1,0,0,0,10,0,0,0,1,0,1,1038122,"2024-01-11T00:00:00.000Z",114,7,"Seth Curry",0,1,1,0,1,0.2
"14057",2524,0,0,0,0,0,0,0,0,0,0,0,0,0,0,0,0,1038122,"2024-01-11T00:00:00.000Z",217,7,"Richaun Holmes",0,0,0,0,0,0
"14058",2525,0,0,0,0,0,0,0,0,0,0,0,0,0,0,0,0,1038122,"2024-01-11T00:00:00.000Z",17554004,7,"AJ Lawson",0,0,0,0,0,0
"14059",2526,5,1,2,0,0,4,2,2,1,22,0,2,5,2,0,1,1037945,"2023-12-18T00:00:00.000Z",12,18,"Kyle Anderson",1,7,12,10,7,16.9
"14060",2527,0,0,0,0,0,0,0,0,0,0,0,0,0,0,0,0,1037946,"2023-12-18T00:00:00.000Z",2309958,28,"Jontay Porter",0,0,0,0,0,0
"14061",2528,1,1,2,0,0,6,5,4,4,23,0,2,14,2,0,2,1037944,"2023-12-18T00:00:00.000Z",3547244,1,"Onyeka Okongwu",1,16,17,15,3,18.9
"14062",2529,0,2,2,5,2,5,2,1,0,23,1,5,6,3,0,2,1037944,"2023-12-18T00:00:00.000Z",666754,1,"Garrison Mathews",2,9,9,6,3,13.6
"14063",2530,0,0,1,1,0,1,0,0,0,9,0,2,0,1,0,0,1037944,"2023-12-18T00:00:00.000Z",56677855,1,"Seth Lundy",0,1,1,0,1,1.2
"14064",2531,1,1,2,1,0,2,1,0,0,15,0,1,2,2,1,1,1037944,"2023-12-18T00:00:00.000Z",301,1,"Wesley Matthews",2,4,5,3,3,10.9
"14065",2532,0,0,0,0,0,0,0,0,0,0,0,0,0,0,0,0,1037944,"2023-12-18T00:00:00.000Z",319,1,"Patty Mills",0,0,0,0,0,0
"14066",2533,0,0,0,0,0,0,0,0,0,0,0,0,0,0,0,0,1037944,"2023-12-18T00:00:00.000Z",56677875,1,"Miles Norris",0,0,0,0,0,0
"14067",2534,0,0,0,0,0,0,0,0,0,0,0,0,0,0,0,0,1037944,"2023-12-18T00:00:00.000Z",56677838,1,"Kobe Bufkin",0,0,0,0,0,0
"14068",2535,0,0,0,0,0,0,0,0,0,0,0,0,0,0,0,0,1037944,"2023-12-18T00:00:00.000Z",38017689,1,"AJ Griffin",0,0,0,0,0,0
"14069",2536,0,0,0,0,0,0,0,0,0,0,0,0,0,0,0,0,1037944,"2023-12-18T00:00:00.000Z",56677806,1,"Mouhamed Gueye",0,0,0,0,0,0
"14070",2537,0,0,0,0,0,0,0,0,0,0,0,0,0,0,0,0,1037944,"2023-12-18T00:00:00.000Z",17896040,1,"Jalen Johnson",0,0,0,0,0,0
"14071",2538,3,0,5,1,0,5,1,0,0,19,3,2,2,8,1,2,1037944,"2023-12-18T00:00:00.000Z",56677826,9,"Ausar Thompson",1,10,13,5,11,17.1
"14072",2539,2,0,1,9,5,17,9,3,2,39,1,3,25,2,0,2,1037944,"2023-12-18T00:00:00.000Z",54,9,"Bojan Bogdanovic",0,27,29,27,4,28.4
"14073",2540,2,0,1,2,0,11,2,2,2,23,1,3,6,2,1,0,1037944,"2023-12-18T00:00:00.000Z",77,9,"Alec Burks",1,8,10,8,4,14.4
"14074",2541,2,1,1,1,0,1,0,2,1,12,1,1,1,2,1,0,1037944,"2023-12-18T00:00:00.000Z",197,9,"Joe Harris",2,3,5,3,4,12.4
"14075",2542,0,0,1,6,2,10,4,0,0,25,1,5,10,2,2,3,1037941,"2023-12-18T00:00:00.000Z",344,6,"Georges Niang",2,12,12,10,2,15.4
"14076",2543,7,1,4,5,3,24,16,9,8,44,1,1,43,5,3,3,1037944,"2023-12-18T00:00:00.000Z",17896075,9,"Cade Cunningham",4,48,55,50,12,68.5
"14077",2544,0,0,0,0,0,0,0,0,0,0,0,0,0,0,0,0,1037947,"2023-12-18T00:00:00.000Z",27924547,21,"Lindy Waters III",0,0,0,0,0,0
"14078",2545,1,0,3,5,1,7,2,0,0,23,2,3,5,5,0,1,1037947,"2023-12-18T00:00:00.000Z",38017731,15,"Vince Williams Jr.",0,10,11,6,6,11.5
"14079",2546,1,0,5,4,1,7,3,5,4,25,0,3,11,5,1,2,1037947,"2023-12-18T00:00:00.000Z",231,15,"Jaren Jackson Jr.",1,16,17,12,6,19.5
"14080",2547,2,1,8,3,0,8,0,0,0,25,0,1,0,8,1,1,1037947,"2023-12-18T00:00:00.000Z",3547285,15,"Xavier Tillman",2,8,10,2,10,17.6
"14081",2548,5,1,1,9,4,14,6,2,1,28,0,1,17,1,0,5,1037947,"2023-12-18T00:00:00.000Z",3547287,15,"Desmond Bane",1,18,23,22,6,23.7
"14082",2549,7,0,1,6,4,9,4,0,0,34,0,2,12,1,1,3,1037947,"2023-12-18T00:00:00.000Z",48248287,15,"Jacob Gilyard",1,13,20,19,8,23.7
"14083",2550,0,0,0,0,0,0,0,0,0,0,0,0,0,0,0,0,1037945,"2023-12-18T00:00:00.000Z",38017715,18,"Josh Minott",0,0,0,0,0,0
"14084",2551,0,0,0,0,0,0,0,0,0,0,0,0,0,0,0,0,1037804,"2023-11-22T00:00:00.000Z",38017507,12,"Andrew Nembhard",0,0,0,0,0,0
"14085",2552,1,0,1,3,1,6,2,3,2,18,1,3,7,2,0,0,1037799,"2023-11-22T00:00:00.000Z",414,30,"Landry Shamet",0,9,10,8,3,10.9
"14086",2553,0,0,0,0,0,0,0,0,0,0,0,0,0,0,0,0,1037799,"2023-11-22T00:00:00.000Z",38124126,30,"John Butler Jr.",0,0,0,0,0,0
"14087",2554,0,0,0,0,0,0,0,0,0,0,0,0,0,0,0,0,1037799,"2023-11-22T00:00:00.000Z",38017712,30,"Ryan Rollins",0,0,0,0,0,0
"14088",2555,0,0,0,0,0,0,0,0,0,0,0,0,0,0,0,0,1037799,"2023-11-22T00:00:00.000Z",487,30,"Delon Wright",0,0,0,0,0,0
"14089",2556,7,0,1,2,2,4,4,2,2,17,0,3,12,1,1,0,1037800,"2023-11-22T00:00:00.000Z",226,22,"Joe Ingles",1,13,20,19,8,26.7
"14090",2557,1,1,4,2,0,6,4,1,1,14,2,1,9,6,1,1,1037800,"2023-11-22T00:00:00.000Z",229,22,"Jonathan Isaac",2,15,16,10,7,22.7
"14091",2558,1,0,2,3,1,7,4,4,3,15,1,1,12,3,1,1,1037800,"2023-11-22T00:00:00.000Z",462,22,"Moritz Wagner",1,15,16,13,4,19.1
"14092",2559,0,0,0,0,0,0,0,0,0,0,0,0,0,0,0,0,1037800,"2023-11-22T00:00:00.000Z",666818,22,"Chuma Okeke",0,0,0,0,0,0
"14093",2560,0,0,0,0,0,0,0,0,0,0,0,0,0,0,0,0,1037800,"2023-11-22T00:00:00.000Z",666885,22,"Admiral Schofield",0,0,0,0,0,0
"14094",2561,0,0,0,0,0,0,0,0,0,0,0,0,0,0,0,0,1037800,"2023-11-22T00:00:00.000Z",85,22,"Wendell Carter Jr.",0,0,0,0,0,0
"14095",2562,0,0,0,0,0,0,0,0,0,0,0,0,0,0,0,0,1037800,"2023-11-22T00:00:00.000Z",165,22,"Markelle Fultz",0,0,0,0,0,0
"14096",2563,0,0,0,0,0,0,0,0,0,0,0,0,0,0,0,0,1037804,"2023-11-22T00:00:00.000Z",38017710,28,"Christian Koloko",0,0,0,0,0,0
"14097",2564,0,0,0,0,0,0,0,0,0,0,0,0,0,0,0,0,1037804,"2023-11-22T00:00:00.000Z",56677869,28,"Markquis Nowell",0,0,0,0,0,0
"14098",2565,0,0,0,0,0,0,0,0,0,0,0,0,0,0,0,0,1037804,"2023-11-22T00:00:00.000Z",489,28,"Thaddeus Young",0,0,0,0,0,0
"14099",2566,2,2,2,4,0,6,1,0,0,27,0,6,2,2,0,2,1037808,"2023-11-22T00:00:00.000Z",666541,21,"Luguentz Dort",2,4,6,4,4,11.4
"14100",2567,0,1,2,2,1,3,2,0,0,24,1,1,5,3,0,1,1037808,"2023-11-22T00:00:00.000Z",56677833,21,"Cason Wallace",1,8,8,5,3,10.6
"14101",2568,2,4,8,3,0,11,5,11,8,32,5,3,18,13,1,2,1037808,"2023-11-22T00:00:00.000Z",38017685,21,"Chet Holmgren",5,31,33,20,15,49.6
"14102",2569,2,0,5,3,1,13,4,2,1,29,1,1,10,6,2,2,1037808,"2023-11-22T00:00:00.000Z",17896065,21,"Josh Giddey",2,16,18,12,8,24.2
"14103",2570,12,3,4,3,1,19,11,18,17,37,1,2,40,5,1,2,1037808,"2023-11-22T00:00:00.000Z",175,21,"Shai Gilgeous-Alexander",4,45,57,52,17,74
"14104",2571,0,1,1,7,5,9,6,3,3,27,0,0,20,1,0,0,1037808,"2023-11-22T00:00:00.000Z",3547272,21,"Isaiah Joe",1,21,21,20,1,24.2
"14105",2572,0,0,0,0,0,0,0,0,0,0,0,0,0,0,0,0,1037808,"2023-11-22T00:00:00.000Z",44,21,"Davis Bertans",0,0,0,0,0,0
"14106",2573,0,0,0,0,0,0,0,0,0,0,0,0,0,0,0,0,1037808,"2023-11-22T00:00:00.000Z",38017716,21,"Ousmane Dieng",0,0,0,0,0,0
"14107",2574,0,0,0,0,0,0,0,0,0,0,0,0,0,0,0,0,1037808,"2023-11-22T00:00:00.000Z",17896036,21,"Tre Mann",0,0,0,0,0,0
"14108",2575,6,1,1,8,2,13,5,3,3,36,2,4,15,3,0,0,1037809,"2023-11-22T00:00:00.000Z",666682,27,"Keldon Johnson",1,18,24,21,9,30.6
"14109",2576,2,1,2,4,1,10,3,0,0,19,1,3,7,3,0,1,1037623,"2023-10-28T00:00:00.000Z",344,6,"Georges Niang",1,10,12,9,5,15.6
"14110",2577,0,0,0,0,0,0,0,0,0,0,0,0,0,0,0,0,1037622,"2023-10-28T00:00:00.000Z",38017726,19,"Dereon Seabron",0,0,0,0,0,0
"14111",2578,2,1,3,6,1,16,7,4,3,30,0,0,18,3,1,3,1037622,"2023-10-28T00:00:00.000Z",666423,20,"RJ Barrett",2,21,23,20,5,27.6
"14112",2579,4,0,12,5,0,15,4,2,2,34,0,4,10,12,0,8,1037622,"2023-10-28T00:00:00.000Z",387,20,"Julius Randle",0,22,26,14,16,22.4
"14113",2580,0,2,5,0,0,8,4,0,0,29,10,1,8,15,0,0,1037622,"2023-10-28T00:00:00.000Z",399,20,"Mitchell Robinson",2,23,23,8,15,32
"14114",2581,1,0,2,6,1,9,2,0,0,26,0,1,5,2,2,0,1037622,"2023-10-28T00:00:00.000Z",17895858,20,"Quentin Grimes",2,7,8,6,3,14.9
"14115",2582,0,0,3,2,0,6,1,3,3,12,1,2,5,4,1,1,1037624,"2023-10-28T00:00:00.000Z",58,28,"Chris Boucher",1,9,9,5,4,11.8
"14116",2583,0,0,0,0,0,0,0,0,0,0,0,0,0,0,0,0,1037624,"2023-10-28T00:00:00.000Z",56677805,28,"Javon Freeman-Liberty",0,0,0,0,0,0
"14117",2584,0,0,0,0,0,0,0,0,0,0,0,0,0,0,0,0,1037624,"2023-10-28T00:00:00.000Z",28,23,"Mo Bamba",0,0,0,0,0,0
"14118",2585,0,0,0,0,0,0,0,0,0,0,0,0,0,0,0,0,1037624,"2023-10-28T00:00:00.000Z",260,23,"Furkan Korkmaz",0,0,0,0,0,0
"14119",2586,0,0,0,0,0,0,0,0,0,0,0,0,0,0,0,0,1037624,"2023-10-28T00:00:00.000Z",17895941,23,"Filip Petrusev",0,0,0,0,0,0
"14120",2587,2,2,3,0,0,7,6,0,0,19,2,3,12,5,0,0,1037626,"2023-10-28T00:00:00.000Z",147,24,"Drew Eubanks",2,17,19,14,7,27
"14121",2588,5,0,3,5,2,9,2,6,6,25,2,2,12,5,1,2,1037626,"2023-10-28T00:00:00.000Z",18678058,24,"Jordan Goodwin",1,17,22,17,10,26.5
"14122",2589,0,1,3,4,1,7,2,2,2,20,1,2,7,4,2,0,1037626,"2023-10-28T00:00:00.000Z",470,24,"Yuta Watanabe",3,11,11,7,4,20.8
"14123",2590,0,0,1,5,0,8,3,0,0,21,0,2,6,1,1,0,1037626,"2023-10-28T00:00:00.000Z",666729,24,"Nassir Little",1,7,7,6,1,10.2
"14124",2591,0,2,1,0,0,0,0,0,0,4,0,0,0,1,0,2,1037626,"2023-10-28T00:00:00.000Z",666451,24,"Bol Bol",2,1,1,0,1,5.2
"14125",2592,2,1,0,1,0,2,1,0,0,4,0,0,2,0,0,0,1037626,"2023-10-28T00:00:00.000Z",3547298,24,"Saben Lee",1,2,4,4,2,8
"14126",2593,1,0,1,0,0,2,1,0,0,3,0,0,2,1,0,0,1037626,"2023-10-28T00:00:00.000Z",314,24,"Chimezie Metu",0,3,4,3,2,4.7
"14127",2594,0,0,0,0,0,0,0,0,0,0,0,0,0,0,0,0,1037626,"2023-10-28T00:00:00.000Z",37,24,"Bradley Beal",0,0,0,0,0,0
"14128",2595,0,0,0,0,0,0,0,0,0,0,0,0,0,0,0,0,1037626,"2023-10-28T00:00:00.000Z",57,24,"Devin Booker",0,0,0,0,0,0
"14129",2596,0,0,0,0,0,0,0,0,0,0,0,0,0,0,0,0,1037626,"2023-10-28T00:00:00.000Z",272,24,"Damion Lee",0,0,0,0,0,0
"14130",2597,4,1,1,7,2,12,4,0,0,19,0,1,10,1,0,1,1037623,"2023-10-28T00:00:00.000Z",210,12,"Buddy Hield",1,11,15,14,5,19.2
"14131",2598,0,0,5,9,5,16,10,2,1,30,4,1,26,9,0,0,1037623,"2023-10-28T00:00:00.000Z",3547250,12,"Aaron Nesmith",0,35,35,26,9,36.8
"14132",2599,3,0,4,3,2,7,5,2,1,19,2,2,13,6,0,1,1037623,"2023-10-28T00:00:00.000Z",3547264,12,"Jalen Smith",0,19,22,16,9,23.7
"14133",2600,0,0,0,0,0,0,0,0,0,0,0,0,0,0,0,0,1037623,"2023-10-28T00:00:00.000Z",3547207,12,"Jordan Nwora",0,0,0,0,0,0
"14134",2601,0,0,0,0,0,0,0,0,0,0,0,0,0,0,0,0,1037991,"2023-12-23T00:00:00.000Z",476,25,"Robert Williams III",0,0,0,0,0,0
"14135",2602,3,0,1,6,3,9,5,3,2,17,0,1,15,1,0,1,1037989,"2023-12-23T00:00:00.000Z",405,14,"D'Angelo Russell",0,16,19,18,4,19.7
"14136",2603,0,0,0,0,0,0,0,0,0,0,0,0,0,0,0,0,1037989,"2023-12-23T00:00:00.000Z",486,14,"Christian Wood",0,0,0,0,0,0
"14137",2604,0,0,0,0,0,0,0,0,0,0,0,0,0,0,0,0,1037989,"2023-12-23T00:00:00.000Z",56677738,14,"Colin Castleton",0,0,0,0,0,0
"14138",2605,0,0,0,0,0,0,0,0,0,0,0,0,0,0,0,0,1037989,"2023-12-23T00:00:00.000Z",56677867,14,"Alex Fudge",0,0,0,0,0,0
"14139",2606,0,0,0,0,0,0,0,0,0,0,0,0,0,0,0,0,1037989,"2023-12-23T00:00:00.000Z",56677868,14,"D'Moi Hodge",0,0,0,0,0,0
"14140",2607,0,0,0,0,0,0,0,0,0,0,0,0,0,0,0,0,1037989,"2023-12-23T00:00:00.000Z",1603383,14,"Gabe Vincent",0,0,0,0,0,0
"14141",2608,0,0,0,0,0,0,0,0,0,0,0,0,0,0,0,0,1037985,"2023-12-23T00:00:00.000Z",420,15,"Marcus Smart",0,0,0,0,0,0
"14142",2609,3,0,4,4,1,8,4,3,1,27,3,1,10,7,0,1,1037992,"2023-12-23T00:00:00.000Z",290,26,"Trey Lyles",0,17,20,13,10,21.9
"14143",2610,1,1,2,0,0,6,3,1,1,9,0,2,7,2,1,1,1037992,"2023-12-23T00:00:00.000Z",306,26,"JaVale McGee",2,9,10,8,3,15.9
"14144",2611,0,0,1,1,0,1,0,0,0,8,0,1,0,1,1,0,1037992,"2023-12-23T00:00:00.000Z",4197162,26,"Aleksandar Vezenkov",1,1,1,0,1,4.2
"14145",2612,0,0,0,0,0,0,0,0,0,0,0,0,0,0,0,0,1037985,"2023-12-23T00:00:00.000Z",3547297,1,"Trent Forrest",0,0,0,0,0,0
"14146",2613,0,0,0,0,0,0,0,0,0,0,0,0,0,0,0,0,1037985,"2023-12-23T00:00:00.000Z",4197387,1,"Vit Krejci",0,0,0,0,0,0
"14147",2614,0,0,0,0,0,0,0,0,0,0,0,0,0,0,0,0,1037985,"2023-12-23T00:00:00.000Z",301,1,"Wesley Matthews",0,0,0,0,0,0
"14148",2615,0,0,0,0,0,0,0,0,0,0,0,0,0,0,0,0,1037985,"2023-12-23T00:00:00.000Z",319,1,"Patty Mills",0,0,0,0,0,0
"14149",2616,0,0,0,0,0,0,0,0,0,0,0,0,0,0,0,0,1037985,"2023-12-23T00:00:00.000Z",38017689,1,"AJ Griffin",0,0,0,0,0,0
"14150",2617,0,0,0,0,0,0,0,0,0,0,0,0,0,0,0,0,1037985,"2023-12-23T00:00:00.000Z",56677806,1,"Mouhamed Gueye",0,0,0,0,0,0
"14151",2618,0,0,0,0,0,0,0,0,0,0,0,0,0,0,0,0,1037985,"2023-12-23T00:00:00.000Z",666656,1,"De'Andre Hunter",0,0,0,0,0,0
"14152",2619,0,2,1,0,0,7,3,0,0,16,2,0,6,3,1,0,1037985,"2023-12-23T00:00:00.000Z",3547285,15,"Xavier Tillman",3,9,9,6,3,18.6
"14153",2620,0,0,0,0,0,0,0,0,0,0,0,0,0,0,0,0,1037985,"2023-12-23T00:00:00.000Z",48248287,15,"Jacob Gilyard",0,0,0,0,0,0
"14154",2621,0,0,1,0,0,0,0,0,0,2,0,0,0,1,0,0,1037992,"2023-12-23T00:00:00.000Z",56677845,26,"Colby Jones",0,1,1,0,1,1.2
"14155",2622,0,0,0,0,0,0,0,0,0,0,0,0,0,0,0,0,1037992,"2023-12-23T00:00:00.000Z",17553994,26,"Davion Mitchell",0,0,0,0,0,0
"14156",2623,0,0,0,0,0,0,0,0,0,0,0,0,0,0,0,0,1037992,"2023-12-23T00:00:00.000Z",56677862,26,"Jalen Slawson",0,0,0,0,0,0
"14157",2624,0,0,0,0,0,0,0,0,0,0,0,0,0,0,0,0,1037992,"2023-12-23T00:00:00.000Z",666925,26,"Juan Toscano-Anderson",0,0,0,0,0,0
"14158",2625,0,0,0,0,0,0,0,0,0,0,0,0,0,0,0,0,1037992,"2023-12-23T00:00:00.000Z",17895990,26,"Jordan Ford",0,0,0,0,0,0
"14159",2626,0,0,0,2,0,4,1,2,2,9,0,2,4,0,1,0,3277534,"2023-11-28T00:00:00.000Z",17553994,26,"Davion Mitchell",1,4,4,4,0,7
"14160",2627,2,1,2,7,3,15,8,2,2,26,1,2,21,3,1,3,3277534,"2023-11-28T00:00:00.000Z",324,26,"Malik Monk",2,24,26,23,5,30.6
"14161",2628,0,2,3,6,2,9,3,0,0,15,1,1,8,4,0,0,3277534,"2023-11-28T00:00:00.000Z",4197162,26,"Aleksandar Vezenkov",2,12,12,8,4,18.8
"14162",2629,0,0,0,0,0,0,0,0,0,0,0,0,0,0,0,0,3277534,"2023-11-28T00:00:00.000Z",56677862,26,"Jalen Slawson",0,0,0,0,0,0
"14163",2630,0,0,0,0,0,0,0,0,0,0,0,0,0,0,0,0,3277534,"2023-11-28T00:00:00.000Z",273,26,"Alex Len",0,0,0,0,0,0
"14164",2631,0,0,0,0,0,0,0,0,0,0,0,0,0,0,0,0,3277534,"2023-11-28T00:00:00.000Z",38017688,26,"Keegan Murray",0,0,0,0,0,0
"14165",2632,3,0,8,5,2,18,11,6,5,36,2,5,29,10,0,3,3277534,"2023-11-28T00:00:00.000Z",475,10,"Andrew Wiggins",0,39,42,32,13,42.5
"14166",2633,3,2,6,4,2,8,3,0,0,33,0,4,8,6,0,4,3277534,"2023-11-28T00:00:00.000Z",185,10,"Draymond Green",2,14,17,11,9,21.7
"14167",2634,2,0,3,0,0,1,0,4,2,29,1,4,2,4,1,0,3277534,"2023-11-28T00:00:00.000Z",282,10,"Kevon Looney",1,6,8,4,6,12.8
"14168",2635,2,2,9,9,3,14,6,6,5,36,0,2,20,9,1,3,3277534,"2023-11-28T00:00:00.000Z",443,10,"Klay Thompson",3,29,31,22,11,39.8
"14169",2636,6,1,7,12,4,20,8,9,9,37,3,5,29,10,0,5,3277534,"2023-11-28T00:00:00.000Z",115,10,"Stephen Curry",1,39,45,35,16,48
"14170",2637,1,1,4,1,0,4,3,1,1,16,1,3,7,5,2,1,3277534,"2023-11-28T00:00:00.000Z",2189,10,"Gary Payton II",3,12,13,8,6,22.5
"14171",2638,3,0,1,4,2,7,3,2,2,17,1,3,10,2,0,0,3277534,"2023-11-28T00:00:00.000Z",407,10,"Dario Saric",0,12,15,13,5,16.9
"14172",2639,0,0,0,2,1,2,1,0,0,5,0,1,3,0,2,0,3277534,"2023-11-28T00:00:00.000Z",367,10,"Chris Paul",2,3,3,3,0,9
"14173",2640,0,0,1,1,0,3,0,0,0,10,0,3,0,1,0,2,3277534,"2023-11-28T00:00:00.000Z",17553979,10,"Jonathan Kuminga",0,1,1,0,1,-0.8
"14174",2641,3,0,4,0,0,2,1,2,2,8,0,0,4,4,0,0,3277534,"2023-11-28T00:00:00.000Z",251,10,"Cory Joseph",0,8,11,7,7,13.3
"14175",2642,2,0,0,3,3,4,4,0,0,13,1,1,11,1,0,0,3277534,"2023-11-28T00:00:00.000Z",17553992,10,"Moses Moody",0,12,14,13,3,15.2
"14176",2643,0,0,0,0,0,0,0,0,0,0,0,0,0,0,0,0,3277534,"2023-11-28T00:00:00.000Z",56677799,10,"Trayce Jackson-Davis",0,0,0,0,0,0
"14177",2644,0,0,0,0,0,0,0,0,0,0,0,0,0,0,0,0,3277534,"2023-11-28T00:00:00.000Z",56677858,10,"Brandin Podziemski",0,0,0,0,0,0
"14178",2645,0,0,0,0,0,0,0,0,0,0,0,0,0,0,0,0,3277534,"2023-11-28T00:00:00.000Z",57875092,10,"Gui Santos",0,0,0,0,0,0
"14179",2646,0,0,0,0,0,0,0,0,0,0,0,0,0,0,0,0,3277534,"2023-11-28T00:00:00.000Z",17896070,10,"Usman Garuba",0,0,0,0,0,0
"14180",2647,0,0,0,0,0,0,0,0,0,0,0,0,0,0,0,0,3277534,"2023-11-28T00:00:00.000Z",45658838,10,"Lester Quinones",0,0,0,0,0,0
"14181",2648,3,1,3,6,4,14,11,6,5,31,3,1,31,6,0,2,1037851,"2023-11-29T00:00:00.000Z",17896026,22,"Franz Wagner",1,37,40,34,9,43.7
"14182",2649,4,0,3,0,0,8,2,3,2,27,1,2,6,4,0,4,1037851,"2023-11-29T00:00:00.000Z",38017683,22,"Paolo Banchero",0,10,14,10,8,12.8
"14183",2650,0,0,0,0,0,0,0,0,0,0,0,0,0,0,0,0,3277534,"2023-11-28T00:00:00.000Z",398,10,"Jerome Robinson",0,0,0,0,0,0
"14184",2651,10,1,5,9,4,15,6,2,2,40,4,1,18,9,0,3,1037675,"2023-11-04T00:00:00.000Z",214,2,"Jrue Holiday",1,27,37,28,19,43.8
"14185",2652,2,0,0,2,0,3,1,1,1,14,0,3,3,0,1,2,1037678,"2023-11-04T00:00:00.000Z",89,5,"Alex Caruso",1,3,5,5,2,7
"14186",2653,3,2,2,5,0,7,2,4,3,28,1,0,7,3,1,1,1037678,"2023-11-04T00:00:00.000Z",3547248,5,"Patrick Williams",3,10,13,10,6,23.1
"14187",2654,0,0,7,0,0,3,2,2,1,15,4,1,5,11,1,0,1037678,"2023-11-04T00:00:00.000Z",137,5,"Andre Drummond",1,16,16,5,11,21.2
"14188",2655,0,0,0,0,0,0,0,0,0,3,0,0,0,0,0,0,1037678,"2023-11-04T00:00:00.000Z",56677857,5,"Julian Phillips",0,0,0,0,0,0
"14189",2656,0,0,0,0,0,0,0,0,0,3,0,0,0,0,0,0,1037678,"2023-11-04T00:00:00.000Z",56677874,5,"Onuralp Bitim",0,0,0,0,0,0
"14190",2657,0,0,0,0,0,0,0,0,0,0,0,0,0,0,0,0,1037675,"2023-11-04T00:00:00.000Z",3547295,2,"Nathan Knight",0,0,0,0,0,0
"14191",2658,0,0,0,0,0,0,0,0,0,0,0,0,0,0,0,0,1037675,"2023-11-04T00:00:00.000Z",17553967,2,"Neemias Queta",0,0,0,0,0,0
"14192",2659,3,0,2,1,0,1,0,0,0,12,1,1,0,3,1,0,1037676,"2023-11-04T00:00:00.000Z",19465326,11,"Jock Landale",1,3,6,3,6,11.1
"14193",2660,0,0,3,0,0,1,0,2,1,6,2,0,1,5,0,1,1037676,"2023-11-04T00:00:00.000Z",188,11,"Jeff Green",0,6,6,1,5,6
"14194",2661,0,0,0,1,0,1,0,2,2,1,0,1,2,0,0,0,1037676,"2023-11-04T00:00:00.000Z",56677809,11,"Jermaine Samuels Jr.",0,2,2,2,0,2
"14195",2662,0,0,1,0,0,0,0,0,0,1,0,0,0,1,0,1,1037676,"2023-11-04T00:00:00.000Z",56677831,11,"Cam Whitmore",0,1,1,0,1,0.2
"14196",2663,0,0,0,0,0,0,0,0,0,1,0,0,0,0,0,0,1037676,"2023-11-04T00:00:00.000Z",3547281,11,"Nate Hinton",0,0,0,0,0,0
"14197",2664,0,0,0,0,0,0,0,0,0,0,0,0,0,0,0,0,1037676,"2023-11-04T00:00:00.000Z",75,11,"Reggie Bullock",0,0,0,0,0,0
"14198",2665,0,0,0,0,0,0,0,0,0,0,0,0,0,0,0,0,1037676,"2023-11-04T00:00:00.000Z",296,11,"Boban Marjanovic",0,0,0,0,0,0
"14199",2666,0,0,0,0,0,0,0,0,0,0,0,0,0,0,0,0,1037676,"2023-11-04T00:00:00.000Z",38017695,11,"Tari Eason",0,0,0,0,0,0
"14200",2667,0,0,0,0,0,0,0,0,0,0,0,0,0,0,0,0,1037676,"2023-11-04T00:00:00.000Z",357,11,"Victor Oladipo",0,0,0,0,0,0
"14201",2668,0,0,0,0,0,0,0,0,0,0,0,0,0,0,0,0,1037676,"2023-11-04T00:00:00.000Z",56677825,11,"Amen Thompson",0,0,0,0,0,0
"14202",2669,0,0,0,0,0,0,0,0,0,0,0,0,0,0,0,0,1037676,"2023-11-04T00:00:00.000Z",47738533,11,"Jeenathan Williams",0,0,0,0,0,0
"14203",2670,4,4,4,3,2,14,6,0,0,38,5,3,14,9,4,1,1037679,"2023-11-05T00:00:00.000Z",56677826,9,"Ausar Thompson",8,23,27,18,13,53.8
"14204",2671,1,0,2,2,1,6,3,2,1,34,0,0,8,2,0,3,1037679,"2023-11-05T00:00:00.000Z",3547267,9,"Isaiah Stewart",0,10,11,9,3,8.9
"14205",2672,3,0,8,0,0,10,6,0,0,31,3,4,12,11,2,5,1037679,"2023-11-05T00:00:00.000Z",38017694,9,"Jalen Duren",2,23,26,15,14,30.7
"14206",2673,6,1,2,6,0,24,12,3,2,39,1,2,26,3,0,6,1037679,"2023-11-05T00:00:00.000Z",17896075,9,"Cade Cunningham",1,29,35,32,9,35.6
"14207",2674,5,1,2,3,1,8,4,4,4,34,0,4,13,2,0,0,1037679,"2023-11-05T00:00:00.000Z",3547241,9,"Killian Hayes",1,15,20,18,7,25.9
"14208",2675,4,0,3,6,4,16,9,0,0,30,0,3,22,3,1,0,1037679,"2023-11-05T00:00:00.000Z",56677792,9,"Marcus Sasser",1,25,29,26,7,34.6
"14209",2676,0,0,0,0,0,2,1,0,0,13,0,0,2,0,0,0,1038045,"2024-01-01T00:00:00.000Z",17896071,9,"Isaiah Livers",0,2,2,2,0,2
"14210",2677,2,0,2,1,0,2,1,2,1,9,0,0,3,2,0,1,1038045,"2024-01-01T00:00:00.000Z",188,11,"Jeff Green",0,5,7,5,4,7.4
"14211",2678,2,0,2,2,1,5,3,0,0,14,0,0,7,2,0,1,1038045,"2024-01-01T00:00:00.000Z",75,11,"Reggie Bullock",0,9,11,9,4,11.4
"14212",2679,0,0,0,0,0,0,0,0,0,0,0,0,0,0,0,0,1038045,"2024-01-01T00:00:00.000Z",66,11,"Dillon Brooks",0,0,0,0,0,0
"14213",2680,1,0,3,8,4,11,6,0,0,17,0,2,16,3,0,1,1038044,"2024-01-01T00:00:00.000Z",3547299,6,"Sam Merrill",0,19,20,17,4,20.1
"14214",2681,0,0,1,1,0,2,0,0,0,6,0,1,0,1,0,0,1038044,"2024-01-01T00:00:00.000Z",56677872,6,"Craig Porter",0,1,1,0,1,1.2
"14215",2682,2,0,4,1,0,5,4,0,0,16,0,5,8,4,0,1,1038044,"2024-01-01T00:00:00.000Z",344,6,"Georges Niang",0,12,14,10,6,14.8
"14216",2683,1,0,1,0,0,0,0,0,0,14,2,3,0,3,0,0,1038044,"2024-01-01T00:00:00.000Z",444,6,"Tristan Thompson",0,3,4,1,4,5.1
"14217",2684,2,1,2,6,3,11,6,6,6,23,0,2,21,2,1,2,1038045,"2024-01-01T00:00:00.000Z",77,9,"Alec Burks",2,23,25,23,4,30.4
"14218",2685,2,2,3,0,0,4,2,2,1,24,1,2,5,4,0,2,1038045,"2024-01-01T00:00:00.000Z",56677826,9,"Ausar Thompson",2,9,11,7,6,16.8
"14219",2686,0,1,3,0,0,1,1,2,2,17,1,5,4,4,0,1,1038045,"2024-01-01T00:00:00.000Z",3547240,9,"James Wiseman",1,8,8,4,4,10.8
"14220",2687,3,0,1,2,1,8,3,4,1,19,0,2,8,1,1,1,1038045,"2024-01-01T00:00:00.000Z",3547241,9,"Killian Hayes",1,9,12,11,4,15.7
"14221",2688,8,2,4,7,4,18,10,5,2,38,1,3,26,5,3,3,1038038,"2023-12-31T00:00:00.000Z",227,19,"Brandon Ingram",5,31,39,34,13,56
"14222",2689,1,1,2,4,2,7,3,2,2,22,1,5,10,3,0,0,1038039,"2023-12-31T00:00:00.000Z",56677833,21,"Cason Wallace",1,13,14,11,4,18.1
"14223",2690,2,1,2,1,0,3,1,1,1,6,1,1,3,3,0,0,1038039,"2023-12-31T00:00:00.000Z",38017706,21,"Jaylin Williams",1,6,8,5,5,12.6
"14224",2691,0,0,4,0,0,0,0,0,0,11,1,0,0,5,0,2,1038039,"2023-12-31T00:00:00.000Z",17896078,21,"Aaron Wiggins",0,5,5,0,5,4
"14225",2692,4,0,2,0,0,1,1,0,0,12,1,4,2,3,1,0,1038039,"2023-12-31T00:00:00.000Z",4197029,21,"Vasilije Micic",1,5,9,6,7,14.6
"14226",2693,2,0,4,2,0,4,1,0,0,18,0,0,2,4,0,0,1038039,"2023-12-31T00:00:00.000Z",480,21,"Kenrich Williams",0,6,8,4,6,9.8
"14227",2694,0,0,0,1,1,1,1,0,0,2,0,0,3,0,0,0,1038039,"2023-12-31T00:00:00.000Z",27924547,21,"Lindy Waters III",0,3,3,3,0,3
"14228",2695,0,0,0,0,0,0,0,0,0,0,0,0,0,0,0,0,1038039,"2023-12-31T00:00:00.000Z",3547271,21,"Aleksej Pokusevski",0,0,0,0,0,0
"14229",2696,2,0,0,0,0,2,1,0,0,9,0,0,2,0,0,0,1038045,"2024-01-01T00:00:00.000Z",24,9,"Marvin Bagley III",0,2,4,4,2,5
"14230",2697,2,0,0,2,2,3,3,2,1,7,0,0,9,0,1,0,1038045,"2024-01-01T00:00:00.000Z",56677792,9,"Marcus Sasser",1,9,11,11,2,15
"14231",2698,0,0,0,0,0,0,0,0,0,0,0,0,0,0,0,0,1038045,"2024-01-01T00:00:00.000Z",197,9,"Joe Harris",0,0,0,0,0,0
"14232",2699,1,1,4,4,2,6,3,0,0,19,0,2,8,4,1,0,1038047,"2024-01-01T00:00:00.000Z",38017721,8,"Peyton Watson",2,12,13,9,5,20.3
"14233",2700,0,0,0,0,0,0,0,0,0,0,0,0,0,0,0,0,1038047,"2024-01-01T00:00:00.000Z",666489,8,"Vlatko Cancar",0,0,0,0,0,0
"14234",2701,3,0,8,4,2,13,6,4,1,30,1,3,15,9,1,0,7996365,"2023-12-08T00:00:00.000Z",349,24,"Jusuf Nurkic",1,24,27,18,12,33.3
"14235",2702,3,1,0,7,3,13,7,2,2,38,0,3,19,0,2,4,7996365,"2023-12-08T00:00:00.000Z",178,24,"Eric Gordon",3,19,22,22,3,28.5
"14236",2703,7,0,7,2,2,14,10,9,6,37,0,4,28,7,1,3,7996365,"2023-12-08T00:00:00.000Z",57,24,"Devin Booker",1,35,42,35,14,46.9
"14237",2704,6,0,3,1,0,6,3,2,2,20,2,2,8,5,0,2,7996365,"2023-12-08T00:00:00.000Z",18678058,24,"Jordan Goodwin",0,13,19,14,11,21
"14238",2705,1,2,4,4,0,9,4,2,2,23,0,1,10,4,2,0,7996365,"2023-12-08T00:00:00.000Z",314,24,"Chimezie Metu",4,14,15,11,5,28.3
"14239",2706,0,0,0,0,0,0,0,0,0,0,0,0,0,0,0,0,7050290,"2023-12-08T00:00:00.000Z",56677809,11,"Jermaine Samuels Jr.",0,0,0,0,0,0
"14240",2707,0,0,0,0,0,0,0,0,0,0,0,0,0,0,0,0,7050290,"2023-12-08T00:00:00.000Z",56677825,11,"Amen Thompson",0,0,0,0,0,0
"14241",2708,0,0,0,0,0,0,0,0,0,0,0,0,0,0,0,0,7050290,"2023-12-08T00:00:00.000Z",56677831,11,"Cam Whitmore",0,0,0,0,0,0
"14242",2709,0,0,4,7,5,8,5,2,1,23,4,3,16,8,2,0,7050289,"2023-12-08T00:00:00.000Z",110,5,"Torrey Craig",2,24,24,16,8,31.6
"14243",2710,1,1,5,5,3,7,3,0,0,36,3,0,9,8,3,2,7050292,"2023-12-08T00:00:00.000Z",666923,25,"Matisse Thybulle",4,17,18,10,9,30.1
"14244",2711,0,0,3,10,2,20,6,0,0,32,6,5,14,9,1,0,7050292,"2023-12-08T00:00:00.000Z",56677850,25,"Toumani Camara",1,23,23,14,9,27.8
"14245",2712,1,0,4,6,2,9,4,0,0,21,2,4,10,6,2,1,7050292,"2023-12-08T00:00:00.000Z",56783340,25,"Duop Reath",2,16,17,11,7,23.7
"14246",2713,5,0,7,10,5,15,7,6,5,32,2,4,24,9,1,2,7050292,"2023-12-08T00:00:00.000Z",38017690,25,"Shaedon Sharpe",1,33,38,29,14,43.3
"14247",2714,8,0,3,10,4,21,10,6,6,36,2,4,30,5,1,6,7050292,"2023-12-08T00:00:00.000Z",419,25,"Anfernee Simons",1,35,43,38,13,45
"14248",2715,0,0,0,0,0,0,0,0,0,0,0,0,0,0,0,0,7050290,"2023-12-08T00:00:00.000Z",17896007,8,"Braxton Key",0,0,0,0,0,0
"14249",2716,1,0,4,10,4,12,6,0,0,33,1,5,16,5,2,3,7050290,"2023-12-08T00:00:00.000Z",66,11,"Dillon Brooks",2,21,22,17,6,26.5
"14250",2717,5,0,6,2,0,9,3,4,3,25,4,1,9,10,0,1,7050290,"2023-12-08T00:00:00.000Z",38017684,11,"Jabari Smith Jr.",0,19,24,14,15,27.5
"14251",2718,7,1,8,1,0,14,7,5,3,34,2,3,17,10,0,1,7050290,"2023-12-08T00:00:00.000Z",17896062,11,"Alperen Sengun",1,27,34,24,17,41.5
"14252",2719,1,0,3,9,2,17,8,9,7,35,0,0,25,3,0,1,7050290,"2023-12-08T00:00:00.000Z",17895966,11,"Jalen Green",0,28,29,26,4,29.1
"14253",2720,3,1,3,10,4,17,6,13,10,40,2,3,26,5,0,1,7050290,"2023-12-08T00:00:00.000Z",458,11,"Fred VanVleet",1,31,34,29,8,38.5
"14254",2721,0,0,1,0,0,0,0,0,0,4,0,0,0,1,0,0,7996365,"2023-12-08T00:00:00.000Z",666729,24,"Nassir Little",0,1,1,0,1,1.2
"14255",2722,0,0,4,0,0,8,4,0,0,16,2,3,8,6,0,1,7996365,"2023-12-08T00:00:00.000Z",147,24,"Drew Eubanks",0,14,14,8,6,14.2
"14256",2723,1,0,2,8,3,8,3,0,0,24,0,0,9,2,0,0,7996365,"2023-12-08T00:00:00.000Z",470,24,"Yuta Watanabe",0,11,12,10,3,12.9
"14257",2724,0,0,0,0,0,0,0,0,0,1,0,0,0,0,0,0,7996365,"2023-12-08T00:00:00.000Z",666451,24,"Bol Bol",0,0,0,0,0,0
"14258",2725,0,0,0,0,0,1,1,2,2,1,0,0,4,0,0,0,7996365,"2023-12-08T00:00:00.000Z",3547298,24,"Saben Lee",0,4,4,4,0,4
"14259",2726,11,0,4,10,4,26,9,6,6,39,2,5,28,6,3,8,3277425,"2023-11-14T00:00:00.000Z",3547239,4,"LaMelo Ball",3,34,45,39,17,52.7
"14260",2727,1,0,4,5,3,7,4,2,1,29,0,4,12,4,1,1,3277425,"2023-11-14T00:00:00.000Z",38017708,4,"Bryce McGowens",1,16,17,13,5,20.3
"14261",2728,0,0,0,1,0,2,0,0,0,3,0,0,0,0,0,0,3277425,"2023-11-14T00:00:00.000Z",56677866,4,"Leaky Black",0,0,0,0,0,0
"14262",2729,0,0,0,0,0,0,0,0,0,0,0,0,0,0,0,0,3277425,"2023-11-14T00:00:00.000Z",56677848,4,"Amari Bailey",0,0,0,0,0,0
"14263",2730,1,1,1,2,0,3,1,0,0,16,0,2,2,1,0,0,3277427,"2023-11-14T00:00:00.000Z",108,23,"Robert Covington",1,3,4,3,2,7.7
"14264",2731,3,0,7,1,0,17,11,1,0,37,0,3,22,7,1,1,3277427,"2023-11-14T00:00:00.000Z",200,23,"Tobias Harris",1,29,32,25,10,36.9
"14265",2732,6,0,9,4,0,22,11,17,17,38,3,4,39,12,3,5,3277427,"2023-11-14T00:00:00.000Z",145,23,"Joel Embiid",3,51,57,45,18,66.4
"14266",2733,1,0,3,5,0,5,0,4,3,14,0,1,3,3,0,0,3277425,"2023-11-14T00:00:00.000Z",285,16,"Kevin Love",0,6,7,4,4,8.1
"14267",2734,0,0,0,0,0,0,0,0,0,0,0,0,0,0,0,0,3277425,"2023-11-14T00:00:00.000Z",39398582,16,"Orlando Robinson",0,0,0,0,0,0
"14268",2735,0,0,0,0,0,0,0,0,0,0,0,0,0,0,0,0,3277425,"2023-11-14T00:00:00.000Z",38017734,16,"Jamal Cain",0,0,0,0,0,0
"14269",2736,0,0,0,0,0,0,0,0,0,0,0,0,0,0,0,0,3277425,"2023-11-14T00:00:00.000Z",3547257,16,"R.J. Hampton",0,0,0,0,0,0
"14270",2737,0,0,0,0,0,0,0,0,0,0,0,0,0,0,0,0,3277425,"2023-11-14T00:00:00.000Z",666633,16,"Tyler Herro",0,0,0,0,0,0
"14271",2738,0,0,0,0,0,0,0,0,0,0,0,0,0,0,0,0,3277426,"2023-11-14T00:00:00.000Z",42097199,9,"Jared Rhoden",0,0,0,0,0,0
"14272",2739,0,0,0,0,0,0,0,0,0,0,0,0,0,0,0,0,3277426,"2023-11-14T00:00:00.000Z",44477024,9,"Stanley Umude",0,0,0,0,0,0
"14273",2740,5,0,3,5,2,14,6,3,2,35,2,3,16,5,1,1,3277426,"2023-11-14T00:00:00.000Z",666656,1,"De'Andre Hunter",1,21,26,21,10,31.5
"14274",2741,1,1,4,2,2,9,6,2,2,36,1,2,16,5,1,2,3277426,"2023-11-14T00:00:00.000Z",17896040,1,"Jalen Johnson",2,21,22,17,6,27.5
"14275",2742,1,3,5,0,0,4,3,2,2,27,2,5,8,7,2,3,3277426,"2023-11-14T00:00:00.000Z",83,1,"Clint Capela",5,15,16,9,8,29.9
"14276",2743,3,1,3,11,3,17,7,0,0,34,0,0,17,3,0,3,3277426,"2023-11-14T00:00:00.000Z",53,1,"Bogdan Bogdanovic",1,20,23,20,6,25.1
"14277",2744,2,1,4,7,2,13,6,6,5,27,1,0,19,5,2,1,3277426,"2023-11-14T00:00:00.000Z",3547256,1,"Saddiq Bey",3,24,26,21,7,36
"14278",2745,4,0,0,0,0,1,0,2,2,13,1,0,2,1,0,0,3277426,"2023-11-14T00:00:00.000Z",3547297,1,"Trent Forrest",0,3,7,6,5,9.2
"14279",2746,0,0,0,0,0,0,0,0,0,0,0,0,0,0,0,0,3277426,"2023-11-14T00:00:00.000Z",666564,1,"Bruno Fernando",0,0,0,0,0,0
"14280",2747,0,0,0,0,0,0,0,0,0,3,0,2,0,0,0,0,3277425,"2023-11-14T00:00:00.000Z",19465585,16,"Dru Smith",0,0,0,0,0,0
"14281",2748,6,1,4,6,0,10,2,2,2,33,1,2,6,5,1,1,3277425,"2023-11-14T00:00:00.000Z",391,16,"Josh Richardson",2,11,17,12,11,26
"14282",2749,3,0,5,2,0,11,5,4,4,36,0,4,14,5,1,0,3277427,"2023-11-14T00:00:00.000Z",69,12,"Bruce Brown",1,19,22,17,8,27.5
"14283",2750,15,1,6,12,7,18,11,5,4,38,1,1,33,7,2,0,3277427,"2023-11-14T00:00:00.000Z",3547245,12,"Tyrese Haliburton",3,40,55,48,22,72.9
"14284",2751,3,0,2,1,0,5,4,0,0,23,2,1,8,4,2,2,1038118,"2024-01-10T00:00:00.000Z",489,28,"Thaddeus Young",2,12,15,11,7,21.3
"14285",2752,4,0,1,5,1,13,8,5,5,34,0,1,22,1,0,2,1038118,"2024-01-10T00:00:00.000Z",409,28,"Dennis Schroder",0,23,27,26,5,27.2
"14286",2753,6,0,4,4,2,16,7,9,9,36,0,1,25,4,1,1,1038118,"2024-01-10T00:00:00.000Z",3547269,28,"Immanuel Quickley",1,29,35,31,10,40.8
"14287",2754,4,0,4,3,1,8,4,0,0,18,3,4,9,7,0,3,1038118,"2024-01-10T00:00:00.000Z",2309958,28,"Jontay Porter",0,16,20,13,11,20.4
"14288",2755,1,0,3,0,0,2,1,0,0,13,0,2,2,3,1,0,1038118,"2024-01-10T00:00:00.000Z",666762,28,"Jalen McDaniels",1,5,6,3,4,10.1
"14289",2756,0,0,1,1,0,3,1,1,1,11,0,0,3,1,0,0,1038118,"2024-01-10T00:00:00.000Z",58,28,"Chris Boucher",0,4,4,3,1,4.2
"14290",2757,2,0,0,4,1,7,2,0,0,20,0,2,5,0,0,0,1038116,"2024-01-10T00:00:00.000Z",236,8,"Reggie Jackson",0,5,7,7,2,8
"14291",2758,0,0,1,5,1,8,1,0,0,17,1,1,3,2,0,0,1038116,"2024-01-10T00:00:00.000Z",38017721,8,"Peyton Watson",0,5,5,3,2,5.4
"14292",2759,0,1,3,0,0,3,1,4,3,8,2,0,5,5,0,0,1038116,"2024-01-10T00:00:00.000Z",250,8,"DeAndre Jordan",1,10,10,5,5,14
"14293",2760,1,0,0,0,0,1,1,0,0,6,2,0,2,2,0,0,1038116,"2024-01-10T00:00:00.000Z",17896007,8,"Braxton Key",0,4,5,3,3,5.9
"14294",2761,1,0,0,1,1,2,1,2,2,6,0,2,5,0,1,0,1038116,"2024-01-10T00:00:00.000Z",3547268,8,"Zeke Nnaji",1,5,6,6,1,9.5
"14295",2762,1,0,0,1,0,2,1,0,0,6,0,1,2,0,0,1,1038116,"2024-01-10T00:00:00.000Z",17896103,8,"Jay Huff",0,2,3,3,1,2.5
"14296",2763,0,0,0,0,0,0,0,0,0,0,0,0,0,0,0,0,1038116,"2024-01-10T00:00:00.000Z",666489,8,"Vlatko Cancar",0,0,0,0,0,0
"14297",2764,0,0,0,0,0,0,0,0,0,0,0,0,0,0,0,0,1038116,"2024-01-10T00:00:00.000Z",56677582,8,"Jalen Pickett",0,0,0,0,0,0
"14298",2765,0,0,0,0,0,0,0,0,0,0,0,0,0,0,0,0,1038116,"2024-01-10T00:00:00.000Z",56677776,8,"Julian Strawther",0,0,0,0,0,0
"14299",2766,0,0,0,0,0,0,0,0,0,0,0,0,0,0,0,0,1038116,"2024-01-10T00:00:00.000Z",56677871,8,"Hunter Tyson",0,0,0,0,0,0
"14300",2767,3,0,0,1,0,9,3,0,0,14,0,0,6,0,0,0,1038118,"2024-01-10T00:00:00.000Z",472,13,"Russell Westbrook",0,6,9,9,3,10.5
"14301",2768,1,0,3,8,3,11,4,2,2,27,0,1,13,3,0,0,1038118,"2024-01-10T00:00:00.000Z",380,13,"Norman Powell",0,16,17,14,4,18.1
"14302",2769,0,0,0,0,0,0,0,0,0,0,0,0,0,0,0,0,1038119,"2024-01-11T00:00:00.000Z",38017662,6,"Isaiah Mobley",0,0,0,0,0,0
"14303",2770,1,0,1,5,1,7,1,2,0,23,1,3,3,2,1,3,1038119,"2024-01-11T00:00:00.000Z",666679,3,"Cameron Johnson",1,5,6,4,3,6.9
"14304",2771,0,1,0,1,0,1,0,0,0,14,0,3,0,0,0,1,1038119,"2024-01-11T00:00:00.000Z",158,3,"Dorian Finney-Smith",1,0,0,0,0,2
"14305",2772,1,0,8,0,0,9,6,2,1,33,3,3,13,11,1,3,1038119,"2024-01-11T00:00:00.000Z",666508,3,"Nicolas Claxton",1,24,25,14,12,27.7
"14306",2773,1,0,6,6,2,18,6,13,12,32,0,3,26,6,1,4,1038119,"2024-01-11T00:00:00.000Z",61,3,"Mikal Bridges",1,32,33,27,7,33.7
"14307",2774,3,0,2,2,0,3,1,0,0,16,0,2,2,2,0,0,1038119,"2024-01-11T00:00:00.000Z",130,3,"Spencer Dinwiddie",0,4,7,5,5,8.9
"14308",2775,1,0,2,2,0,2,0,0,0,17,0,2,0,2,0,1,1038119,"2024-01-11T00:00:00.000Z",351,3,"Royce O'Neale",0,2,3,1,3,2.9
"14309",2776,0,0,1,1,1,1,1,0,0,2,0,0,3,1,0,0,1037953,"2023-12-19T00:00:00.000Z",284,17,"Robin Lopez",0,4,4,3,1,4.2
"14310",2777,1,0,0,0,0,0,0,0,0,1,0,0,0,0,0,0,1037953,"2023-12-19T00:00:00.000Z",2148,17,"Thanasis Antetokounmpo",0,0,1,1,1,1.5
"14311",2778,0,0,0,0,0,0,0,0,0,0,0,0,0,0,0,0,1037953,"2023-12-19T00:00:00.000Z",666453,17,"Marques Bolden",0,0,0,0,0,0
"14312",2779,0,0,0,0,0,0,0,0,0,0,0,0,0,0,0,0,1037953,"2023-12-19T00:00:00.000Z",112,17,"Jae Crowder",0,0,0,0,0,0
"14313",2780,0,0,0,0,0,0,0,0,0,0,0,0,0,0,0,0,1037953,"2023-12-19T00:00:00.000Z",56677854,17,"Chris Livingston",0,0,0,0,0,0
"14314",2781,0,0,0,0,0,0,0,0,0,0,0,0,0,0,0,0,1037953,"2023-12-19T00:00:00.000Z",38017691,17,"TyTy Washington Jr.",0,0,0,0,0,0
"14315",2782,0,0,0,0,0,0,0,0,0,0,0,0,0,0,0,0,1037953,"2023-12-19T00:00:00.000Z",666960,17,"Lindell Wigginton",0,0,0,0,0,0
"14316",2783,0,0,0,0,0,0,0,0,0,0,0,0,0,0,0,0,1037954,"2023-12-19T00:00:00.000Z",185,10,"Draymond Green",0,0,0,0,0,0
"14317",2784,4,1,4,15,6,21,9,0,0,40,0,0,24,4,1,1,1037954,"2023-12-19T00:00:00.000Z",443,10,"Klay Thompson",2,28,32,28,8,39.8
"14318",2785,2,0,3,4,1,13,8,2,0,34,4,0,17,7,2,1,1037954,"2023-12-19T00:00:00.000Z",17553979,10,"Jonathan Kuminga",2,24,26,19,9,33.4
"14319",2786,2,0,5,0,0,2,1,1,1,14,1,0,3,6,0,1,1037954,"2023-12-19T00:00:00.000Z",282,10,"Kevon Looney",0,9,11,5,8,12.2
"14320",2787,1,0,4,3,1,4,2,0,0,16,1,2,5,5,1,1,1037954,"2023-12-19T00:00:00.000Z",56677858,10,"Brandin Podziemski",1,10,11,6,6,14.5
"14321",2788,6,0,3,11,6,21,11,5,5,38,0,5,33,3,0,4,1037954,"2023-12-19T00:00:00.000Z",115,10,"Stephen Curry",0,36,42,39,9,41.6
"14322",2789,0,1,6,1,1,4,2,0,0,21,3,3,5,9,3,2,1037955,"2023-12-19T00:00:00.000Z",56677850,25,"Toumani Camara",4,14,14,5,9,25.8
"14323",2790,4,2,1,4,3,15,8,3,3,36,0,2,22,1,0,2,1037955,"2023-12-19T00:00:00.000Z",182,25,"Jerami Grant",2,23,27,26,5,33.2
"14324",2791,3,0,11,0,0,18,6,4,4,40,4,3,16,15,0,3,1037955,"2023-12-19T00:00:00.000Z",22,25,"Deandre Ayton",0,31,34,19,18,35.5
"14325",2792,0,0,1,0,0,1,0,0,0,8,0,2,0,1,0,0,1037955,"2023-12-19T00:00:00.000Z",38017690,25,"Shaedon Sharpe",0,1,1,0,1,1.2
"14326",2793,7,0,3,7,2,23,9,5,3,38,0,2,23,3,1,1,1037955,"2023-12-19T00:00:00.000Z",419,25,"Anfernee Simons",1,26,33,30,10,39.1
"14327",2794,4,0,4,9,4,10,5,0,0,32,0,0,14,4,0,1,1037955,"2023-12-19T00:00:00.000Z",65,25,"Malcolm Brogdon",0,18,22,18,8,23.8
"14328",2795,0,0,0,0,0,0,0,0,0,0,0,0,0,0,0,0,1037955,"2023-12-19T00:00:00.000Z",666476,25,"Moses Brown",0,0,0,0,0,0
"14329",2796,12,0,6,5,1,12,4,0,0,35,1,2,9,7,0,0,1037954,"2023-12-19T00:00:00.000Z",367,10,"Chris Paul",0,16,28,21,19,35.4
"14330",2797,0,3,5,3,1,10,6,15,11,29,1,4,24,6,0,2,1037952,"2023-12-19T00:00:00.000Z",231,15,"Jaren Jackson Jr.",3,30,30,24,6,38.2
"14331",2798,0,1,2,0,0,5,4,0,0,22,0,3,8,2,1,1,1037952,"2023-12-19T00:00:00.000Z",48,15,"Bismack Biyombo",2,10,10,8,2,15.4
"14332",2799,5,0,0,9,3,19,8,2,2,35,1,1,21,1,0,4,1037952,"2023-12-19T00:00:00.000Z",3547287,15,"Desmond Bane",0,22,27,26,6,25.7
"14333",2800,8,1,3,5,0,24,12,12,10,35,3,2,34,6,2,5,1037952,"2023-12-19T00:00:00.000Z",666786,15,"Ja Morant",3,40,48,42,14,57.2
"14334",2801,0,0,0,0,0,0,0,0,0,0,0,0,0,0,0,0,3277505,"2023-11-24T00:00:00.000Z",3547259,18,"Jaden McDaniels",0,0,0,0,0,0
"14335",2802,0,0,0,0,0,0,0,0,0,0,0,0,0,0,0,0,3277505,"2023-11-24T00:00:00.000Z",666767,18,"Jordan McLaughlin",0,0,0,0,0,0
"14336",2803,0,0,0,0,0,0,0,0,0,0,0,0,0,0,0,0,3277505,"2023-11-24T00:00:00.000Z",38017700,18,"Wendell Moore Jr.",0,0,0,0,0,0
"14337",2804,0,0,0,0,0,0,0,0,0,0,0,0,0,0,0,0,3277500,"2023-11-24T00:00:00.000Z",19,20,"Ryan Arcidiacono",0,0,0,0,0,0
"14338",2805,0,0,0,0,0,0,0,0,0,0,0,0,0,0,0,0,3277505,"2023-11-24T00:00:00.000Z",4197162,26,"Aleksandar Vezenkov",0,0,0,0,0,0
"14339",2806,0,0,0,0,0,0,0,0,0,0,0,0,0,0,0,0,3277505,"2023-11-24T00:00:00.000Z",38017714,26,"Keon Ellis",0,0,0,0,0,0
"14340",2807,0,0,0,0,0,0,0,0,0,0,0,0,0,0,0,0,3277505,"2023-11-24T00:00:00.000Z",17895990,26,"Jordan Ford",0,0,0,0,0,0
"14341",2808,0,0,0,0,0,0,0,0,0,0,0,0,0,0,0,0,3277505,"2023-11-24T00:00:00.000Z",273,26,"Alex Len",0,0,0,0,0,0
"14342",2809,0,0,0,0,0,0,0,0,0,0,0,0,0,0,0,0,3277500,"2023-11-24T00:00:00.000Z",160,20,"Evan Fournier",0,0,0,0,0,0
"14343",2810,0,0,0,0,0,0,0,0,0,0,0,0,0,0,0,0,3277500,"2023-11-24T00:00:00.000Z",666675,20,"DaQuan Jeffries",0,0,0,0,0,0
"14344",2811,0,0,0,0,0,0,0,0,0,0,0,0,0,0,0,0,3277500,"2023-11-24T00:00:00.000Z",17896033,20,"Miles McBride",0,0,0,0,0,0
"14345",2812,0,0,0,0,0,0,0,0,0,0,0,0,0,0,0,0,3277500,"2023-11-24T00:00:00.000Z",17896063,20,"Jericho Sims",0,0,0,0,0,0
"14346",2813,0,0,0,0,0,0,0,0,0,0,0,0,0,0,0,0,3277500,"2023-11-24T00:00:00.000Z",666474,20,"Charles Brown",0,0,0,0,0,0
"14347",2814,0,0,0,0,0,0,0,0,0,0,0,0,0,0,0,0,3277500,"2023-11-24T00:00:00.000Z",56677795,20,"Jacob Toppin",0,0,0,0,0,0
"14348",2815,0,0,0,0,0,0,0,0,0,0,0,0,0,0,0,0,3277500,"2023-11-24T00:00:00.000Z",17896089,20,"Duane Washington Jr.",0,0,0,0,0,0
"14349",2816,0,0,0,0,0,0,0,0,0,0,0,0,0,0,0,0,3277505,"2023-11-24T00:00:00.000Z",38017688,26,"Keegan Murray",0,0,0,0,0,0
"14350",2817,2,3,3,0,0,6,3,0,0,14,3,1,6,6,0,1,3277502,"2023-11-24T00:00:00.000Z",24,9,"Marvin Bagley III",3,12,14,8,8,24.2
"14351",2818,3,1,0,6,1,16,9,9,6,32,2,3,25,2,1,3,3277502,"2023-11-24T00:00:00.000Z",38017682,9,"Jaden Ivey",2,27,30,28,5,34.9
"14352",2819,5,0,3,4,2,26,10,9,9,38,0,0,31,3,0,4,3277502,"2023-11-24T00:00:00.000Z",17896075,9,"Cade Cunningham",0,34,39,36,8,38.1
"14353",2820,4,1,9,1,0,10,5,4,3,29,4,5,13,13,1,2,3277502,"2023-11-24T00:00:00.000Z",38017694,9,"Jalen Duren",2,26,30,17,17,38.6
"14354",2821,0,0,2,4,2,5,3,0,0,26,0,2,8,2,0,0,3277502,"2023-11-24T00:00:00.000Z",17896071,9,"Isaiah Livers",0,10,10,8,2,10.4
"14355",2822,1,1,2,3,2,6,2,0,0,14,0,1,6,2,1,2,3277502,"2023-11-24T00:00:00.000Z",77,9,"Alec Burks",2,8,9,7,3,13.9
"14356",2823,3,0,1,0,0,6,3,0,0,17,0,0,6,1,0,0,3277502,"2023-11-24T00:00:00.000Z",3547241,9,"Killian Hayes",0,7,10,9,4,11.7
"14357",2824,0,2,1,0,0,1,0,0,0,8,1,3,0,2,1,1,3277502,"2023-11-24T00:00:00.000Z",44477024,9,"Stanley Umude",3,2,2,0,2,10.4
"14358",2825,0,0,0,0,0,1,0,0,0,5,0,0,0,0,0,0,3277502,"2023-11-24T00:00:00.000Z",56677792,9,"Marcus Sasser",0,0,0,0,0,0
"14359",2826,1,1,2,7,2,19,4,4,3,34,0,2,13,2,3,4,1037651,"2023-11-01T00:00:00.000Z",17896048,3,"Cam Thomas",4,15,16,14,3,24.9
"14360",2827,0,0,0,0,0,0,0,0,0,0,0,0,0,0,0,0,1037651,"2023-11-01T00:00:00.000Z",666679,3,"Cameron Johnson",0,0,0,0,0,0
"14361",2828,0,0,0,0,0,0,0,0,0,0,0,0,0,0,0,0,1037651,"2023-11-01T00:00:00.000Z",17896041,3,"Keon Johnson",0,0,0,0,0,0
"14362",2829,0,0,0,0,0,0,0,0,0,0,0,0,0,0,0,0,1037651,"2023-11-01T00:00:00.000Z",421,3,"Dennis Smith Jr.",0,0,0,0,0,0
"14363",2830,0,0,0,0,0,0,0,0,0,0,0,0,0,0,0,0,1037647,"2023-11-01T00:00:00.000Z",38017694,9,"Jalen Duren",0,0,0,0,0,0
"14364",2831,0,0,0,0,0,0,0,0,0,0,0,0,0,0,0,0,1037651,"2023-11-01T00:00:00.000Z",56677841,3,"Dariq Whitehead",0,0,0,0,0,0
"14365",2832,0,1,5,3,1,4,2,0,0,13,0,2,5,5,3,1,1037654,"2023-11-01T00:00:00.000Z",18678001,4,"JT Thor",4,10,10,5,5,22
"14366",2833,0,0,0,0,0,0,0,0,0,0,0,0,0,0,0,0,1037647,"2023-11-01T00:00:00.000Z",17896071,9,"Isaiah Livers",0,0,0,0,0,0
"14367",2834,0,0,0,0,0,0,0,0,0,0,0,0,0,0,0,0,1037647,"2023-11-01T00:00:00.000Z",330,9,"Monte Morris",0,0,0,0,0,0
"14368",2835,1,0,1,3,0,3,0,0,0,17,0,1,0,1,1,0,1037647,"2023-11-01T00:00:00.000Z",666923,25,"Matisse Thybulle",1,1,2,1,2,5.7
"14369",2836,0,0,0,0,0,0,0,0,0,0,0,0,0,0,0,0,1037647,"2023-11-01T00:00:00.000Z",56783340,25,"Duop Reath",0,0,0,0,0,0
"14370",2837,0,0,0,0,0,0,0,0,0,0,0,0,0,0,0,0,1037654,"2023-11-01T00:00:00.000Z",56677846,4,"Nick Smith Jr.",0,0,0,0,0,0
"14371",2838,0,0,0,0,0,0,0,0,0,0,0,0,0,0,0,0,1037654,"2023-11-01T00:00:00.000Z",17896037,4,"James Bouknight",0,0,0,0,0,0
"14372",2839,0,0,0,0,0,0,0,0,0,0,0,0,0,0,0,0,1037654,"2023-11-01T00:00:00.000Z",666748,4,"Cody Martin",0,0,0,0,0,0
"14373",2840,0,0,0,0,0,0,0,0,0,0,0,0,0,0,0,0,1037654,"2023-11-01T00:00:00.000Z",347,4,"Frank Ntilikina",0,0,0,0,0,0
"14374",2841,0,0,0,0,0,0,0,0,0,0,0,0,0,0,0,0,1037647,"2023-11-01T00:00:00.000Z",419,25,"Anfernee Simons",0,0,0,0,0,0
"14375",2842,0,0,0,0,0,0,0,0,0,0,0,0,0,0,0,0,1037647,"2023-11-01T00:00:00.000Z",17896120,25,"Ish Wainright",0,0,0,0,0,0
"14376",2843,0,0,0,0,0,0,0,0,0,0,0,0,0,0,0,0,1037654,"2023-11-01T00:00:00.000Z",422,4,"Ish Smith",0,0,0,0,0,0
"14377",2844,1,0,1,1,0,3,1,2,2,13,0,3,4,1,1,1,1037654,"2023-11-01T00:00:00.000Z",56677825,11,"Amen Thompson",1,5,6,5,2,8.7
"14378",2845,5,0,5,2,1,5,1,2,1,19,1,4,4,6,0,0,1037654,"2023-11-01T00:00:00.000Z",3547301,11,"Jae'Sean Tate",0,10,15,9,11,18.7
"14379",2846,1,1,2,3,0,7,1,2,2,19,3,1,4,5,1,1,1037654,"2023-11-01T00:00:00.000Z",19465326,11,"Jock Landale",2,9,10,5,6,16.5
"14380",2847,0,0,2,2,2,3,2,4,3,12,0,1,9,2,0,1,1037654,"2023-11-01T00:00:00.000Z",188,11,"Jeff Green",0,11,11,9,2,10.4
"14381",2848,1,0,1,2,2,2,2,0,0,11,0,1,6,1,0,1,1037654,"2023-11-01T00:00:00.000Z",213,11,"Aaron Holiday",0,7,8,7,2,7.7
"14382",2849,0,0,0,0,0,0,0,0,0,0,0,0,0,0,0,0,1037654,"2023-11-01T00:00:00.000Z",75,11,"Reggie Bullock",0,0,0,0,0,0
"14383",2850,0,0,0,0,0,0,0,0,0,0,0,0,0,0,0,0,1037654,"2023-11-01T00:00:00.000Z",3547281,11,"Nate Hinton",0,0,0,0,0,0
"14384",2851,0,0,0,0,0,0,0,0,0,0,0,0,0,0,0,0,1038023,"2023-12-29T00:00:00.000Z",17895990,26,"Jordan Ford",0,0,0,0,0,0
"14385",2852,0,0,0,0,0,0,0,0,0,0,0,0,0,0,0,0,1038023,"2023-12-29T00:00:00.000Z",56677845,26,"Colby Jones",0,0,0,0,0,0
"14386",2853,0,0,0,0,0,0,0,0,0,0,0,0,0,0,0,0,1038023,"2023-12-29T00:00:00.000Z",56677862,26,"Jalen Slawson",0,0,0,0,0,0
"14387",2854,0,0,4,0,0,0,0,0,0,4,0,1,0,4,0,0,1038029,"2023-12-29T00:00:00.000Z",666476,25,"Moses Brown",0,4,4,0,4,4.8
"14388",2855,7,0,1,7,5,18,9,4,4,37,0,2,27,1,1,1,1038029,"2023-12-29T00:00:00.000Z",65,25,"Malcolm Brogdon",1,28,35,34,8,40.7
"14389",2856,11,1,3,5,3,21,9,2,1,37,4,5,22,7,1,4,1038029,"2023-12-29T00:00:00.000Z",56677747,25,"Scoot Henderson",2,29,40,33,18,48.9
"14390",2857,1,2,1,0,0,0,0,2,2,10,1,3,2,2,0,0,1038029,"2023-12-29T00:00:00.000Z",39613724,25,"Ibou Badji",2,4,5,3,3,11.9
"14391",2858,2,0,1,1,1,10,5,0,0,20,1,0,11,2,1,0,1038029,"2023-12-29T00:00:00.000Z",3547289,25,"Skylar Mays",1,13,15,13,4,19.4
"14392",2859,0,2,1,4,1,6,3,0,0,27,0,1,7,1,1,1,1038029,"2023-12-29T00:00:00.000Z",666923,25,"Matisse Thybulle",3,8,8,7,1,16.2
"14393",2860,1,1,3,2,1,11,7,13,10,30,6,4,25,9,1,1,1038029,"2023-12-29T00:00:00.000Z",38017711,25,"Jabari Walker",2,34,35,26,10,42.3
"14394",2861,0,0,0,0,0,0,0,0,0,0,0,0,0,0,0,0,1038029,"2023-12-29T00:00:00.000Z",47957121,25,"Justin Minaya",0,0,0,0,0,0
"14395",2862,0,0,0,0,0,0,0,0,0,0,0,0,0,0,0,0,1038029,"2023-12-29T00:00:00.000Z",56677791,25,"Kris Murray",0,0,0,0,0,0
"14396",2863,0,0,0,0,0,0,0,0,0,0,0,0,0,0,0,0,1038029,"2023-12-29T00:00:00.000Z",56677829,25,"Rayan Rupert",0,0,0,0,0,0
"14397",2864,0,0,0,0,0,0,0,0,0,0,0,0,0,0,0,0,1038029,"2023-12-29T00:00:00.000Z",17896120,25,"Ish Wainright",0,0,0,0,0,0
"14398",2865,0,0,0,0,0,0,0,0,0,0,0,0,0,0,0,0,1038029,"2023-12-29T00:00:00.000Z",22,25,"Deandre Ayton",0,0,0,0,0,0
"14399",2866,0,0,0,0,0,0,0,0,0,0,0,0,0,0,0,0,1038029,"2023-12-29T00:00:00.000Z",56783340,25,"Duop Reath",0,0,0,0,0,0
"14400",2867,0,0,0,0,0,0,0,0,0,0,0,0,0,0,0,0,1038029,"2023-12-29T00:00:00.000Z",38017690,25,"Shaedon Sharpe",0,0,0,0,0,0
"14401",2868,1,0,1,8,6,9,6,0,0,23,0,1,18,1,0,2,1038029,"2023-12-29T00:00:00.000Z",305,27,"Doug McDermott",0,19,20,19,2,18.7
"14402",2869,2,0,1,1,0,2,1,0,0,7,0,1,2,1,0,0,1038029,"2023-12-29T00:00:00.000Z",17896059,27,"Sandro Mamukelashvili",0,3,5,4,3,6.2
"14403",2870,0,0,0,0,0,0,0,0,0,0,0,0,0,0,0,0,1038029,"2023-12-29T00:00:00.000Z",38017693,27,"Blake Wesley",0,0,0,0,0,0
"14404",2871,6,0,5,4,2,9,6,0,0,20,1,1,14,6,0,4,1038030,"2023-12-29T00:00:00.000Z",472,13,"Russell Westbrook",0,20,26,20,12,26.2
"14405",2872,1,0,6,4,1,12,5,2,2,25,0,2,13,6,0,1,1038030,"2023-12-29T00:00:00.000Z",380,13,"Norman Powell",0,19,20,14,7,20.7
"14406",2873,0,2,1,1,0,3,2,2,1,13,1,3,5,2,0,1,1038030,"2023-12-29T00:00:00.000Z",439,13,"Daniel Theis",2,7,7,5,2,12.4
"14407",2874,0,0,0,0,0,0,0,0,0,0,0,0,0,0,0,0,1038030,"2023-12-29T00:00:00.000Z",17896031,13,"Nah'Shon Hyland",0,0,0,0,0,0
"14408",2875,0,0,0,0,0,0,0,0,0,0,0,0,0,0,0,0,1038030,"2023-12-29T00:00:00.000Z",56677856,13,"Jordan Miller",0,0,0,0,0,0
"14409",2876,0,0,0,0,0,0,0,0,0,0,0,0,0,0,0,0,1037887,"2023-12-11T00:00:00.000Z",414,30,"Landry Shamet",0,0,0,0,0,0
"14410",2877,0,0,0,0,0,0,0,0,0,0,0,0,0,0,0,0,1037887,"2023-12-11T00:00:00.000Z",487,30,"Delon Wright",0,0,0,0,0,0
"14411",2878,1,0,4,4,1,8,3,0,0,17,1,3,7,5,1,0,1037887,"2023-12-11T00:00:00.000Z",360,23,"Kelly Oubre Jr.",1,12,13,8,6,17.5
"14412",2879,1,0,2,3,2,6,5,0,0,12,0,3,12,2,1,0,1037887,"2023-12-11T00:00:00.000Z",328,23,"Marcus Morris",1,14,15,13,3,18.9
"14413",2880,3,1,4,0,0,2,2,1,0,13,2,3,4,6,0,0,1037887,"2023-12-11T00:00:00.000Z",3547270,23,"Paul Reed",1,10,13,7,9,18.7
"14414",2881,0,0,0,1,0,5,2,2,2,9,0,3,6,0,2,1,1037887,"2023-12-11T00:00:00.000Z",17896025,23,"Jaden Springer",2,6,6,6,0,11
"14415",2882,0,0,0,0,0,0,0,0,0,0,0,0,0,0,0,0,1037887,"2023-12-11T00:00:00.000Z",56913527,23,"Ricky Council IV",0,0,0,0,0,0
"14416",2883,0,0,0,0,0,0,0,0,0,0,0,0,0,0,0,0,1037887,"2023-12-11T00:00:00.000Z",17554001,23,"Javonte Smart",0,0,0,0,0,0
"14417",2884,0,0,0,0,0,0,0,0,0,0,0,0,0,0,0,0,1037887,"2023-12-11T00:00:00.000Z",56677788,23,"Terquavion Smith",0,0,0,0,0,0
"14418",2885,3,0,1,5,0,9,1,6,4,26,1,4,6,2,1,3,1037886,"2023-12-11T00:00:00.000Z",666908,6,"Max Strus",1,8,11,9,5,12.9
"14419",2886,0,0,2,4,2,5,3,2,1,29,4,2,9,6,3,2,1037886,"2023-12-11T00:00:00.000Z",666940,6,"Dean Wade",3,15,15,9,6,23.2
"14420",2887,1,0,5,0,0,3,2,0,0,15,2,6,4,7,1,1,1037886,"2023-12-11T00:00:00.000Z",9,6,"Jarrett Allen",1,11,12,5,8,15.9
"14421",2888,3,1,2,10,2,18,6,9,8,37,1,3,22,3,3,2,1037886,"2023-12-11T00:00:00.000Z",322,6,"Donovan Mitchell",4,25,28,25,6,40.1
"14422",2889,5,0,5,9,3,23,11,12,11,39,1,0,36,6,2,3,1037886,"2023-12-11T00:00:00.000Z",666581,6,"Darius Garland",2,42,47,41,11,53.7
"14423",2890,0,0,3,5,0,10,0,0,0,22,1,3,0,4,0,0,1037886,"2023-12-11T00:00:00.000Z",344,6,"Georges Niang",0,4,4,0,4,4.8
"14424",2891,0,0,1,4,0,4,0,4,1,26,3,2,1,4,0,1,1037886,"2023-12-11T00:00:00.000Z",3547247,6,"Isaac Okoro",0,5,5,1,4,4.8
"14425",2892,1,0,2,4,2,6,2,0,0,17,1,2,6,3,0,1,1037886,"2023-12-11T00:00:00.000Z",3547299,6,"Sam Merrill",0,9,10,7,4,10.1
"14426",2893,2,2,9,0,0,7,5,0,0,29,3,1,10,12,0,0,1037886,"2023-12-11T00:00:00.000Z",444,6,"Tristan Thompson",2,22,24,12,14,33.4
"14427",2894,0,0,0,0,0,0,0,0,0,0,0,0,0,0,0,0,1037886,"2023-12-11T00:00:00.000Z",248,6,"Damian Jones",0,0,0,0,0,0
"14428",2895,0,0,0,0,0,0,0,0,0,0,0,0,0,0,0,0,1037886,"2023-12-11T00:00:00.000Z",404,6,"Ricky Rubio",0,0,0,0,0,0
"14429",2896,2,0,8,6,3,8,5,1,1,27,2,1,14,10,0,2,7981426,"2023-12-08T00:00:00.000Z",219,2,"Al Horford",0,24,26,16,12,27
"14430",2897,2,0,1,3,1,4,2,0,0,18,1,2,5,2,0,0,7981426,"2023-12-08T00:00:00.000Z",3547276,2,"Payton Pritchard",0,7,9,7,4,10.4
"14431",2898,1,0,0,0,0,3,2,0,0,11,1,0,4,1,0,0,7981426,"2023-12-08T00:00:00.000Z",261,2,"Luke Kornet",0,5,6,5,2,6.7
"14432",2899,0,0,0,0,0,0,0,0,0,0,0,0,0,0,0,0,7981426,"2023-12-08T00:00:00.000Z",338,2,"Svi Mykhailiuk",0,0,0,0,0,0
"14433",2900,0,0,0,0,0,0,0,0,0,0,0,0,0,0,0,0,7981426,"2023-12-08T00:00:00.000Z",17553967,2,"Neemias Queta",0,0,0,0,0,0
"14434",2901,0,0,0,0,0,0,0,0,0,0,0,0,0,0,0,0,3277450,"2023-11-17T00:00:00.000Z",56677870,27,"Sir'Jabari Rice",0,0,0,0,0,0
"14435",2902,1,0,5,5,4,6,4,0,0,18,0,0,12,5,1,2,3277452,"2023-11-17T00:00:00.000Z",3547293,19,"Naji Marshall",1,17,18,13,6,20.5
"14436",2903,1,1,2,0,0,5,3,2,2,16,1,0,8,3,1,1,3277448,"2023-11-17T00:00:00.000Z",24,9,"Marvin Bagley III",2,11,12,9,4,18.1
"14437",2904,0,1,5,3,2,3,2,4,4,17,1,1,10,6,1,0,3277448,"2023-11-17T00:00:00.000Z",44477024,9,"Stanley Umude",2,16,16,10,6,23.2
"14438",2905,0,0,2,0,0,0,0,0,0,4,0,0,0,2,0,0,3277448,"2023-11-17T00:00:00.000Z",3547240,9,"James Wiseman",0,2,2,0,2,2.4
"14439",2906,0,0,0,0,0,0,0,0,0,0,0,0,0,0,0,0,3277448,"2023-11-17T00:00:00.000Z",38017694,9,"Jalen Duren",0,0,0,0,0,0
"14440",2907,0,0,0,0,0,0,0,0,0,0,0,0,0,0,0,0,3277448,"2023-11-17T00:00:00.000Z",17896071,9,"Isaiah Livers",0,0,0,0,0,0
"14441",2908,4,0,5,3,1,7,3,0,0,26,0,0,7,5,0,0,3277452,"2023-11-17T00:00:00.000Z",56677837,19,"Jordan Hawkins",0,12,16,11,9,19
"14442",2909,0,0,0,5,3,7,3,1,0,19,0,0,9,0,0,0,3277452,"2023-11-17T00:00:00.000Z",17896017,19,"Matt Ryan",0,9,9,9,0,9
"14443",2910,0,0,0,0,0,0,0,0,0,1,0,0,0,0,0,0,3277452,"2023-11-17T00:00:00.000Z",17896021,19,"Jeremiah Robinson-Earl",0,0,0,0,0,0
"14444",2911,0,0,0,0,0,0,0,0,0,0,0,0,0,0,0,0,3277452,"2023-11-17T00:00:00.000Z",17896097,19,"Jose Alvarado",0,0,0,0,0,0
"14445",2912,0,0,0,0,0,0,0,0,0,0,0,0,0,0,0,0,3277452,"2023-11-17T00:00:00.000Z",3547260,19,"Kira Lewis Jr.",0,0,0,0,0,0
"14446",2913,0,0,0,0,0,0,0,0,0,0,0,0,0,0,0,0,3277452,"2023-11-17T00:00:00.000Z",250,8,"DeAndre Jordan",0,0,0,0,0,0
"14447",2914,0,0,0,0,0,0,0,0,0,0,0,0,0,0,0,0,3277452,"2023-11-17T00:00:00.000Z",17896007,8,"Braxton Key",0,0,0,0,0,0
"14448",2915,0,0,0,0,0,0,0,0,0,0,0,0,0,0,0,0,3277449,"2023-11-17T00:00:00.000Z",436,28,"Garrett Temple",0,0,0,0,0,0
"14449",2916,0,0,0,0,0,0,0,0,0,0,0,0,0,0,0,0,3277449,"2023-11-17T00:00:00.000Z",56677805,28,"Javon Freeman-Liberty",0,0,0,0,0,0
"14450",2917,0,0,0,0,0,0,0,0,0,0,0,0,0,0,0,0,3277449,"2023-11-17T00:00:00.000Z",38017717,28,"Ron Harper Jr.",0,0,0,0,0,0
"14451",2918,0,0,0,0,0,0,0,0,0,0,0,0,0,0,0,0,3277449,"2023-11-17T00:00:00.000Z",38017710,28,"Christian Koloko",0,0,0,0,0,0
"14452",2919,0,0,0,0,0,0,0,0,0,0,0,0,0,0,0,0,3277449,"2023-11-17T00:00:00.000Z",56677869,28,"Markquis Nowell",0,0,0,0,0,0
"14453",2920,0,0,0,0,0,0,0,0,0,0,0,0,0,0,0,0,3277449,"2023-11-17T00:00:00.000Z",376,28,"Otto Porter Jr.",0,0,0,0,0,0
"14454",2921,0,0,0,0,0,0,0,0,0,0,0,0,0,0,0,0,3277449,"2023-11-17T00:00:00.000Z",338,2,"Svi Mykhailiuk",0,0,0,0,0,0
"14455",2922,1,0,0,0,0,2,2,0,0,8,0,1,4,0,0,1,3277450,"2023-11-17T00:00:00.000Z",306,26,"JaVale McGee",0,4,5,5,1,4.5
"14456",2923,0,0,3,3,2,4,2,0,0,15,0,2,6,3,2,2,3277450,"2023-11-17T00:00:00.000Z",17896030,26,"Chris Duarte",2,9,9,6,3,13.6
"14457",2924,0,0,0,0,0,0,0,0,0,0,0,0,0,0,0,0,3277450,"2023-11-17T00:00:00.000Z",17895990,26,"Jordan Ford",0,0,0,0,0,0
"14458",2925,0,0,0,0,0,0,0,0,0,0,0,0,0,0,0,0,3277450,"2023-11-17T00:00:00.000Z",56677845,26,"Colby Jones",0,0,0,0,0,0
"14459",2926,8,0,6,9,2,15,5,5,5,40,0,2,17,6,1,3,1037614,"2023-10-27T00:00:00.000Z",666956,5,"Coby White",1,23,31,25,14,36.2
"14460",2927,2,1,7,5,2,9,5,2,1,32,6,5,13,13,2,0,1037614,"2023-10-27T00:00:00.000Z",89,5,"Alex Caruso",3,26,28,15,15,40.6
"14461",2928,0,1,2,4,1,7,3,0,0,24,3,2,7,5,1,0,1037614,"2023-10-27T00:00:00.000Z",110,5,"Torrey Craig",2,12,12,7,5,19
"14462",2929,0,0,0,0,0,0,0,0,0,0,0,0,0,0,0,0,1037612,"2023-10-27T00:00:00.000Z",38017736,16,"Cole Swider",0,0,0,0,0,0
"14463",2930,1,0,2,6,4,7,5,0,0,23,0,1,14,2,0,3,1037615,"2023-10-27T00:00:00.000Z",359,27,"Cedi Osman",0,16,17,15,3,14.9
"14464",2931,0,0,0,0,0,0,0,0,0,0,0,0,0,0,0,0,1037615,"2023-10-27T00:00:00.000Z",38017693,27,"Blake Wesley",0,0,0,0,0,0
"14465",2932,0,0,0,0,0,0,0,0,0,0,0,0,0,0,0,0,1037615,"2023-10-27T00:00:00.000Z",56677865,27,"Charles Bediako",0,0,0,0,0,0
"14466",2933,0,0,0,0,0,0,0,0,0,0,0,0,0,0,0,0,1037615,"2023-10-27T00:00:00.000Z",56677817,27,"Sidy Cissoko",0,0,0,0,0,0
"14467",2934,0,0,0,0,0,0,0,0,0,0,0,0,0,0,0,0,1037615,"2023-10-27T00:00:00.000Z",56677870,27,"Sir'Jabari Rice",0,0,0,0,0,0
"14468",2935,2,0,2,2,1,13,7,2,2,39,0,4,17,2,1,2,1037615,"2023-10-27T00:00:00.000Z",66,11,"Dillon Brooks",1,19,21,19,4,23.4
"14469",2936,0,0,3,1,0,4,2,0,0,22,0,3,4,3,1,0,1037611,"2023-10-27T00:00:00.000Z",202,20,"Josh Hart",1,7,7,4,3,10.6
"14470",2937,6,0,6,9,1,14,4,2,2,24,0,2,11,6,1,4,1037611,"2023-10-27T00:00:00.000Z",3547269,20,"Immanuel Quickley",1,17,23,17,12,26.2
"14471",2938,1,1,1,0,0,4,3,4,2,10,1,4,8,2,1,1,1037611,"2023-10-27T00:00:00.000Z",201,20,"Isaiah Hartenstein",2,10,11,9,3,16.9
"14472",2939,0,0,5,8,2,16,5,4,1,37,4,4,13,9,1,2,1037615,"2023-10-27T00:00:00.000Z",38017684,11,"Jabari Smith Jr.",1,22,22,13,9,24.8
"14473",2940,1,1,1,5,3,10,6,2,1,20,1,2,16,2,1,2,1037611,"2023-10-27T00:00:00.000Z",131,20,"Donte DiVincenzo",2,18,19,17,3,23.9
"14474",2941,0,0,0,0,0,0,0,0,0,0,0,0,0,0,0,0,1037611,"2023-10-27T00:00:00.000Z",19,20,"Ryan Arcidiacono",0,0,0,0,0,0
"14475",2942,0,0,0,0,0,0,0,0,0,0,0,0,0,0,0,0,1037611,"2023-10-27T00:00:00.000Z",160,20,"Evan Fournier",0,0,0,0,0,0
"14476",2943,0,0,0,0,0,0,0,0,0,0,0,0,0,0,0,0,1037611,"2023-10-27T00:00:00.000Z",666675,20,"DaQuan Jeffries",0,0,0,0,0,0
"14477",2944,0,0,0,0,0,0,0,0,0,0,0,0,0,0,0,0,1037611,"2023-10-27T00:00:00.000Z",17896033,20,"Miles McBride",0,0,0,0,0,0
"14478",2945,7,1,8,3,1,18,11,6,2,41,6,6,25,14,2,6,1037615,"2023-10-27T00:00:00.000Z",17896062,11,"Alperen Sengun",3,39,46,32,21,55.3
"14479",2946,0,0,0,1,1,4,4,2,2,13,2,0,11,2,1,0,1037616,"2023-10-27T00:00:00.000Z",379,7,"Dwight Powell",1,13,13,11,2,16.4
"14480",2947,0,0,0,0,0,0,0,0,0,0,0,0,0,0,0,0,1037616,"2023-10-27T00:00:00.000Z",329,7,"Markieff Morris",0,0,0,0,0,0
"14481",2948,0,0,0,0,0,0,0,0,0,0,0,0,0,0,0,0,1037616,"2023-10-27T00:00:00.000Z",56677859,7,"Olivier-Maxence Prosper",0,0,0,0,0,0
"14482",2949,0,0,0,0,0,0,0,0,0,0,0,0,0,0,0,0,1037616,"2023-10-27T00:00:00.000Z",17896028,7,"Greg Brown III",0,0,0,0,0,0
"14483",2950,0,0,0,0,0,0,0,0,0,0,0,0,0,0,0,0,1037616,"2023-10-27T00:00:00.000Z",56677873,7,"Dexter Dennis",0,0,0,0,0,0
"14484",2951,0,0,0,0,0,0,0,0,0,0,0,0,0,0,0,0,1038002,"2023-12-26T00:00:00.000Z",3,15,"Steven Adams",0,0,0,0,0,0
"14485",2952,0,0,0,0,0,0,0,0,0,0,0,0,0,0,0,0,1038001,"2023-12-26T00:00:00.000Z",56677778,12,"Oscar Tshiebwe",0,0,0,0,0,0
"14486",2953,0,0,0,0,0,0,0,0,0,0,0,0,0,0,0,0,1038001,"2023-12-26T00:00:00.000Z",56677794,12,"Isaiah Wong",0,0,0,0,0,0
"14487",2954,7,1,4,14,5,22,9,5,4,40,0,5,27,4,0,1,1038002,"2023-12-26T00:00:00.000Z",3547287,15,"Desmond Bane",1,31,38,34,11,44.3
"14488",2955,7,2,4,7,1,24,12,8,6,40,1,2,31,5,1,6,1038002,"2023-12-26T00:00:00.000Z",666786,15,"Ja Morant",3,36,43,38,12,50.5
"14489",2956,2,0,2,4,2,6,4,0,0,20,0,0,10,2,0,1,1038000,"2023-12-26T00:00:00.000Z",87,5,"Jevon Carter",0,12,14,12,4,14.4
"14490",2957,0,0,0,0,0,0,0,0,0,0,0,0,0,0,0,0,1038000,"2023-12-26T00:00:00.000Z",110,5,"Torrey Craig",0,0,0,0,0,0
"14491",2958,0,1,2,2,0,2,0,0,0,9,0,2,0,2,0,0,1038002,"2023-12-26T00:00:00.000Z",17896067,15,"Santi Aldama",1,2,2,0,2,5.4
"14492",2959,0,0,0,0,0,0,0,0,0,0,0,0,0,0,0,0,1038002,"2023-12-26T00:00:00.000Z",48248287,15,"Jacob Gilyard",0,0,0,0,0,0
"14493",2960,0,0,0,0,0,0,0,0,0,0,0,0,0,0,0,0,1038002,"2023-12-26T00:00:00.000Z",56677830,15,"GG Jackson",0,0,0,0,0,0
"14494",2961,0,0,0,0,0,0,0,0,0,0,0,0,0,0,0,0,1038002,"2023-12-26T00:00:00.000Z",254,15,"Luke Kennard",0,0,0,0,0,0
"14495",2962,4,0,6,1,0,8,5,0,0,29,3,1,10,9,1,2,1038000,"2023-12-26T00:00:00.000Z",17896040,1,"Jalen Johnson",1,19,23,14,13,27.8
"14496",2963,1,1,2,0,0,9,5,4,3,27,3,3,13,5,0,1,1038000,"2023-12-26T00:00:00.000Z",83,1,"Clint Capela",1,18,19,14,6,22.5
"14497",2964,4,1,6,9,2,15,6,4,3,34,0,4,17,6,2,3,1038000,"2023-12-26T00:00:00.000Z",334,1,"Dejounte Murray",3,23,27,21,10,36.2
"14498",2965,13,0,2,13,3,17,6,7,6,40,0,3,21,2,1,6,1038000,"2023-12-26T00:00:00.000Z",490,1,"Trae Young",1,23,36,34,15,39.9
"14499",2966,0,0,0,1,0,1,0,0,0,1,0,0,0,0,0,1,1038000,"2023-12-26T00:00:00.000Z",56677855,1,"Seth Lundy",0,0,0,0,0,-1
"14500",2967,1,0,2,12,3,21,8,3,3,31,1,2,22,3,0,0,1038000,"2023-12-26T00:00:00.000Z",53,1,"Bogdan Bogdanovic",0,25,26,23,4,27.1
"14501",2968,1,1,0,0,0,0,0,0,0,6,0,1,0,0,0,1,1038000,"2023-12-26T00:00:00.000Z",301,1,"Wesley Matthews",1,0,1,1,1,3.5
"14502",2969,0,0,5,2,1,6,4,2,2,21,1,3,11,6,1,1,1038000,"2023-12-26T00:00:00.000Z",3547244,1,"Onyeka Okongwu",1,17,17,11,6,20.2
"14503",2970,0,0,1,2,2,2,2,0,0,13,0,3,6,1,0,0,1038000,"2023-12-26T00:00:00.000Z",666754,1,"Garrison Mathews",0,7,7,6,1,7.2
"14504",2971,0,0,0,0,0,0,0,0,0,4,0,0,0,0,0,0,1038000,"2023-12-26T00:00:00.000Z",3547297,1,"Trent Forrest",0,0,0,0,0,0
"14505",2972,0,0,0,0,0,0,0,0,0,0,0,0,0,0,0,0,1038000,"2023-12-26T00:00:00.000Z",666564,1,"Bruno Fernando",0,0,0,0,0,0
"14506",2973,0,0,0,0,0,0,0,0,0,0,0,0,0,0,0,0,1038000,"2023-12-26T00:00:00.000Z",319,1,"Patty Mills",0,0,0,0,0,0
"14507",2974,0,0,0,0,0,0,0,0,0,0,0,0,0,0,0,0,1038000,"2023-12-26T00:00:00.000Z",56677838,1,"Kobe Bufkin",0,0,0,0,0,0
"14508",2975,0,0,0,0,0,0,0,0,0,0,0,0,0,0,0,0,1038000,"2023-12-26T00:00:00.000Z",38017689,1,"AJ Griffin",0,0,0,0,0,0
"14509",2976,1,0,2,1,0,4,1,0,0,11,0,2,2,2,0,0,1037870,"2023-12-01T00:00:00.000Z",38017677,19,"Dyson Daniels",0,4,5,3,3,5.9
"14510",2977,0,0,0,2,1,3,1,0,0,15,0,1,3,0,0,1,1037870,"2023-12-01T00:00:00.000Z",56677837,19,"Jordan Hawkins",0,3,3,3,0,2
"14511",2978,1,0,2,0,0,0,0,2,2,13,1,1,2,3,0,0,1037870,"2023-12-01T00:00:00.000Z",491,19,"Cody Zeller",0,5,6,3,4,7.1
"14512",2979,0,0,4,1,1,4,3,3,3,19,2,1,10,6,0,2,1037870,"2023-12-01T00:00:00.000Z",3547293,19,"Naji Marshall",0,16,16,10,6,15.2
"14513",2980,0,0,0,0,0,0,0,0,0,0,0,0,0,0,0,0,1037870,"2023-12-01T00:00:00.000Z",3547260,19,"Kira Lewis Jr.",0,0,0,0,0,0
"14514",2981,0,0,0,0,0,0,0,0,0,0,0,0,0,0,0,0,1037870,"2023-12-01T00:00:00.000Z",38017663,19,"E.J. Liddell",0,0,0,0,0,0
"14515",2982,0,0,0,0,0,0,0,0,0,0,0,0,0,0,0,0,1037870,"2023-12-01T00:00:00.000Z",340,19,"Larry Nance Jr.",0,0,0,0,0,0
"14516",2983,0,0,0,0,0,0,0,0,0,0,0,0,0,0,0,0,1037870,"2023-12-01T00:00:00.000Z",17896021,19,"Jeremiah Robinson-Earl",0,0,0,0,0,0
"14517",2984,0,0,0,0,0,0,0,0,0,0,0,0,0,0,0,0,1037870,"2023-12-01T00:00:00.000Z",17896017,19,"Matt Ryan",0,0,0,0,0,0
"14518",2985,0,0,0,0,0,0,0,0,0,0,0,0,0,0,0,0,1037870,"2023-12-01T00:00:00.000Z",38017726,19,"Dereon Seabron",0,0,0,0,0,0
"14519",2986,3,0,4,6,3,7,4,1,1,22,1,3,12,5,0,3,1037870,"2023-12-01T00:00:00.000Z",38017649,27,"Julian Champagnie",0,17,20,15,8,19.5
"14520",2987,2,0,0,0,0,0,0,0,0,3,0,0,0,0,0,0,1037870,"2023-12-01T00:00:00.000Z",38017693,27,"Blake Wesley",0,0,2,2,2,3
"14521",2988,0,0,0,0,0,1,1,0,0,3,0,0,2,0,0,0,1037870,"2023-12-01T00:00:00.000Z",38017730,27,"Dominick Barlow",0,2,2,2,0,2
"14522",2989,0,0,0,0,0,0,0,0,0,0,0,0,0,0,0,0,1037870,"2023-12-01T00:00:00.000Z",180,27,"Devonte' Graham",0,0,0,0,0,0
"14523",2990,0,0,0,0,0,0,0,0,0,0,0,0,0,0,0,0,1037870,"2023-12-01T00:00:00.000Z",56677865,27,"Charles Bediako",0,0,0,0,0,0
"14524",2991,0,0,0,0,0,0,0,0,0,0,0,0,0,0,0,0,1037870,"2023-12-01T00:00:00.000Z",56677817,27,"Sidy Cissoko",0,0,0,0,0,0
"14525",2992,0,0,0,0,0,0,0,0,0,0,0,0,0,0,0,0,1037870,"2023-12-01T00:00:00.000Z",305,27,"Doug McDermott",0,0,0,0,0,0
"14526",2993,0,0,0,0,0,0,0,0,0,0,0,0,0,0,0,0,1037870,"2023-12-01T00:00:00.000Z",56677870,27,"Sir'Jabari Rice",0,0,0,0,0,0
"14527",2994,0,0,0,0,0,0,0,0,0,0,0,0,0,0,0,0,1037870,"2023-12-01T00:00:00.000Z",56677822,27,"Victor Wembanyama",0,0,0,0,0,0
"14528",2995,0,0,0,6,1,9,3,2,1,22,0,0,8,0,0,1,1037866,"2023-12-01T00:00:00.000Z",196,22,"Gary Harris",0,8,8,8,0,7
"14529",2996,0,0,0,0,0,0,0,0,0,0,0,0,0,0,0,0,1037867,"2023-12-01T00:00:00.000Z",2175,23,"Danuel House Jr.",0,0,0,0,0,0
"14530",2997,11,3,4,3,1,25,8,13,13,36,0,2,30,4,1,1,1037871,"2023-12-01T00:00:00.000Z",140,24,"Kevin Durant",4,34,45,41,15,62.3
"14531",2998,1,0,1,0,0,1,0,4,4,17,0,0,4,1,0,0,1037871,"2023-12-01T00:00:00.000Z",32,24,"Keita Bates-Diop",0,5,6,5,2,6.7
"14532",2999,2,1,3,6,2,22,13,5,3,33,3,6,31,6,0,6,1037871,"2023-12-01T00:00:00.000Z",349,24,"Jusuf Nurkic",1,37,39,33,8,38.2
"14533",3000,3,1,3,7,4,11,6,0,0,33,1,1,16,4,1,3,1037871,"2023-12-01T00:00:00.000Z",178,24,"Eric Gordon",2,20,23,19,7,28.3
"14534",3001,1,0,1,2,1,3,2,0,0,5,0,1,5,1,0,0,1037709,"2023-11-08T00:00:00.000Z",65,25,"Malcolm Brogdon",0,6,7,6,2,7.7
"14535",3002,11,0,2,2,0,15,8,2,2,37,0,4,18,2,2,3,1037709,"2023-11-08T00:00:00.000Z",3547289,25,"Skylar Mays",2,20,31,29,13,39.9
"14536",3003,1,0,3,0,0,2,1,0,0,25,1,3,2,4,3,1,1037709,"2023-11-08T00:00:00.000Z",56677850,25,"Toumani Camara",3,6,7,3,5,16.3
"14537",3004,1,1,1,0,0,3,2,2,0,5,2,1,4,3,0,0,1037709,"2023-11-08T00:00:00.000Z",666476,25,"Moses Brown",1,7,8,5,4,12.1
"14538",3005,1,0,2,1,0,2,1,0,0,15,0,4,2,2,0,1,1037709,"2023-11-08T00:00:00.000Z",38017711,25,"Jabari Walker",0,4,5,3,3,4.9
"14539",3006,0,1,0,0,0,1,0,0,0,9,0,1,0,0,0,0,1037709,"2023-11-08T00:00:00.000Z",56677791,25,"Kris Murray",1,0,0,0,0,3
"14540",3007,0,0,1,0,0,0,0,0,0,8,1,1,0,2,0,1,1037709,"2023-11-08T00:00:00.000Z",47957121,25,"Justin Minaya",0,2,2,0,2,1.4
"14541",3008,0,0,0,0,0,0,0,0,0,0,0,0,0,0,0,0,1037709,"2023-11-08T00:00:00.000Z",56677829,25,"Rayan Rupert",0,0,0,0,0,0
"14542",3009,0,0,0,0,0,0,0,0,0,0,0,0,0,0,0,0,1037709,"2023-11-08T00:00:00.000Z",56677747,25,"Scoot Henderson",0,0,0,0,0,0
"14543",3010,0,0,0,0,0,0,0,0,0,0,0,0,0,0,0,0,1037709,"2023-11-08T00:00:00.000Z",56783340,25,"Duop Reath",0,0,0,0,0,0
"14544",3011,0,0,0,0,0,0,0,0,0,0,0,0,0,0,0,0,1037709,"2023-11-08T00:00:00.000Z",419,25,"Anfernee Simons",0,0,0,0,0,0
"14545",3012,0,0,0,0,0,0,0,0,0,0,0,0,0,0,0,0,1037709,"2023-11-08T00:00:00.000Z",17896120,25,"Ish Wainright",0,0,0,0,0,0
"14546",3013,0,0,0,0,0,0,0,0,0,0,0,0,0,0,0,0,1037709,"2023-11-08T00:00:00.000Z",476,25,"Robert Williams III",0,0,0,0,0,0
"14547",3014,0,0,0,0,0,0,0,0,0,0,0,0,0,0,0,0,1037710,"2023-11-09T00:00:00.000Z",56677794,12,"Isaiah Wong",0,0,0,0,0,0
"14548",3015,1,0,2,0,0,1,1,0,0,12,1,2,2,3,1,2,1037701,"2023-11-08T00:00:00.000Z",137,5,"Andre Drummond",1,5,6,3,4,8.1
"14549",3016,0,0,0,0,0,2,1,0,0,11,0,0,2,0,0,0,1037708,"2023-11-08T00:00:00.000Z",38017721,8,"Peyton Watson",0,2,2,2,0,2
"14550",3017,0,0,1,1,0,1,0,0,0,8,0,2,0,1,0,0,1037708,"2023-11-08T00:00:00.000Z",56677776,8,"Julian Strawther",0,1,1,0,1,1.2
"14551",3018,2,0,2,0,0,1,0,0,0,6,0,0,0,2,0,0,1037708,"2023-11-08T00:00:00.000Z",3547268,8,"Zeke Nnaji",0,2,4,2,4,5.4
"14552",3019,0,0,0,0,0,0,0,0,0,0,0,0,0,0,0,0,1037708,"2023-11-08T00:00:00.000Z",17896007,8,"Braxton Key",0,0,0,0,0,0
"14553",3020,0,0,0,0,0,0,0,0,0,0,0,0,0,0,0,0,1037708,"2023-11-08T00:00:00.000Z",56677582,8,"Jalen Pickett",0,0,0,0,0,0
"14554",3021,0,0,0,0,0,0,0,0,0,0,0,0,0,0,0,0,1037708,"2023-11-08T00:00:00.000Z",56677871,8,"Hunter Tyson",0,0,0,0,0,0
"14555",3022,0,0,0,0,0,0,0,0,0,0,0,0,0,0,0,0,1037708,"2023-11-08T00:00:00.000Z",666489,8,"Vlatko Cancar",0,0,0,0,0,0
"14556",3023,0,0,0,0,0,0,0,0,0,0,0,0,0,0,0,0,1037708,"2023-11-08T00:00:00.000Z",17896103,8,"Jay Huff",0,0,0,0,0,0
"14557",3024,0,0,0,0,0,0,0,0,0,0,0,0,0,0,0,0,1037708,"2023-11-08T00:00:00.000Z",335,8,"Jamal Murray",0,0,0,0,0,0
"14558",3025,0,0,2,3,0,13,4,4,3,29,3,3,11,5,0,1,1037708,"2023-11-08T00:00:00.000Z",475,10,"Andrew Wiggins",0,16,16,11,5,16
"14559",3026,0,0,3,1,1,6,4,3,3,13,0,0,12,3,1,0,1038088,"2024-01-06T00:00:00.000Z",56677831,11,"Cam Whitmore",1,15,15,12,3,18.6
"14560",3027,0,0,0,0,0,0,0,0,0,0,0,0,0,0,0,0,1038088,"2024-01-06T00:00:00.000Z",296,11,"Boban Marjanovic",0,0,0,0,0,0
"14561",3028,2,1,14,2,1,25,16,21,15,39,3,4,48,17,0,2,1038088,"2024-01-06T00:00:00.000Z",15,17,"Giannis Antetokounmpo",1,65,67,50,19,72.4
"14562",3029,0,1,5,6,1,9,3,0,0,31,0,2,7,5,1,0,1038088,"2024-01-06T00:00:00.000Z",283,17,"Brook Lopez",2,12,12,7,5,19
"14563",3030,0,0,1,1,1,1,1,0,0,16,0,2,3,1,0,2,1038088,"2024-01-06T00:00:00.000Z",38,17,"Malik Beasley",0,4,4,3,1,2.2
"14564",3031,9,0,2,8,1,16,5,10,7,39,0,1,18,2,2,1,1038088,"2024-01-06T00:00:00.000Z",278,17,"Damian Lillard",2,20,29,27,11,38.9
"14565",3032,0,1,6,2,1,5,2,2,1,17,0,5,6,6,1,2,1038088,"2024-01-06T00:00:00.000Z",377,17,"Bobby Portis",2,12,12,6,6,17.2
"14566",3033,3,1,3,3,1,4,2,0,0,23,1,1,5,4,0,1,1038088,"2024-01-06T00:00:00.000Z",38017676,17,"MarJon Beauchamp",1,9,12,8,7,16.3
"14567",3034,1,0,1,5,3,5,3,0,0,19,0,0,9,1,0,0,1038088,"2024-01-06T00:00:00.000Z",105,17,"Pat Connaughton",0,10,11,10,2,11.7
"14568",3035,1,0,0,1,0,1,0,2,1,8,0,0,1,0,0,0,1038088,"2024-01-06T00:00:00.000Z",368,17,"Cameron Payne",0,1,2,2,1,2.5
"14569",3036,0,0,2,1,0,1,0,1,1,12,0,3,1,2,2,0,1038088,"2024-01-06T00:00:00.000Z",56677852,17,"Andre Jackson Jr.",2,3,3,1,2,9.4
"14570",3037,0,0,0,0,0,0,0,0,0,3,0,1,0,0,0,0,1038088,"2024-01-06T00:00:00.000Z",38017733,17,"A.J. Green",0,0,0,0,0,0
"14571",3038,0,0,0,0,0,0,0,0,0,0,0,0,0,0,0,0,1038088,"2024-01-06T00:00:00.000Z",2148,17,"Thanasis Antetokounmpo",0,0,0,0,0,0
"14572",3039,0,0,0,0,0,0,0,0,0,0,0,0,0,0,0,0,1038080,"2024-01-05T00:00:00.000Z",56677839,22,"Jett Howard",0,0,0,0,0,0
"14573",3040,0,0,0,0,0,0,0,0,0,0,0,0,0,0,0,0,1038080,"2024-01-05T00:00:00.000Z",226,22,"Joe Ingles",0,0,0,0,0,0
"14574",3041,0,0,0,0,0,0,0,0,0,0,0,0,0,0,0,0,1038080,"2024-01-05T00:00:00.000Z",229,22,"Jonathan Isaac",0,0,0,0,0,0
"14575",3042,0,0,1,3,2,8,3,0,0,32,1,0,8,2,1,0,1038083,"2024-01-05T00:00:00.000Z",666860,14,"Cameron Reddish",1,10,10,8,2,13.4
"14576",3043,7,0,3,9,4,24,11,10,6,39,2,0,32,5,5,4,1038083,"2024-01-05T00:00:00.000Z",237,14,"LeBron James",5,37,44,39,12,59.5
"14577",3044,4,2,3,3,0,22,13,7,5,41,3,4,31,6,0,4,1038083,"2024-01-05T00:00:00.000Z",117,14,"Anthony Davis",2,37,41,35,10,46.2
"14578",3045,2,1,1,7,3,9,3,2,1,35,1,3,10,2,2,1,1038083,"2024-01-05T00:00:00.000Z",383,14,"Taurean Prince",3,12,14,12,4,23.4
"14579",3046,12,0,7,3,0,14,8,4,3,40,0,4,19,7,2,1,1038083,"2024-01-05T00:00:00.000Z",17553995,14,"Austin Reaves",2,26,38,31,19,50.4
"14580",3047,1,0,4,0,0,0,0,0,0,17,1,1,0,5,1,0,1038083,"2024-01-05T00:00:00.000Z",457,14,"Jarred Vanderbilt",1,5,6,1,6,10.5
"14581",3048,0,0,3,1,0,3,1,0,0,20,0,2,2,3,1,2,1038083,"2024-01-05T00:00:00.000Z",38017697,14,"Max Christie",1,5,5,2,3,6.6
"14582",3049,0,0,5,2,1,5,3,4,4,16,0,0,11,5,1,1,1038083,"2024-01-05T00:00:00.000Z",486,14,"Christian Wood",1,16,16,11,5,19
"14583",3050,0,0,0,0,0,0,0,0,0,0,0,0,0,0,0,0,1038083,"2024-01-05T00:00:00.000Z",56677867,14,"Alex Fudge",0,0,0,0,0,0
"14584",3051,1,0,1,0,0,2,0,0,0,19,2,2,0,3,1,2,1037938,"2023-12-17T00:00:00.000Z",3547301,11,"Jae'Sean Tate",1,3,4,1,4,6.1
"14585",3052,0,0,0,0,0,0,0,0,0,0,0,0,0,0,0,0,1037938,"2023-12-17T00:00:00.000Z",75,11,"Reggie Bullock",0,0,0,0,0,0
"14586",3053,0,0,0,0,0,0,0,0,0,0,0,0,0,0,0,0,1037938,"2023-12-17T00:00:00.000Z",19465326,11,"Jock Landale",0,0,0,0,0,0
"14587",3054,0,0,0,0,0,0,0,0,0,0,0,0,0,0,0,0,1037938,"2023-12-17T00:00:00.000Z",296,11,"Boban Marjanovic",0,0,0,0,0,0
"14588",3055,0,0,0,0,0,0,0,0,0,0,0,0,0,0,0,0,1037938,"2023-12-17T00:00:00.000Z",47738533,11,"Jeenathan Williams",0,0,0,0,0,0
"14589",3056,0,0,0,0,0,0,0,0,0,0,0,0,0,0,0,0,1037938,"2023-12-17T00:00:00.000Z",3547281,11,"Nate Hinton",0,0,0,0,0,0
"14590",3057,0,0,0,0,0,0,0,0,0,0,0,0,0,0,0,0,1037938,"2023-12-17T00:00:00.000Z",357,11,"Victor Oladipo",0,0,0,0,0,0
"14591",3058,0,0,0,0,0,0,0,0,0,0,0,0,0,0,0,0,1037938,"2023-12-17T00:00:00.000Z",56677809,11,"Jermaine Samuels Jr.",0,0,0,0,0,0
"14592",3059,0,0,0,0,0,0,0,0,0,0,0,0,0,0,0,0,1037938,"2023-12-17T00:00:00.000Z",56677825,11,"Amen Thompson",0,0,0,0,0,0
"14593",3060,0,0,0,0,0,0,0,0,0,0,0,0,0,0,0,0,1037938,"2023-12-17T00:00:00.000Z",56677831,11,"Cam Whitmore",0,0,0,0,0,0
"14594",3061,1,0,5,2,1,3,2,0,0,23,2,2,5,7,0,1,1037939,"2023-12-17T00:00:00.000Z",666729,24,"Nassir Little",0,12,13,6,8,13.9
"14595",3062,5,1,2,2,0,24,11,9,6,35,3,1,28,5,1,2,1037939,"2023-12-17T00:00:00.000Z",140,24,"Kevin Durant",2,33,38,33,10,45.5
"14596",3063,5,1,14,1,0,7,2,4,2,30,3,5,6,17,1,2,1037939,"2023-12-17T00:00:00.000Z",349,24,"Jusuf Nurkic",2,23,28,11,22,37.9
"14597",3064,3,2,3,6,1,8,2,6,6,33,1,2,11,4,2,1,1037939,"2023-12-17T00:00:00.000Z",8,24,"Grayson Allen",4,15,18,14,7,31.3
"14598",3065,8,1,4,11,3,24,10,5,4,42,0,4,27,4,1,5,1037939,"2023-12-17T00:00:00.000Z",57,24,"Devin Booker",2,31,39,35,12,44.8
"14599",3066,0,0,2,3,3,4,3,4,2,22,1,2,11,3,2,1,1037940,"2023-12-17T00:00:00.000Z",56677850,25,"Toumani Camara",2,14,14,11,3,19.6
"14600",3067,6,0,6,9,3,19,11,5,5,41,1,4,30,7,1,3,1037940,"2023-12-17T00:00:00.000Z",182,25,"Jerami Grant",1,37,43,36,13,47.4
"14601",3068,1,1,5,0,0,8,4,0,0,33,3,0,8,8,0,1,1037940,"2023-12-17T00:00:00.000Z",22,25,"Deandre Ayton",1,16,17,9,9,21.1
"14602",3069,1,0,4,5,3,10,4,1,1,27,1,3,12,5,1,2,1037940,"2023-12-17T00:00:00.000Z",38017690,25,"Shaedon Sharpe",1,17,18,13,6,20.5
"14603",3070,7,0,3,5,0,20,9,6,6,35,0,3,24,3,1,4,1037940,"2023-12-17T00:00:00.000Z",419,25,"Anfernee Simons",1,27,34,31,10,37.1
"14604",3071,2,0,1,4,1,9,4,5,5,22,0,2,14,1,1,1,1037940,"2023-12-17T00:00:00.000Z",56677747,25,"Scoot Henderson",1,15,17,16,3,20.2
"14605",3072,5,0,1,5,2,8,3,0,0,27,0,1,8,1,0,0,1037940,"2023-12-17T00:00:00.000Z",65,25,"Malcolm Brogdon",0,9,14,13,6,16.7
"14606",3073,0,1,3,0,0,3,1,2,2,15,2,4,4,5,1,1,1037940,"2023-12-17T00:00:00.000Z",38017711,25,"Jabari Walker",2,9,9,4,5,15
"14607",3074,1,2,3,4,1,4,1,0,0,18,1,1,3,4,3,0,1037940,"2023-12-17T00:00:00.000Z",666923,25,"Matisse Thybulle",5,7,8,4,5,24.3
"14608",3075,0,0,0,0,0,0,0,0,0,0,0,0,0,0,0,0,1037940,"2023-12-17T00:00:00.000Z",666476,25,"Moses Brown",0,0,0,0,0,0
"14609",3076,3,1,5,3,3,6,4,2,2,24,1,0,13,6,1,3,1037827,"2023-11-25T00:00:00.000Z",358,29,"Kelly Olynyk",2,19,22,16,9,27.7
"14610",3077,0,0,0,0,0,0,0,0,0,0,0,0,0,0,0,0,1037827,"2023-11-25T00:00:00.000Z",666881,29,"Luka Samanic",0,0,0,0,0,0
"14611",3078,0,0,0,0,0,0,0,0,0,0,0,0,0,0,0,0,1037827,"2023-11-25T00:00:00.000Z",17896023,29,"Josh Christopher",0,0,0,0,0,0
"14612",3079,0,1,2,0,0,3,2,1,1,18,1,1,5,3,0,2,1037826,"2023-11-25T00:00:00.000Z",3547247,6,"Isaac Okoro",1,8,8,5,3,9.6
"14613",3080,1,0,1,1,1,7,5,0,0,17,0,2,11,1,0,1,1037826,"2023-11-25T00:00:00.000Z",56677872,6,"Craig Porter",0,12,13,12,2,12.7
"14614",3081,0,0,0,0,0,0,0,0,0,0,0,0,0,0,0,0,1037826,"2023-11-25T00:00:00.000Z",444,6,"Tristan Thompson",0,0,0,0,0,0
"14615",3082,0,0,0,0,0,0,0,0,0,0,0,0,0,0,0,0,1037826,"2023-11-25T00:00:00.000Z",56677847,6,"Emoni Bates",0,0,0,0,0,0
"14616",3083,0,0,0,0,0,0,0,0,0,0,0,0,0,0,0,0,1037826,"2023-11-25T00:00:00.000Z",666676,6,"Ty Jerome",0,0,0,0,0,0
"14617",3084,0,0,0,0,0,0,0,0,0,0,0,0,0,0,0,0,1037826,"2023-11-25T00:00:00.000Z",38017662,6,"Isaiah Mobley",0,0,0,0,0,0
"14618",3085,0,0,0,0,0,0,0,0,0,0,0,0,0,0,0,0,1037826,"2023-11-25T00:00:00.000Z",404,6,"Ricky Rubio",0,0,0,0,0,0
"14619",3086,0,0,0,0,0,0,0,0,0,0,0,0,0,0,0,0,1037826,"2023-11-25T00:00:00.000Z",666940,6,"Dean Wade",0,0,0,0,0,0
"14620",3087,10,0,4,2,1,8,4,6,6,32,1,1,15,5,2,2,1037826,"2023-11-25T00:00:00.000Z",17553995,14,"Austin Reaves",2,20,30,25,15,40
"14621",3088,0,0,2,3,2,7,5,1,1,17,1,1,13,3,0,1,1037826,"2023-11-25T00:00:00.000Z",486,14,"Christian Wood",0,16,16,13,3,15.6
"14622",3089,0,0,0,0,0,0,0,0,0,0,0,0,0,0,0,0,1037826,"2023-11-25T00:00:00.000Z",56677738,14,"Colin Castleton",0,0,0,0,0,0
"14623",3090,0,0,0,0,0,0,0,0,0,0,0,0,0,0,0,0,1037826,"2023-11-25T00:00:00.000Z",666609,14,"Rui Hachimura",0,0,0,0,0,0
"14624",3091,0,0,0,0,0,0,0,0,0,0,0,0,0,0,0,0,1037826,"2023-11-25T00:00:00.000Z",666860,14,"Cameron Reddish",0,0,0,0,0,0
"14625",3092,0,0,0,0,0,0,0,0,0,0,0,0,0,0,0,0,1037826,"2023-11-25T00:00:00.000Z",457,14,"Jarred Vanderbilt",0,0,0,0,0,0
"14626",3093,0,0,0,0,0,0,0,0,0,0,0,0,0,0,0,0,1037826,"2023-11-25T00:00:00.000Z",1603383,14,"Gabe Vincent",0,0,0,0,0,0
"14627",3094,3,2,6,5,0,12,2,4,4,29,0,1,8,6,0,2,1037828,"2023-11-25T00:00:00.000Z",274,13,"Kawhi Leonard",2,14,17,11,9,23.7
"14628",3095,4,0,8,5,2,19,9,5,5,36,1,4,25,9,0,1,1037828,"2023-11-25T00:00:00.000Z",172,13,"Paul George",0,34,38,29,13,40.8
"14629",3096,1,0,10,0,0,8,5,5,1,23,4,1,11,14,0,1,1037828,"2023-11-25T00:00:00.000Z",493,13,"Ivica Zubac",0,25,26,12,15,28.3
"14630",3097,1,1,1,4,0,14,7,4,3,32,2,0,17,3,0,0,1037828,"2023-11-25T00:00:00.000Z",666743,13,"Terance Mann",1,20,21,18,4,25.1
"14631",3098,7,2,4,6,2,8,2,2,2,28,0,1,8,4,1,2,1037828,"2023-11-25T00:00:00.000Z",192,13,"James Harden",3,12,19,15,11,30.3
"14632",3099,7,0,4,1,0,9,6,3,2,25,4,2,14,8,0,2,1037828,"2023-11-25T00:00:00.000Z",472,13,"Russell Westbrook",0,22,29,21,15,32.1
"14633",3100,1,0,3,3,3,4,4,4,4,24,0,2,15,3,0,1,1037828,"2023-11-25T00:00:00.000Z",380,13,"Norman Powell",0,18,19,16,4,19.1
"14634",3101,8,2,3,8,2,22,10,5,4,33,0,1,26,3,3,3,1037705,"2023-11-08T00:00:00.000Z",3547238,18,"Anthony Edwards",5,29,37,34,11,53.6
"14635",3102,8,0,7,4,1,9,4,2,0,33,0,4,9,7,0,3,1037700,"2023-11-08T00:00:00.000Z",666682,27,"Keldon Johnson",0,16,24,17,15,26.4
"14636",3103,0,0,3,4,1,8,4,0,0,22,1,2,9,4,1,0,1037705,"2023-11-08T00:00:00.000Z",667378,18,"Naz Reid",1,13,13,9,4,16.8
"14637",3104,1,0,4,5,1,9,4,1,1,19,0,1,10,4,2,2,1037705,"2023-11-08T00:00:00.000Z",320,18,"Shake Milton",2,14,15,11,5,20.3
"14638",3105,0,0,0,1,0,5,2,0,0,5,1,0,4,1,0,0,1037705,"2023-11-08T00:00:00.000Z",68,18,"Troy Brown Jr.",0,5,5,4,1,5.2
"14639",3106,0,0,1,0,0,4,2,2,1,5,1,3,5,2,0,0,1037705,"2023-11-08T00:00:00.000Z",17896056,18,"Luka Garza",0,7,7,5,2,7.4
"14640",3107,0,0,0,1,0,1,0,0,0,3,0,2,0,0,0,0,1037705,"2023-11-08T00:00:00.000Z",38017715,18,"Josh Minott",0,0,0,0,0,0
"14641",3108,0,0,0,0,0,0,0,0,0,3,0,0,0,0,0,0,1037705,"2023-11-08T00:00:00.000Z",17895968,18,"Daishen Nix",0,0,0,0,0,0
"14642",3109,0,0,0,0,0,0,0,0,0,0,0,0,0,0,0,0,1037705,"2023-11-08T00:00:00.000Z",56677851,18,"Jaylen Clark",0,0,0,0,0,0
"14643",3110,0,0,0,0,0,0,0,0,0,0,0,0,0,0,0,0,1037701,"2023-11-08T00:00:00.000Z",17896116,5,"Terry Taylor",0,0,0,0,0,0
"14644",3111,0,0,0,0,0,0,0,0,0,0,0,0,0,0,0,0,1037701,"2023-11-08T00:00:00.000Z",38017719,5,"Dalen Terry",0,0,0,0,0,0
"14645",3112,0,0,1,5,0,9,1,0,0,21,1,2,2,2,2,1,1037703,"2023-11-08T00:00:00.000Z",17896027,15,"Ziaire Williams",2,4,4,2,2,9.4
"14646",3113,2,1,2,8,2,18,9,10,8,33,2,5,28,4,0,1,1037703,"2023-11-08T00:00:00.000Z",231,15,"Jaren Jackson Jr.",1,32,34,30,6,37.8
"14647",3114,0,0,4,0,0,4,4,2,1,30,6,4,9,10,1,1,1037703,"2023-11-08T00:00:00.000Z",48,15,"Bismack Biyombo",1,19,19,9,10,23
"14648",3115,3,2,5,8,2,16,4,6,5,36,0,3,15,5,1,1,1037703,"2023-11-08T00:00:00.000Z",3547287,15,"Desmond Bane",3,20,23,18,8,33.5
"14649",3116,7,0,4,3,0,14,4,4,3,32,0,4,11,4,2,3,1037703,"2023-11-08T00:00:00.000Z",420,15,"Marcus Smart",2,15,22,18,11,29.3
"14650",3117,0,1,6,4,2,14,5,2,0,26,2,4,12,8,2,1,1037703,"2023-11-08T00:00:00.000Z",17896067,15,"Santi Aldama",3,20,20,12,8,29.6
"14651",3118,3,0,2,6,3,7,4,2,2,27,0,1,13,2,1,3,1037703,"2023-11-08T00:00:00.000Z",254,15,"Luke Kennard",1,15,18,16,5,19.9
"14652",3119,1,0,0,0,0,3,1,0,0,7,0,1,2,0,0,0,1037703,"2023-11-08T00:00:00.000Z",38017732,15,"Kenneth Lofton Jr.",0,2,3,3,1,3.5
"14653",3120,4,0,0,3,2,3,2,0,0,15,0,1,6,0,0,0,1037703,"2023-11-08T00:00:00.000Z",48248287,15,"Jacob Gilyard",0,6,10,10,4,12
"14654",3121,0,0,0,0,0,0,0,0,0,0,0,0,0,0,0,0,1037703,"2023-11-08T00:00:00.000Z",56677830,15,"GG Jackson",0,0,0,0,0,0
"14655",3122,0,0,0,0,0,0,0,0,0,0,0,0,0,0,0,0,1037703,"2023-11-08T00:00:00.000Z",38017728,15,"Jake LaRavia",0,0,0,0,0,0
"14656",3123,0,1,1,7,3,16,8,2,2,28,0,0,21,1,1,0,1037699,"2023-11-08T00:00:00.000Z",464,3,"Lonnie Walker IV",2,22,22,21,1,28.2
"14657",3124,2,0,3,2,1,6,3,2,2,19,2,2,9,5,3,4,1037699,"2023-11-08T00:00:00.000Z",17896058,3,"Trendon Watford",3,14,16,11,7,23
"14658",3125,0,0,0,0,0,0,0,0,0,0,0,0,0,0,0,0,1037699,"2023-11-08T00:00:00.000Z",56677722,3,"Jalen Wilson",0,0,0,0,0,0
"14659",3126,0,0,0,0,0,0,0,0,0,0,0,0,0,0,0,0,1038087,"2024-01-06T00:00:00.000Z",2175,23,"Danuel House Jr.",0,0,0,0,0,0
"14660",3127,0,0,0,0,0,0,0,0,0,0,0,0,0,0,0,0,1038087,"2024-01-06T00:00:00.000Z",56677788,23,"Terquavion Smith",0,0,0,0,0,0
"14661",3128,0,0,0,0,0,0,0,0,0,0,0,0,0,0,0,0,1038087,"2024-01-06T00:00:00.000Z",200,23,"Tobias Harris",0,0,0,0,0,0
"14662",3129,0,0,0,0,0,0,0,0,0,0,0,0,0,0,0,0,1038087,"2024-01-06T00:00:00.000Z",260,23,"Furkan Korkmaz",0,0,0,0,0,0
"14663",3130,0,0,0,0,0,0,0,0,0,0,0,0,0,0,0,0,1038087,"2024-01-06T00:00:00.000Z",38017732,23,"Kenneth Lofton Jr.",0,0,0,0,0,0
"14664",3131,0,0,0,0,0,0,0,0,0,0,0,0,0,0,0,0,1038061,"2024-01-03T00:00:00.000Z",357,11,"Victor Oladipo",0,0,0,0,0,0
"14665",3132,0,0,0,0,0,0,0,0,0,0,0,0,0,0,0,0,1038061,"2024-01-03T00:00:00.000Z",56677809,11,"Jermaine Samuels Jr.",0,0,0,0,0,0
"14666",3133,0,0,0,0,0,0,0,0,0,0,0,0,0,0,0,0,1038061,"2024-01-03T00:00:00.000Z",47738533,11,"Jeenathan Williams",0,0,0,0,0,0
"14667",3134,5,1,6,6,3,13,6,2,0,32,0,0,15,6,0,0,1038061,"2024-01-03T00:00:00.000Z",666679,3,"Cameron Johnson",1,21,26,20,11,32.7
"14668",3135,2,1,1,11,1,16,4,0,0,20,1,2,9,2,0,2,1038061,"2024-01-03T00:00:00.000Z",158,3,"Dorian Finney-Smith",1,11,13,11,4,15.4
"14669",3136,0,2,8,0,0,8,6,0,0,28,5,5,12,13,1,1,1038061,"2024-01-03T00:00:00.000Z",666508,3,"Nicolas Claxton",3,25,25,12,13,35.6
"14670",3137,3,1,4,12,3,18,5,3,2,36,0,1,15,4,1,1,1038061,"2024-01-03T00:00:00.000Z",61,3,"Mikal Bridges",2,19,22,18,7,29.3
"14671",3138,5,0,1,3,2,5,3,5,3,28,0,1,11,1,2,1,1038061,"2024-01-03T00:00:00.000Z",130,3,"Spencer Dinwiddie",2,12,17,16,6,24.7
"14672",3139,3,0,3,8,2,13,5,2,1,30,1,3,13,4,2,1,1038061,"2024-01-03T00:00:00.000Z",351,3,"Royce O'Neale",2,17,20,16,7,27.3
"14673",3140,1,1,8,0,0,7,4,6,3,20,4,5,11,12,1,1,1038061,"2024-01-03T00:00:00.000Z",17896038,3,"Day'Ron Sharpe",2,23,24,12,13,31.9
"14674",3141,0,0,0,0,0,0,0,0,0,5,0,0,0,0,1,0,1038061,"2024-01-03T00:00:00.000Z",56677722,3,"Jalen Wilson",1,0,0,0,0,3
"14675",3142,5,0,0,2,0,7,0,4,4,18,0,1,4,0,1,1,1038061,"2024-01-03T00:00:00.000Z",17896048,3,"Cam Thomas",1,4,9,9,5,13.5
"14676",3143,1,0,4,2,2,6,3,4,3,20,4,1,11,8,1,0,1038061,"2024-01-03T00:00:00.000Z",17896058,3,"Trendon Watford",1,19,20,12,9,25.1
"14677",3144,0,0,1,0,0,0,0,0,0,3,0,0,0,1,0,0,1038061,"2024-01-03T00:00:00.000Z",9051997,3,"Armoni Brooks",0,1,1,0,1,1.2
"14678",3145,0,0,0,0,0,0,0,0,0,0,0,0,0,0,0,0,1038061,"2024-01-03T00:00:00.000Z",174,3,"Harry Giles III",0,0,0,0,0,0
"14679",3146,0,0,0,0,0,0,0,0,0,0,0,0,0,0,0,0,1038061,"2024-01-03T00:00:00.000Z",421,3,"Dennis Smith Jr.",0,0,0,0,0,0
"14680",3147,0,0,0,0,0,0,0,0,0,0,0,0,0,0,0,0,1038061,"2024-01-03T00:00:00.000Z",56677843,3,"Noah Clowney",0,0,0,0,0,0
"14681",3148,0,0,0,0,0,0,0,0,0,0,0,0,0,0,0,0,1038061,"2024-01-03T00:00:00.000Z",17896041,3,"Keon Johnson",0,0,0,0,0,0
"14682",3149,0,0,0,0,0,0,0,0,0,0,0,0,0,0,0,0,1038061,"2024-01-03T00:00:00.000Z",417,3,"Ben Simmons",0,0,0,0,0,0
"14683",3150,0,0,0,0,0,0,0,0,0,0,0,0,0,0,0,0,1038061,"2024-01-03T00:00:00.000Z",464,3,"Lonnie Walker IV",0,0,0,0,0,0
"14684",3151,0,0,1,3,1,4,2,3,3,16,2,2,8,3,0,0,1037936,"2023-12-17T00:00:00.000Z",38017724,22,"Caleb Houstan",0,11,11,8,3,11.6
"14685",3152,3,0,2,7,3,13,5,1,0,30,0,2,13,2,0,1,1037937,"2023-12-17T00:00:00.000Z",3547246,27,"Devin Vassell",0,15,18,16,5,18.9
"14686",3153,3,0,4,4,0,18,6,2,1,31,4,2,13,8,4,5,1037937,"2023-12-17T00:00:00.000Z",666682,27,"Keldon Johnson",4,21,24,16,11,34.1
"14687",3154,4,4,12,6,2,13,6,4,3,31,1,2,17,13,1,3,1037937,"2023-12-17T00:00:00.000Z",56677822,27,"Victor Wembanyama",5,30,34,21,17,50.6
"14688",3155,2,0,2,3,1,8,4,2,2,30,0,1,11,2,0,2,1037937,"2023-12-17T00:00:00.000Z",38017692,27,"Malaki Branham",0,13,15,13,4,14.4
"14689",3156,4,0,2,0,0,7,1,4,3,25,1,1,5,3,1,0,1037937,"2023-12-17T00:00:00.000Z",38017699,27,"Jeremy Sochan",1,8,12,9,7,17.6
"14690",3157,2,0,4,1,0,3,1,0,0,16,1,2,2,5,0,0,1037937,"2023-12-17T00:00:00.000Z",102,27,"Zach Collins",0,7,9,4,7,11
"14691",3158,1,2,0,6,5,6,5,0,0,14,1,0,15,1,0,0,1037937,"2023-12-17T00:00:00.000Z",38017649,27,"Julian Champagnie",2,16,17,16,2,23.7
"14692",3159,2,0,0,3,2,3,2,2,1,7,0,1,7,0,0,0,1037937,"2023-12-17T00:00:00.000Z",180,27,"Devonte' Graham",0,7,9,9,2,10
"14693",3160,0,0,2,2,1,3,1,4,3,12,0,3,6,2,0,0,1037936,"2023-12-17T00:00:00.000Z",462,22,"Moritz Wagner",0,8,8,6,2,8.4
"14694",3161,1,0,0,0,0,0,0,0,0,2,0,0,0,0,0,0,1037936,"2023-12-17T00:00:00.000Z",666885,22,"Admiral Schofield",0,0,1,1,1,1.5
"14695",3162,0,0,0,0,0,0,0,0,0,0,0,0,0,0,0,0,1037936,"2023-12-17T00:00:00.000Z",85,22,"Wendell Carter Jr.",0,0,0,0,0,0
"14696",3163,0,0,0,0,0,0,0,0,0,0,0,0,0,0,0,0,1037936,"2023-12-17T00:00:00.000Z",165,22,"Markelle Fultz",0,0,0,0,0,0
"14697",3164,0,0,0,0,0,0,0,0,0,0,0,0,0,0,0,0,1037936,"2023-12-17T00:00:00.000Z",38017607,22,"Kevon Harris",0,0,0,0,0,0
"14698",3165,0,0,0,0,0,0,0,0,0,0,0,0,0,0,0,0,1037936,"2023-12-17T00:00:00.000Z",17553983,22,"Trevelin Queen",0,0,0,0,0,0
"14699",3166,0,0,3,2,1,7,5,4,3,17,0,2,14,3,0,1,1037937,"2023-12-17T00:00:00.000Z",359,27,"Cedi Osman",0,17,17,14,3,16.6
"14700",3167,5,0,0,2,0,5,2,0,0,16,0,1,4,0,0,0,1037937,"2023-12-17T00:00:00.000Z",3547274,27,"Tre Jones",0,4,9,9,5,11.5
"14701",3168,1,0,1,5,1,7,2,2,2,15,1,1,7,2,0,0,1037937,"2023-12-17T00:00:00.000Z",305,27,"Doug McDermott",0,9,10,8,3,10.9
"14702",3169,2,0,0,3,0,4,1,0,0,8,0,0,2,0,0,1,1037937,"2023-12-17T00:00:00.000Z",17896059,27,"Sandro Mamukelashvili",0,2,4,4,2,4
"14703",3170,0,0,0,0,0,0,0,0,0,0,0,0,0,0,0,0,1037937,"2023-12-17T00:00:00.000Z",38017730,27,"Dominick Barlow",0,0,0,0,0,0
"14704",3171,0,0,0,0,0,0,0,0,0,0,0,0,0,0,0,0,1037937,"2023-12-17T00:00:00.000Z",17895854,27,"Charles Bassey",0,0,0,0,0,0
"14705",3172,0,0,0,0,0,0,0,0,0,0,0,0,0,0,0,0,1037937,"2023-12-17T00:00:00.000Z",56677865,27,"Charles Bediako",0,0,0,0,0,0
"14706",3173,0,0,0,0,0,0,0,0,0,0,0,0,0,0,0,0,1037937,"2023-12-17T00:00:00.000Z",56677817,27,"Sidy Cissoko",0,0,0,0,0,0
"14707",3174,0,0,0,0,0,0,0,0,0,0,0,0,0,0,0,0,1037937,"2023-12-17T00:00:00.000Z",17896049,27,"David Duke Jr.",0,0,0,0,0,0
"14708",3175,0,0,0,0,0,0,0,0,0,0,0,0,0,0,0,0,1037937,"2023-12-17T00:00:00.000Z",38017693,27,"Blake Wesley",0,0,0,0,0,0
"14709",3176,0,0,0,0,0,0,0,0,0,0,0,0,0,0,0,0,1037840,"2023-11-27T00:00:00.000Z",3547260,19,"Kira Lewis Jr.",0,0,0,0,0,0
"14710",3177,0,1,2,1,0,3,2,2,1,30,1,2,5,3,0,1,1037841,"2023-11-27T00:00:00.000Z",666743,13,"Terance Mann",1,8,8,5,3,10.6
"14711",3178,4,0,2,5,3,7,3,2,2,36,0,3,11,2,1,3,1037841,"2023-11-27T00:00:00.000Z",192,13,"James Harden",1,13,17,15,6,19.4
"14712",3179,3,1,10,0,0,9,5,6,4,27,1,4,14,11,0,2,1037841,"2023-11-27T00:00:00.000Z",472,13,"Russell Westbrook",1,25,28,17,14,32.7
"14713",3180,1,2,0,0,0,4,2,0,0,12,1,3,4,1,0,1,1037841,"2023-11-27T00:00:00.000Z",439,13,"Daniel Theis",2,5,6,5,2,11.7
"14714",3181,1,1,1,5,1,8,2,5,5,21,1,3,10,2,1,0,1037841,"2023-11-27T00:00:00.000Z",380,13,"Norman Powell",2,12,13,11,3,19.9
"14715",3182,1,0,0,0,0,0,0,0,0,6,0,1,0,0,2,0,1037841,"2023-11-27T00:00:00.000Z",450,13,"PJ Tucker",2,0,1,1,1,7.5
"14716",3183,0,0,0,0,0,0,0,0,0,0,0,0,0,0,0,0,1037841,"2023-11-27T00:00:00.000Z",56677849,13,"Kobe Brown",0,0,0,0,0,0
"14717",3184,0,0,0,0,0,0,0,0,0,0,0,0,0,0,0,0,1037841,"2023-11-27T00:00:00.000Z",666511,13,"Amir Coffey",0,0,0,0,0,0
"14718",3185,0,0,0,0,0,0,0,0,0,0,0,0,0,0,0,0,1037841,"2023-11-27T00:00:00.000Z",38017725,13,"Moussa Diabate",0,0,0,0,0,0
"14719",3186,0,0,0,0,0,0,0,0,0,0,0,0,0,0,0,0,1037841,"2023-11-27T00:00:00.000Z",17896031,13,"Nah'Shon Hyland",0,0,0,0,0,0
"14720",3187,0,0,0,0,0,0,0,0,0,0,0,0,0,0,0,0,1037841,"2023-11-27T00:00:00.000Z",56677856,13,"Jordan Miller",0,0,0,0,0,0
"14721",3188,0,0,0,0,0,0,0,0,0,0,0,0,0,0,0,0,1037841,"2023-11-27T00:00:00.000Z",24417679,13,"Xavier Moon",0,0,0,0,0,0
"14722",3189,0,0,0,0,0,0,0,0,0,0,0,0,0,0,0,0,1037841,"2023-11-27T00:00:00.000Z",17896022,13,"Brandon Boston Jr.",0,0,0,0,0,0
"14723",3190,0,0,0,0,0,0,0,0,0,0,0,0,0,0,0,0,1037841,"2023-11-27T00:00:00.000Z",371,13,"Mason Plumlee",0,0,0,0,0,0
"14724",3191,0,0,0,0,0,0,0,0,0,0,0,0,0,0,0,0,1037841,"2023-11-27T00:00:00.000Z",17896051,13,"Joshua Primo",0,0,0,0,0,0
"14725",3192,3,0,7,7,2,13,3,0,0,29,3,5,8,10,0,1,1037841,"2023-11-27T00:00:00.000Z",375,8,"Michael Porter Jr.",0,18,21,11,13,23.5
"14726",3193,1,0,5,4,2,8,5,0,0,34,1,2,12,6,1,3,1037841,"2023-11-27T00:00:00.000Z",215,8,"Justin Holiday",1,18,19,13,7,20.7
"14727",3194,5,1,10,0,0,11,8,11,5,33,3,3,21,13,2,2,1037841,"2023-11-27T00:00:00.000Z",250,8,"DeAndre Jordan",3,34,39,26,18,51.1
"14728",3195,2,0,1,1,0,14,3,6,6,38,2,2,12,3,1,0,1037841,"2023-11-27T00:00:00.000Z",81,8,"Kentavious Caldwell-Pope",1,15,17,14,5,21.6
"14729",3196,13,0,4,4,3,19,15,4,2,40,1,3,35,5,2,2,1037841,"2023-11-27T00:00:00.000Z",236,8,"Reggie Jackson",2,40,53,48,18,64.5
"14730",3197,1,1,3,0,0,7,4,2,0,23,0,0,8,3,2,1,1037841,"2023-11-27T00:00:00.000Z",38017721,8,"Peyton Watson",3,11,12,9,4,21.1
"14731",3198,0,3,0,0,0,8,3,5,2,11,7,2,8,7,0,1,1037841,"2023-11-27T00:00:00.000Z",3547268,8,"Zeke Nnaji",3,15,15,8,7,24.4
"14732",3199,2,0,1,1,0,4,0,0,0,12,1,4,0,2,0,0,1037841,"2023-11-27T00:00:00.000Z",38017709,8,"Christian Braun",0,2,4,2,4,5.4
"14733",3200,1,1,3,5,3,8,3,0,0,19,0,1,9,3,0,1,1037841,"2023-11-27T00:00:00.000Z",56677776,8,"Julian Strawther",1,12,13,10,4,16.1
"14734",3201,0,0,0,0,0,0,0,0,0,0,0,0,0,0,0,0,1037682,"2023-11-05T00:00:00.000Z",217,7,"Richaun Holmes",0,0,0,0,0,0
"14735",3202,0,0,0,0,0,0,0,0,0,0,0,0,0,0,0,0,1037682,"2023-11-05T00:00:00.000Z",329,7,"Markieff Morris",0,0,0,0,0,0
"14736",3203,0,0,0,0,0,0,0,0,0,0,0,0,0,0,0,0,1037682,"2023-11-05T00:00:00.000Z",56677859,7,"Olivier-Maxence Prosper",0,0,0,0,0,0
"14737",3204,0,0,0,0,0,0,0,0,0,0,0,0,0,0,0,0,1037682,"2023-11-05T00:00:00.000Z",17896028,7,"Greg Brown III",0,0,0,0,0,0
"14738",3205,0,0,0,0,0,0,0,0,0,0,0,0,0,0,0,0,1037682,"2023-11-05T00:00:00.000Z",56677873,7,"Dexter Dennis",0,0,0,0,0,0
"14739",3206,0,0,0,0,0,0,0,0,0,0,0,0,0,0,0,0,1037682,"2023-11-05T00:00:00.000Z",257,7,"Maxi Kleber",0,0,0,0,0,0
"14740",3207,0,0,0,0,0,0,0,0,0,0,0,0,0,0,0,0,1037682,"2023-11-05T00:00:00.000Z",17554004,7,"AJ Lawson",0,0,0,0,0,0
"14741",3208,8,0,2,4,1,23,9,4,1,34,2,2,20,4,1,1,1037682,"2023-11-05T00:00:00.000Z",204,4,"Gordon Hayward",1,24,32,28,12,38.8
"14742",3209,1,0,4,4,1,15,8,4,3,34,0,3,20,4,0,0,1037682,"2023-11-05T00:00:00.000Z",666950,4,"P.J. Washington",0,24,25,21,5,26.3
"14743",3210,1,0,8,0,0,8,8,6,3,27,2,3,19,10,0,2,1037682,"2023-11-05T00:00:00.000Z",38017698,4,"Mark Williams",0,29,30,20,11,30.5
"14744",3211,1,0,1,5,0,12,3,2,1,36,0,3,7,1,1,0,1037682,"2023-11-05T00:00:00.000Z",56677823,4,"Brandon Miller",1,8,9,8,2,12.7
"14745",3212,13,1,8,10,5,23,11,3,3,39,2,6,30,10,1,3,1037682,"2023-11-05T00:00:00.000Z",3547239,4,"LaMelo Ball",2,40,53,43,23,64.5
"14746",3213,4,0,0,6,1,9,4,0,0,21,0,1,9,0,0,1,1037682,"2023-11-05T00:00:00.000Z",3547253,4,"Theo Maledon",0,9,13,13,4,14
"14747",3214,0,0,0,0,0,0,0,0,0,0,0,0,0,0,0,0,1037682,"2023-11-05T00:00:00.000Z",56677848,4,"Amari Bailey",0,0,0,0,0,0
"14748",3215,0,0,0,0,0,0,0,0,0,0,0,0,0,0,0,0,1037682,"2023-11-05T00:00:00.000Z",56677866,4,"Leaky Black",0,0,0,0,0,0
"14749",3216,0,0,1,0,0,3,2,1,1,11,2,4,5,3,0,1,1037683,"2023-11-05T00:00:00.000Z",476,25,"Robert Williams III",0,8,8,5,3,7.6
"14750",3217,1,1,2,5,0,9,2,1,1,16,3,2,5,5,3,0,1037683,"2023-11-05T00:00:00.000Z",38017711,25,"Jabari Walker",4,10,11,6,6,24.5
"14751",3218,0,0,0,0,0,0,0,0,0,0,0,0,0,0,0,0,1037683,"2023-11-05T00:00:00.000Z",56677791,25,"Kris Murray",0,0,0,0,0,0
"14752",3219,0,0,0,0,0,0,0,0,0,0,0,0,0,0,0,0,1037683,"2023-11-05T00:00:00.000Z",56677829,25,"Rayan Rupert",0,0,0,0,0,0
"14753",3220,0,0,0,0,0,0,0,0,0,0,0,0,0,0,0,0,1037683,"2023-11-05T00:00:00.000Z",56677747,25,"Scoot Henderson",0,0,0,0,0,0
"14754",3221,0,0,0,0,0,0,0,0,0,0,0,0,0,0,0,0,1037683,"2023-11-05T00:00:00.000Z",56783340,25,"Duop Reath",0,0,0,0,0,0
"14755",3222,0,0,0,0,0,0,0,0,0,0,0,0,0,0,0,0,1037683,"2023-11-05T00:00:00.000Z",419,25,"Anfernee Simons",0,0,0,0,0,0
"14756",3223,0,0,0,0,0,0,0,0,0,0,0,0,0,0,0,0,1037683,"2023-11-05T00:00:00.000Z",17896120,25,"Ish Wainright",0,0,0,0,0,0
"14757",3224,1,1,6,2,1,4,2,2,1,28,1,2,6,7,0,2,1037683,"2023-11-05T00:00:00.000Z",17896027,15,"Ziaire Williams",1,13,14,7,8,16.9
"14758",3225,2,1,4,4,1,18,11,6,4,37,3,1,27,7,1,2,1037683,"2023-11-05T00:00:00.000Z",231,15,"Jaren Jackson Jr.",2,34,36,29,9,42.4
"14759",3226,0,0,0,0,0,0,0,0,0,0,0,0,0,0,0,0,1038085,"2024-01-06T00:00:00.000Z",38017507,12,"Andrew Nembhard",0,0,0,0,0,0
"14760",3227,0,0,0,0,0,0,0,0,0,0,0,0,0,0,0,0,1038085,"2024-01-06T00:00:00.000Z",56677794,12,"Isaiah Wong",0,0,0,0,0,0
"14761",3228,0,0,4,9,2,12,5,2,2,28,1,2,14,5,0,2,1038067,"2024-01-03T00:00:00.000Z",38017697,14,"Max Christie",0,19,19,14,5,18
"14762",3229,0,0,0,0,0,0,0,0,0,0,0,0,0,0,0,0,1038067,"2024-01-03T00:00:00.000Z",666609,14,"Rui Hachimura",0,0,0,0,0,0
"14763",3230,0,0,0,1,0,1,0,0,0,1,0,0,0,0,0,0,1038067,"2024-01-03T00:00:00.000Z",38017736,16,"Cole Swider",0,0,0,0,0,0
"14764",3231,0,0,0,0,0,0,0,0,0,0,0,0,0,0,0,0,1038067,"2024-01-03T00:00:00.000Z",79,16,"Jimmy Butler",0,0,0,0,0,0
"14765",3232,0,0,0,0,0,0,0,0,0,0,0,0,0,0,0,0,1038067,"2024-01-03T00:00:00.000Z",3092,16,"Haywood Highsmith",0,0,0,0,0,0
"14766",3233,0,0,0,0,0,0,0,0,0,0,0,0,0,0,0,0,1038067,"2024-01-03T00:00:00.000Z",666747,16,"Caleb Martin",0,0,0,0,0,0
"14767",3234,0,0,0,0,0,0,0,0,0,0,0,0,0,0,0,0,1038067,"2024-01-03T00:00:00.000Z",19465585,16,"Dru Smith",0,0,0,0,0,0
"14768",3235,5,1,3,8,5,18,8,6,5,33,0,3,26,3,0,1,1038062,"2024-01-03T00:00:00.000Z",3547269,28,"Immanuel Quickley",1,29,34,31,8,39.1
"14769",3236,1,0,1,4,2,8,5,0,0,23,2,1,12,3,2,0,1038065,"2024-01-03T00:00:00.000Z",666743,13,"Terance Mann",2,15,16,13,4,23.1
"14770",3237,11,1,5,7,4,13,7,4,4,36,0,2,22,5,0,4,1038065,"2024-01-03T00:00:00.000Z",192,13,"James Harden",1,27,38,33,16,43.5
"14771",3238,9,1,3,13,7,20,12,8,6,46,0,5,37,3,2,3,1038068,"2024-01-03T00:00:00.000Z",324,26,"Malik Monk",3,40,49,46,12,60.1
"14772",3239,0,0,0,0,0,0,0,0,0,1,0,0,0,0,0,0,1038068,"2024-01-03T00:00:00.000Z",666925,26,"Juan Toscano-Anderson",0,0,0,0,0,0
"14773",3240,0,0,0,0,0,0,0,0,0,0,0,0,0,0,0,0,1038068,"2024-01-03T00:00:00.000Z",4197162,26,"Aleksandar Vezenkov",0,0,0,0,0,0
"14774",3241,0,0,0,0,0,0,0,0,0,0,0,0,0,0,0,0,1038068,"2024-01-03T00:00:00.000Z",17895990,26,"Jordan Ford",0,0,0,0,0,0
"14775",3242,0,0,0,0,0,0,0,0,0,0,0,0,0,0,0,0,1038068,"2024-01-03T00:00:00.000Z",56677845,26,"Colby Jones",0,0,0,0,0,0
"14776",3243,0,0,0,0,0,0,0,0,0,0,0,0,0,0,0,0,1038068,"2024-01-03T00:00:00.000Z",56677862,26,"Jalen Slawson",0,0,0,0,0,0
"14777",3244,1,0,2,1,1,4,2,1,1,5,0,0,6,2,0,0,1038068,"2024-01-03T00:00:00.000Z",17896026,22,"Franz Wagner",0,8,9,7,3,9.9
"14778",3245,5,0,3,9,6,25,13,14,11,45,1,4,43,4,0,8,1038068,"2024-01-03T00:00:00.000Z",38017683,22,"Paolo Banchero",0,47,52,48,9,47.3
"14779",3246,2,3,5,1,0,5,2,2,2,28,1,3,6,6,1,1,1038068,"2024-01-03T00:00:00.000Z",666442,22,"Goga Bitadze",4,12,14,8,8,27.2
"14780",3247,1,0,1,3,1,4,2,1,0,12,0,2,5,1,1,1,1038068,"2024-01-03T00:00:00.000Z",196,22,"Gary Harris",1,6,7,6,2,9.7
"14781",3248,1,0,0,1,0,1,0,0,0,19,0,2,0,0,0,4,1038067,"2024-01-03T00:00:00.000Z",666860,14,"Cameron Reddish",0,0,1,1,1,-2.5
"14782",3249,9,0,6,6,0,18,6,0,0,38,0,2,12,6,0,2,1038067,"2024-01-03T00:00:00.000Z",237,14,"LeBron James",0,18,27,21,15,30.7
"14783",3250,6,5,14,1,0,17,10,10,9,43,3,2,29,17,3,5,1038067,"2024-01-03T00:00:00.000Z",117,14,"Anthony Davis",8,46,52,35,23,77.4
"14784",3251,0,0,0,0,0,0,0,0,0,0,0,0,0,0,0,0,1037915,"2023-12-14T00:00:00.000Z",47957121,25,"Justin Minaya",0,0,0,0,0,0
"14785",3252,0,0,0,0,0,0,0,0,0,3,0,0,0,0,0,0,1037920,"2023-12-15T00:00:00.000Z",3547302,30,"Anthony Gill",0,0,0,0,0,0
"14786",3253,0,0,0,0,0,0,0,0,0,0,0,0,0,0,0,0,1037920,"2023-12-15T00:00:00.000Z",414,30,"Landry Shamet",0,0,0,0,0,0
"14787",3255,0,0,0,0,0,0,0,0,0,0,0,0,0,0,0,0,1037920,"2023-12-15T00:00:00.000Z",38017687,30,"Johnny Davis",0,0,0,0,0,0
"14788",3256,0,0,0,0,0,0,0,0,0,0,0,0,0,0,0,0,1037920,"2023-12-15T00:00:00.000Z",17896106,30,"Eugene Omoruyi",0,0,0,0,0,0
"14789",3257,0,0,0,0,0,0,0,0,0,0,0,0,0,0,0,0,1037920,"2023-12-15T00:00:00.000Z",38017712,30,"Ryan Rollins",0,0,0,0,0,0
"14790",3258,0,0,0,0,0,0,0,0,0,0,0,0,0,0,0,0,1037920,"2023-12-15T00:00:00.000Z",487,30,"Delon Wright",0,0,0,0,0,0
"14791",3259,3,3,3,11,3,14,4,0,0,27,0,1,11,3,2,2,1037920,"2023-12-15T00:00:00.000Z",210,12,"Buddy Hield",5,14,17,14,6,32.1
"14792",3260,1,0,0,1,1,4,4,2,2,16,1,4,11,1,0,2,1037921,"2023-12-15T00:00:00.000Z",666468,2,"Oshae Brissett",0,12,13,12,2,11.7
"14793",3261,0,0,0,0,0,0,0,0,0,0,0,0,0,0,0,0,1037918,"2023-12-15T00:00:00.000Z",56677848,4,"Amari Bailey",0,0,0,0,0,0
"14794",3262,0,0,0,0,0,0,0,0,0,0,0,0,0,0,0,0,1037918,"2023-12-15T00:00:00.000Z",3547239,4,"LaMelo Ball",0,0,0,0,0,0
"14795",3263,0,0,0,0,0,0,0,0,0,0,0,0,0,0,0,0,1037918,"2023-12-15T00:00:00.000Z",3547253,4,"Theo Maledon",0,0,0,0,0,0
"14796",3264,0,0,0,0,0,0,0,0,0,0,0,0,0,0,0,0,1037918,"2023-12-15T00:00:00.000Z",666748,4,"Cody Martin",0,0,0,0,0,0
"14797",3265,0,0,0,0,0,0,0,0,0,0,0,0,0,0,0,0,1037918,"2023-12-15T00:00:00.000Z",347,4,"Frank Ntilikina",0,0,0,0,0,0
"14798",3266,0,0,0,0,0,0,0,0,0,0,0,0,0,0,0,0,1037918,"2023-12-15T00:00:00.000Z",666950,4,"P.J. Washington",0,0,0,0,0,0
"14799",3267,0,0,0,0,0,0,0,0,0,0,0,0,0,0,0,0,1037918,"2023-12-15T00:00:00.000Z",38017698,4,"Mark Williams",0,0,0,0,0,0
"14800",3268,7,0,3,1,0,8,3,2,2,32,0,3,8,3,0,9,1037918,"2023-12-15T00:00:00.000Z",227,19,"Brandon Ingram",0,11,18,15,10,13.1
"14801",3269,4,0,8,0,0,16,9,4,3,30,3,4,21,11,0,1,1037918,"2023-12-15T00:00:00.000Z",666969,19,"Zion Williamson",0,32,36,25,15,39.2
"14802",3270,4,1,3,5,0,15,8,3,2,30,0,0,18,3,0,2,1037921,"2023-12-15T00:00:00.000Z",70,2,"Jaylen Brown",1,21,25,22,7,28.6
"14803",3271,4,0,6,9,2,22,11,9,6,39,0,3,30,6,0,2,1037921,"2023-12-15T00:00:00.000Z",434,2,"Jayson Tatum",0,36,40,34,10,41.2
"14804",3272,0,1,2,3,1,7,3,2,1,14,1,2,8,3,2,1,1037921,"2023-12-15T00:00:00.000Z",3547279,2,"Lamar Stevens",3,11,11,8,3,19.6
"14805",3273,8,1,3,7,3,15,7,2,2,30,1,0,19,4,4,1,1037921,"2023-12-15T00:00:00.000Z",473,2,"Derrick White",5,23,31,27,12,49.8
"14806",3274,4,1,3,3,2,7,2,0,0,28,1,2,6,4,2,0,1037921,"2023-12-15T00:00:00.000Z",214,2,"Jrue Holiday",3,10,14,10,8,25.8
"14807",3275,4,0,5,6,3,8,4,0,0,32,2,1,11,7,4,1,1037921,"2023-12-15T00:00:00.000Z",17896060,2,"Sam Hauser",4,18,22,15,11,36.4
"14808",3276,1,0,1,9,3,26,11,5,5,33,0,4,30,1,0,0,1037788,"2023-11-20T00:00:00.000Z",666848,30,"Jordan Poole",0,31,32,31,2,32.7
"14809",3277,3,0,2,1,0,13,9,0,0,26,0,0,18,2,0,0,1037788,"2023-11-20T00:00:00.000Z",249,30,"Tyus Jones",0,20,23,21,5,24.9
"14810",3278,0,0,0,0,0,0,0,0,0,1,0,0,0,0,0,0,1037788,"2023-11-20T00:00:00.000Z",18677954,30,"Jared Butler",0,0,0,0,0,0
"14811",3279,0,0,0,0,0,0,0,0,0,0,0,0,0,0,0,0,1037788,"2023-11-20T00:00:00.000Z",38017704,30,"Patrick Baldwin Jr.",0,0,0,0,0,0
"14812",3280,0,0,0,0,0,0,0,0,0,0,0,0,0,0,0,0,1037788,"2023-11-20T00:00:00.000Z",38124126,30,"John Butler Jr.",0,0,0,0,0,0
"14813",3281,7,0,4,1,0,10,4,4,3,37,4,1,11,8,1,2,1037787,"2023-11-20T00:00:00.000Z",177,8,"Aaron Gordon",1,19,26,18,15,32.1
"14814",3282,5,1,5,4,1,8,4,0,0,15,0,1,9,5,0,1,1037787,"2023-11-20T00:00:00.000Z",246,8,"Nikola Jokic",1,14,19,14,10,24.5
"14815",3283,3,2,2,5,2,17,8,2,2,36,1,2,20,3,2,3,1037787,"2023-11-20T00:00:00.000Z",81,8,"Kentavious Caldwell-Pope",4,23,26,23,6,37.1
"14816",3284,6,1,3,3,1,15,9,3,2,32,0,2,21,3,1,0,1037787,"2023-11-20T00:00:00.000Z",236,8,"Reggie Jackson",2,24,30,27,9,39.6
"14817",3285,2,1,5,2,2,10,5,4,3,32,1,2,15,6,1,2,1037787,"2023-11-20T00:00:00.000Z",38017709,8,"Christian Braun",2,21,23,17,8,29.2
"14818",3286,2,2,1,0,0,2,1,2,2,14,0,1,4,1,0,1,1037787,"2023-11-20T00:00:00.000Z",38017721,8,"Peyton Watson",2,5,7,6,3,13.2
"14819",3287,0,0,0,0,0,0,0,0,0,0,0,0,0,0,0,0,1037787,"2023-11-20T00:00:00.000Z",38017727,8,"Collin Gillespie",0,0,0,0,0,0
"14820",3288,0,0,0,0,0,0,0,0,0,0,0,0,0,0,0,0,1037787,"2023-11-20T00:00:00.000Z",215,8,"Justin Holiday",0,0,0,0,0,0
"14821",3289,0,0,0,0,0,0,0,0,0,0,0,0,0,0,0,0,1037787,"2023-11-20T00:00:00.000Z",250,8,"DeAndre Jordan",0,0,0,0,0,0
"14822",3290,0,0,0,0,0,0,0,0,0,0,0,0,0,0,0,0,1037787,"2023-11-20T00:00:00.000Z",56677871,8,"Hunter Tyson",0,0,0,0,0,0
"14823",3291,0,0,0,0,0,0,0,0,0,0,0,0,0,0,0,0,1037787,"2023-11-20T00:00:00.000Z",666489,8,"Vlatko Cancar",0,0,0,0,0,0
"14824",3292,0,0,0,0,0,0,0,0,0,0,0,0,0,0,0,0,1037787,"2023-11-20T00:00:00.000Z",17896103,8,"Jay Huff",0,0,0,0,0,0
"14825",3293,0,0,0,0,0,0,0,0,0,0,0,0,0,0,0,0,1037787,"2023-11-20T00:00:00.000Z",335,8,"Jamal Murray",0,0,0,0,0,0
"14826",3294,0,0,2,0,0,1,0,0,0,10,1,2,0,3,0,1,1037787,"2023-11-20T00:00:00.000Z",3547240,9,"James Wiseman",0,3,3,0,3,2.6
"14827",3295,2,0,0,1,0,2,0,0,0,14,0,2,0,0,2,2,1037787,"2023-11-20T00:00:00.000Z",3547241,9,"Killian Hayes",2,0,2,2,2,7
"14828",3296,1,0,2,3,0,7,1,4,4,23,2,2,6,4,0,2,1037787,"2023-11-20T00:00:00.000Z",17896071,9,"Isaiah Livers",0,10,11,7,5,10.3
"14829",3297,2,0,1,5,3,8,4,0,0,18,0,1,11,1,0,1,1037787,"2023-11-20T00:00:00.000Z",44477024,9,"Stanley Umude",0,12,14,13,3,14.2
"14830",3298,0,0,0,1,0,2,1,0,0,5,0,0,2,0,0,0,1037787,"2023-11-20T00:00:00.000Z",56677792,9,"Marcus Sasser",0,2,2,2,0,2
"14831",3299,0,0,0,0,0,0,0,0,0,0,0,0,0,0,0,0,3277479,"2023-11-21T00:00:00.000Z",85,22,"Wendell Carter Jr.",0,0,0,0,0,0
"14832",3300,0,0,0,0,0,0,0,0,0,0,0,0,0,0,0,0,3277479,"2023-11-21T00:00:00.000Z",165,22,"Markelle Fultz",0,0,0,0,0,0
"14833",3301,1,0,0,0,0,0,0,0,0,4,0,1,0,0,0,0,1037646,"2023-10-31T00:00:00.000Z",56677827,22,"Anthony Black",0,0,1,1,1,1.5
"14834",3302,0,0,0,4,1,5,2,1,1,4,0,0,6,0,0,0,1037646,"2023-10-31T00:00:00.000Z",38017724,22,"Caleb Houstan",0,6,6,6,0,6
"14835",3303,0,0,1,0,0,1,1,0,0,4,0,0,2,1,0,0,1037646,"2023-10-31T00:00:00.000Z",56677839,22,"Jett Howard",0,3,3,2,1,3.2
"14836",3304,3,0,0,0,0,0,0,2,1,4,1,0,1,1,0,0,1037646,"2023-10-31T00:00:00.000Z",666442,22,"Goga Bitadze",0,2,5,4,4,6.7
"14837",3305,3,0,2,1,1,7,7,2,1,25,0,5,16,2,1,2,1037648,"2023-11-01T00:00:00.000Z",18,28,"OG Anunoby",1,18,21,19,5,23.9
"14838",3306,7,0,6,8,5,13,9,3,3,33,0,3,26,6,0,3,1037648,"2023-11-01T00:00:00.000Z",416,28,"Pascal Siakam",0,32,39,33,13,40.7
"14839",3307,2,4,7,0,0,10,7,0,0,29,4,4,14,11,0,2,1037648,"2023-11-01T00:00:00.000Z",373,28,"Jakob Poeltl",4,25,27,16,13,40.2
"14840",3308,5,2,7,6,4,16,8,1,1,29,5,1,21,12,1,3,1037648,"2023-11-01T00:00:00.000Z",17896055,28,"Scottie Barnes",3,33,38,26,17,48.9
"14841",3309,11,0,3,4,2,13,9,4,4,29,1,2,24,4,1,2,1037648,"2023-11-01T00:00:00.000Z",409,28,"Dennis Schroder",1,28,39,35,15,46.3
"14842",3310,1,1,1,2,0,7,4,6,5,14,0,2,13,1,1,1,1037646,"2023-10-31T00:00:00.000Z",462,22,"Moritz Wagner",2,14,15,14,2,20.7
"14843",3311,0,0,0,0,0,1,1,0,0,4,1,0,2,1,0,1,1037646,"2023-10-31T00:00:00.000Z",666818,22,"Chuma Okeke",0,3,3,2,1,2.2
"14844",3312,0,0,0,0,0,0,0,0,0,0,0,0,0,0,0,0,1037646,"2023-10-31T00:00:00.000Z",38017607,22,"Kevon Harris",0,0,0,0,0,0
"14845",3313,0,0,0,0,0,0,0,0,0,0,0,0,0,0,0,0,1037646,"2023-10-31T00:00:00.000Z",229,22,"Jonathan Isaac",0,0,0,0,0,0
"14846",3314,0,0,0,0,0,0,0,0,0,0,0,0,0,0,0,0,1037646,"2023-10-31T00:00:00.000Z",17553983,22,"Trevelin Queen",0,0,0,0,0,0
"14847",3315,0,0,0,0,0,0,0,0,0,0,0,0,0,0,0,0,1037646,"2023-10-31T00:00:00.000Z",666885,22,"Admiral Schofield",0,0,0,0,0,0
"14848",3316,1,0,2,5,0,11,4,0,0,23,1,2,8,3,0,1,1037648,"2023-11-01T00:00:00.000Z",3089,28,"Gary Trent Jr.",0,11,12,9,4,12.1
"14849",3317,0,0,1,8,1,10,2,0,0,21,0,1,5,1,0,0,1037648,"2023-11-01T00:00:00.000Z",56677828,28,"Gradey Dick",0,6,6,5,1,6.2
"14850",3318,4,0,2,1,0,3,1,0,0,19,1,1,2,3,3,3,1037648,"2023-11-01T00:00:00.000Z",3547275,28,"Malachi Flynn",3,5,9,6,7,17.6
"14851",3319,1,0,4,1,0,4,2,2,2,13,1,3,6,5,1,0,1037648,"2023-11-01T00:00:00.000Z",58,28,"Chris Boucher",1,11,12,7,6,16.5
"14852",3320,0,0,0,0,0,0,0,0,0,0,0,0,0,0,0,0,1037648,"2023-11-01T00:00:00.000Z",666762,28,"Jalen McDaniels",0,0,0,0,0,0
"14853",3321,0,0,0,0,0,1,0,0,0,4,0,0,0,0,0,0,1037648,"2023-11-01T00:00:00.000Z",2148,17,"Thanasis Antetokounmpo",0,0,0,0,0,0
"14854",3322,0,0,0,0,0,0,0,0,0,0,0,0,0,0,0,0,1037648,"2023-11-01T00:00:00.000Z",666960,17,"Lindell Wigginton",0,0,0,0,0,0
"14855",3323,0,0,1,6,3,7,3,0,0,30,1,4,9,2,1,1,1037653,"2023-11-01T00:00:00.000Z",666541,21,"Luguentz Dort",1,11,11,9,2,13.4
"14856",3324,3,0,7,3,0,13,5,9,8,38,1,3,18,8,0,1,1037653,"2023-11-01T00:00:00.000Z",38017703,21,"Jalen Williams",0,26,29,21,11,31.1
"14857",3325,3,2,8,5,1,14,8,2,2,37,3,4,19,11,1,5,1037653,"2023-11-01T00:00:00.000Z",38017685,21,"Chet Holmgren",3,30,33,22,14,40.7
"14858",3326,0,0,0,0,0,0,0,0,0,0,0,0,0,0,0,0,1038087,"2024-01-06T00:00:00.000Z",260,23,"Furkan Korkmaz",0,0,0,0,0,0
"14859",3327,0,0,0,0,0,0,0,0,0,0,0,0,0,0,0,0,1038087,"2024-01-06T00:00:00.000Z",38017732,23,"Kenneth Lofton Jr.",0,0,0,0,0,0
"14860",3328,0,0,0,0,0,0,0,0,0,0,0,0,0,0,0,0,1038061,"2024-01-03T00:00:00.000Z",357,11,"Victor Oladipo",0,0,0,0,0,0
"14861",3329,0,0,0,0,0,0,0,0,0,0,0,0,0,0,0,0,1038061,"2024-01-03T00:00:00.000Z",56677809,11,"Jermaine Samuels Jr.",0,0,0,0,0,0
"14862",3330,0,0,0,0,0,0,0,0,0,0,0,0,0,0,0,0,1038061,"2024-01-03T00:00:00.000Z",47738533,11,"Jeenathan Williams",0,0,0,0,0,0
"14863",3331,5,1,6,6,3,13,6,2,0,32,0,0,15,6,0,0,1038061,"2024-01-03T00:00:00.000Z",666679,3,"Cameron Johnson",1,21,26,20,11,32.7
"14864",3332,2,1,1,11,1,16,4,0,0,20,1,2,9,2,0,2,1038061,"2024-01-03T00:00:00.000Z",158,3,"Dorian Finney-Smith",1,11,13,11,4,15.4
"14865",3333,0,2,8,0,0,8,6,0,0,28,5,5,12,13,1,1,1038061,"2024-01-03T00:00:00.000Z",666508,3,"Nicolas Claxton",3,25,25,12,13,35.6
"14866",3334,3,1,4,12,3,18,5,3,2,36,0,1,15,4,1,1,1038061,"2024-01-03T00:00:00.000Z",61,3,"Mikal Bridges",2,19,22,18,7,29.3
"14867",3335,5,0,1,3,2,5,3,5,3,28,0,1,11,1,2,1,1038061,"2024-01-03T00:00:00.000Z",130,3,"Spencer Dinwiddie",2,12,17,16,6,24.7
"14868",3336,3,0,3,8,2,13,5,2,1,30,1,3,13,4,2,1,1038061,"2024-01-03T00:00:00.000Z",351,3,"Royce O'Neale",2,17,20,16,7,27.3
"14869",3337,1,1,8,0,0,7,4,6,3,20,4,5,11,12,1,1,1038061,"2024-01-03T00:00:00.000Z",17896038,3,"Day'Ron Sharpe",2,23,24,12,13,31.9
"14870",3338,0,0,0,0,0,0,0,0,0,5,0,0,0,0,1,0,1038061,"2024-01-03T00:00:00.000Z",56677722,3,"Jalen Wilson",1,0,0,0,0,3
"14871",3339,5,0,0,2,0,7,0,4,4,18,0,1,4,0,1,1,1038061,"2024-01-03T00:00:00.000Z",17896048,3,"Cam Thomas",1,4,9,9,5,13.5
"14872",3340,1,0,4,2,2,6,3,4,3,20,4,1,11,8,1,0,1038061,"2024-01-03T00:00:00.000Z",17896058,3,"Trendon Watford",1,19,20,12,9,25.1
"14873",3341,0,0,1,0,0,0,0,0,0,3,0,0,0,1,0,0,1038061,"2024-01-03T00:00:00.000Z",9051997,3,"Armoni Brooks",0,1,1,0,1,1.2
"14874",3342,0,0,0,0,0,0,0,0,0,0,0,0,0,0,0,0,1038061,"2024-01-03T00:00:00.000Z",174,3,"Harry Giles III",0,0,0,0,0,0
"14875",3343,0,0,0,0,0,0,0,0,0,0,0,0,0,0,0,0,1038061,"2024-01-03T00:00:00.000Z",421,3,"Dennis Smith Jr.",0,0,0,0,0,0
"14876",3344,0,0,0,0,0,0,0,0,0,0,0,0,0,0,0,0,1038061,"2024-01-03T00:00:00.000Z",56677843,3,"Noah Clowney",0,0,0,0,0,0
"14877",3345,0,0,0,0,0,0,0,0,0,0,0,0,0,0,0,0,1038061,"2024-01-03T00:00:00.000Z",17896041,3,"Keon Johnson",0,0,0,0,0,0
"14878",3346,0,0,0,0,0,0,0,0,0,0,0,0,0,0,0,0,1038061,"2024-01-03T00:00:00.000Z",417,3,"Ben Simmons",0,0,0,0,0,0
"14879",3347,0,0,0,0,0,0,0,0,0,0,0,0,0,0,0,0,1038061,"2024-01-03T00:00:00.000Z",464,3,"Lonnie Walker IV",0,0,0,0,0,0
"14880",3348,0,0,0,0,0,0,0,0,0,0,0,0,0,0,0,0,1038061,"2024-01-03T00:00:00.000Z",56677841,3,"Dariq Whitehead",0,0,0,0,0,0
"14881",3349,0,0,0,0,0,0,0,0,0,0,0,0,0,0,0,0,1038084,"2024-01-05T00:00:00.000Z",436,28,"Garrett Temple",0,0,0,0,0,0
"14882",3350,0,0,0,0,0,0,0,0,0,0,0,0,0,0,0,0,1038084,"2024-01-05T00:00:00.000Z",3089,28,"Gary Trent Jr.",0,0,0,0,0,0
"14883",3351,1,0,0,1,1,2,2,0,0,6,3,1,5,3,0,0,1037914,"2023-12-14T00:00:00.000Z",3547268,8,"Zeke Nnaji",0,8,9,6,4,10.1
"14884",3352,0,0,0,0,0,0,0,0,0,0,0,0,0,0,0,0,1037911,"2023-12-14T00:00:00.000Z",17896094,2,"Dalano Banton",0,0,0,0,0,0
"14885",3353,0,0,0,0,0,0,0,0,0,0,0,0,0,0,0,0,1037911,"2023-12-14T00:00:00.000Z",666468,2,"Oshae Brissett",0,0,0,0,0,0
"14886",3354,0,0,0,0,0,0,0,0,0,0,0,0,0,0,0,0,1037911,"2023-12-14T00:00:00.000Z",261,2,"Luke Kornet",0,0,0,0,0,0
"14887",3355,0,0,0,0,0,0,0,0,0,0,0,0,0,0,0,0,1037911,"2023-12-14T00:00:00.000Z",338,2,"Svi Mykhailiuk",0,0,0,0,0,0
"14888",3356,0,0,0,0,0,0,0,0,0,0,0,0,0,0,0,0,1037913,"2023-12-14T00:00:00.000Z",228,7,"Kyrie Irving",0,0,0,0,0,0
"14889",3357,0,0,0,0,0,0,0,0,0,0,0,0,0,0,0,0,1037913,"2023-12-14T00:00:00.000Z",257,7,"Maxi Kleber",0,0,0,0,0,0
"14890",3358,1,1,1,2,0,9,5,1,1,24,1,3,11,2,0,0,1037913,"2023-12-14T00:00:00.000Z",3547259,18,"Jaden McDaniels",1,13,14,12,3,17.9
"14891",3359,1,0,4,6,2,10,3,0,0,20,0,0,8,4,0,0,1037914,"2023-12-14T00:00:00.000Z",56677776,8,"Julian Strawther",0,12,13,9,5,14.3
"14892",3360,5,1,4,5,2,10,7,3,2,24,3,3,18,7,1,1,1037914,"2023-12-14T00:00:00.000Z",38017721,8,"Peyton Watson",2,25,30,23,12,38.9
"14893",3361,1,0,0,1,1,1,1,0,0,2,0,0,3,0,0,0,1037914,"2023-12-14T00:00:00.000Z",56677582,8,"Jalen Pickett",0,3,4,4,1,4.5
"14894",3362,0,0,1,0,0,0,0,0,0,2,0,0,0,1,0,0,1037914,"2023-12-14T00:00:00.000Z",56677871,8,"Hunter Tyson",0,1,1,0,1,1.2
"14895",3363,0,0,0,0,0,0,0,0,0,0,0,0,0,0,0,0,1037914,"2023-12-14T00:00:00.000Z",81,8,"Kentavious Caldwell-Pope",0,0,0,0,0,0
"14896",3364,2,0,12,3,1,14,8,5,4,31,5,1,21,17,0,3,1037913,"2023-12-14T00:00:00.000Z",447,18,"Karl-Anthony Towns",0,38,40,23,19,41.4
"14897",3365,5,1,10,0,0,4,3,6,2,30,2,4,8,12,3,2,1037913,"2023-12-14T00:00:00.000Z",176,18,"Rudy Gobert",4,20,25,13,17,39.9
"14898",3366,11,0,1,3,0,19,3,6,3,35,1,2,9,2,2,5,1037913,"2023-12-14T00:00:00.000Z",3547238,18,"Anthony Edwards",2,11,22,20,13,28.9
"14899",3367,3,0,2,4,2,9,5,2,2,29,0,2,14,2,1,1,1037913,"2023-12-14T00:00:00.000Z",104,18,"Mike Conley",1,16,19,17,5,22.9
"14900",3368,1,1,0,4,3,6,5,0,0,20,1,2,13,1,0,1,1037913,"2023-12-14T00:00:00.000Z",666400,18,"Nickeil Alexander-Walker",1,14,15,14,2,17.7
"14901",3369,3,0,4,11,7,14,8,4,4,31,2,2,27,6,1,2,1037913,"2023-12-14T00:00:00.000Z",667378,18,"Naz Reid",1,33,36,30,9,39.7
"14902",3370,2,1,2,1,0,7,3,0,0,18,0,2,6,2,2,1,1037913,"2023-12-14T00:00:00.000Z",12,18,"Kyle Anderson",3,8,10,8,4,19.4
"14903",3371,1,0,1,3,1,4,2,0,0,14,0,0,5,1,0,0,1037913,"2023-12-14T00:00:00.000Z",68,18,"Troy Brown Jr.",0,6,7,6,2,7.7
"14904",3372,1,0,0,0,0,0,0,0,0,2,0,0,0,0,0,0,1037913,"2023-12-14T00:00:00.000Z",666767,18,"Jordan McLaughlin",0,0,1,1,1,1.5
"14905",3373,0,0,0,0,0,0,0,0,0,2,0,1,0,0,0,0,1037913,"2023-12-14T00:00:00.000Z",38017700,18,"Wendell Moore Jr.",0,0,0,0,0,0
"14906",3374,0,0,0,0,0,0,0,0,0,0,0,0,0,0,0,0,1037914,"2023-12-14T00:00:00.000Z",666489,8,"Vlatko Cancar",0,0,0,0,0,0
"14907",3375,0,0,0,0,0,0,0,0,0,0,0,0,0,0,0,0,1037914,"2023-12-14T00:00:00.000Z",38017727,8,"Collin Gillespie",0,0,0,0,0,0
"14908",3376,0,1,3,3,1,6,4,4,4,22,2,1,13,5,1,0,3277482,"2023-11-21T00:00:00.000Z",666729,24,"Nassir Little",2,18,18,13,5,25
"14909",3377,0,0,0,0,0,0,0,0,0,0,0,0,0,0,0,0,3277481,"2023-11-21T00:00:00.000Z",38017662,6,"Isaiah Mobley",0,0,0,0,0,0
"14910",3378,0,0,0,0,0,0,0,0,0,0,0,0,0,0,0,0,3277481,"2023-11-21T00:00:00.000Z",666676,6,"Ty Jerome",0,0,0,0,0,0
"14911",3379,0,0,0,0,0,0,0,0,0,0,0,0,0,0,0,0,3277481,"2023-11-21T00:00:00.000Z",322,6,"Donovan Mitchell",0,0,0,0,0,0
"14912",3380,0,0,0,0,0,0,0,0,0,0,0,0,0,0,0,0,3277481,"2023-11-21T00:00:00.000Z",3547247,6,"Isaac Okoro",0,0,0,0,0,0
"14913",3381,0,0,0,0,0,0,0,0,0,0,0,0,0,0,0,0,3277481,"2023-11-21T00:00:00.000Z",404,6,"Ricky Rubio",0,0,0,0,0,0
"14914",3382,0,0,0,0,0,0,0,0,0,0,0,0,0,0,0,0,3277479,"2023-11-21T00:00:00.000Z",38017710,28,"Christian Koloko",0,0,0,0,0,0
"14915",3383,0,0,0,0,0,0,0,0,0,0,0,0,0,0,0,0,3277479,"2023-11-21T00:00:00.000Z",56677869,28,"Markquis Nowell",0,0,0,0,0,0
"14916",3384,0,0,3,2,0,6,3,2,2,14,0,5,8,3,0,1,3277482,"2023-11-21T00:00:00.000Z",38017711,25,"Jabari Walker",0,11,11,8,3,10.6
"14917",3385,0,1,1,2,0,2,0,0,0,22,1,1,0,2,1,0,3277482,"2023-11-21T00:00:00.000Z",666923,25,"Matisse Thybulle",2,2,2,0,2,8.4
"14918",3386,1,0,0,3,2,6,4,0,0,13,1,1,10,1,2,0,3277482,"2023-11-21T00:00:00.000Z",56783340,25,"Duop Reath",2,11,12,11,2,18.7
"14919",3387,1,0,0,0,0,1,0,0,0,2,0,0,0,0,1,0,3277482,"2023-11-21T00:00:00.000Z",56677829,25,"Rayan Rupert",1,0,1,1,1,4.5
"14920",3388,0,0,0,0,0,0,0,0,0,0,0,0,0,0,0,0,3277482,"2023-11-21T00:00:00.000Z",56677747,25,"Scoot Henderson",0,0,0,0,0,0
"14921",3389,0,0,0,0,0,0,0,0,0,0,0,0,0,0,0,0,3277482,"2023-11-21T00:00:00.000Z",47957121,25,"Justin Minaya",0,0,0,0,0,0
"14922",3390,0,0,0,0,0,0,0,0,0,0,0,0,0,0,0,0,3277482,"2023-11-21T00:00:00.000Z",419,25,"Anfernee Simons",0,0,0,0,0,0
"14923",3391,0,0,0,0,0,0,0,0,0,0,0,0,0,0,0,0,3277482,"2023-11-21T00:00:00.000Z",17896120,25,"Ish Wainright",0,0,0,0,0,0
"14924",3392,0,0,0,0,0,0,0,0,0,0,0,0,0,0,0,0,3277482,"2023-11-21T00:00:00.000Z",476,25,"Robert Williams III",0,0,0,0,0,0
"14925",3393,0,0,0,0,0,0,0,0,0,5,0,1,0,0,0,0,3277483,"2023-11-21T00:00:00.000Z",666860,14,"Cameron Reddish",0,0,0,0,0,0
"14926",3394,9,0,6,5,3,10,6,2,2,24,1,0,17,7,0,2,3277483,"2023-11-21T00:00:00.000Z",237,14,"LeBron James",0,24,33,26,16,36.9
"14927",3395,4,0,11,0,0,14,11,5,4,29,5,1,26,16,2,2,3277483,"2023-11-21T00:00:00.000Z",117,14,"Anthony Davis",2,42,46,30,20,55.2
"14928",3396,1,1,0,4,0,8,1,3,2,31,0,0,4,0,0,2,3277483,"2023-11-21T00:00:00.000Z",383,14,"Taurean Prince",1,4,5,5,1,6.5
"14929",3397,8,1,3,4,3,9,7,5,3,26,0,2,20,3,0,0,3277483,"2023-11-21T00:00:00.000Z",405,14,"D'Angelo Russell",1,23,31,28,11,38.6
"14930",3398,1,0,4,5,2,13,4,2,2,28,2,3,12,6,0,1,3277483,"2023-11-21T00:00:00.000Z",666609,14,"Rui Hachimura",0,18,19,13,7,19.7
"14931",3399,5,0,5,4,1,13,7,4,4,26,0,0,19,5,3,2,3277483,"2023-11-21T00:00:00.000Z",17553995,14,"Austin Reaves",3,24,29,24,10,39.5
"14932",3400,0,0,1,0,0,1,0,2,1,10,0,0,1,1,0,0,3277482,"2023-11-21T00:00:00.000Z",32,24,"Keita Bates-Diop",0,2,2,1,1,2.2
"14933",3401,3,0,3,2,0,16,7,8,6,34,4,1,20,7,1,1,1037651,"2023-11-01T00:00:00.000Z",79,16,"Jimmy Butler",1,27,30,23,10,34.9
"14934",3402,2,0,10,9,2,13,5,0,0,30,2,1,12,12,2,0,1037593,"2023-10-24T00:00:00.000Z",375,8,"Michael Porter Jr.",2,24,26,14,14,35.4
"14935",3403,5,1,5,2,1,11,7,0,0,35,2,0,15,7,2,0,1037593,"2023-10-24T00:00:00.000Z",177,8,"Aaron Gordon",3,22,27,20,12,39.9
"14936",3404,11,1,10,5,3,22,12,4,2,36,3,2,29,13,1,2,1037593,"2023-10-24T00:00:00.000Z",246,8,"Nikola Jokic",2,42,53,40,24,65.1
"14937",3405,1,1,1,3,2,12,8,2,2,36,1,5,20,2,3,3,1037593,"2023-10-24T00:00:00.000Z",81,8,"Kentavious Caldwell-Pope",4,22,23,21,3,32.9
"14938",3406,6,1,2,5,3,13,8,2,2,34,0,3,21,2,0,1,1037593,"2023-10-24T00:00:00.000Z",335,8,"Jamal Murray",1,23,29,27,8,34.4
"14939",3407,1,0,3,5,2,8,3,0,0,24,0,0,8,3,1,2,1037593,"2023-10-24T00:00:00.000Z",236,8,"Reggie Jackson",1,11,12,9,4,14.1
"14940",3408,2,1,2,1,0,5,2,2,1,19,1,1,5,3,0,1,1037593,"2023-10-24T00:00:00.000Z",38017709,8,"Christian Braun",1,8,10,7,5,13.6
"14941",3409,0,0,0,0,0,0,0,0,0,1,0,0,0,0,0,0,1037593,"2023-10-24T00:00:00.000Z",38017727,8,"Collin Gillespie",0,0,0,0,0,0
"14942",3410,0,0,0,0,0,0,0,0,0,0,0,0,0,0,0,0,1037593,"2023-10-24T00:00:00.000Z",215,8,"Justin Holiday",0,0,0,0,0,0
"14943",3411,0,0,0,0,0,0,0,0,0,0,0,0,0,0,0,0,1037593,"2023-10-24T00:00:00.000Z",250,8,"DeAndre Jordan",0,0,0,0,0,0
"14944",3412,3,1,1,6,1,7,1,0,0,20,0,1,3,1,0,0,1037663,"2023-11-02T00:00:00.000Z",38017692,27,"Malaki Branham",1,4,7,6,4,11.7
"14945",3413,1,0,1,0,0,1,1,1,1,6,0,0,3,1,1,1,1037663,"2023-11-02T00:00:00.000Z",17895854,27,"Charles Bassey",1,4,5,4,2,7.7
"14946",3414,0,0,0,0,0,0,0,0,0,0,0,0,0,0,0,0,1037663,"2023-11-02T00:00:00.000Z",38017730,27,"Dominick Barlow",0,0,0,0,0,0
"14947",3415,0,0,0,0,0,0,0,0,0,0,0,0,0,0,0,0,1037663,"2023-11-02T00:00:00.000Z",56677870,27,"Sir'Jabari Rice",0,0,0,0,0,0
"14948",3416,1,0,4,4,0,5,1,2,1,26,0,1,3,4,0,0,1037663,"2023-11-02T00:00:00.000Z",470,24,"Yuta Watanabe",0,7,8,4,5,9.3
"14949",3417,0,0,0,0,0,0,0,0,0,0,0,0,0,0,0,0,1037663,"2023-11-02T00:00:00.000Z",666729,24,"Nassir Little",0,0,0,0,0,0
"14950",3418,0,0,0,0,0,0,0,0,0,0,0,0,0,0,0,0,1037663,"2023-11-02T00:00:00.000Z",314,24,"Chimezie Metu",0,0,0,0,0,0
"14951",3419,0,0,0,0,0,0,0,0,0,0,0,0,0,0,0,0,1037663,"2023-11-02T00:00:00.000Z",37,24,"Bradley Beal",0,0,0,0,0,0
"14952",3420,0,0,0,0,0,0,0,0,0,0,0,0,0,0,0,0,1037663,"2023-11-02T00:00:00.000Z",272,24,"Damion Lee",0,0,0,0,0,0
"14953",3421,6,1,6,6,1,11,3,0,0,35,1,5,7,7,2,0,1037663,"2023-11-02T00:00:00.000Z",666682,27,"Keldon Johnson",3,14,20,13,13,33.4
"14954",3422,2,2,8,6,3,26,15,6,5,34,2,3,38,10,1,2,1037663,"2023-11-02T00:00:00.000Z",56677822,27,"Victor Wembanyama",3,48,50,40,12,60
"14955",3423,4,0,4,3,3,10,7,2,2,35,4,2,19,8,0,3,1037663,"2023-11-02T00:00:00.000Z",102,27,"Zach Collins",0,27,31,23,12,31.6
"14956",3424,1,0,2,3,3,10,7,0,0,17,0,2,17,2,0,0,1037663,"2023-11-02T00:00:00.000Z",3547246,27,"Devin Vassell",0,19,20,18,3,20.9
"14957",3425,9,1,4,0,0,13,7,0,0,26,1,4,14,5,0,1,1037663,"2023-11-02T00:00:00.000Z",38017699,27,"Jeremy Sochan",1,19,28,23,14,35.5
"14958",3426,1,0,2,2,0,3,0,0,0,11,0,2,0,2,0,1,1038089,"2024-01-07T00:00:00.000Z",666940,6,"Dean Wade",0,2,3,1,3,2.9
"14959",3427,2,1,11,0,0,19,11,7,7,31,5,3,29,16,1,1,1038089,"2024-01-07T00:00:00.000Z",9,6,"Jarrett Allen",2,45,47,31,18,56.2
"14960",3428,4,0,4,9,2,11,3,0,0,37,1,2,8,5,2,2,1038089,"2024-01-07T00:00:00.000Z",666908,6,"Max Strus",2,13,17,12,9,24
"14961",3429,9,0,2,10,1,18,7,4,2,37,0,1,17,2,1,4,1038089,"2024-01-07T00:00:00.000Z",322,6,"Donovan Mitchell",1,19,28,26,11,31.9
"14962",3430,3,0,2,5,4,13,9,3,1,26,0,2,23,2,2,4,1038089,"2024-01-07T00:00:00.000Z",277,6,"Caris LeVert",2,25,28,26,5,31.9
"14963",3431,3,0,3,9,5,11,5,3,3,23,0,0,18,3,0,0,1038089,"2024-01-07T00:00:00.000Z",3547299,6,"Sam Merrill",0,21,24,21,6,26.1
"14964",3432,2,0,2,0,0,4,3,4,2,17,2,4,8,4,0,1,1038089,"2024-01-07T00:00:00.000Z",444,6,"Tristan Thompson",0,12,14,10,6,14.8
"14965",3433,1,1,4,6,3,7,4,0,0,27,0,2,11,4,0,1,1038089,"2024-01-07T00:00:00.000Z",344,6,"Georges Niang",1,15,16,12,5,19.3
"14966",3434,1,1,1,0,0,0,0,0,0,4,0,0,0,1,0,0,1038089,"2024-01-07T00:00:00.000Z",56677872,6,"Craig Porter",1,1,2,1,2,5.7
"14967",3435,0,0,0,0,0,0,0,0,0,0,0,0,0,0,0,0,1038089,"2024-01-07T00:00:00.000Z",56677847,6,"Emoni Bates",0,0,0,0,0,0
"14968",3436,0,0,0,0,0,0,0,0,0,0,0,0,0,0,0,0,1038089,"2024-01-07T00:00:00.000Z",248,6,"Damian Jones",0,0,0,0,0,0
"14969",3437,0,0,0,0,0,0,0,0,0,0,0,0,0,0,0,0,1038089,"2024-01-07T00:00:00.000Z",666581,6,"Darius Garland",0,0,0,0,0,0
"14970",3439,0,0,0,0,0,0,0,0,0,0,0,0,0,0,0,0,1038086,"2024-01-06T00:00:00.000Z",38017712,30,"Ryan Rollins",0,0,0,0,0,0
"14971",3440,0,0,0,0,0,0,0,0,0,0,0,0,0,0,0,0,1038086,"2024-01-06T00:00:00.000Z",414,30,"Landry Shamet",0,0,0,0,0,0
"14972",3441,2,0,3,3,1,7,4,0,0,31,2,3,9,5,1,1,1038086,"2024-01-06T00:00:00.000Z",18,20,"OG Anunoby",1,14,16,11,7,20
"14973",3442,5,0,4,8,3,23,13,13,10,38,3,2,39,7,1,2,1038086,"2024-01-06T00:00:00.000Z",387,20,"Julius Randle",1,46,51,44,12,55.9
"14974",3443,2,2,17,0,0,8,4,0,0,39,2,3,8,19,4,5,1038086,"2024-01-06T00:00:00.000Z",201,20,"Isaiah Hartenstein",6,27,29,10,21,46.8
"14975",3444,3,0,4,7,2,10,4,0,0,26,1,1,10,5,1,1,1038086,"2024-01-06T00:00:00.000Z",131,20,"Donte DiVincenzo",1,15,18,13,8,22.5
"14976",3445,8,3,6,5,2,8,4,2,0,30,1,1,10,7,1,2,1038085,"2024-01-06T00:00:00.000Z",219,2,"Al Horford",4,17,25,18,15,40.4
"14977",3446,0,0,2,3,1,5,2,0,0,15,0,0,5,2,1,0,1038085,"2024-01-06T00:00:00.000Z",3547276,2,"Payton Pritchard",1,7,7,5,2,10.4
"14978",3447,3,0,1,0,0,2,1,2,2,16,3,1,4,4,1,1,1038085,"2024-01-06T00:00:00.000Z",261,2,"Luke Kornet",1,8,11,7,7,15.3
"14979",3448,0,0,0,0,0,0,0,0,0,1,0,0,0,0,0,0,1038085,"2024-01-06T00:00:00.000Z",338,2,"Svi Mykhailiuk",0,0,0,0,0,0
"14980",3449,2,0,2,4,1,6,3,0,0,15,1,0,7,3,2,1,1038065,"2024-01-03T00:00:00.000Z",314,24,"Chimezie Metu",2,10,12,9,5,18.6
"14981",3450,1,0,5,1,0,5,3,3,3,25,1,3,9,6,1,1,1038065,"2024-01-03T00:00:00.000Z",349,24,"Jusuf Nurkic",1,15,16,10,7,19.7
"14982",3451,2,1,5,5,0,12,1,2,2,27,2,3,4,7,0,0,1037915,"2023-12-14T00:00:00.000Z",38017690,25,"Shaedon Sharpe",1,11,13,6,9,18.4
"14983",3452,6,0,1,6,2,8,3,2,1,22,0,1,9,1,1,2,1037915,"2023-12-14T00:00:00.000Z",419,25,"Anfernee Simons",1,10,16,15,7,20.2
"14984",3453,10,0,2,7,2,21,9,3,3,35,0,1,23,2,1,4,1037915,"2023-12-14T00:00:00.000Z",56677747,25,"Scoot Henderson",1,25,35,33,12,39.4
"14985",3454,0,0,1,0,0,0,0,0,0,5,0,0,0,1,0,0,1037915,"2023-12-14T00:00:00.000Z",666476,25,"Moses Brown",0,1,1,0,1,1.2
"14986",3455,1,0,0,6,3,6,3,2,0,14,0,0,9,0,0,0,1037915,"2023-12-14T00:00:00.000Z",65,25,"Malcolm Brogdon",0,9,10,10,1,10.5
"14987",3456,1,0,5,2,0,10,5,5,3,28,4,0,13,9,1,0,1037915,"2023-12-14T00:00:00.000Z",38017711,25,"Jabari Walker",1,22,23,14,10,28.3
"14988",3457,2,0,3,6,2,12,7,0,0,26,0,3,16,3,0,1,1037915,"2023-12-14T00:00:00.000Z",38017620,29,"Ochai Agbaji",0,19,21,18,5,21.6
"14989",3458,3,0,5,3,1,3,1,0,0,15,1,2,3,6,0,0,1037916,"2023-12-14T00:00:00.000Z",38017706,21,"Jaylin Williams",0,9,12,6,9,14.7
"14990",3459,0,0,0,0,0,4,3,0,0,7,1,0,6,1,0,1,1037916,"2023-12-14T00:00:00.000Z",17896078,21,"Aaron Wiggins",0,7,7,6,1,6.2
"14991",3460,1,0,0,2,0,5,1,0,0,11,0,1,2,0,0,0,1037916,"2023-12-14T00:00:00.000Z",480,21,"Kenrich Williams",0,2,3,3,1,3.5
"14992",3461,0,0,0,0,0,0,0,0,0,0,0,0,0,0,0,0,1037913,"2023-12-14T00:00:00.000Z",17896056,18,"Luka Garza",0,0,0,0,0,0
"14993",3462,0,0,0,0,0,0,0,0,0,0,0,0,0,0,0,0,1037913,"2023-12-14T00:00:00.000Z",56677782,18,"Leonard Miller",0,0,0,0,0,0
"14994",3463,0,0,0,0,0,0,0,0,0,0,0,0,0,0,0,0,1037913,"2023-12-14T00:00:00.000Z",17895968,18,"Daishen Nix",0,0,0,0,0,0
"14995",3464,2,0,2,4,0,5,1,0,0,20,1,1,2,3,1,0,1037917,"2023-12-14T00:00:00.000Z",666743,13,"Terance Mann",1,5,7,4,5,11.6
"14996",3465,1,2,1,0,0,7,2,0,0,22,3,3,4,4,1,2,1037915,"2023-12-14T00:00:00.000Z",11891374,29,"Omer Yurtseven",3,8,9,5,5,17.3
"14997",3466,0,0,4,5,2,9,4,0,0,25,3,1,10,7,1,2,1037915,"2023-12-14T00:00:00.000Z",56677824,29,"Taylor Hendricks",1,17,17,10,7,19.4
"14998",3467,5,0,1,2,0,8,3,0,0,26,1,2,6,2,0,0,1037915,"2023-12-14T00:00:00.000Z",139,29,"Kris Dunn",0,8,13,11,7,15.9
"14999",3468,0,0,0,0,0,0,0,0,0,3,0,0,0,0,0,0,1037915,"2023-12-14T00:00:00.000Z",19465584,29,"Micah Potter",0,0,0,0,0,0
"15000",3469,0,0,0,0,0,0,0,0,0,0,0,0,0,0,0,0,1037915,"2023-12-14T00:00:00.000Z",101,29,"John Collins",0,0,0,0,0,0
"15001",3470,0,0,0,0,0,0,0,0,0,0,0,0,0,0,0,0,1037915,"2023-12-14T00:00:00.000Z",666881,29,"Luka Samanic",0,0,0,0,0,0
"15002",3471,0,0,0,0,0,0,0,0,0,0,0,0,0,0,0,0,1037915,"2023-12-14T00:00:00.000Z",17896023,29,"Josh Christopher",0,0,0,0,0,0
"15003",3472,2,1,5,4,2,16,9,9,7,39,3,2,27,8,1,2,1037917,"2023-12-14T00:00:00.000Z",274,13,"Kawhi Leonard",2,35,37,29,10,43.6
"15004",3473,2,2,5,0,0,10,5,0,0,30,3,5,10,8,0,3,1037917,"2023-12-14T00:00:00.000Z",493,13,"Ivica Zubac",2,18,20,12,10,25.6
"15005",3474,1,0,3,11,4,15,6,3,2,30,1,2,18,4,0,1,1037917,"2023-12-14T00:00:00.000Z",666511,13,"Amir Coffey",0,22,23,19,5,23.3
"15006",3475,0,0,0,0,0,0,0,0,0,0,0,0,0,0,0,0,1037915,"2023-12-14T00:00:00.000Z",100,29,"Jordan Clarkson",0,0,0,0,0,0
"15007",3476,4,0,4,3,0,8,4,2,2,29,0,5,10,4,1,2,1037800,"2023-11-22T00:00:00.000Z",17896073,22,"Jalen Suggs",1,14,18,14,8,21.8
"15008",3477,0,0,9,7,3,19,11,10,8,37,2,2,33,11,2,2,1037799,"2023-11-22T00:00:00.000Z",62,4,"Miles Bridges",2,44,44,33,11,50.2
"15009",3478,0,3,9,0,0,10,4,6,3,35,5,4,11,14,0,0,1037799,"2023-11-22T00:00:00.000Z",38017698,4,"Mark Williams",3,25,25,11,14,36.8
"15010",3479,3,0,0,6,3,12,6,0,0,31,0,2,15,0,1,0,1037799,"2023-11-22T00:00:00.000Z",56677823,4,"Brandon Miller",1,15,18,18,3,22.5
"15011",3480,13,0,6,16,6,31,13,3,2,40,2,2,34,8,1,4,1037799,"2023-11-22T00:00:00.000Z",3547239,4,"LaMelo Ball",1,42,55,47,21,62.1
"15012",3481,4,0,0,0,0,1,0,0,0,20,0,1,0,0,1,1,1037799,"2023-11-22T00:00:00.000Z",422,4,"Ish Smith",1,0,4,4,4,8
"15013",3482,0,1,2,4,3,5,4,2,2,23,1,1,13,3,1,1,1037799,"2023-11-22T00:00:00.000Z",38017708,4,"Bryce McGowens",2,16,16,13,3,21.6
"15014",3483,0,0,0,0,0,0,0,0,0,0,0,0,0,0,0,0,1037799,"2023-11-22T00:00:00.000Z",17896037,4,"James Bouknight",0,0,0,0,0,0
"15015",3484,0,0,0,0,0,0,0,0,0,0,0,0,0,0,0,0,1037799,"2023-11-22T00:00:00.000Z",3547253,4,"Theo Maledon",0,0,0,0,0,0
"15016",3485,1,0,6,2,2,7,4,3,3,21,1,4,13,7,0,3,1037800,"2023-11-22T00:00:00.000Z",38017709,8,"Christian Braun",0,20,21,14,8,19.9
"15017",3486,2,0,1,4,1,6,2,2,2,17,1,5,7,2,0,0,1037800,"2023-11-22T00:00:00.000Z",56677776,8,"Julian Strawther",0,9,11,9,4,12.4
"15018",3487,0,0,1,3,0,4,0,0,0,8,0,0,0,1,0,1,1037800,"2023-11-22T00:00:00.000Z",56677582,8,"Jalen Pickett",0,1,1,0,1,0.2
"15019",3488,0,0,0,0,0,1,1,2,0,10,1,1,2,1,0,0,1037800,"2023-11-22T00:00:00.000Z",38017721,8,"Peyton Watson",0,3,3,2,1,3.2
"15020",3489,2,0,0,0,0,2,1,2,1,12,1,1,3,1,0,0,1037800,"2023-11-22T00:00:00.000Z",3547268,8,"Zeke Nnaji",0,4,6,5,3,7.2
"15021",3490,0,0,0,0,0,0,0,0,0,0,0,0,0,0,0,0,1037800,"2023-11-22T00:00:00.000Z",215,8,"Justin Holiday",0,0,0,0,0,0
"15022",3491,0,0,0,0,0,0,0,0,0,0,0,0,0,0,0,0,1037800,"2023-11-22T00:00:00.000Z",38017727,8,"Collin Gillespie",0,0,0,0,0,0
"15023",3492,0,0,0,0,0,0,0,0,0,0,0,0,0,0,0,0,1037800,"2023-11-22T00:00:00.000Z",250,8,"DeAndre Jordan",0,0,0,0,0,0
"15024",3493,0,0,0,0,0,0,0,0,0,0,0,0,0,0,0,0,1037800,"2023-11-22T00:00:00.000Z",17896007,8,"Braxton Key",0,0,0,0,0,0
"15025",3494,0,0,0,0,0,0,0,0,0,0,0,0,0,0,0,0,1037800,"2023-11-22T00:00:00.000Z",56677871,8,"Hunter Tyson",0,0,0,0,0,0
"15026",3495,0,0,0,0,0,0,0,0,0,0,0,0,0,0,0,0,1037800,"2023-11-22T00:00:00.000Z",666489,8,"Vlatko Cancar",0,0,0,0,0,0
"15027",3496,0,0,0,0,0,0,0,0,0,0,0,0,0,0,0,0,1037800,"2023-11-22T00:00:00.000Z",38017607,22,"Kevon Harris",0,0,0,0,0,0
"15028",3497,0,0,0,0,0,0,0,0,0,0,0,0,0,0,0,0,1037800,"2023-11-22T00:00:00.000Z",56677839,22,"Jett Howard",0,0,0,0,0,0
"15029",3498,0,0,0,0,0,0,0,0,0,0,0,0,0,0,0,0,1037800,"2023-11-22T00:00:00.000Z",17553983,22,"Trevelin Queen",0,0,0,0,0,0
"15030",3499,0,0,2,9,5,16,9,2,2,31,0,4,25,2,1,0,1037800,"2023-11-22T00:00:00.000Z",375,8,"Michael Porter Jr.",1,27,27,25,2,30.4
"15031",3500,1,0,3,3,1,16,7,2,0,37,7,3,15,10,2,2,1037800,"2023-11-22T00:00:00.000Z",177,8,"Aaron Gordon",2,25,26,16,11,32.5
"15032",3501,3,1,4,5,4,9,7,1,0,31,0,3,18,4,0,0,1037682,"2023-11-05T00:00:00.000Z",666965,7,"Grant Williams",1,22,25,21,7,30.3
"15033",3502,1,1,11,0,0,9,7,2,1,32,3,4,15,14,0,2,1037682,"2023-11-05T00:00:00.000Z",56677840,7,"Dereck Lively II",1,29,30,16,15,34.3
"15034",3503,10,1,3,6,2,14,6,4,4,34,0,3,18,3,1,2,1037682,"2023-11-05T00:00:00.000Z",228,7,"Kyrie Irving",2,21,31,28,13,40.6
"15035",3504,9,1,11,9,1,19,8,7,6,36,1,3,23,12,0,4,1037682,"2023-11-05T00:00:00.000Z",132,7,"Luka Doncic",1,35,44,32,21,49.9
"15036",3505,0,0,1,1,1,2,1,0,0,3,0,1,3,1,0,0,1037682,"2023-11-05T00:00:00.000Z",151,7,"Dante Exum",0,4,4,3,1,4.2
"15037",3506,0,0,0,0,0,0,0,0,0,0,0,0,0,0,0,0,1037682,"2023-11-05T00:00:00.000Z",114,7,"Seth Curry",0,0,0,0,0,0
"15038",3507,0,0,3,3,1,3,1,0,0,13,1,1,3,4,3,0,1037681,"2023-11-05T00:00:00.000Z",666940,6,"Dean Wade",3,7,7,3,4,16.8
"15039",3508,0,0,0,0,0,0,0,0,0,1,0,0,0,0,0,0,1037681,"2023-11-05T00:00:00.000Z",3547299,6,"Sam Merrill",0,0,0,0,0,0
"15040",3509,0,0,0,0,0,0,0,0,0,1,0,0,0,0,0,0,1037681,"2023-11-05T00:00:00.000Z",248,6,"Damian Jones",0,0,0,0,0,0
"15041",3510,0,0,0,0,0,0,0,0,0,0,0,0,0,0,0,0,1037681,"2023-11-05T00:00:00.000Z",56677847,6,"Emoni Bates",0,0,0,0,0,0
"15042",3511,0,0,0,0,0,0,0,0,0,0,0,0,0,0,0,0,1037681,"2023-11-05T00:00:00.000Z",666676,6,"Ty Jerome",0,0,0,0,0,0
"15043",3512,0,0,0,0,0,0,0,0,0,0,0,0,0,0,0,0,1037681,"2023-11-05T00:00:00.000Z",38017662,6,"Isaiah Mobley",0,0,0,0,0,0
"15044",3513,0,0,0,0,0,0,0,0,0,0,0,0,0,0,0,0,1037681,"2023-11-05T00:00:00.000Z",3547247,6,"Isaac Okoro",0,0,0,0,0,0
"15045",3514,0,0,0,0,0,0,0,0,0,0,0,0,0,0,0,0,1037681,"2023-11-05T00:00:00.000Z",56677872,6,"Craig Porter",0,0,0,0,0,0
"15046",3515,0,2,2,4,1,14,5,4,4,20,1,2,15,3,0,1,1037681,"2023-11-05T00:00:00.000Z",17553979,10,"Jonathan Kuminga",2,18,18,15,3,23.6
"15047",3516,0,0,2,2,0,3,1,2,1,14,1,1,3,3,1,0,1037681,"2023-11-05T00:00:00.000Z",17553992,10,"Moses Moody",1,6,6,3,3,9.6
"15048",3517,1,1,3,0,0,3,2,6,1,12,1,4,5,4,1,0,1037681,"2023-11-05T00:00:00.000Z",56677799,10,"Trayce Jackson-Davis",2,9,10,6,5,17.3
"15049",3518,2,0,1,1,0,2,0,0,0,8,1,0,0,2,1,2,1037681,"2023-11-05T00:00:00.000Z",56677858,10,"Brandin Podziemski",1,2,4,2,4,6.4
"15050",3519,0,0,0,0,0,0,0,0,0,3,0,0,0,0,1,0,1037681,"2023-11-05T00:00:00.000Z",251,10,"Cory Joseph",1,0,0,0,0,3
"15051",3520,0,0,0,0,0,0,0,0,0,0,0,0,0,0,0,0,1037681,"2023-11-05T00:00:00.000Z",17896070,10,"Usman Garuba",0,0,0,0,0,0
"15052",3521,0,0,0,0,0,0,0,0,0,0,0,0,0,0,0,0,1037681,"2023-11-05T00:00:00.000Z",45658838,10,"Lester Quinones",0,0,0,0,0,0
"15053",3522,0,0,0,0,0,0,0,0,0,0,0,0,0,0,0,0,1037681,"2023-11-05T00:00:00.000Z",398,10,"Jerome Robinson",0,0,0,0,0,0
"15054",3523,1,2,3,3,2,3,2,0,0,19,0,1,6,3,1,1,1037683,"2023-11-05T00:00:00.000Z",666923,25,"Matisse Thybulle",3,9,10,7,4,19.1
"15055",3524,1,0,2,0,0,1,0,0,0,15,1,0,0,3,0,0,1037682,"2023-11-05T00:00:00.000Z",18678001,4,"JT Thor",0,3,4,1,4,5.1
"15056",3525,1,1,6,0,0,7,6,0,0,21,3,4,12,9,0,0,1037682,"2023-11-05T00:00:00.000Z",3547282,4,"Nick Richards",1,21,22,13,10,27.3
"15057",3526,0,0,0,0,0,0,0,0,0,0,0,0,0,0,0,0,1038090,"2024-01-07T00:00:00.000Z",38017711,25,"Jabari Walker",0,0,0,0,0,0
"15058",3527,4,0,2,3,2,8,3,2,2,30,1,2,10,3,0,2,1038090,"2024-01-07T00:00:00.000Z",56677747,25,"Scoot Henderson",0,13,17,14,7,17.6
"15059",3528,1,1,1,6,3,14,7,7,4,40,0,2,21,1,2,0,1038090,"2024-01-07T00:00:00.000Z",38017690,25,"Shaedon Sharpe",3,22,23,22,2,32.7
"15060",3529,0,0,1,0,0,0,0,0,0,9,2,3,0,3,0,0,1038090,"2024-01-07T00:00:00.000Z",39613724,25,"Ibou Badji",0,3,3,0,3,3.6
"15061",3530,0,0,2,0,0,2,0,0,0,7,1,1,0,3,0,2,1038090,"2024-01-07T00:00:00.000Z",56677791,25,"Kris Murray",0,3,3,0,3,1.6
"15062",3531,0,0,0,0,0,0,0,0,0,0,0,0,0,0,0,0,1038090,"2024-01-07T00:00:00.000Z",666923,25,"Matisse Thybulle",0,0,0,0,0,0
"15063",3532,0,0,0,0,0,0,0,0,0,0,0,0,0,0,0,0,1038090,"2024-01-07T00:00:00.000Z",476,25,"Robert Williams III",0,0,0,0,0,0
"15064",3533,4,0,1,14,7,15,8,3,2,36,1,2,25,2,1,0,1038091,"2024-01-07T00:00:00.000Z",38017724,22,"Caleb Houstan",1,27,31,29,6,36.4
"15065",3534,4,1,9,7,4,29,13,7,5,45,1,2,35,10,3,2,1038091,"2024-01-07T00:00:00.000Z",38017683,22,"Paolo Banchero",4,45,49,39,14,63
"15066",3535,0,0,0,5,2,9,4,0,0,22,1,1,10,1,0,0,1038092,"2024-01-07T00:00:00.000Z",30,26,"Harrison Barnes",0,11,11,10,1,11.2
"15067",3536,0,0,0,6,1,9,2,3,3,26,1,1,8,1,2,0,1038092,"2024-01-07T00:00:00.000Z",38017688,26,"Keegan Murray",2,9,9,8,1,15.2
"15068",3537,6,0,10,2,1,12,8,1,0,29,0,2,17,10,1,3,1038092,"2024-01-07T00:00:00.000Z",406,26,"Domantas Sabonis",1,27,33,23,16,38
"15069",3538,1,0,0,2,0,3,0,2,1,15,0,0,1,0,0,0,1038092,"2024-01-07T00:00:00.000Z",17896030,26,"Chris Duarte",0,1,2,2,1,2.5
"15070",3539,4,0,2,4,1,10,1,0,0,26,0,3,3,2,0,4,1038092,"2024-01-07T00:00:00.000Z",161,26,"De'Aaron Fox",0,5,9,7,6,7.4
"15071",3540,5,1,1,6,2,9,2,0,0,21,0,1,6,1,1,1,1038092,"2024-01-07T00:00:00.000Z",324,26,"Malik Monk",2,7,12,11,6,19.7
"15072",3541,3,1,0,6,2,10,6,4,3,24,1,0,17,1,1,0,1038092,"2024-01-07T00:00:00.000Z",221,26,"Kevin Huerter",2,18,21,20,4,28.7
"15073",3542,2,0,4,1,1,4,3,4,4,22,1,2,11,5,0,1,1038092,"2024-01-07T00:00:00.000Z",3547293,19,"Naji Marshall",0,16,18,13,7,19
"15074",3543,4,1,5,0,0,4,1,0,0,14,2,1,2,7,0,2,1038092,"2024-01-07T00:00:00.000Z",340,19,"Larry Nance Jr.",1,9,13,6,11,17.4
"15075",3544,0,1,0,2,1,4,3,0,0,10,0,1,7,0,0,1,1038092,"2024-01-07T00:00:00.000Z",17896021,19,"Jeremiah Robinson-Earl",1,7,7,7,0,9
"15076",3545,1,0,1,1,1,3,2,2,2,7,1,0,7,2,0,2,1038092,"2024-01-07T00:00:00.000Z",491,19,"Cody Zeller",0,9,10,8,3,8.9
"15077",3546,0,1,0,0,0,0,0,0,0,4,0,1,0,0,0,1,1038092,"2024-01-07T00:00:00.000Z",38017663,19,"E.J. Liddell",1,0,0,0,0,2
"15078",3547,0,0,0,0,0,0,0,0,0,0,0,0,0,0,0,0,1038092,"2024-01-07T00:00:00.000Z",17896097,19,"Jose Alvarado",0,0,0,0,0,0
"15079",3548,0,0,0,0,0,0,0,0,0,0,0,0,0,0,0,0,1038092,"2024-01-07T00:00:00.000Z",3547260,19,"Kira Lewis Jr.",0,0,0,0,0,0
"15080",3549,0,0,0,0,0,0,0,0,0,0,0,0,0,0,0,0,1038092,"2024-01-07T00:00:00.000Z",17896017,19,"Matt Ryan",0,0,0,0,0,0
"15081",3550,0,0,0,0,0,0,0,0,0,0,0,0,0,0,0,0,1038092,"2024-01-07T00:00:00.000Z",38017726,19,"Dereon Seabron",0,0,0,0,0,0
"15082",3551,3,0,3,2,0,5,1,0,0,20,1,1,2,4,0,0,1037948,"2023-12-18T00:00:00.000Z",56677859,7,"Olivier-Maxence Prosper",0,6,9,5,7,11.3
"15083",3552,0,0,3,2,0,3,1,0,0,13,0,1,2,3,0,0,1037948,"2023-12-18T00:00:00.000Z",329,7,"Markieff Morris",0,5,5,2,3,5.6
"15084",3553,0,0,0,0,0,0,0,0,0,7,0,2,0,0,0,0,1037948,"2023-12-18T00:00:00.000Z",114,7,"Seth Curry",0,0,0,0,0,0
"15085",3554,3,1,1,3,2,9,3,2,1,19,0,1,9,1,0,1,1037948,"2023-12-18T00:00:00.000Z",38017679,7,"Jaden Hardy",1,10,13,12,4,16.7
"15086",3555,0,0,1,2,1,4,2,2,1,15,1,2,6,2,0,1,1037948,"2023-12-18T00:00:00.000Z",17554004,7,"AJ Lawson",0,8,8,6,2,7.4
"15087",3556,0,0,1,0,0,3,2,5,1,9,1,1,5,2,0,1,1037948,"2023-12-18T00:00:00.000Z",17896028,7,"Greg Brown III",0,7,7,5,2,6.4
"15088",3557,0,0,3,0,0,4,1,0,0,7,1,0,2,4,0,0,1037948,"2023-12-18T00:00:00.000Z",217,7,"Richaun Holmes",0,6,6,2,4,6.8
"15089",3558,0,0,0,0,0,0,0,0,0,0,0,0,0,0,0,0,1037948,"2023-12-18T00:00:00.000Z",56677873,7,"Dexter Dennis",0,0,0,0,0,0
"15090",3559,0,0,0,0,0,0,0,0,0,0,0,0,0,0,0,0,1037948,"2023-12-18T00:00:00.000Z",3547258,7,"Josh Green",0,0,0,0,0,0
"15091",3560,0,0,0,0,0,0,0,0,0,0,0,0,0,0,0,0,1037948,"2023-12-18T00:00:00.000Z",228,7,"Kyrie Irving",0,0,0,0,0,0
"15092",3561,0,0,0,0,0,0,0,0,0,0,0,0,0,0,0,0,1037948,"2023-12-18T00:00:00.000Z",257,7,"Maxi Kleber",0,0,0,0,0,0
"15093",3562,0,0,0,0,0,0,0,0,0,0,0,0,0,0,0,0,1037948,"2023-12-18T00:00:00.000Z",56677840,7,"Dereck Lively II",0,0,0,0,0,0
"15094",3563,0,0,0,4,2,11,8,1,1,33,0,1,19,0,1,1,1037950,"2023-12-18T00:00:00.000Z",30,26,"Harrison Barnes",1,19,19,19,0,21
"15095",3564,4,0,4,7,4,17,9,3,3,32,1,4,25,5,1,0,1037950,"2023-12-18T00:00:00.000Z",38017688,26,"Keegan Murray",1,30,34,29,9,40
"15096",3565,12,1,10,1,1,16,11,6,5,32,3,1,28,13,0,2,1037950,"2023-12-18T00:00:00.000Z",406,26,"Domantas Sabonis",1,41,53,40,25,62.6
"15097",3566,2,1,4,4,1,8,4,2,2,23,0,4,11,4,0,0,1037950,"2023-12-18T00:00:00.000Z",221,26,"Kevin Huerter",1,15,17,13,6,21.8
"15098",3567,6,1,5,7,2,19,10,12,8,33,0,2,30,5,3,1,1037950,"2023-12-18T00:00:00.000Z",161,26,"De'Aaron Fox",4,35,41,36,11,56
"15099",3568,6,1,1,6,3,7,3,2,1,21,0,3,10,1,0,1,1037950,"2023-12-18T00:00:00.000Z",324,26,"Malik Monk",1,11,17,16,7,22.2
"15100",3569,2,1,1,5,1,5,1,0,0,15,0,4,3,1,1,0,1037950,"2023-12-18T00:00:00.000Z",38017714,26,"Keon Ellis",2,4,6,5,3,13.2
"15101",3570,0,0,2,3,0,3,0,0,0,18,0,0,0,2,0,0,1037950,"2023-12-18T00:00:00.000Z",290,26,"Trey Lyles",0,2,2,0,2,2.4
"15102",3571,1,0,3,3,2,5,3,0,0,12,4,1,8,7,2,1,1037950,"2023-12-18T00:00:00.000Z",4197162,26,"Aleksandar Vezenkov",2,15,16,9,8,22.9
"15103",3572,0,0,1,0,0,1,1,0,0,5,0,3,2,1,0,0,1037950,"2023-12-18T00:00:00.000Z",666925,26,"Juan Toscano-Anderson",0,3,3,2,1,3.2
"15104",3573,0,0,0,1,0,1,0,0,0,4,0,0,0,0,0,0,1037950,"2023-12-18T00:00:00.000Z",17896030,26,"Chris Duarte",0,0,0,0,0,0
"15105",3574,1,0,1,2,1,2,1,0,0,4,0,0,3,1,0,1,1037950,"2023-12-18T00:00:00.000Z",17896044,26,"Kessler Edwards",0,4,5,4,2,4.7
"15106",3575,1,0,1,0,0,2,1,0,0,4,0,0,2,1,0,0,1037950,"2023-12-18T00:00:00.000Z",17553994,26,"Davion Mitchell",0,3,4,3,2,4.7
"15107",3576,0,0,0,0,0,0,0,0,0,0,0,0,0,0,0,0,1037841,"2023-11-27T00:00:00.000Z",56677856,13,"Jordan Miller",0,0,0,0,0,0
"15108",3577,0,0,0,0,0,0,0,0,0,0,0,0,0,0,0,0,1037841,"2023-11-27T00:00:00.000Z",24417679,13,"Xavier Moon",0,0,0,0,0,0
"15109",3578,0,0,0,0,0,0,0,0,0,0,0,0,0,0,0,0,1037841,"2023-11-27T00:00:00.000Z",17896022,13,"Brandon Boston Jr.",0,0,0,0,0,0
"15110",3579,0,0,0,0,0,0,0,0,0,0,0,0,0,0,0,0,1037841,"2023-11-27T00:00:00.000Z",371,13,"Mason Plumlee",0,0,0,0,0,0
"15111",3580,0,0,0,0,0,0,0,0,0,0,0,0,0,0,0,0,1037841,"2023-11-27T00:00:00.000Z",17896051,13,"Joshua Primo",0,0,0,0,0,0
"15112",3581,3,0,7,7,2,13,3,0,0,29,3,5,8,10,0,1,1037841,"2023-11-27T00:00:00.000Z",375,8,"Michael Porter Jr.",0,18,21,11,13,23.5
"15113",3582,1,0,5,4,2,8,5,0,0,34,1,2,12,6,1,3,1037841,"2023-11-27T00:00:00.000Z",215,8,"Justin Holiday",1,18,19,13,7,20.7
"15114",3583,5,1,10,0,0,11,8,11,5,33,3,3,21,13,2,2,1037841,"2023-11-27T00:00:00.000Z",250,8,"DeAndre Jordan",3,34,39,26,18,51.1
"15115",3584,2,0,1,1,0,14,3,6,6,38,2,2,12,3,1,0,1037841,"2023-11-27T00:00:00.000Z",81,8,"Kentavious Caldwell-Pope",1,15,17,14,5,21.6
"15116",3585,13,0,4,4,3,19,15,4,2,40,1,3,35,5,2,2,1037841,"2023-11-27T00:00:00.000Z",236,8,"Reggie Jackson",2,40,53,48,18,64.5
"15117",3586,1,1,3,0,0,7,4,2,0,23,0,0,8,3,2,1,1037841,"2023-11-27T00:00:00.000Z",38017721,8,"Peyton Watson",3,11,12,9,4,21.1
"15118",3587,0,3,0,0,0,8,3,5,2,11,7,2,8,7,0,1,1037841,"2023-11-27T00:00:00.000Z",3547268,8,"Zeke Nnaji",3,15,15,8,7,24.4
"15119",3588,2,0,1,1,0,4,0,0,0,12,1,4,0,2,0,0,1037841,"2023-11-27T00:00:00.000Z",38017709,8,"Christian Braun",0,2,4,2,4,5.4
"15120",3589,1,1,3,5,3,8,3,0,0,19,0,1,9,3,0,1,1037841,"2023-11-27T00:00:00.000Z",56677776,8,"Julian Strawther",1,12,13,10,4,16.1
"15121",3590,0,0,0,0,0,0,0,0,0,1,0,0,0,0,0,0,1037841,"2023-11-27T00:00:00.000Z",17896103,8,"Jay Huff",0,0,0,0,0,0
"15122",3591,0,0,0,0,0,0,0,0,0,0,0,0,0,0,0,0,1037841,"2023-11-27T00:00:00.000Z",38017727,8,"Collin Gillespie",0,0,0,0,0,0
"15123",3592,0,0,0,0,0,0,0,0,0,0,0,0,0,0,0,0,1037841,"2023-11-27T00:00:00.000Z",17896007,8,"Braxton Key",0,0,0,0,0,0
"15124",3593,0,0,0,0,0,0,0,0,0,0,0,0,0,0,0,0,1037841,"2023-11-27T00:00:00.000Z",56677582,8,"Jalen Pickett",0,0,0,0,0,0
"15125",3594,0,0,0,0,0,0,0,0,0,0,0,0,0,0,0,0,1037841,"2023-11-27T00:00:00.000Z",666489,8,"Vlatko Cancar",0,0,0,0,0,0
"15126",3595,0,0,0,0,0,0,0,0,0,0,0,0,0,0,0,0,1037841,"2023-11-27T00:00:00.000Z",177,8,"Aaron Gordon",0,0,0,0,0,0
"15127",3596,7,0,2,7,3,13,7,4,3,37,1,2,20,3,0,0,3277530,"2023-11-28T00:00:00.000Z",391,16,"Josh Richardson",0,23,30,27,10,34.1
"15128",3597,4,0,6,5,2,11,2,0,0,26,4,2,6,10,0,0,3277530,"2023-11-28T00:00:00.000Z",285,16,"Kevin Love",0,16,20,10,14,24
"15129",3598,5,2,8,0,0,27,13,7,5,42,2,3,31,10,0,2,3277530,"2023-11-28T00:00:00.000Z",4,16,"Bam Adebayo",2,41,46,36,15,54.5
"15130",3599,3,1,3,7,3,11,5,2,0,31,0,3,13,3,0,2,3277530,"2023-11-28T00:00:00.000Z",397,16,"Duncan Robinson",1,16,19,16,6,22.1
"15131",3600,6,1,4,5,3,10,7,4,4,34,0,5,21,4,1,1,3277530,"2023-11-28T00:00:00.000Z",286,16,"Kyle Lowry",2,25,31,27,10,39.8
"15132",3601,0,0,0,0,0,0,0,0,0,0,0,0,0,0,0,0,1037694,"2023-11-06T00:00:00.000Z",38017689,1,"AJ Griffin",0,0,0,0,0,0
"15133",3602,0,0,0,0,0,0,0,0,0,0,0,0,0,0,0,0,1037692,"2023-11-06T00:00:00.000Z",47738533,11,"Jeenathan Williams",0,0,0,0,0,0
"15134",3603,1,0,0,4,0,6,1,2,1,22,0,0,3,0,0,0,1037692,"2023-11-06T00:00:00.000Z",30,26,"Harrison Barnes",0,3,4,4,1,4.5
"15135",3604,1,0,5,6,2,11,5,0,0,28,0,3,12,5,1,2,1037692,"2023-11-06T00:00:00.000Z",38017688,26,"Keegan Murray",1,17,18,13,6,20.5
"15136",3605,5,0,5,0,0,4,3,3,2,30,3,4,8,8,0,4,1037692,"2023-11-06T00:00:00.000Z",406,26,"Domantas Sabonis",0,16,21,13,13,21.1
"15137",3606,2,0,3,8,3,10,5,1,0,25,0,0,13,3,1,3,1037692,"2023-11-06T00:00:00.000Z",221,26,"Kevin Huerter",1,16,18,15,5,19.6
"15138",3607,2,1,0,5,1,11,2,0,0,27,1,2,5,1,0,0,1037692,"2023-11-06T00:00:00.000Z",17553994,26,"Davion Mitchell",1,6,8,7,3,12.2
"15139",3608,6,0,1,4,2,13,5,0,0,33,0,2,12,1,2,0,1037687,"2023-11-06T00:00:00.000Z",249,30,"Tyus Jones",2,13,19,18,7,28.2
"15140",3609,0,1,3,3,1,7,3,3,3,19,0,3,10,3,0,0,1037687,"2023-11-06T00:00:00.000Z",56677844,30,"Bilal Coulibaly",1,13,13,10,3,16.6
"15141",3610,1,1,4,6,2,14,5,10,8,36,1,5,20,5,1,1,1037693,"2023-11-06T00:00:00.000Z",378,2,"Kristaps Porzingis",2,25,26,21,6,32.5
"15142",3611,4,0,7,8,3,21,10,4,3,39,0,5,26,7,1,3,1037693,"2023-11-06T00:00:00.000Z",70,2,"Jaylen Brown",1,33,37,30,11,40.4
"15143",3612,6,0,8,4,0,16,4,6,4,42,3,3,12,11,1,3,1037693,"2023-11-06T00:00:00.000Z",214,2,"Jrue Holiday",1,23,29,18,17,34.2
"15144",3613,0,0,1,0,0,1,0,0,0,4,0,0,0,1,1,0,1037693,"2023-11-06T00:00:00.000Z",3547279,2,"Lamar Stevens",1,1,1,0,1,4.2
"15145",3614,0,1,3,8,3,8,3,2,2,25,1,3,11,4,1,1,1037693,"2023-11-06T00:00:00.000Z",17896060,2,"Sam Hauser",2,15,15,11,4,20.8
"15146",3615,3,0,3,1,0,3,0,0,0,20,3,2,0,6,0,0,1037693,"2023-11-06T00:00:00.000Z",3547276,2,"Payton Pritchard",0,6,9,3,9,11.7
"15147",3616,0,0,8,1,0,8,3,1,1,25,6,3,7,14,0,2,1037694,"2023-11-06T00:00:00.000Z",3547244,1,"Onyeka Okongwu",0,21,21,7,14,21.8
"15148",3617,0,0,0,0,0,0,0,0,0,0,0,0,0,0,0,0,1037694,"2023-11-06T00:00:00.000Z",319,1,"Patty Mills",0,0,0,0,0,0
"15149",3618,0,0,0,0,0,0,0,0,0,0,0,0,0,0,0,0,1037694,"2023-11-06T00:00:00.000Z",56677838,1,"Kobe Bufkin",0,0,0,0,0,0
"15150",3619,0,0,0,0,0,0,0,0,0,0,0,0,0,0,0,0,1037694,"2023-11-06T00:00:00.000Z",56677855,1,"Seth Lundy",0,0,0,0,0,0
"15151",3620,0,0,0,0,0,0,0,0,0,0,0,0,0,0,0,0,1037694,"2023-11-06T00:00:00.000Z",301,1,"Wesley Matthews",0,0,0,0,0,0
"15152",3621,0,0,0,0,0,0,0,0,0,0,0,0,0,0,0,0,1037694,"2023-11-06T00:00:00.000Z",56677875,1,"Miles Norris",0,0,0,0,0,0
"15153",3622,0,0,0,0,0,0,0,0,0,0,0,0,0,0,0,0,1037693,"2023-11-06T00:00:00.000Z",17553967,2,"Neemias Queta",0,0,0,0,0,0
"15154",3623,0,0,0,0,0,0,0,0,0,0,0,0,0,0,0,0,1037693,"2023-11-06T00:00:00.000Z",56677864,2,"Jordan Walsh",0,0,0,0,0,0
"15155",3624,0,0,0,0,0,0,0,0,0,0,0,0,0,0,0,0,1037693,"2023-11-06T00:00:00.000Z",473,2,"Derrick White",0,0,0,0,0,0
"15156",3625,5,1,6,4,0,15,6,2,1,34,6,2,13,12,3,0,1037694,"2023-11-06T00:00:00.000Z",17896040,1,"Jalen Johnson",4,25,30,18,17,46.9
"15157",3626,1,0,3,2,1,8,4,2,2,31,2,5,11,5,1,0,1038094,"2024-01-07T00:00:00.000Z",17896071,9,"Isaiah Livers",1,16,17,12,6,21.5
"15158",3627,0,0,0,0,0,0,0,0,0,0,0,0,0,0,0,0,1038095,"2024-01-07T00:00:00.000Z",18678058,24,"Jordan Goodwin",0,0,0,0,0,0
"15159",3628,0,0,0,0,0,0,0,0,0,0,0,0,0,0,0,0,1038095,"2024-01-07T00:00:00.000Z",470,24,"Yuta Watanabe",0,0,0,0,0,0
"15160",3629,6,1,9,8,3,20,11,4,3,32,1,5,28,10,0,2,1038095,"2024-01-07T00:00:00.000Z",231,15,"Jaren Jackson Jr.",1,38,44,34,16,50
"15161",3630,2,3,5,0,0,2,0,2,1,26,1,3,1,6,0,2,1038095,"2024-01-07T00:00:00.000Z",48,15,"Bismack Biyombo",3,7,9,3,8,18.2
"15162",3631,4,0,3,0,0,12,8,6,4,30,2,1,20,5,0,1,1038094,"2024-01-07T00:00:00.000Z",38017694,9,"Jalen Duren",0,25,29,24,9,31
"15163",3632,6,0,3,6,0,11,4,8,5,27,1,2,13,4,1,4,1038094,"2024-01-07T00:00:00.000Z",38017682,9,"Jaden Ivey",1,17,23,19,10,25.8
"15164",3633,3,0,3,2,1,6,1,0,0,11,0,2,3,3,0,0,1038094,"2024-01-07T00:00:00.000Z",17896075,9,"Cade Cunningham",0,6,9,6,6,11.1
"15165",3634,6,0,2,1,0,5,1,0,0,25,0,4,2,2,1,1,1038094,"2024-01-07T00:00:00.000Z",3547241,9,"Killian Hayes",1,4,10,8,8,15.4
"15166",3635,1,0,3,3,3,9,6,3,3,20,1,1,18,4,0,1,1038094,"2024-01-07T00:00:00.000Z",77,9,"Alec Burks",0,22,23,19,5,23.3
"15167",3636,0,0,0,0,0,0,0,0,0,0,0,0,0,0,0,0,1038093,"2024-01-07T00:00:00.000Z",320,18,"Shake Milton",0,0,0,0,0,0
"15168",3637,0,0,0,0,0,0,0,0,0,0,0,0,0,0,0,0,1038093,"2024-01-07T00:00:00.000Z",38017715,18,"Josh Minott",0,0,0,0,0,0
"15169",3638,0,0,0,0,0,0,0,0,0,0,0,0,0,0,0,0,1038093,"2024-01-07T00:00:00.000Z",56677851,18,"Jaylen Clark",0,0,0,0,0,0
"15170",3639,0,0,0,0,0,0,0,0,0,0,0,0,0,0,0,0,1038096,"2024-01-07T00:00:00.000Z",185,10,"Draymond Green",0,0,0,0,0,0
"15171",3640,0,0,0,1,0,3,0,0,0,3,3,1,0,3,0,0,1038095,"2024-01-07T00:00:00.000Z",3547285,15,"Xavier Tillman",0,3,3,0,3,3.6
"15172",3641,5,1,3,7,2,14,8,5,5,36,2,3,23,5,1,3,1038095,"2024-01-07T00:00:00.000Z",3547287,15,"Desmond Bane",2,28,33,28,10,39.5
"15173",3642,8,0,6,13,4,20,9,5,3,38,0,2,25,6,3,5,1038095,"2024-01-07T00:00:00.000Z",420,15,"Marcus Smart",3,31,39,33,14,48.2
"15174",3643,1,2,5,4,3,11,6,4,4,37,4,2,19,9,0,0,1038095,"2024-01-07T00:00:00.000Z",38017731,15,"Vince Williams Jr.",2,28,29,20,10,37.3
"15175",3644,3,0,2,5,1,10,4,1,0,27,2,4,9,4,2,1,1038095,"2024-01-07T00:00:00.000Z",17896027,15,"Ziaire Williams",2,13,16,12,7,23.3
"15176",3645,1,1,5,7,1,11,2,3,2,16,2,2,7,7,1,4,1038095,"2024-01-07T00:00:00.000Z",17896067,15,"Santi Aldama",2,14,15,8,8,18.9
"15177",3646,0,0,1,1,0,1,0,0,0,3,0,0,0,1,0,0,1038095,"2024-01-07T00:00:00.000Z",666703,15,"John Konchar",0,1,1,0,1,1.2
"15178",3647,0,0,0,0,0,0,0,0,0,0,0,0,0,0,0,0,1038095,"2024-01-07T00:00:00.000Z",38017729,15,"David Roddy",0,0,0,0,0,0
"15179",3648,0,0,0,0,0,0,0,0,0,0,0,0,0,0,0,0,1038093,"2024-01-07T00:00:00.000Z",17896056,18,"Luka Garza",0,0,0,0,0,0
"15180",3649,0,0,0,0,0,0,0,0,0,0,0,0,0,0,0,0,1038093,"2024-01-07T00:00:00.000Z",17895968,18,"Daishen Nix",0,0,0,0,0,0
"15181",3650,0,0,0,0,0,0,0,0,0,0,0,0,0,0,0,0,1038095,"2024-01-07T00:00:00.000Z",401,15,"Derrick Rose",0,0,0,0,0,0
"15182",3651,0,0,0,0,0,0,0,0,0,0,0,0,0,0,0,0,1037958,"2023-12-20T00:00:00.000Z",56677839,22,"Jett Howard",0,0,0,0,0,0
"15183",3652,1,0,2,2,2,3,3,0,0,16,0,4,8,2,0,4,1037956,"2023-12-20T00:00:00.000Z",139,29,"Kris Dunn",0,10,11,9,3,7.9
"15184",3653,6,2,1,1,0,3,2,2,1,20,1,0,5,2,1,3,1037956,"2023-12-20T00:00:00.000Z",358,29,"Kelly Olynyk",3,7,13,11,8,22.4
"15185",3654,0,0,0,0,0,0,0,0,0,0,0,0,0,0,0,0,1037956,"2023-12-20T00:00:00.000Z",56677824,29,"Taylor Hendricks",0,0,0,0,0,0
"15186",3655,0,0,0,0,0,0,0,0,0,0,0,0,0,0,0,0,1037956,"2023-12-20T00:00:00.000Z",666881,29,"Luka Samanic",0,0,0,0,0,0
"15187",3656,0,0,0,0,0,0,0,0,0,0,0,0,0,0,0,0,1037956,"2023-12-20T00:00:00.000Z",11891374,29,"Omer Yurtseven",0,0,0,0,0,0
"15188",3657,0,0,0,0,0,0,0,0,0,0,0,0,0,0,0,0,1037956,"2023-12-20T00:00:00.000Z",17896023,29,"Josh Christopher",0,0,0,0,0,0
"15189",3658,0,0,0,0,0,0,0,0,0,0,0,0,0,0,0,0,1037956,"2023-12-20T00:00:00.000Z",100,29,"Jordan Clarkson",0,0,0,0,0,0
"15190",3659,4,0,2,4,1,7,1,2,2,29,1,1,5,3,2,0,1037955,"2023-12-19T00:00:00.000Z",178,24,"Eric Gordon",2,8,12,9,7,20.6
"15191",3660,2,1,3,2,0,7,1,0,0,20,3,2,2,6,0,1,1037955,"2023-12-19T00:00:00.000Z",18678058,24,"Jordan Goodwin",1,8,10,4,8,14.2
"15192",3661,0,0,0,0,0,0,0,0,0,0,0,0,0,0,0,0,1037956,"2023-12-20T00:00:00.000Z",56677834,29,"Keyonte George",0,0,0,0,0,0
"15193",3662,0,0,0,0,0,0,0,0,0,0,0,0,0,0,0,0,1037956,"2023-12-20T00:00:00.000Z",38017630,29,"Johnny Juzang",0,0,0,0,0,0
"15194",3663,0,0,0,0,0,0,0,0,0,0,0,0,0,0,0,0,1037956,"2023-12-20T00:00:00.000Z",19465584,29,"Micah Potter",0,0,0,0,0,0
"15195",3664,0,0,1,7,2,10,4,2,2,27,3,1,12,4,0,1,1037957,"2023-12-20T00:00:00.000Z",666950,4,"P.J. Washington",0,16,16,12,4,15.8
"15196",3665,0,0,0,0,0,0,0,2,2,6,1,2,2,1,0,0,1037957,"2023-12-20T00:00:00.000Z",18678001,4,"JT Thor",0,3,3,2,1,3.2
"15197",3666,0,0,0,0,0,0,0,0,0,0,0,0,0,0,0,0,1037957,"2023-12-20T00:00:00.000Z",56677848,4,"Amari Bailey",0,0,0,0,0,0
"15198",3667,0,0,0,0,0,0,0,0,0,0,0,0,0,0,0,0,1037957,"2023-12-20T00:00:00.000Z",3547239,4,"LaMelo Ball",0,0,0,0,0,0
"15199",3668,0,0,0,0,0,0,0,0,0,0,0,0,0,0,0,0,1037957,"2023-12-20T00:00:00.000Z",666748,4,"Cody Martin",0,0,0,0,0,0
"15200",3669,0,0,0,0,0,0,0,0,0,0,0,0,0,0,0,0,1037957,"2023-12-20T00:00:00.000Z",347,4,"Frank Ntilikina",0,0,0,0,0,0
"15201",3670,0,0,0,0,0,0,0,0,0,0,0,0,0,0,0,0,1037957,"2023-12-20T00:00:00.000Z",38017698,4,"Mark Williams",0,0,0,0,0,0
"15202",3671,0,0,0,0,0,1,1,2,1,7,0,1,3,0,0,0,1037959,"2023-12-20T00:00:00.000Z",3547294,23,"Kenyon Martin Jr.",0,3,3,3,0,3
"15203",3672,0,0,0,0,0,1,0,0,0,2,0,0,0,0,0,0,1037959,"2023-12-20T00:00:00.000Z",260,23,"Furkan Korkmaz",0,0,0,0,0,0
"15204",3673,0,0,0,0,0,0,0,0,0,2,0,0,0,0,0,0,1037959,"2023-12-20T00:00:00.000Z",28,23,"Mo Bamba",0,0,0,0,0,0
"15205",3674,0,0,0,0,0,0,0,0,0,0,0,0,0,0,0,0,1037958,"2023-12-20T00:00:00.000Z",226,22,"Joe Ingles",0,0,0,0,0,0
"15206",3675,0,0,0,0,0,0,0,0,0,0,0,0,0,0,0,0,1037958,"2023-12-20T00:00:00.000Z",17553983,22,"Trevelin Queen",0,0,0,0,0,0
"15207",3676,2,0,3,3,0,3,0,0,0,17,0,0,0,3,0,0,3277529,"2023-11-28T00:00:00.000Z",301,1,"Wesley Matthews",0,3,5,2,5,6.6
"15208",3677,0,0,0,0,0,1,0,0,0,4,0,0,0,0,0,0,3277529,"2023-11-28T00:00:00.000Z",3547297,1,"Trent Forrest",0,0,0,0,0,0
"15209",3678,0,0,1,0,0,6,1,0,0,4,2,1,2,3,0,1,3277529,"2023-11-28T00:00:00.000Z",666564,1,"Bruno Fernando",0,5,5,2,3,4.6
"15210",3679,0,0,1,1,0,1,0,0,0,4,0,0,0,1,0,0,3277529,"2023-11-28T00:00:00.000Z",666754,1,"Garrison Mathews",0,1,1,0,1,1.2
"15211",3680,0,0,0,0,0,0,0,0,0,0,0,0,0,0,0,0,3277529,"2023-11-28T00:00:00.000Z",319,1,"Patty Mills",0,0,0,0,0,0
"15212",3681,0,0,0,0,0,0,0,0,0,0,0,0,0,0,0,0,3277529,"2023-11-28T00:00:00.000Z",56677838,1,"Kobe Bufkin",0,0,0,0,0,0
"15213",3682,0,0,0,0,0,0,0,0,0,0,0,0,0,0,0,0,3277529,"2023-11-28T00:00:00.000Z",56677806,1,"Mouhamed Gueye",0,0,0,0,0,0
"15214",3683,0,0,0,0,0,0,0,0,0,0,0,0,0,0,0,0,3277529,"2023-11-28T00:00:00.000Z",17896040,1,"Jalen Johnson",0,0,0,0,0,0
"15215",3684,0,0,0,0,0,0,0,0,0,0,0,0,0,0,0,0,3277529,"2023-11-28T00:00:00.000Z",56677855,1,"Seth Lundy",0,0,0,0,0,0
"15216",3685,0,0,0,0,0,0,0,0,0,0,0,0,0,0,0,0,3277529,"2023-11-28T00:00:00.000Z",56677875,1,"Miles Norris",0,0,0,0,0,0
"15217",3686,2,0,8,4,0,18,6,7,5,35,2,2,17,10,1,2,3277528,"2023-11-28T00:00:00.000Z",416,28,"Pascal Siakam",1,27,29,19,12,33
"15218",3687,4,2,6,0,0,5,3,0,0,25,3,2,6,9,1,1,3277528,"2023-11-28T00:00:00.000Z",373,28,"Jakob Poeltl",3,15,19,10,13,30.8
"15219",3688,6,0,7,7,3,19,5,5,4,36,4,4,17,11,3,1,3277528,"2023-11-28T00:00:00.000Z",17896055,28,"Scottie Barnes",3,28,34,23,17,47.2
"15220",3689,9,0,4,5,2,15,5,3,2,32,1,3,14,5,1,0,3277528,"2023-11-28T00:00:00.000Z",409,28,"Dennis Schroder",1,19,28,23,14,36.5
"15221",3690,1,0,2,4,1,12,7,0,0,25,0,1,15,2,1,0,3277528,"2023-11-28T00:00:00.000Z",3089,28,"Gary Trent Jr.",1,17,18,16,3,21.9
"15222",3691,1,0,2,2,0,4,0,4,1,10,1,3,1,3,1,1,3277528,"2023-11-28T00:00:00.000Z",3547249,28,"Precious Achiuwa",1,4,5,2,4,8.1
"15223",3692,1,0,0,3,1,5,2,0,0,16,0,1,5,0,0,0,3277528,"2023-11-28T00:00:00.000Z",3547275,28,"Malachi Flynn",0,5,6,6,1,6.5
"15224",3693,10,0,1,8,2,14,3,6,5,32,0,3,13,1,1,3,3277529,"2023-11-28T00:00:00.000Z",490,1,"Trae Young",1,14,24,23,11,29.2
"15225",3694,1,0,5,10,4,16,6,2,2,31,1,2,18,6,2,1,3277529,"2023-11-28T00:00:00.000Z",53,1,"Bogdan Bogdanovic",2,24,25,19,7,31.7
"15226",3695,6,1,6,8,3,23,12,5,3,35,2,1,30,8,0,3,3277527,"2023-11-28T00:00:00.000Z",70,2,"Jaylen Brown",1,38,44,36,14,48.6
"15227",3696,4,0,6,8,2,16,8,3,3,35,1,2,21,7,0,4,3277527,"2023-11-28T00:00:00.000Z",434,2,"Jayson Tatum",0,28,32,25,11,31.4
"15228",3697,6,3,9,6,4,8,6,0,0,28,0,3,16,9,2,3,3277527,"2023-11-28T00:00:00.000Z",219,2,"Al Horford",5,25,31,22,15,47.8
"15229",3698,7,0,3,3,2,7,5,2,2,28,0,4,14,3,2,0,3277527,"2023-11-28T00:00:00.000Z",473,2,"Derrick White",2,17,24,21,10,34.1
"15230",3699,9,0,6,5,4,8,5,0,0,33,1,3,14,7,1,3,3277527,"2023-11-28T00:00:00.000Z",214,2,"Jrue Holiday",1,21,30,23,16,35.9
"15231",3700,2,0,6,10,2,12,3,2,1,21,4,1,9,10,0,2,3277527,"2023-11-28T00:00:00.000Z",17896060,2,"Sam Hauser",0,19,21,11,12,22
"15232",3701,1,0,2,2,1,7,3,2,2,17,1,1,9,3,0,0,1037705,"2023-11-08T00:00:00.000Z",38017726,19,"Dereon Seabron",0,12,13,10,4,14.1
"15233",3702,2,0,1,3,1,4,2,2,1,12,0,0,6,1,0,0,1037707,"2023-11-08T00:00:00.000Z",38017679,7,"Jaden Hardy",0,7,9,8,3,10.2
"15234",3703,7,2,8,4,0,15,4,8,6,39,6,2,14,14,4,0,1037707,"2023-11-08T00:00:00.000Z",17896055,28,"Scottie Barnes",6,28,35,21,21,59.3
"15235",3704,5,1,2,4,1,13,7,4,3,30,0,4,18,2,2,2,1037707,"2023-11-08T00:00:00.000Z",409,28,"Dennis Schroder",3,20,25,23,7,34.9
"15236",3705,1,0,2,8,4,11,6,0,0,26,0,0,16,2,1,0,1037707,"2023-11-08T00:00:00.000Z",3089,28,"Gary Trent Jr.",1,18,19,17,3,22.9
"15237",3706,0,0,0,0,0,1,0,0,0,6,0,1,0,0,0,2,1037707,"2023-11-08T00:00:00.000Z",56677828,28,"Gradey Dick",0,0,0,0,0,-2
"15238",3707,3,0,4,4,2,5,2,2,2,15,0,2,8,4,0,0,1037707,"2023-11-08T00:00:00.000Z",3547275,28,"Malachi Flynn",0,12,15,11,7,17.3
"15239",3708,0,0,3,2,0,3,0,0,0,15,0,1,0,3,1,0,1037707,"2023-11-08T00:00:00.000Z",376,28,"Otto Porter Jr.",1,3,3,0,3,6.6
"15240",3709,2,0,5,2,0,13,7,5,4,27,1,1,18,6,0,3,1037702,"2023-11-08T00:00:00.000Z",237,14,"LeBron James",0,24,26,20,8,25.2
"15241",3710,2,2,6,8,3,17,7,0,0,37,2,1,17,8,0,0,1037708,"2023-11-08T00:00:00.000Z",375,8,"Michael Porter Jr.",2,25,27,19,10,35.6
"15242",3711,3,1,7,2,1,14,5,4,3,34,4,2,14,11,3,2,1037708,"2023-11-08T00:00:00.000Z",177,8,"Aaron Gordon",4,25,28,17,14,41.7
"15243",3712,5,1,10,8,1,25,14,10,6,37,3,3,35,13,3,3,1037708,"2023-11-08T00:00:00.000Z",246,8,"Nikola Jokic",4,48,53,40,18,67.1
"15244",3713,3,0,2,3,0,8,3,4,4,35,1,3,10,3,1,0,1037708,"2023-11-08T00:00:00.000Z",81,8,"Kentavious Caldwell-Pope",1,13,16,13,6,21.1
"15245",3714,6,0,2,7,3,17,8,2,1,32,0,5,20,2,0,0,1037708,"2023-11-08T00:00:00.000Z",236,8,"Reggie Jackson",0,22,28,26,8,31.4
"15246",3715,1,0,0,2,1,2,1,0,0,16,0,2,3,0,0,1,1037708,"2023-11-08T00:00:00.000Z",38017727,8,"Collin Gillespie",0,3,4,4,1,3.5
"15247",3716,2,0,2,2,1,3,1,2,1,16,0,1,4,2,0,0,1037708,"2023-11-08T00:00:00.000Z",38017709,8,"Christian Braun",0,6,8,6,4,9.4
"15248",3717,0,0,0,0,0,0,0,0,0,0,0,0,0,0,0,0,1037705,"2023-11-08T00:00:00.000Z",303,19,"CJ McCollum",0,0,0,0,0,0
"15249",3718,0,0,0,0,0,0,0,0,0,0,0,0,0,0,0,0,1037705,"2023-11-08T00:00:00.000Z",18677986,19,"Trey Murphy III",0,0,0,0,0,0
"15250",3719,0,0,0,0,0,0,0,0,0,0,0,0,0,0,0,0,1037703,"2023-11-08T00:00:00.000Z",285,16,"Kevin Love",0,0,0,0,0,0
"15251",3720,0,0,0,0,0,0,0,0,0,0,0,0,0,0,0,0,1037703,"2023-11-08T00:00:00.000Z",39398582,16,"Orlando Robinson",0,0,0,0,0,0
"15252",3721,0,0,4,2,0,4,2,0,0,21,1,5,4,5,1,2,1037697,"2023-11-08T00:00:00.000Z",358,29,"Kelly Olynyk",1,9,9,4,5,11
"15253",3722,5,1,2,1,0,8,3,0,0,20,2,1,6,4,0,4,1037697,"2023-11-08T00:00:00.000Z",666650,29,"Talen Horton-Tucker",1,10,15,11,9,17.3
"15254",3723,2,0,2,2,1,9,3,3,3,16,0,0,10,2,0,0,1037697,"2023-11-08T00:00:00.000Z",413,29,"Collin Sexton",0,12,14,12,4,15.4
"15255",3724,4,0,4,13,6,17,6,5,5,34,1,2,23,5,1,3,1037708,"2023-11-08T00:00:00.000Z",115,10,"Stephen Curry",1,28,32,27,9,35
"15256",3725,4,0,4,4,1,10,4,0,0,27,1,2,9,5,1,1,1037708,"2023-11-08T00:00:00.000Z",367,10,"Chris Paul",1,14,18,13,9,23
"15257",3726,5,0,0,1,0,3,2,0,0,16,0,1,4,0,1,1,1038105,"2024-01-09T00:00:00.000Z",666767,18,"Jordan McLaughlin",1,4,9,9,5,13.5
"15258",3727,0,0,0,0,0,2,2,0,0,2,0,0,4,0,0,0,1038105,"2024-01-09T00:00:00.000Z",320,18,"Shake Milton",0,4,4,4,0,4
"15259",3728,1,0,1,2,0,2,0,0,0,2,0,0,0,1,0,0,1038105,"2024-01-09T00:00:00.000Z",68,18,"Troy Brown Jr.",0,1,2,1,2,2.7
"15260",3729,0,0,0,0,0,0,0,0,0,0,0,0,0,0,0,0,1038105,"2024-01-09T00:00:00.000Z",56677851,18,"Jaylen Clark",0,0,0,0,0,0
"15261",3730,0,0,0,0,0,0,0,0,0,0,0,0,0,0,0,0,1038091,"2024-01-07T00:00:00.000Z",85,22,"Wendell Carter Jr.",0,0,0,0,0,0
"15262",3731,1,0,3,3,2,6,2,2,1,20,1,1,7,4,2,5,1038097,"2024-01-07T00:00:00.000Z",666860,14,"Cameron Reddish",2,11,12,8,5,14.3
"15263",3732,7,0,7,3,1,19,11,3,2,38,1,2,25,8,1,4,1038097,"2024-01-07T00:00:00.000Z",237,14,"LeBron James",1,33,40,32,15,44.1
"15264",3733,1,1,9,1,0,15,10,4,2,39,1,1,22,10,3,3,1038097,"2024-01-07T00:00:00.000Z",117,14,"Anthony Davis",4,32,33,23,11,44.5
"15265",3734,2,0,1,6,3,8,4,2,2,30,0,3,13,1,1,0,1038097,"2024-01-07T00:00:00.000Z",383,14,"Taurean Prince",1,14,16,15,3,20.2
"15266",3735,2,0,0,3,0,5,2,5,4,32,0,0,8,0,0,2,1038097,"2024-01-07T00:00:00.000Z",17553995,14,"Austin Reaves",0,8,10,10,2,9
"15267",3736,0,2,1,1,1,6,3,0,0,13,2,0,7,3,0,0,1038097,"2024-01-07T00:00:00.000Z",38017697,14,"Max Christie",2,10,10,7,3,16.6
"15268",3737,0,0,0,0,0,0,0,0,0,0,0,0,0,0,0,0,1038097,"2024-01-07T00:00:00.000Z",666626,14,"Jaxson Hayes",0,0,0,0,0,0
"15269",3738,0,0,0,0,0,0,0,0,0,0,0,0,0,0,0,0,1038097,"2024-01-07T00:00:00.000Z",56677835,14,"Jalen Hood-Schifino",0,0,0,0,0,0
"15270",3739,1,0,1,1,0,2,0,0,0,7,0,1,0,1,0,0,1038096,"2024-01-07T00:00:00.000Z",398,10,"Jerome Robinson",0,1,2,1,2,2.7
"15271",3740,0,0,1,2,1,3,2,0,0,6,0,1,5,1,1,1,1038096,"2024-01-07T00:00:00.000Z",45658838,10,"Lester Quinones",1,6,6,5,1,8.2
"15272",3741,1,0,1,5,2,11,6,0,0,26,0,1,14,1,2,0,1038096,"2024-01-07T00:00:00.000Z",3089,28,"Gary Trent Jr.",2,15,16,15,2,22.7
"15273",3742,0,0,0,1,1,2,1,0,0,4,0,0,3,0,0,1,1038096,"2024-01-07T00:00:00.000Z",489,28,"Thaddeus Young",0,3,3,3,0,2
"15274",3743,0,0,0,0,0,0,0,0,0,0,0,0,0,0,0,0,1038096,"2024-01-07T00:00:00.000Z",56677828,28,"Gradey Dick",0,0,0,0,0,0
"15275",3744,0,0,0,0,0,0,0,0,0,0,0,0,0,0,0,0,1038096,"2024-01-07T00:00:00.000Z",56677805,28,"Javon Freeman-Liberty",0,0,0,0,0,0
"15276",3745,0,0,0,0,0,0,0,0,0,0,0,0,0,0,0,0,1038096,"2024-01-07T00:00:00.000Z",38017710,28,"Christian Koloko",0,0,0,0,0,0
"15277",3746,0,0,0,0,0,0,0,0,0,0,0,0,0,0,0,0,1038096,"2024-01-07T00:00:00.000Z",56677869,28,"Markquis Nowell",0,0,0,0,0,0
"15278",3747,0,0,0,0,0,0,0,0,0,0,0,0,0,0,0,0,1038093,"2024-01-07T00:00:00.000Z",329,7,"Markieff Morris",0,0,0,0,0,0
"15279",3748,0,0,0,0,0,0,0,0,0,0,0,0,0,0,0,0,1038093,"2024-01-07T00:00:00.000Z",56677859,7,"Olivier-Maxence Prosper",0,0,0,0,0,0
"15280",3749,0,0,0,0,0,0,0,0,0,0,0,0,0,0,0,0,1038093,"2024-01-07T00:00:00.000Z",24489167,7,"Brandon Williams",0,0,0,0,0,0
"15281",3750,0,0,0,0,0,0,0,0,0,0,0,0,0,0,0,0,1038093,"2024-01-07T00:00:00.000Z",151,7,"Dante Exum",0,0,0,0,0,0
"15282",3751,1,0,2,0,0,1,1,0,0,6,0,0,2,2,0,0,1037971,"2023-12-21T00:00:00.000Z",38017706,21,"Jaylin Williams",0,4,5,3,3,5.9
"15283",3752,4,0,1,3,0,4,1,0,0,13,0,2,2,1,0,0,1037970,"2023-12-21T00:00:00.000Z",368,17,"Cameron Payne",0,3,7,6,5,9.2
"15284",3753,1,1,7,3,0,12,4,5,5,32,2,4,13,9,2,3,1037966,"2023-12-21T00:00:00.000Z",101,29,"John Collins",3,22,23,14,10,31.3
"15285",3754,8,0,1,3,1,18,6,6,6,32,3,3,19,4,4,3,1037966,"2023-12-21T00:00:00.000Z",413,29,"Collin Sexton",4,23,31,27,12,44.8
"15286",3755,10,1,4,2,0,11,5,4,3,33,1,2,13,5,2,1,1037966,"2023-12-21T00:00:00.000Z",139,29,"Kris Dunn",3,18,28,23,15,42
"15287",3756,1,4,5,0,0,3,2,1,0,20,5,1,4,10,0,1,1037966,"2023-12-21T00:00:00.000Z",38017705,29,"Walker Kessler",4,14,15,5,11,28.5
"15288",3757,0,0,2,6,2,12,7,2,2,33,0,4,18,2,2,0,1037966,"2023-12-21T00:00:00.000Z",38017620,29,"Ochai Agbaji",2,20,20,18,2,26.4
"15289",3758,0,1,1,2,1,5,3,0,0,16,3,0,7,4,0,0,1037966,"2023-12-21T00:00:00.000Z",56677824,29,"Taylor Hendricks",1,11,11,7,4,14.8
"15290",3759,0,0,4,1,0,5,0,2,2,10,1,1,2,5,0,0,1037966,"2023-12-21T00:00:00.000Z",666881,29,"Luka Samanic",0,7,7,2,5,8
"15291",3760,0,0,0,0,0,0,0,0,0,0,0,0,0,0,0,0,1037966,"2023-12-21T00:00:00.000Z",56677834,29,"Keyonte George",0,0,0,0,0,0
"15292",3761,0,0,0,0,0,0,0,0,0,0,0,0,0,0,0,0,1037966,"2023-12-21T00:00:00.000Z",38017630,29,"Johnny Juzang",0,0,0,0,0,0
"15293",3762,0,0,0,0,0,0,0,0,0,0,0,0,0,0,0,0,1037966,"2023-12-21T00:00:00.000Z",11891374,29,"Omer Yurtseven",0,0,0,0,0,0
"15294",3763,0,0,0,0,0,0,0,0,0,0,0,0,0,0,0,0,1037966,"2023-12-21T00:00:00.000Z",17896023,29,"Josh Christopher",0,0,0,0,0,0
"15295",3764,0,0,0,0,0,0,0,0,0,0,0,0,0,0,0,0,1037966,"2023-12-21T00:00:00.000Z",100,29,"Jordan Clarkson",0,0,0,0,0,0
"15296",3765,0,0,0,0,0,0,0,0,0,0,0,0,0,0,0,0,1037966,"2023-12-21T00:00:00.000Z",666650,29,"Talen Horton-Tucker",0,0,0,0,0,0
"15297",3766,0,0,0,0,0,0,0,0,0,0,0,0,0,0,0,0,1037966,"2023-12-21T00:00:00.000Z",297,29,"Lauri Markkanen",0,0,0,0,0,0
"15298",3767,0,0,0,0,0,0,0,0,0,0,0,0,0,0,0,0,1037966,"2023-12-21T00:00:00.000Z",19465584,29,"Micah Potter",0,0,0,0,0,0
"15299",3768,0,0,0,0,0,0,0,0,0,0,0,0,0,0,0,0,1037966,"2023-12-21T00:00:00.000Z",56677842,29,"Brice Sensabaugh",0,0,0,0,0,0
"15300",3769,3,0,2,3,0,6,1,0,0,26,0,3,2,2,1,1,1037980,"2023-12-23T00:00:00.000Z",202,20,"Josh Hart",1,4,7,5,5,10.9
"15301",3770,1,0,2,5,1,8,2,2,2,22,0,1,7,2,0,1,1037980,"2023-12-23T00:00:00.000Z",3547269,20,"Immanuel Quickley",0,9,10,8,3,9.9
"15302",3771,0,0,2,1,0,3,1,0,0,16,0,2,2,2,1,0,1037980,"2023-12-23T00:00:00.000Z",17895858,20,"Quentin Grimes",1,4,4,2,2,7.4
"15303",3772,0,0,1,0,0,0,0,0,0,1,0,0,0,1,0,0,1037980,"2023-12-23T00:00:00.000Z",17896033,20,"Miles McBride",0,1,1,0,1,1.2
"15304",3773,0,0,0,1,0,1,0,0,0,1,0,0,0,0,0,0,1037980,"2023-12-23T00:00:00.000Z",666474,20,"Charles Brown",0,0,0,0,0,0
"15305",3775,0,0,0,0,0,0,0,0,0,1,0,1,0,0,0,0,1037980,"2023-12-23T00:00:00.000Z",19,20,"Ryan Arcidiacono",0,0,0,0,0,0
"15306",3776,0,0,0,0,0,0,0,0,0,0,0,0,0,0,0,0,1037855,"2023-11-29T00:00:00.000Z",38017721,8,"Peyton Watson",0,0,0,0,0,0
"15307",3777,0,0,0,0,0,0,0,0,0,0,0,0,0,0,0,0,1037853,"2023-11-29T00:00:00.000Z",420,15,"Marcus Smart",0,0,0,0,0,0
"15308",3778,0,0,0,0,0,0,0,0,0,0,0,0,0,0,0,0,1037853,"2023-11-29T00:00:00.000Z",3547285,15,"Xavier Tillman",0,0,0,0,0,0
"15309",3779,4,0,4,8,4,13,4,0,0,26,0,1,12,4,1,0,1037853,"2023-11-29T00:00:00.000Z",38017739,29,"Simone Fontecchio",1,16,20,16,8,25.8
"15310",3780,1,0,3,5,3,14,7,2,0,29,1,2,17,4,1,1,1037853,"2023-11-29T00:00:00.000Z",101,29,"John Collins",1,21,22,18,5,25.3
"15311",3781,1,0,2,0,0,5,2,0,0,15,2,2,4,4,1,2,1037853,"2023-11-29T00:00:00.000Z",11891374,29,"Omer Yurtseven",1,8,9,5,5,11.3
"15312",3782,2,0,2,4,2,6,2,2,2,24,1,0,8,3,0,2,1037853,"2023-11-29T00:00:00.000Z",56677834,29,"Keyonte George",0,11,13,10,5,12.6
"15313",3783,5,0,2,5,2,10,4,3,2,27,1,0,12,3,0,4,1037853,"2023-11-29T00:00:00.000Z",100,29,"Jordan Clarkson",0,15,20,17,8,19.1
"15314",3784,2,6,5,2,0,11,4,2,1,28,3,0,9,8,1,1,1037853,"2023-11-29T00:00:00.000Z",38017705,29,"Walker Kessler",7,17,19,11,10,41.6
"15315",3785,3,0,1,4,1,10,3,3,2,22,1,3,9,2,1,2,1037853,"2023-11-29T00:00:00.000Z",413,29,"Collin Sexton",1,11,14,12,5,16.9
"15316",3786,0,0,0,0,0,0,0,0,0,0,0,0,0,0,0,0,1037853,"2023-11-29T00:00:00.000Z",17896023,29,"Josh Christopher",0,0,0,0,0,0
"15317",3787,0,0,0,0,0,0,0,0,0,0,0,0,0,0,0,0,1037853,"2023-11-29T00:00:00.000Z",139,29,"Kris Dunn",0,0,0,0,0,0
"15318",3788,0,0,0,0,0,0,0,0,0,0,0,0,0,0,0,0,1037853,"2023-11-29T00:00:00.000Z",56677824,29,"Taylor Hendricks",0,0,0,0,0,0
"15319",3789,0,0,0,0,0,0,0,0,0,0,0,0,0,0,0,0,1037853,"2023-11-29T00:00:00.000Z",38017630,29,"Johnny Juzang",0,0,0,0,0,0
"15320",3790,0,0,0,0,0,0,0,0,0,0,0,0,0,0,0,0,1037853,"2023-11-29T00:00:00.000Z",297,29,"Lauri Markkanen",0,0,0,0,0,0
"15321",3791,0,0,0,3,1,7,2,1,1,10,1,1,6,1,0,0,1037850,"2023-11-29T00:00:00.000Z",77,9,"Alec Burks",0,7,7,6,1,7.2
"15322",3792,8,0,1,3,0,9,3,1,1,22,0,2,7,1,2,0,1037850,"2023-11-29T00:00:00.000Z",3547241,9,"Killian Hayes",2,8,16,15,9,26.2
"15323",3793,2,0,6,5,2,9,2,2,2,20,0,5,8,6,1,3,1037850,"2023-11-29T00:00:00.000Z",44477024,9,"Stanley Umude",1,14,16,10,8,18.2
"15324",3794,0,0,1,0,0,4,2,2,0,14,1,0,4,2,0,0,1037850,"2023-11-29T00:00:00.000Z",24,9,"Marvin Bagley III",0,6,6,4,2,6.4
"15325",3795,0,0,0,1,1,1,1,0,0,6,0,0,3,0,0,0,1037850,"2023-11-29T00:00:00.000Z",259,9,"Kevin Knox",0,3,3,3,0,3
"15326",3796,0,0,0,0,0,0,0,0,0,0,0,0,0,0,0,0,1037850,"2023-11-29T00:00:00.000Z",54,9,"Bojan Bogdanovic",0,0,0,0,0,0
"15327",3797,0,0,0,0,0,0,0,0,0,0,0,0,0,0,0,0,1037850,"2023-11-29T00:00:00.000Z",56677729,9,"Malcolm Cazalon",0,0,0,0,0,0
"15328",3798,0,0,0,0,0,0,0,0,0,0,0,0,0,0,0,0,1037850,"2023-11-29T00:00:00.000Z",197,9,"Joe Harris",0,0,0,0,0,0
"15329",3799,0,0,0,0,0,0,0,0,0,0,0,0,0,0,0,0,1037850,"2023-11-29T00:00:00.000Z",330,9,"Monte Morris",0,0,0,0,0,0
"15330",3800,0,0,0,0,0,0,0,0,0,0,0,0,0,0,0,0,1037850,"2023-11-29T00:00:00.000Z",42097199,9,"Jared Rhoden",0,0,0,0,0,0
"15331",3801,0,0,0,0,0,0,0,0,0,0,0,0,0,0,0,0,1037738,"2023-11-13T00:00:00.000Z",56677860,5,"Adama Sanogo",0,0,0,0,0,0
"15332",3802,0,0,0,0,0,0,0,0,0,0,0,0,0,0,0,0,1037738,"2023-11-13T00:00:00.000Z",38017719,5,"Dalen Terry",0,0,0,0,0,0
"15333",3803,0,0,0,1,0,1,0,0,0,1,0,0,0,0,0,0,1037736,"2023-11-13T00:00:00.000Z",17896033,20,"Miles McBride",0,0,0,0,0,0
"15334",3804,0,0,0,0,0,0,0,0,0,1,0,0,0,0,0,0,1037736,"2023-11-13T00:00:00.000Z",17896063,20,"Jericho Sims",0,0,0,0,0,0
"15335",3805,0,0,0,0,0,0,0,0,0,0,0,0,0,0,0,0,1037736,"2023-11-13T00:00:00.000Z",666423,20,"RJ Barrett",0,0,0,0,0,0
"15336",3806,0,0,0,0,0,0,0,0,0,0,0,0,0,0,0,0,1037736,"2023-11-13T00:00:00.000Z",666675,20,"DaQuan Jeffries",0,0,0,0,0,0
"15337",3807,0,0,0,0,0,0,0,0,0,0,0,0,0,0,0,0,1037736,"2023-11-13T00:00:00.000Z",666474,20,"Charles Brown",0,0,0,0,0,0
"15338",3808,0,0,0,0,0,0,0,0,0,0,0,0,0,0,0,0,1037736,"2023-11-13T00:00:00.000Z",160,20,"Evan Fournier",0,0,0,0,0,0
"15339",3809,0,0,0,0,0,0,0,0,0,0,0,0,0,0,0,0,1037736,"2023-11-13T00:00:00.000Z",56677795,20,"Jacob Toppin",0,0,0,0,0,0
"15340",3810,0,0,0,0,0,0,0,0,0,0,0,0,0,0,0,0,1037736,"2023-11-13T00:00:00.000Z",17896089,20,"Duane Washington Jr.",0,0,0,0,0,0
"15341",3811,0,0,0,0,0,0,0,0,0,0,0,0,0,0,0,0,1037736,"2023-11-13T00:00:00.000Z",666971,20,"Dylan Windler",0,0,0,0,0,0
"15342",3812,1,0,4,11,6,23,12,2,2,36,2,1,32,6,0,1,3277425,"2023-11-14T00:00:00.000Z",666950,4,"P.J. Washington",0,38,39,33,7,39.7
"15343",3813,1,0,1,2,1,6,2,0,0,28,3,1,5,4,0,0,3277425,"2023-11-14T00:00:00.000Z",18678001,4,"JT Thor",0,9,10,6,5,11.3
"15344",3814,0,0,3,0,0,5,5,4,1,23,4,2,11,7,1,0,3277425,"2023-11-14T00:00:00.000Z",38017698,4,"Mark Williams",1,18,18,11,7,22.4
"15345",3815,3,0,3,2,0,5,0,2,2,23,0,1,2,3,0,2,3277425,"2023-11-14T00:00:00.000Z",3547253,4,"Theo Maledon",0,5,8,5,6,8.1
"15346",3816,11,0,4,10,4,26,9,6,6,39,2,5,28,6,3,8,3277425,"2023-11-14T00:00:00.000Z",3547239,4,"LaMelo Ball",3,34,45,39,17,52.7
"15347",3817,1,0,4,5,3,7,4,2,1,29,0,4,12,4,1,1,3277425,"2023-11-14T00:00:00.000Z",38017708,4,"Bryce McGowens",1,16,17,13,5,20.3
"15348",3818,0,0,0,1,0,2,0,0,0,3,0,0,0,0,0,0,3277425,"2023-11-14T00:00:00.000Z",56677866,4,"Leaky Black",0,0,0,0,0,0
"15349",3819,0,0,0,0,0,0,0,0,0,0,0,0,0,0,0,0,3277425,"2023-11-14T00:00:00.000Z",56677848,4,"Amari Bailey",0,0,0,0,0,0
"15350",3820,1,1,1,2,0,3,1,0,0,16,0,2,2,1,0,0,3277427,"2023-11-14T00:00:00.000Z",108,23,"Robert Covington",1,3,4,3,2,7.7
"15351",3821,3,0,7,1,0,17,11,1,0,37,0,3,22,7,1,1,3277427,"2023-11-14T00:00:00.000Z",200,23,"Tobias Harris",1,29,32,25,10,36.9
"15352",3822,6,0,9,4,0,22,11,17,17,38,3,4,39,12,3,5,3277427,"2023-11-14T00:00:00.000Z",145,23,"Joel Embiid",3,51,57,45,18,66.4
"15353",3823,1,0,3,5,0,5,0,4,3,14,0,1,3,3,0,0,3277425,"2023-11-14T00:00:00.000Z",285,16,"Kevin Love",0,6,7,4,4,8.1
"15354",3824,0,0,0,0,0,0,0,0,0,0,0,0,0,0,0,0,3277425,"2023-11-14T00:00:00.000Z",39398582,16,"Orlando Robinson",0,0,0,0,0,0
"15355",3825,0,0,0,0,0,0,0,0,0,0,0,0,0,0,0,0,3277425,"2023-11-14T00:00:00.000Z",38017734,16,"Jamal Cain",0,0,0,0,0,0
"15356",3826,1,1,8,0,0,3,3,4,1,24,3,1,7,11,1,0,1037601,"2023-10-25T00:00:00.000Z",373,28,"Jakob Poeltl",2,18,19,8,12,27.7
"15357",3827,5,5,7,4,1,16,6,6,4,37,1,1,17,8,2,4,1037601,"2023-10-25T00:00:00.000Z",17896055,28,"Scottie Barnes",7,25,30,22,13,51.1
"15358",3828,7,0,2,8,4,17,8,2,2,32,1,1,22,3,0,2,1037601,"2023-10-25T00:00:00.000Z",409,28,"Dennis Schroder",0,25,32,29,10,34.1
"15359",3829,6,0,6,1,0,11,6,4,2,28,2,4,14,8,0,1,1037598,"2023-10-25T00:00:00.000Z",17896062,11,"Alperen Sengun",0,22,28,20,14,31.6
"15360",3830,0,1,1,1,0,10,2,7,6,30,0,2,10,1,1,4,1037598,"2023-10-25T00:00:00.000Z",17895966,11,"Jalen Green",2,11,11,10,1,13.2
"15361",3831,5,0,1,6,4,13,5,0,0,34,0,0,14,1,1,3,1037598,"2023-10-25T00:00:00.000Z",458,11,"Fred VanVleet",1,15,20,19,6,22.7
"15362",3832,2,0,4,7,1,10,3,2,1,21,1,2,8,5,0,4,1037598,"2023-10-25T00:00:00.000Z",56677825,11,"Amen Thompson",0,13,15,10,7,13
"15363",3833,2,0,0,2,1,2,1,0,0,9,0,1,3,0,0,1,1037598,"2023-10-25T00:00:00.000Z",19465326,11,"Jock Landale",0,3,5,5,2,5
"15364",3834,0,1,2,1,1,2,2,0,0,15,0,1,5,2,1,0,1037598,"2023-10-25T00:00:00.000Z",3547301,11,"Jae'Sean Tate",2,7,7,5,2,13.4
"15365",3835,4,0,4,2,0,12,6,9,8,35,2,4,20,6,3,3,1037599,"2023-10-25T00:00:00.000Z",61,3,"Mikal Bridges",3,26,30,24,10,39.2
"15366",3836,3,0,3,4,1,10,5,2,1,26,2,1,12,5,2,2,1037599,"2023-10-25T00:00:00.000Z",666679,3,"Cameron Johnson",2,17,20,15,8,26.5
"15367",3837,4,3,3,0,0,10,3,1,1,28,4,1,7,7,0,0,1037599,"2023-10-25T00:00:00.000Z",666508,3,"Nicolas Claxton",3,14,18,11,11,30.4
"15368",3838,3,0,1,3,1,3,1,2,2,24,0,2,5,1,0,1,1037599,"2023-10-25T00:00:00.000Z",130,3,"Spencer Dinwiddie",0,6,9,8,4,9.7
"15369",3839,9,1,9,0,0,6,2,0,0,23,1,2,4,10,0,2,1037599,"2023-10-25T00:00:00.000Z",417,3,"Ben Simmons",1,14,23,13,19,30.5
"15370",3840,2,0,3,5,2,21,13,11,8,25,0,0,36,3,1,1,1037599,"2023-10-25T00:00:00.000Z",17896048,3,"Cam Thomas",1,39,41,38,5,44.6
"15371",3841,0,2,1,0,0,3,2,0,0,12,1,2,4,2,0,3,1037599,"2023-10-25T00:00:00.000Z",17896038,3,"Day'Ron Sharpe",2,6,6,4,2,9.4
"15372",3842,9,0,1,9,1,19,4,15,14,36,0,3,23,1,1,5,1037595,"2023-10-25T00:00:00.000Z",490,1,"Trae Young",1,24,33,32,10,35.7
"15373",3843,0,0,0,0,0,0,0,0,0,0,0,0,0,0,0,0,1037595,"2023-10-25T00:00:00.000Z",56677855,1,"Seth Lundy",0,0,0,0,0,0
"15374",3844,0,0,0,0,0,0,0,0,0,0,0,0,0,0,0,0,1037595,"2023-10-25T00:00:00.000Z",301,1,"Wesley Matthews",0,0,0,0,0,0
"15375",3845,0,0,0,0,0,0,0,0,0,0,0,0,0,0,0,0,1037595,"2023-10-25T00:00:00.000Z",56677875,1,"Miles Norris",0,0,0,0,0,0
"15376",3846,6,0,5,1,1,8,3,1,1,25,1,1,8,6,3,0,1037596,"2023-10-25T00:00:00.000Z",487,30,"Delon Wright",3,14,20,14,12,33.2
"15377",3847,1,0,3,5,1,11,4,2,2,25,2,1,11,5,0,1,1037596,"2023-10-25T00:00:00.000Z",17896045,30,"Corey Kispert",0,16,17,12,6,17.5
"15378",3848,0,0,1,2,2,7,4,6,6,17,2,1,16,3,0,0,1037596,"2023-10-25T00:00:00.000Z",167,30,"Danilo Gallinari",0,19,19,16,3,19.6
"15379",3849,3,3,4,1,1,3,1,0,0,23,0,1,3,4,0,3,1037596,"2023-10-25T00:00:00.000Z",56677844,30,"Bilal Coulibaly",3,7,10,6,7,18.3
"15380",3850,0,0,3,0,0,0,0,0,0,8,0,0,0,3,0,0,1037596,"2023-10-25T00:00:00.000Z",337,30,"Mike Muscala",0,3,3,0,3,3.6
"15381",3851,1,1,9,7,3,7,3,0,0,34,0,2,9,9,0,0,1038024,"2023-12-29T00:00:00.000Z",17896060,2,"Sam Hauser",1,18,19,10,10,24.3
"15382",3852,3,3,3,0,0,11,9,2,2,33,5,3,20,8,0,1,1038024,"2023-12-29T00:00:00.000Z",261,2,"Luke Kornet",3,28,31,23,11,42.1
"15383",3853,7,2,4,10,2,19,5,9,9,36,1,2,21,5,3,3,1038024,"2023-12-29T00:00:00.000Z",473,2,"Derrick White",5,26,33,28,12,49.5
"15384",3854,3,0,2,5,3,15,5,4,2,32,0,1,15,2,0,1,1038024,"2023-12-29T00:00:00.000Z",214,2,"Jrue Holiday",0,17,20,18,5,20.9
"15385",3855,0,0,0,0,0,1,1,0,0,2,0,0,2,0,0,1,1038024,"2023-12-29T00:00:00.000Z",17896094,2,"Dalano Banton",0,2,2,2,0,1
"15386",3856,2,1,7,5,3,19,11,7,7,39,2,1,32,9,4,4,1038021,"2023-12-29T00:00:00.000Z",17896026,22,"Franz Wagner",5,41,43,34,11,56.8
"15387",3857,3,0,4,0,0,7,5,0,0,18,5,3,10,9,0,2,1038022,"2023-12-29T00:00:00.000Z",17896038,3,"Day'Ron Sharpe",0,19,22,13,12,23.3
"15388",3858,3,0,1,1,0,15,6,6,3,24,0,0,15,1,0,1,1038022,"2023-12-29T00:00:00.000Z",17896048,3,"Cam Thomas",0,16,19,18,4,19.7
"15389",3859,3,0,2,1,0,6,2,2,1,20,0,3,5,2,2,0,1038022,"2023-12-29T00:00:00.000Z",421,3,"Dennis Smith Jr.",2,7,10,8,5,17.9
"15390",3860,0,0,0,0,0,0,0,0,0,0,0,0,0,0,0,0,1038022,"2023-12-29T00:00:00.000Z",464,3,"Lonnie Walker IV",0,0,0,0,0,0
"15391",3861,0,0,0,0,0,0,0,0,0,0,0,0,0,0,0,0,1038022,"2023-12-29T00:00:00.000Z",17896058,3,"Trendon Watford",0,0,0,0,0,0
"15392",3862,0,0,0,0,0,0,0,0,0,0,0,0,0,0,0,0,1038022,"2023-12-29T00:00:00.000Z",9051997,3,"Armoni Brooks",0,0,0,0,0,0
"15393",3863,0,0,0,0,0,0,0,0,0,0,0,0,0,0,0,0,1038022,"2023-12-29T00:00:00.000Z",56677843,3,"Noah Clowney",0,0,0,0,0,0
"15394",3864,0,0,0,0,0,0,0,0,0,0,0,0,0,0,0,0,1038022,"2023-12-29T00:00:00.000Z",17896041,3,"Keon Johnson",0,0,0,0,0,0
"15395",3865,0,0,0,0,0,0,0,0,0,0,0,0,0,0,0,0,1038022,"2023-12-29T00:00:00.000Z",417,3,"Ben Simmons",0,0,0,0,0,0
"15396",3866,0,0,0,0,0,0,0,0,0,0,0,0,0,0,0,0,1038022,"2023-12-29T00:00:00.000Z",56677841,3,"Dariq Whitehead",0,0,0,0,0,0
"15397",3867,3,1,2,1,0,5,3,2,2,30,0,3,8,2,1,1,1038025,"2023-12-29T00:00:00.000Z",3547247,6,"Isaac Okoro",2,10,13,11,5,19.9
"15398",3868,1,0,5,2,0,3,0,0,0,17,0,1,0,5,1,2,1038025,"2023-12-29T00:00:00.000Z",666940,6,"Dean Wade",1,5,6,1,6,8.5
"15399",3869,6,2,9,0,0,17,15,0,0,40,3,2,30,12,0,0,1038025,"2023-12-29T00:00:00.000Z",9,6,"Jarrett Allen",2,42,48,36,18,59.4
"15400",3870,2,2,3,11,2,18,5,0,0,37,1,3,12,4,4,1,1038025,"2023-12-29T00:00:00.000Z",666908,6,"Max Strus",6,16,18,14,6,36.8
"15401",3871,9,1,5,10,2,23,14,4,4,36,1,3,34,6,2,2,1038025,"2023-12-29T00:00:00.000Z",322,6,"Donovan Mitchell",3,40,49,43,15,61.7
"15402",3872,4,0,1,6,0,14,3,0,0,28,0,2,6,1,1,2,1038025,"2023-12-29T00:00:00.000Z",277,6,"Caris LeVert",1,7,11,10,5,14.2
"15403",3873,1,0,1,3,1,10,6,1,1,15,0,1,14,1,1,0,1038025,"2023-12-29T00:00:00.000Z",56677872,6,"Craig Porter",1,15,16,15,2,19.7
"15404",3874,0,1,0,6,0,7,1,0,0,14,0,2,2,0,1,0,1038025,"2023-12-29T00:00:00.000Z",344,6,"Georges Niang",2,2,2,2,0,8
"15405",3875,1,0,0,4,1,4,1,0,0,15,0,1,3,0,0,0,1038025,"2023-12-29T00:00:00.000Z",3547299,6,"Sam Merrill",0,3,4,4,1,4.5
"15406",3876,2,0,6,2,0,4,2,1,1,17,0,2,5,6,0,1,1037902,"2023-12-13T00:00:00.000Z",108,23,"Robert Covington",0,11,13,7,8,14.2
"15407",3877,10,0,4,0,0,8,4,7,7,29,2,1,15,6,1,4,1037904,"2023-12-13T00:00:00.000Z",79,16,"Jimmy Butler",1,21,31,25,16,36.2
"15408",3878,4,1,3,3,1,13,4,0,0,36,3,2,9,6,0,4,1037904,"2023-12-13T00:00:00.000Z",666747,16,"Caleb Martin",1,15,19,13,10,21.2
"15409",3879,1,0,2,0,0,5,3,0,0,12,2,2,6,4,0,3,1037904,"2023-12-13T00:00:00.000Z",39398582,16,"Orlando Robinson",0,10,11,7,5,9.3
"15410",3880,3,0,2,9,6,12,7,3,3,41,0,2,23,2,2,3,1037904,"2023-12-13T00:00:00.000Z",397,16,"Duncan Robinson",2,25,28,26,5,32.9
"15411",3881,1,0,2,4,4,5,5,3,3,24,0,2,17,2,2,2,1037904,"2023-12-13T00:00:00.000Z",286,16,"Kyle Lowry",2,19,20,18,3,24.9
"15412",3882,1,1,1,6,2,12,5,2,2,29,2,0,14,3,2,0,1037904,"2023-12-13T00:00:00.000Z",38017734,16,"Jamal Cain",3,17,18,15,4,28.1
"15413",3883,8,0,4,2,2,16,7,1,1,33,2,0,17,6,1,2,1037904,"2023-12-13T00:00:00.000Z",56677785,16,"Jaime Jaquez Jr.",1,23,31,25,14,37.2
"15414",3884,1,1,9,6,0,9,1,2,1,20,0,1,3,9,2,2,1037904,"2023-12-13T00:00:00.000Z",285,16,"Kevin Love",3,12,13,4,10,22.3
"15415",3885,0,0,3,0,0,7,5,1,1,16,6,2,11,9,0,1,1037904,"2023-12-13T00:00:00.000Z",74,16,"Thomas Bryant",0,20,20,11,9,20.8
"15416",3886,0,0,0,0,0,0,0,0,0,0,0,0,0,0,0,0,1037904,"2023-12-13T00:00:00.000Z",4,16,"Bam Adebayo",0,0,0,0,0,0
"15417",3887,0,0,0,0,0,0,0,0,0,0,0,0,0,0,0,0,1037904,"2023-12-13T00:00:00.000Z",3547257,16,"R.J. Hampton",0,0,0,0,0,0
"15418",3888,0,0,0,0,0,0,0,0,0,0,0,0,0,0,0,0,1037904,"2023-12-13T00:00:00.000Z",38017736,16,"Cole Swider",0,0,0,0,0,0
"15419",3889,0,0,0,0,0,0,0,0,0,0,0,0,0,0,0,0,1037904,"2023-12-13T00:00:00.000Z",666633,16,"Tyler Herro",0,0,0,0,0,0
"15420",3890,0,0,0,0,0,0,0,0,0,0,0,0,0,0,0,0,1037904,"2023-12-13T00:00:00.000Z",3092,16,"Haywood Highsmith",0,0,0,0,0,0
"15421",3891,0,0,0,0,0,0,0,0,0,0,0,0,0,0,0,0,1037904,"2023-12-13T00:00:00.000Z",38017696,16,"Nikola Jovic",0,0,0,0,0,0
"15422",3892,0,0,0,0,0,0,0,0,0,0,0,0,0,0,0,0,1037904,"2023-12-13T00:00:00.000Z",391,16,"Josh Richardson",0,0,0,0,0,0
"15423",3893,0,0,0,0,0,0,0,0,0,0,0,0,0,0,0,0,1037904,"2023-12-13T00:00:00.000Z",19465585,16,"Dru Smith",0,0,0,0,0,0
"15424",3894,7,0,4,2,1,12,7,5,5,35,1,2,20,5,0,4,1037904,"2023-12-13T00:00:00.000Z",204,4,"Gordon Hayward",0,25,32,27,12,32.5
"15425",3895,4,1,4,8,1,19,9,0,0,34,1,2,19,5,2,4,1037904,"2023-12-13T00:00:00.000Z",62,4,"Miles Bridges",3,24,28,23,9,36
"15426",3896,0,4,10,0,0,5,3,1,0,40,1,1,6,11,0,2,1037904,"2023-12-13T00:00:00.000Z",3547282,4,"Nick Richards",4,17,17,6,11,29.2
"15427",3897,2,0,2,10,4,16,7,0,0,39,0,3,18,2,2,5,1037904,"2023-12-13T00:00:00.000Z",56677823,4,"Brandon Miller",2,20,22,20,4,24.4
"15428",3898,7,1,3,6,5,14,10,3,3,37,0,2,28,3,4,1,1037904,"2023-12-13T00:00:00.000Z",403,4,"Terry Rozier",5,31,38,35,10,56.1
"15429",3899,1,0,0,0,0,0,0,0,0,4,0,0,0,0,1,1,1037904,"2023-12-13T00:00:00.000Z",666950,4,"P.J. Washington",1,0,1,1,1,3.5
"15430",3900,4,0,2,1,0,5,3,0,0,17,0,3,6,2,0,3,1037904,"2023-12-13T00:00:00.000Z",422,4,"Ish Smith",0,8,12,10,6,11.4
"15431",3901,2,0,1,1,0,7,3,2,1,21,0,5,7,1,1,0,1037810,"2023-11-22T00:00:00.000Z",17553979,10,"Jonathan Kuminga",1,8,10,9,3,14.2
"15432",3902,1,0,5,1,0,12,6,0,0,32,6,0,12,11,0,0,1037811,"2023-11-22T00:00:00.000Z",101,29,"John Collins",0,23,24,13,12,26.7
"15433",3903,5,0,2,4,2,11,5,2,1,32,0,0,13,2,0,7,1037811,"2023-11-22T00:00:00.000Z",100,29,"Jordan Clarkson",0,15,20,18,7,15.9
"15434",3904,7,0,3,6,3,9,3,7,7,34,0,2,16,3,1,0,1037811,"2023-11-22T00:00:00.000Z",56677834,29,"Keyonte George",1,19,26,23,10,33.1
"15435",3905,2,0,1,3,0,5,0,2,1,11,1,2,1,2,1,2,1037811,"2023-11-22T00:00:00.000Z",413,29,"Collin Sexton",1,3,5,3,4,7.4
"15436",3906,1,0,0,2,0,4,1,4,3,14,0,4,5,0,0,3,1037811,"2023-11-22T00:00:00.000Z",666650,29,"Talen Horton-Tucker",0,5,6,6,1,3.5
"15437",3907,1,0,0,6,2,7,3,0,0,16,1,1,8,1,1,1,1037811,"2023-11-22T00:00:00.000Z",38017739,29,"Simone Fontecchio",1,9,10,9,2,12.7
"15438",3908,1,1,0,1,1,4,4,0,0,14,0,0,9,0,0,1,1037811,"2023-11-22T00:00:00.000Z",38017620,29,"Ochai Agbaji",1,9,10,10,1,12.5
"15439",3909,1,0,6,2,1,3,1,0,0,16,0,1,3,6,0,2,1037811,"2023-11-22T00:00:00.000Z",11891374,29,"Omer Yurtseven",0,9,10,4,7,9.7
"15440",3910,1,1,2,0,0,1,0,2,1,5,0,0,1,2,0,0,1037811,"2023-11-22T00:00:00.000Z",139,29,"Kris Dunn",1,3,4,2,3,7.9
"15441",3911,0,0,0,0,0,0,0,0,0,0,0,0,0,0,0,0,1037811,"2023-11-22T00:00:00.000Z",666881,29,"Luka Samanic",0,0,0,0,0,0
"15442",3912,0,0,0,0,0,0,0,0,0,0,0,0,0,0,0,0,1037811,"2023-11-22T00:00:00.000Z",17896023,29,"Josh Christopher",0,0,0,0,0,0
"15443",3913,0,0,0,0,0,0,0,0,0,0,0,0,0,0,0,0,1037811,"2023-11-22T00:00:00.000Z",56677824,29,"Taylor Hendricks",0,0,0,0,0,0
"15444",3914,0,0,0,0,0,0,0,0,0,0,0,0,0,0,0,0,1037811,"2023-11-22T00:00:00.000Z",38017630,29,"Johnny Juzang",0,0,0,0,0,0
"15445",3915,0,0,0,0,0,0,0,0,0,0,0,0,0,0,0,0,1037811,"2023-11-22T00:00:00.000Z",38017705,29,"Walker Kessler",0,0,0,0,0,0
"15446",3916,0,0,0,0,0,0,0,0,0,0,0,0,0,0,0,0,1037811,"2023-11-22T00:00:00.000Z",19465584,29,"Micah Potter",0,0,0,0,0,0
"15447",3917,2,0,4,5,2,9,3,2,2,37,3,1,10,7,0,2,1037808,"2023-11-22T00:00:00.000Z",3547248,5,"Patrick Williams",0,17,19,12,9,19.4
"15448",3918,5,0,1,12,7,17,8,0,0,37,0,5,23,1,1,3,1037808,"2023-11-22T00:00:00.000Z",666956,5,"Coby White",1,24,29,28,6,31.7
"15449",3919,0,0,0,0,0,0,0,0,0,0,0,0,0,0,0,0,1037810,"2023-11-22T00:00:00.000Z",398,10,"Jerome Robinson",0,0,0,0,0,0
"15450",3920,6,1,7,6,1,17,8,0,0,35,0,2,17,7,0,3,3277498,"2023-11-24T00:00:00.000Z",17896026,22,"Franz Wagner",1,24,30,23,13,34.4
"15451",3921,5,0,7,6,2,16,10,2,1,35,1,4,23,8,0,3,3277498,"2023-11-24T00:00:00.000Z",38017683,22,"Paolo Banchero",0,31,36,28,13,37.1
"15452",3922,3,1,3,0,0,5,3,0,0,19,2,5,6,5,1,0,3277498,"2023-11-24T00:00:00.000Z",666442,22,"Goga Bitadze",2,11,14,9,8,22.5
"15453",3923,1,0,4,4,3,8,3,2,1,28,0,2,10,4,1,3,3277498,"2023-11-24T00:00:00.000Z",17896073,22,"Jalen Suggs",1,14,15,11,5,16.3
"15454",3924,0,0,1,0,0,1,0,0,0,6,0,1,0,1,0,1,3277498,"2023-11-24T00:00:00.000Z",56677827,22,"Anthony Black",0,1,1,0,1,0.2
"15455",3925,6,1,2,4,2,17,6,4,2,28,1,4,16,3,2,3,3277498,"2023-11-24T00:00:00.000Z",3547251,22,"Cole Anthony",3,19,25,22,9,34.6
"15456",3926,3,0,3,0,0,16,9,10,7,32,2,2,25,5,0,0,1037674,"2023-11-04T00:00:00.000Z",666969,19,"Zion Williamson",0,30,33,28,8,35.5
"15457",3927,2,0,3,3,2,6,4,1,1,30,1,2,11,4,1,0,1037673,"2023-11-04T00:00:00.000Z",56677827,22,"Anthony Black",1,15,17,13,6,21.8
"15458",3928,3,0,3,5,2,6,2,1,1,25,0,2,7,3,1,2,1037673,"2023-11-04T00:00:00.000Z",226,22,"Joe Ingles",1,10,13,10,6,16.1
"15459",3929,1,0,2,5,3,9,4,3,3,23,3,1,14,5,0,3,1037673,"2023-11-04T00:00:00.000Z",3547251,22,"Cole Anthony",0,19,20,15,6,18.5
"15460",3930,0,1,0,2,0,3,0,0,0,11,0,2,0,0,0,1,1037673,"2023-11-04T00:00:00.000Z",229,22,"Jonathan Isaac",1,0,0,0,0,2
"15461",3931,1,0,1,0,0,0,0,0,0,3,0,0,0,1,0,0,1037673,"2023-11-04T00:00:00.000Z",38017724,22,"Caleb Houstan",0,1,2,1,2,2.7
"15462",3932,1,0,0,1,0,1,0,0,0,3,1,0,0,1,0,0,1037673,"2023-11-04T00:00:00.000Z",666818,22,"Chuma Okeke",0,1,2,1,2,2.7
"15463",3933,0,0,0,1,0,2,0,0,0,3,1,0,0,1,0,0,1037673,"2023-11-04T00:00:00.000Z",56677839,22,"Jett Howard",0,1,1,0,1,1.2
"15464",3934,0,0,0,3,1,4,2,0,0,3,0,0,5,0,0,0,1037673,"2023-11-04T00:00:00.000Z",666885,22,"Admiral Schofield",0,5,5,5,0,5
"15465",3935,3,2,5,2,1,17,10,2,2,34,1,3,23,6,0,1,1037672,"2023-11-04T00:00:00.000Z",204,4,"Gordon Hayward",2,29,32,26,9,39.7
"15466",3936,4,2,2,1,1,13,6,2,2,33,1,0,15,3,1,1,1037672,"2023-11-04T00:00:00.000Z",666950,4,"P.J. Washington",3,18,22,19,7,32.6
"15467",3937,1,2,3,0,0,12,9,9,9,30,4,2,27,7,2,3,1037672,"2023-11-04T00:00:00.000Z",38017698,4,"Mark Williams",4,34,35,28,8,45.9
"15468",3938,3,1,6,5,3,14,7,5,5,31,0,0,22,6,0,0,1037672,"2023-11-04T00:00:00.000Z",403,4,"Terry Rozier",1,28,31,25,9,36.7
"15469",3939,11,0,1,7,2,15,4,1,1,31,1,5,11,2,2,6,1037672,"2023-11-04T00:00:00.000Z",3547239,4,"LaMelo Ball",2,13,24,22,13,29.9
"15470",3940,1,1,2,2,0,7,4,2,2,34,1,4,10,3,0,0,1037672,"2023-11-04T00:00:00.000Z",56677823,4,"Brandon Miller",1,13,14,11,4,18.1
"15471",3941,0,2,7,0,0,4,4,2,2,18,3,1,10,10,0,1,1037672,"2023-11-04T00:00:00.000Z",3547282,4,"Nick Richards",2,20,20,10,10,27
"15472",3942,0,0,0,2,0,3,0,0,0,14,0,4,0,0,0,1,1037672,"2023-11-04T00:00:00.000Z",3547253,4,"Theo Maledon",0,0,0,0,0,-1
"15473",3943,0,0,0,0,0,0,0,0,0,0,0,0,0,0,0,0,1037672,"2023-11-04T00:00:00.000Z",56677848,4,"Amari Bailey",0,0,0,0,0,0
"15474",3944,0,0,0,0,0,0,0,0,0,0,0,0,0,0,0,0,1037672,"2023-11-04T00:00:00.000Z",56677866,4,"Leaky Black",0,0,0,0,0,0
"15475",3945,0,0,0,0,0,0,0,0,0,0,0,0,0,0,0,0,1037672,"2023-11-04T00:00:00.000Z",62,4,"Miles Bridges",0,0,0,0,0,0
"15476",3946,0,0,0,0,0,0,0,0,0,0,0,0,0,0,0,0,1037672,"2023-11-04T00:00:00.000Z",38017708,4,"Bryce McGowens",0,0,0,0,0,0
"15477",3947,0,0,5,8,4,11,5,1,1,24,0,3,15,5,1,1,1037674,"2023-11-04T00:00:00.000Z",56677837,19,"Jordan Hawkins",1,20,20,15,5,23
"15478",3948,5,1,2,2,1,4,3,0,0,22,1,0,7,3,1,0,1037674,"2023-11-04T00:00:00.000Z",38017677,19,"Dyson Daniels",2,10,15,12,8,24.1
"15479",3949,1,0,1,3,0,4,1,2,2,17,1,2,4,2,0,1,1037674,"2023-11-04T00:00:00.000Z",17896017,19,"Matt Ryan",0,6,7,5,3,6.9
"15480",3950,0,0,0,0,0,0,0,0,0,1,0,0,0,0,0,0,1037674,"2023-11-04T00:00:00.000Z",38017663,19,"E.J. Liddell",0,0,0,0,0,0
"15481",3951,0,0,0,0,0,0,0,0,0,0,0,0,0,0,0,0,1038084,"2024-01-05T00:00:00.000Z",17896044,26,"Kessler Edwards",0,0,0,0,0,0
"15482",3952,0,0,0,0,0,0,0,0,0,0,0,0,0,0,0,0,1038084,"2024-01-05T00:00:00.000Z",38017714,26,"Keon Ellis",0,0,0,0,0,0
"15483",3953,0,0,0,0,0,0,0,0,0,0,0,0,0,0,0,0,1038082,"2024-01-05T00:00:00.000Z",330,9,"Monte Morris",0,0,0,0,0,0
"15484",3954,0,0,0,0,0,0,0,0,0,0,0,0,0,0,0,0,1038082,"2024-01-05T00:00:00.000Z",42097199,9,"Jared Rhoden",0,0,0,0,0,0
"15485",3955,0,0,0,0,0,0,0,0,0,0,0,0,0,0,0,0,1038082,"2024-01-05T00:00:00.000Z",3547267,9,"Isaiah Stewart",0,0,0,0,0,0
"15486",3956,0,0,0,0,0,0,0,0,0,0,0,0,0,0,0,0,1038082,"2024-01-05T00:00:00.000Z",44477024,9,"Stanley Umude",0,0,0,0,0,0
"15487",3957,0,0,0,0,0,0,0,0,0,0,0,0,0,0,0,0,1038084,"2024-01-05T00:00:00.000Z",273,26,"Alex Len",0,0,0,0,0,0
"15488",3958,0,0,0,0,0,0,0,0,0,0,0,0,0,0,0,0,1038090,"2024-01-07T00:00:00.000Z",56677841,3,"Dariq Whitehead",0,0,0,0,0,0
"15489",3959,0,0,0,0,0,0,0,0,0,0,0,0,0,0,0,0,1038090,"2024-01-07T00:00:00.000Z",56677722,3,"Jalen Wilson",0,0,0,0,0,0
"15490",3960,1,0,5,2,0,4,1,4,3,29,1,4,5,6,1,2,1038090,"2024-01-07T00:00:00.000Z",56677850,25,"Toumani Camara",1,11,12,6,7,14.7
"15491",3961,1,1,2,7,3,24,11,2,2,42,0,2,27,2,1,0,1038090,"2024-01-07T00:00:00.000Z",182,25,"Jerami Grant",2,29,30,28,3,36.9
"15492",3962,1,3,10,4,3,10,5,3,2,41,3,4,15,13,1,1,1038090,"2024-01-07T00:00:00.000Z",56783340,25,"Duop Reath",4,28,29,16,14,43.1
"15493",3963,11,0,4,10,5,25,13,8,7,45,0,2,38,4,0,2,1038090,"2024-01-07T00:00:00.000Z",419,25,"Anfernee Simons",0,42,53,49,15,57.3
"15494",3964,4,0,2,3,2,8,3,2,2,30,1,2,10,3,0,2,1038090,"2024-01-07T00:00:00.000Z",56677747,25,"Scoot Henderson",0,13,17,14,7,17.6
"15495",3965,1,1,1,6,3,14,7,7,4,40,0,2,21,1,2,0,1038090,"2024-01-07T00:00:00.000Z",38017690,25,"Shaedon Sharpe",3,22,23,22,2,32.7
"15496",3966,0,0,1,0,0,0,0,0,0,9,2,3,0,3,0,0,1038090,"2024-01-07T00:00:00.000Z",39613724,25,"Ibou Badji",0,3,3,0,3,3.6
"15497",3967,0,0,2,0,0,2,0,0,0,7,1,1,0,3,0,2,1038090,"2024-01-07T00:00:00.000Z",56677791,25,"Kris Murray",0,3,3,0,3,1.6
"15498",3968,2,0,2,6,4,8,5,4,4,22,1,0,18,3,0,0,1038090,"2024-01-07T00:00:00.000Z",65,25,"Malcolm Brogdon",0,21,23,20,5,24.6
"15499",3969,0,0,0,0,0,0,0,0,0,0,0,0,0,0,0,0,1038090,"2024-01-07T00:00:00.000Z",47957121,25,"Justin Minaya",0,0,0,0,0,0
"15500",3970,0,0,0,0,0,0,0,0,0,0,0,0,0,0,0,0,1038090,"2024-01-07T00:00:00.000Z",56677829,25,"Rayan Rupert",0,0,0,0,0,0
"15501",3971,0,0,0,0,0,0,0,0,0,0,0,0,0,0,0,0,1038090,"2024-01-07T00:00:00.000Z",38017711,25,"Jabari Walker",0,0,0,0,0,0
"15502",3972,0,0,0,0,0,0,0,0,0,0,0,0,0,0,0,0,1038090,"2024-01-07T00:00:00.000Z",22,25,"Deandre Ayton",0,0,0,0,0,0
"15503",3973,0,0,0,0,0,0,0,0,0,0,0,0,0,0,0,0,1038090,"2024-01-07T00:00:00.000Z",666476,25,"Moses Brown",0,0,0,0,0,0
"15504",3974,0,0,0,0,0,0,0,0,0,0,0,0,0,0,0,0,1038090,"2024-01-07T00:00:00.000Z",666923,25,"Matisse Thybulle",0,0,0,0,0,0
"15505",3975,0,0,0,0,0,0,0,0,0,0,0,0,0,0,0,0,1038090,"2024-01-07T00:00:00.000Z",476,25,"Robert Williams III",0,0,0,0,0,0
"15506",3976,4,0,2,4,1,6,2,0,0,24,1,2,5,3,1,0,1037989,"2023-12-23T00:00:00.000Z",56677833,21,"Cason Wallace",1,8,12,9,7,17.6
"15507",3977,7,0,4,5,1,21,12,10,9,38,1,2,34,5,2,3,1037989,"2023-12-23T00:00:00.000Z",175,21,"Shai Gilgeous-Alexander",2,39,46,41,12,53.5
"15508",3978,0,0,0,2,1,3,2,0,0,11,0,2,5,0,0,0,1037989,"2023-12-23T00:00:00.000Z",38017716,21,"Ousmane Dieng",0,5,5,5,0,5
"15509",3979,1,2,4,6,1,11,3,0,0,20,1,1,7,5,1,1,1037989,"2023-12-23T00:00:00.000Z",3547272,21,"Isaiah Joe",3,12,13,8,6,22.5
"15510",3980,1,0,9,4,3,14,9,2,2,27,2,4,23,11,2,2,1037980,"2023-12-23T00:00:00.000Z",377,17,"Bobby Portis",2,34,35,24,12,41.7
"15511",3981,1,0,1,1,1,2,2,4,3,14,0,0,8,1,0,0,1037980,"2023-12-23T00:00:00.000Z",368,17,"Cameron Payne",0,9,10,9,2,10.7
"15512",3982,0,0,0,0,0,0,0,0,0,0,0,0,0,0,0,0,1037980,"2023-12-23T00:00:00.000Z",284,17,"Robin Lopez",0,0,0,0,0,0
"15513",3983,0,0,0,0,0,0,0,0,0,0,0,0,0,0,0,0,1037980,"2023-12-23T00:00:00.000Z",666453,17,"Marques Bolden",0,0,0,0,0,0
"15514",3984,0,0,0,0,0,0,0,0,0,0,0,0,0,0,0,0,1037980,"2023-12-23T00:00:00.000Z",112,17,"Jae Crowder",0,0,0,0,0,0
"15515",3985,0,0,0,0,0,0,0,0,0,0,0,0,0,0,0,0,1037980,"2023-12-23T00:00:00.000Z",38017691,17,"TyTy Washington Jr.",0,0,0,0,0,0
"15516",3986,0,0,0,0,0,0,0,0,0,0,0,0,0,0,0,0,1037980,"2023-12-23T00:00:00.000Z",666960,17,"Lindell Wigginton",0,0,0,0,0,0
"15517",3987,1,0,1,2,1,2,1,0,0,11,0,0,3,1,0,0,1037989,"2023-12-23T00:00:00.000Z",44,21,"Davis Bertans",0,4,5,4,2,5.7
"15518",3988,0,0,0,0,0,0,0,0,0,0,0,0,0,0,0,0,1037989,"2023-12-23T00:00:00.000Z",17896036,21,"Tre Mann",0,0,0,0,0,0
"15519",3989,0,0,1,1,0,1,0,0,0,6,0,2,0,1,0,2,1037986,"2023-12-23T00:00:00.000Z",56677792,9,"Marcus Sasser",0,1,1,0,1,-0.8
"15520",3990,0,0,1,3,3,6,5,1,1,24,0,2,14,1,0,0,1037986,"2023-12-23T00:00:00.000Z",259,9,"Kevin Knox",0,15,15,14,1,15.2
"15521",3991,0,0,0,0,0,0,0,0,0,0,0,0,0,0,0,0,1037986,"2023-12-23T00:00:00.000Z",17896071,9,"Isaiah Livers",0,0,0,0,0,0
"15522",3992,0,0,0,0,0,0,0,0,0,0,0,0,0,0,0,0,1037986,"2023-12-23T00:00:00.000Z",3547240,9,"James Wiseman",0,0,0,0,0,0
"15523",3993,0,0,0,0,0,0,0,0,0,0,0,0,0,0,0,0,1037986,"2023-12-23T00:00:00.000Z",56677729,9,"Malcolm Cazalon",0,0,0,0,0,0
"15524",3994,0,0,0,0,0,0,0,0,0,0,0,0,0,0,0,0,1037986,"2023-12-23T00:00:00.000Z",42097199,9,"Jared Rhoden",0,0,0,0,0,0
"15525",3995,0,0,0,0,0,0,0,0,0,0,0,0,0,0,0,0,1037986,"2023-12-23T00:00:00.000Z",44477024,9,"Stanley Umude",0,0,0,0,0,0
"15526",3996,1,0,2,3,0,6,2,0,0,20,1,3,4,3,0,1,1037988,"2023-12-23T00:00:00.000Z",17895983,5,"Ayo Dosunmu",0,7,8,5,4,8.1
"15527",3997,0,0,1,1,0,3,2,2,2,17,0,1,6,1,1,0,1037988,"2023-12-23T00:00:00.000Z",38017719,5,"Dalen Terry",1,7,7,6,1,10.2
"15528",3998,0,0,4,0,0,0,0,2,1,13,2,4,1,6,1,1,1037988,"2023-12-23T00:00:00.000Z",137,5,"Andre Drummond",1,7,7,1,6,10.2
"15529",3999,0,0,0,0,0,0,0,0,0,0,0,0,0,0,0,0,1037988,"2023-12-23T00:00:00.000Z",110,5,"Torrey Craig",0,0,0,0,0,0
"15530",4000,0,0,0,0,0,0,0,0,0,0,0,0,0,0,0,0,1037987,"2023-12-23T00:00:00.000Z",56677828,28,"Gradey Dick",0,0,0,0,0,0
"15531",4001,0,0,0,0,0,0,0,0,0,0,0,0,0,0,0,0,7050287,"2023-12-08T00:00:00.000Z",38017715,18,"Josh Minott",0,0,0,0,0,0
"15532",4002,0,0,0,0,0,0,0,0,0,0,0,0,0,0,0,0,7050289,"2023-12-08T00:00:00.000Z",56677865,27,"Charles Bediako",0,0,0,0,0,0
"15533",4003,2,0,2,4,1,17,8,1,0,30,1,2,17,3,0,3,7050285,"2023-12-08T00:00:00.000Z",265,30,"Kyle Kuzma",0,20,22,19,5,20.6
"15534",4004,0,2,7,6,3,12,8,1,1,40,1,3,20,8,0,2,7050290,"2023-12-08T00:00:00.000Z",375,8,"Michael Porter Jr.",2,28,28,20,8,33.6
"15535",4005,3,0,5,2,0,5,1,5,1,22,1,1,3,6,0,1,7050290,"2023-12-08T00:00:00.000Z",177,8,"Aaron Gordon",0,9,12,6,9,13.7
"15536",4006,5,2,9,2,1,26,9,7,4,34,7,5,23,16,0,3,7050290,"2023-12-08T00:00:00.000Z",246,8,"Nikola Jokic",2,39,44,28,21,52.7
"15537",4007,0,1,0,3,2,6,5,2,2,25,0,1,14,0,0,0,7050290,"2023-12-08T00:00:00.000Z",81,8,"Kentavious Caldwell-Pope",1,14,14,14,0,17
"15538",4008,3,0,5,8,4,17,6,5,5,32,0,2,21,5,0,1,7050290,"2023-12-08T00:00:00.000Z",335,8,"Jamal Murray",0,26,29,24,8,30.5
"15539",4009,0,0,0,0,0,0,0,0,0,0,0,0,0,0,0,0,7050289,"2023-12-08T00:00:00.000Z",56677817,27,"Sidy Cissoko",0,0,0,0,0,0
"15540",4010,0,0,0,0,0,0,0,0,0,0,0,0,0,0,0,0,7050289,"2023-12-08T00:00:00.000Z",56677870,27,"Sir'Jabari Rice",0,0,0,0,0,0
"15541",4011,10,0,5,2,0,24,7,10,6,39,1,2,20,6,3,2,7050289,"2023-12-08T00:00:00.000Z",125,5,"DeMar DeRozan",3,26,36,30,16,49.2
"15542",4012,3,1,5,3,2,11,8,4,2,34,1,3,20,6,1,0,7050289,"2023-12-08T00:00:00.000Z",3547248,5,"Patrick Williams",2,26,29,23,9,37.7
"15543",4013,2,1,6,2,0,22,9,3,3,36,10,2,21,16,0,0,7050289,"2023-12-08T00:00:00.000Z",460,5,"Nikola Vucevic",1,37,39,23,18,46.2
"15544",4014,2,0,2,2,0,5,2,0,0,18,1,2,4,3,1,2,7050289,"2023-12-08T00:00:00.000Z",89,5,"Alex Caruso",1,7,9,6,5,11.6
"15545",4015,1,0,0,1,0,1,0,0,0,4,0,0,0,0,0,0,7050287,"2023-12-08T00:00:00.000Z",38017700,18,"Wendell Moore Jr.",0,0,1,1,1,1.5
"15546",4016,0,0,0,0,0,0,0,0,0,0,0,0,0,0,0,0,7050287,"2023-12-08T00:00:00.000Z",56677851,18,"Jaylen Clark",0,0,0,0,0,0
"15547",4017,1,0,1,2,0,4,1,0,0,14,0,3,2,1,2,1,7050290,"2023-12-08T00:00:00.000Z",38017709,8,"Christian Braun",2,3,4,3,2,9.7
"15548",4018,6,0,4,7,5,15,9,1,1,39,0,0,24,4,1,3,7050289,"2023-12-08T00:00:00.000Z",666956,5,"Coby White",1,28,34,30,10,37.8
"15549",4019,3,0,3,2,0,5,2,0,0,26,0,1,4,3,1,0,7050289,"2023-12-08T00:00:00.000Z",17895983,5,"Ayo Dosunmu",1,7,10,7,6,15.1
"15550",4020,0,0,0,0,0,0,0,0,0,0,0,0,0,0,0,0,7050289,"2023-12-08T00:00:00.000Z",17896116,5,"Terry Taylor",0,0,0,0,0,0
"15551",4021,0,0,0,0,0,0,0,0,0,0,0,0,0,0,0,0,7050289,"2023-12-08T00:00:00.000Z",38017719,5,"Dalen Terry",0,0,0,0,0,0
"15552",4022,0,0,0,0,0,0,0,0,0,0,0,0,0,0,0,0,7050289,"2023-12-08T00:00:00.000Z",27,5,"Lonzo Ball",0,0,0,0,0,0
"15553",4023,0,0,0,0,0,0,0,0,0,0,0,0,0,0,0,0,7050289,"2023-12-08T00:00:00.000Z",56677874,5,"Onuralp Bitim",0,0,0,0,0,0
"15554",4024,0,0,0,0,0,0,0,0,0,0,0,0,0,0,0,0,7050289,"2023-12-08T00:00:00.000Z",268,5,"Zach LaVine",0,0,0,0,0,0
"15555",4025,0,0,0,0,0,0,0,0,0,0,0,0,0,0,0,0,7050289,"2023-12-08T00:00:00.000Z",45969255,5,"Justin Lewis",0,0,0,0,0,0
"15556",4026,0,0,0,0,0,0,0,0,0,0,0,0,0,0,0,0,1037777,"2023-11-19T00:00:00.000Z",17896048,3,"Cam Thomas",0,0,0,0,0,0
"15557",4027,0,0,0,0,0,0,0,0,0,0,0,0,0,0,0,0,1037777,"2023-11-19T00:00:00.000Z",9051997,3,"Armoni Brooks",0,0,0,0,0,0
"15558",4028,0,0,0,0,0,0,0,0,0,0,0,0,0,0,0,0,1037777,"2023-11-19T00:00:00.000Z",56677843,3,"Noah Clowney",0,0,0,0,0,0
"15559",4029,0,0,0,0,0,0,0,0,0,0,0,0,0,0,0,0,1037777,"2023-11-19T00:00:00.000Z",17896041,3,"Keon Johnson",0,0,0,0,0,0
"15560",4030,0,0,0,0,0,0,0,0,0,0,0,0,0,0,0,0,1037777,"2023-11-19T00:00:00.000Z",417,3,"Ben Simmons",0,0,0,0,0,0
"15561",4031,0,0,0,0,0,0,0,0,0,0,0,0,0,0,0,0,1037777,"2023-11-19T00:00:00.000Z",56677841,3,"Dariq Whitehead",0,0,0,0,0,0
"15562",4032,0,0,0,0,0,0,0,0,0,0,0,0,0,0,0,0,1037777,"2023-11-19T00:00:00.000Z",56677722,3,"Jalen Wilson",0,0,0,0,0,0
"15563",4033,3,0,3,1,1,1,1,0,0,24,0,2,3,3,0,0,1037777,"2023-11-19T00:00:00.000Z",33,23,"Nicolas Batum",0,6,9,6,6,11.1
"15564",4034,1,0,4,4,0,13,5,0,0,32,1,0,10,5,2,0,1037777,"2023-11-19T00:00:00.000Z",200,23,"Tobias Harris",2,15,16,11,6,23.5
"15565",4035,9,1,10,2,1,24,11,10,9,31,2,3,32,12,0,1,1037777,"2023-11-19T00:00:00.000Z",145,23,"Joel Embiid",1,44,53,41,21,61.9
"15566",4036,1,0,5,6,4,10,8,1,1,27,0,3,21,5,3,1,1037777,"2023-11-19T00:00:00.000Z",313,23,"De'Anthony Melton",3,26,27,22,6,36.5
"15567",4037,10,0,1,11,6,20,8,3,3,37,1,0,25,2,0,1,1037777,"2023-11-19T00:00:00.000Z",3547254,23,"Tyrese Maxey",0,27,37,35,12,41.4
"15568",4038,0,1,2,0,0,2,2,0,0,11,0,1,4,2,1,0,1037777,"2023-11-19T00:00:00.000Z",108,23,"Robert Covington",2,6,6,4,2,12.4
"15569",4039,2,0,1,1,0,4,1,0,0,12,0,1,2,1,0,1,1037777,"2023-11-19T00:00:00.000Z",45,23,"Patrick Beverley",0,3,5,4,3,5.2
"15570",4040,3,0,1,2,1,4,1,0,0,14,2,3,3,3,1,0,1037777,"2023-11-19T00:00:00.000Z",2175,23,"Danuel House Jr.",1,6,9,6,6,14.1
"15571",4041,3,0,6,3,1,12,4,5,5,25,0,6,14,6,1,0,1037778,"2023-11-19T00:00:00.000Z",38017686,12,"Bennedict Mathurin",1,20,23,17,9,28.7
"15572",4042,2,0,2,3,0,8,3,0,0,16,2,2,6,4,0,2,1037778,"2023-11-19T00:00:00.000Z",3547243,12,"Obi Toppin",0,10,12,8,6,11.8
"15573",4043,3,3,1,3,0,10,3,6,4,23,3,2,10,4,1,1,1037778,"2023-11-19T00:00:00.000Z",452,12,"Myles Turner",4,14,17,13,7,30.3
"15574",4044,1,1,5,2,1,7,4,2,2,22,0,3,11,5,0,1,1037778,"2023-11-19T00:00:00.000Z",69,12,"Bruce Brown",1,16,17,12,6,20.5
"15575",4045,3,1,2,3,1,14,4,3,3,25,0,2,12,2,0,4,1037778,"2023-11-19T00:00:00.000Z",3547245,12,"Tyrese Haliburton",1,14,17,15,5,17.9
"15576",4046,2,0,1,4,1,4,1,0,0,15,0,4,3,1,0,1,1037778,"2023-11-19T00:00:00.000Z",210,12,"Buddy Hield",0,4,6,5,3,6.2
"15577",4047,5,0,3,1,0,9,5,3,1,21,1,1,11,4,0,2,1037778,"2023-11-19T00:00:00.000Z",304,12,"T.J. McConnell",0,15,20,16,9,21.3
"15578",4048,0,0,1,0,0,2,0,0,0,15,0,2,0,1,0,0,1037778,"2023-11-19T00:00:00.000Z",3547250,12,"Aaron Nesmith",0,1,1,0,1,1.2
"15579",4049,1,0,3,5,2,11,8,1,1,23,2,3,19,5,2,1,1037778,"2023-11-19T00:00:00.000Z",3547207,12,"Jordan Nwora",2,24,25,20,6,31.5
"15580",4050,1,1,3,0,0,2,1,6,4,12,1,2,6,4,3,0,1037778,"2023-11-19T00:00:00.000Z",17896035,12,"Isaiah Jackson",4,10,11,7,5,24.3
"15581",4051,0,0,0,0,0,0,0,0,0,0,0,0,0,0,0,0,1038005,"2023-12-26T00:00:00.000Z",47957121,25,"Justin Minaya",0,0,0,0,0,0
"15582",4052,6,0,2,3,2,17,8,7,7,40,0,3,25,2,1,1,1038000,"2023-12-26T00:00:00.000Z",125,5,"DeMar DeRozan",1,27,33,31,8,38.4
"15583",4053,0,0,0,1,0,7,2,2,2,25,1,2,6,1,1,1,1038000,"2023-12-26T00:00:00.000Z",3547248,5,"Patrick Williams",1,7,7,6,1,9.2
"15584",4054,1,2,15,0,0,13,11,2,2,39,10,4,24,25,3,2,1038000,"2023-12-26T00:00:00.000Z",137,5,"Andre Drummond",5,49,50,25,26,68.5
"15585",4055,5,0,3,5,1,10,2,6,6,29,2,2,11,5,2,1,1038000,"2023-12-26T00:00:00.000Z",89,5,"Alex Caruso",2,16,21,16,10,29.5
"15586",4056,5,0,5,7,0,22,7,8,5,37,0,2,19,5,0,1,1038000,"2023-12-26T00:00:00.000Z",666956,5,"Coby White",0,24,29,24,10,31.5
"15587",4057,4,0,3,4,2,14,6,6,5,35,4,1,19,7,3,0,1038000,"2023-12-26T00:00:00.000Z",17895983,5,"Ayo Dosunmu",3,26,30,23,11,42.4
"15588",4058,0,2,4,6,5,9,7,2,1,33,0,4,20,4,1,1,1038003,"2023-12-26T00:00:00.000Z",666541,21,"Luguentz Dort",3,24,24,20,4,32.8
"15589",4059,3,2,1,6,4,11,7,3,3,26,0,3,21,1,0,1,1038003,"2023-12-26T00:00:00.000Z",38017703,21,"Jalen Williams",2,22,25,24,4,31.7
"15590",4060,5,1,4,6,3,13,8,2,1,29,0,4,20,4,0,1,1038003,"2023-12-26T00:00:00.000Z",38017685,21,"Chet Holmgren",1,24,29,25,9,34.3
"15591",4061,7,0,2,2,0,7,4,2,2,25,0,3,10,2,0,2,1038003,"2023-12-26T00:00:00.000Z",17896065,21,"Josh Giddey",0,12,19,17,9,20.9
"15592",4062,9,1,6,3,0,19,14,7,6,33,0,3,34,6,2,3,1038003,"2023-12-26T00:00:00.000Z",175,21,"Shai Gilgeous-Alexander",3,40,49,43,15,60.7
"15593",4063,2,0,1,3,2,4,3,0,0,16,1,3,8,2,0,0,1038003,"2023-12-26T00:00:00.000Z",3547272,21,"Isaiah Joe",0,10,12,10,4,13.4
"15594",4064,4,0,0,4,0,7,1,0,0,16,0,3,2,0,2,1,1038003,"2023-12-26T00:00:00.000Z",4197029,21,"Vasilije Micic",2,2,6,6,4,13
"15595",4065,0,0,0,0,0,0,0,0,0,2,0,0,0,0,0,0,1038003,"2023-12-26T00:00:00.000Z",17896036,21,"Tre Mann",0,0,0,0,0,0
"15596",4066,0,0,0,0,0,0,0,0,0,0,0,0,0,0,0,0,1038003,"2023-12-26T00:00:00.000Z",44,21,"Davis Bertans",0,0,0,0,0,0
"15597",4067,0,0,0,0,0,0,0,0,0,0,0,0,0,0,0,0,1038003,"2023-12-26T00:00:00.000Z",38017716,21,"Ousmane Dieng",0,0,0,0,0,0
"15598",4068,0,0,0,0,0,0,0,0,0,0,0,0,0,0,0,0,1038003,"2023-12-26T00:00:00.000Z",24572055,21,"Olivier Sarr",0,0,0,0,0,0
"15599",4069,1,0,4,5,1,13,4,6,5,30,0,2,14,4,0,0,1038012,"2023-12-27T00:00:00.000Z",191,7,"Tim Hardaway Jr.",0,18,19,15,5,20.3
"15600",4070,1,3,3,4,0,13,5,2,2,36,2,3,12,5,1,2,1038012,"2023-12-27T00:00:00.000Z",247,7,"Derrick Jones Jr.",4,17,18,13,6,29.5
"15601",4071,1,2,2,0,0,2,2,1,0,25,2,4,4,4,0,1,1038012,"2023-12-27T00:00:00.000Z",56677840,7,"Dereck Lively II",2,8,9,5,5,15.3
"15602",4072,6,0,4,3,1,8,4,4,4,33,0,4,13,4,3,0,1038012,"2023-12-27T00:00:00.000Z",151,7,"Dante Exum",3,17,23,19,10,35.8
"15603",4073,6,2,7,10,3,29,14,10,8,37,0,0,39,7,2,5,1038012,"2023-12-27T00:00:00.000Z",132,7,"Luka Doncic",4,46,52,45,13,63.4
"15604",4074,0,0,4,4,0,7,2,0,0,26,2,5,4,6,2,0,1038012,"2023-12-27T00:00:00.000Z",666965,7,"Grant Williams",2,10,10,4,6,17.2
"15605",4075,5,0,3,2,0,4,1,0,0,21,0,1,2,3,2,1,1038012,"2023-12-27T00:00:00.000Z",3547258,7,"Josh Green",2,5,10,7,8,18.1
"15606",4076,0,0,0,0,0,0,0,0,0,0,0,0,0,0,0,0,1038006,"2023-12-26T00:00:00.000Z",17896037,4,"James Bouknight",0,0,0,0,0,0
"15607",4077,5,0,9,0,0,19,14,7,6,36,3,4,34,12,0,2,1038005,"2023-12-26T00:00:00.000Z",406,26,"Domantas Sabonis",0,46,51,39,17,53.9
"15608",4078,2,1,1,5,1,8,2,0,0,22,1,1,5,2,0,0,1038005,"2023-12-26T00:00:00.000Z",221,26,"Kevin Huerter",1,7,9,7,4,13.4
"15609",4079,4,1,6,15,7,26,16,6,4,38,2,2,43,8,2,5,1038005,"2023-12-26T00:00:00.000Z",161,26,"De'Aaron Fox",3,51,55,47,12,62.6
"15610",4080,4,1,1,7,1,11,3,0,0,19,0,2,7,1,0,0,1038005,"2023-12-26T00:00:00.000Z",324,26,"Malik Monk",1,8,12,11,5,17.2
"15611",4081,1,0,0,0,0,2,2,0,0,5,1,1,4,1,0,1,1038005,"2023-12-26T00:00:00.000Z",306,26,"JaVale McGee",0,5,6,5,2,5.7
"15612",4082,1,0,3,0,0,2,2,0,0,8,0,0,4,3,1,0,1038005,"2023-12-26T00:00:00.000Z",17896030,26,"Chris Duarte",1,7,8,5,4,12.1
"15613",4083,0,0,0,0,0,0,0,0,0,2,0,0,0,0,0,0,1038005,"2023-12-26T00:00:00.000Z",17896044,26,"Kessler Edwards",0,0,0,0,0,0
"15614",4084,0,0,1,2,0,3,1,0,0,2,0,0,2,1,0,0,1038005,"2023-12-26T00:00:00.000Z",17553994,26,"Davion Mitchell",0,3,3,2,1,3.2
"15615",4085,0,0,0,0,0,0,0,0,0,2,0,0,0,0,0,0,1038005,"2023-12-26T00:00:00.000Z",273,26,"Alex Len",0,0,0,0,0,0
"15616",4086,0,0,0,0,0,0,0,0,0,2,0,0,0,0,1,0,1038005,"2023-12-26T00:00:00.000Z",666925,26,"Juan Toscano-Anderson",1,0,0,0,0,3
"15617",4087,1,1,8,0,0,6,5,4,3,33,2,2,13,10,0,1,1038006,"2023-12-26T00:00:00.000Z",3547282,4,"Nick Richards",1,23,24,14,11,28.5
"15618",4088,4,0,1,0,0,4,2,0,0,16,0,1,4,1,0,1,1038006,"2023-12-26T00:00:00.000Z",422,4,"Ish Smith",0,5,9,8,5,10.2
"15619",4089,3,0,4,2,0,10,7,4,4,27,4,3,18,8,2,2,1038006,"2023-12-26T00:00:00.000Z",666950,4,"P.J. Washington",2,26,29,21,11,36.1
"15620",4091,0,0,0,0,0,0,0,0,0,0,0,0,0,0,0,0,1038006,"2023-12-26T00:00:00.000Z",18678001,4,"JT Thor",0,0,0,0,0,0
"15621",4092,0,0,0,0,0,0,0,0,0,0,0,0,0,0,0,0,1038006,"2023-12-26T00:00:00.000Z",56677848,4,"Amari Bailey",0,0,0,0,0,0
"15622",4093,0,0,0,0,0,0,0,0,0,0,0,0,0,0,0,0,1038006,"2023-12-26T00:00:00.000Z",3547239,4,"LaMelo Ball",0,0,0,0,0,0
"15623",4094,0,0,0,0,0,0,0,0,0,0,0,0,0,0,0,0,1038006,"2023-12-26T00:00:00.000Z",56677866,4,"Leaky Black",0,0,0,0,0,0
"15624",4095,0,0,0,0,0,0,0,0,0,0,0,0,0,0,0,0,1038006,"2023-12-26T00:00:00.000Z",56677823,4,"Brandon Miller",0,0,0,0,0,0
"15625",4096,0,0,0,0,0,0,0,0,0,0,0,0,0,0,0,0,1038006,"2023-12-26T00:00:00.000Z",347,4,"Frank Ntilikina",0,0,0,0,0,0
"15626",4097,0,0,0,0,0,0,0,0,0,0,0,0,0,0,0,0,1038006,"2023-12-26T00:00:00.000Z",38017698,4,"Mark Williams",0,0,0,0,0,0
"15627",4098,1,0,5,6,3,8,3,2,1,36,2,2,10,7,2,2,1038002,"2023-12-26T00:00:00.000Z",18677986,19,"Trey Murphy III",2,17,18,11,8,23.9
"15628",4099,2,0,2,4,1,8,3,2,1,11,1,0,8,3,1,0,1038002,"2023-12-26T00:00:00.000Z",17896097,19,"Jose Alvarado",1,11,13,10,5,17.6
"15629",4100,1,0,0,1,1,3,3,6,4,19,0,4,11,0,2,0,1038002,"2023-12-26T00:00:00.000Z",38017677,19,"Dyson Daniels",2,11,12,12,1,18.5
"15630",4101,0,0,0,0,0,0,0,0,0,0,0,0,0,0,0,0,1038006,"2023-12-26T00:00:00.000Z",24417679,13,"Xavier Moon",0,0,0,0,0,0
"15631",4102,4,1,6,15,7,26,16,6,4,38,2,2,43,8,2,5,1038005,"2023-12-26T00:00:00.000Z",161,26,"De'Aaron Fox",3,51,55,47,12,62.6
"15632",4103,4,1,1,7,1,11,3,0,0,19,0,2,7,1,0,0,1038005,"2023-12-26T00:00:00.000Z",324,26,"Malik Monk",1,8,12,11,5,17.2
"15633",4104,1,0,0,0,0,2,2,0,0,5,1,1,4,1,0,1,1038005,"2023-12-26T00:00:00.000Z",306,26,"JaVale McGee",0,5,6,5,2,5.7
"15634",4105,1,0,3,0,0,2,2,0,0,8,0,0,4,3,1,0,1038005,"2023-12-26T00:00:00.000Z",17896030,26,"Chris Duarte",1,7,8,5,4,12.1
"15635",4106,0,0,0,0,0,0,0,0,0,2,0,0,0,0,0,0,1038005,"2023-12-26T00:00:00.000Z",17896044,26,"Kessler Edwards",0,0,0,0,0,0
"15636",4107,0,0,1,2,0,3,1,0,0,2,0,0,2,1,0,0,1038005,"2023-12-26T00:00:00.000Z",17553994,26,"Davion Mitchell",0,3,3,2,1,3.2
"15637",4108,0,0,0,0,0,0,0,0,0,2,0,0,0,0,0,0,1038005,"2023-12-26T00:00:00.000Z",273,26,"Alex Len",0,0,0,0,0,0
"15638",4109,0,0,0,0,0,0,0,0,0,2,0,0,0,0,1,0,1038005,"2023-12-26T00:00:00.000Z",666925,26,"Juan Toscano-Anderson",1,0,0,0,0,3
"15639",4110,1,1,8,0,0,6,5,4,3,33,2,2,13,10,0,1,1038006,"2023-12-26T00:00:00.000Z",3547282,4,"Nick Richards",1,23,24,14,11,28.5
"15640",4111,4,0,1,0,0,4,2,0,0,16,0,1,4,1,0,1,1038006,"2023-12-26T00:00:00.000Z",422,4,"Ish Smith",0,5,9,8,5,10.2
"15641",4112,3,0,4,2,0,10,7,4,4,27,4,3,18,8,2,2,1038006,"2023-12-26T00:00:00.000Z",666950,4,"P.J. Washington",2,26,29,21,11,36.1
"15642",4114,0,0,0,0,0,0,0,0,0,0,0,0,0,0,0,0,1038006,"2023-12-26T00:00:00.000Z",18678001,4,"JT Thor",0,0,0,0,0,0
"15643",4115,0,0,0,0,0,0,0,0,0,0,0,0,0,0,0,0,1038006,"2023-12-26T00:00:00.000Z",56677848,4,"Amari Bailey",0,0,0,0,0,0
"15644",4116,0,0,0,0,0,0,0,0,0,0,0,0,0,0,0,0,1038006,"2023-12-26T00:00:00.000Z",3547239,4,"LaMelo Ball",0,0,0,0,0,0
"15645",4117,0,0,0,0,0,0,0,0,0,0,0,0,0,0,0,0,1038006,"2023-12-26T00:00:00.000Z",56677866,4,"Leaky Black",0,0,0,0,0,0
"15646",4118,0,0,0,0,0,0,0,0,0,0,0,0,0,0,0,0,1038006,"2023-12-26T00:00:00.000Z",56677823,4,"Brandon Miller",0,0,0,0,0,0
"15647",4119,0,0,0,0,0,0,0,0,0,0,0,0,0,0,0,0,1038006,"2023-12-26T00:00:00.000Z",347,4,"Frank Ntilikina",0,0,0,0,0,0
"15648",4120,0,0,0,0,0,0,0,0,0,0,0,0,0,0,0,0,1038006,"2023-12-26T00:00:00.000Z",38017698,4,"Mark Williams",0,0,0,0,0,0
"15649",4121,1,0,5,6,3,8,3,2,1,36,2,2,10,7,2,2,1038002,"2023-12-26T00:00:00.000Z",18677986,19,"Trey Murphy III",2,17,18,11,8,23.9
"15650",4122,2,0,2,4,1,8,3,2,1,11,1,0,8,3,1,0,1038002,"2023-12-26T00:00:00.000Z",17896097,19,"Jose Alvarado",1,11,13,10,5,17.6
"15651",4123,1,0,0,1,1,3,3,6,4,19,0,4,11,0,2,0,1038002,"2023-12-26T00:00:00.000Z",38017677,19,"Dyson Daniels",2,11,12,12,1,18.5
"15652",4124,3,0,5,5,1,16,8,8,7,36,0,4,24,5,1,4,1038007,"2023-12-27T00:00:00.000Z",17896026,22,"Franz Wagner",1,29,32,27,8,33.5
"15653",4125,4,1,9,8,1,21,6,7,6,38,0,0,19,9,1,1,1038007,"2023-12-27T00:00:00.000Z",38017683,22,"Paolo Banchero",2,28,32,23,13,40.8
"15654",4126,2,0,4,4,1,8,4,2,1,25,0,2,10,4,0,1,1038008,"2023-12-27T00:00:00.000Z",56677844,30,"Bilal Coulibaly",0,14,16,12,6,16.8
"15655",4127,0,0,1,2,0,3,1,0,0,2,0,0,2,1,0,0,1038005,"2023-12-26T00:00:00.000Z",17553994,26,"Davion Mitchell",0,3,3,2,1,3.2
"15656",4128,0,0,0,0,0,0,0,0,0,2,0,0,0,0,0,0,1038005,"2023-12-26T00:00:00.000Z",273,26,"Alex Len",0,0,0,0,0,0
"15657",4129,0,0,0,0,0,0,0,0,0,2,0,0,0,0,1,0,1038005,"2023-12-26T00:00:00.000Z",666925,26,"Juan Toscano-Anderson",1,0,0,0,0,3
"15658",4130,1,1,8,0,0,6,5,4,3,33,2,2,13,10,0,1,1038006,"2023-12-26T00:00:00.000Z",3547282,4,"Nick Richards",1,23,24,14,11,28.5
"15659",4131,4,0,1,0,0,4,2,0,0,16,0,1,4,1,0,1,1038006,"2023-12-26T00:00:00.000Z",422,4,"Ish Smith",0,5,9,8,5,10.2
"15660",4132,3,0,4,2,0,10,7,4,4,27,4,3,18,8,2,2,1038006,"2023-12-26T00:00:00.000Z",666950,4,"P.J. Washington",2,26,29,21,11,36.1
"15661",4134,0,0,0,0,0,0,0,0,0,0,0,0,0,0,0,0,1038006,"2023-12-26T00:00:00.000Z",18678001,4,"JT Thor",0,0,0,0,0,0
"15662",4135,0,0,0,0,0,0,0,0,0,0,0,0,0,0,0,0,1038006,"2023-12-26T00:00:00.000Z",56677848,4,"Amari Bailey",0,0,0,0,0,0
"15663",4136,0,0,0,0,0,0,0,0,0,0,0,0,0,0,0,0,1038006,"2023-12-26T00:00:00.000Z",3547239,4,"LaMelo Ball",0,0,0,0,0,0
"15664",4137,0,0,0,0,0,0,0,0,0,0,0,0,0,0,0,0,1038006,"2023-12-26T00:00:00.000Z",56677866,4,"Leaky Black",0,0,0,0,0,0
"15665",4138,0,0,0,0,0,0,0,0,0,0,0,0,0,0,0,0,1038006,"2023-12-26T00:00:00.000Z",56677823,4,"Brandon Miller",0,0,0,0,0,0
"15666",4139,0,0,0,0,0,0,0,0,0,0,0,0,0,0,0,0,1038006,"2023-12-26T00:00:00.000Z",347,4,"Frank Ntilikina",0,0,0,0,0,0
"15667",4140,0,0,0,0,0,0,0,0,0,0,0,0,0,0,0,0,1038006,"2023-12-26T00:00:00.000Z",38017698,4,"Mark Williams",0,0,0,0,0,0
"15668",4141,1,0,5,6,3,8,3,2,1,36,2,2,10,7,2,2,1038002,"2023-12-26T00:00:00.000Z",18677986,19,"Trey Murphy III",2,17,18,11,8,23.9
"15669",4142,2,0,2,4,1,8,3,2,1,11,1,0,8,3,1,0,1038002,"2023-12-26T00:00:00.000Z",17896097,19,"Jose Alvarado",1,11,13,10,5,17.6
"15670",4143,1,0,0,1,1,3,3,6,4,19,0,4,11,0,2,0,1038002,"2023-12-26T00:00:00.000Z",38017677,19,"Dyson Daniels",2,11,12,12,1,18.5
"15671",4144,3,0,5,5,1,16,8,8,7,36,0,4,24,5,1,4,1038007,"2023-12-27T00:00:00.000Z",17896026,22,"Franz Wagner",1,29,32,27,8,33.5
"15672",4145,4,1,9,8,1,21,6,7,6,38,0,0,19,9,1,1,1038007,"2023-12-27T00:00:00.000Z",38017683,22,"Paolo Banchero",2,28,32,23,13,40.8
"15673",4146,1,2,2,2,0,4,1,2,2,22,2,0,4,4,0,1,1038007,"2023-12-27T00:00:00.000Z",85,22,"Wendell Carter Jr.",2,8,9,5,5,15.3
"15674",4147,1,1,1,2,1,12,8,3,3,28,1,5,20,2,1,3,1038007,"2023-12-27T00:00:00.000Z",17896073,22,"Jalen Suggs",2,22,23,21,3,26.9
"15675",4148,4,1,3,3,1,6,1,0,0,24,1,2,3,4,1,0,1038007,"2023-12-27T00:00:00.000Z",56677827,22,"Anthony Black",2,7,11,7,8,19.8
"15676",4149,1,0,4,4,1,7,2,1,0,23,2,1,5,6,0,4,1038007,"2023-12-27T00:00:00.000Z",3547251,22,"Cole Anthony",0,11,12,6,7,9.7
"15677",4150,2,0,4,4,2,4,2,1,1,26,2,2,7,6,0,2,1038007,"2023-12-27T00:00:00.000Z",38017724,22,"Caleb Houstan",0,13,15,9,8,15.2
"15678",4151,1,0,1,1,1,2,2,0,0,8,0,0,5,1,0,1,1037901,"2023-12-12T00:00:00.000Z",17895990,26,"Jordan Ford",0,6,7,6,2,6.7
"15679",4152,0,0,0,0,0,0,0,0,0,0,0,0,0,0,0,0,1037901,"2023-12-12T00:00:00.000Z",273,26,"Alex Len",0,0,0,0,0,0
"15680",4153,3,0,5,1,0,8,4,0,0,20,2,0,8,7,0,4,1037901,"2023-12-12T00:00:00.000Z",472,13,"Russell Westbrook",0,15,18,11,10,16.9
"15681",4154,0,0,0,0,0,0,0,0,0,0,0,0,0,0,0,0,1037901,"2023-12-12T00:00:00.000Z",450,13,"PJ Tucker",0,0,0,0,0,0
"15682",4155,0,0,0,0,0,0,0,0,0,0,0,0,0,0,0,0,1037901,"2023-12-12T00:00:00.000Z",17896022,13,"Brandon Boston Jr.",0,0,0,0,0,0
"15683",4156,0,0,0,0,0,0,0,0,0,0,0,0,0,0,0,0,1037901,"2023-12-12T00:00:00.000Z",38017725,13,"Moussa Diabate",0,0,0,0,0,0
"15684",4157,0,0,0,0,0,0,0,0,0,0,0,0,0,0,0,0,1037901,"2023-12-12T00:00:00.000Z",56677856,13,"Jordan Miller",0,0,0,0,0,0
"15685",4158,0,0,0,0,0,0,0,0,0,0,0,0,0,0,0,0,1037901,"2023-12-12T00:00:00.000Z",371,13,"Mason Plumlee",0,0,0,0,0,0
"15686",4159,0,0,0,0,0,0,0,0,0,0,0,0,0,0,0,0,1037901,"2023-12-12T00:00:00.000Z",17896051,13,"Joshua Primo",0,0,0,0,0,0
"15687",4160,1,0,1,2,0,3,1,0,0,19,0,2,2,1,0,0,1037901,"2023-12-12T00:00:00.000Z",30,26,"Harrison Barnes",0,3,4,3,2,4.7
"15688",4161,1,0,7,5,0,14,6,6,5,31,0,2,17,7,3,0,1037901,"2023-12-12T00:00:00.000Z",38017688,26,"Keegan Murray",3,24,25,18,8,35.9
"15689",4162,3,0,5,2,0,11,5,8,5,26,5,3,15,10,2,2,1037901,"2023-12-12T00:00:00.000Z",406,26,"Domantas Sabonis",2,25,28,18,13,35.5
"15690",4163,3,0,4,4,1,8,1,0,0,16,0,1,3,4,1,0,1037901,"2023-12-12T00:00:00.000Z",221,26,"Kevin Huerter",1,7,10,6,7,15.3
"15691",4164,3,0,3,7,3,16,5,1,1,25,0,3,14,3,0,4,1037901,"2023-12-12T00:00:00.000Z",161,26,"De'Aaron Fox",0,17,20,17,6,18.1
"15692",4165,7,0,5,3,1,8,4,4,4,30,1,1,13,6,0,2,1037903,"2023-12-13T00:00:00.000Z",3547242,30,"Deni Avdija",0,19,26,20,13,28.7
"15693",4166,4,1,7,8,4,19,10,4,3,29,0,1,27,7,1,1,1037903,"2023-12-13T00:00:00.000Z",265,30,"Kyle Kuzma",2,34,38,31,11,46.4
"15694",4167,3,0,6,1,0,7,5,0,0,30,2,3,10,8,1,0,1037902,"2023-12-13T00:00:00.000Z",56677826,9,"Ausar Thompson",1,18,21,13,11,27.1
"15695",4168,2,0,1,9,5,19,11,8,6,34,0,1,33,1,1,1,1037902,"2023-12-13T00:00:00.000Z",54,9,"Bojan Bogdanovic",1,34,36,35,3,39.2
"15696",4169,2,0,2,1,0,3,1,2,2,22,2,3,4,4,0,2,1037902,"2023-12-13T00:00:00.000Z",3547267,9,"Isaiah Stewart",0,8,10,6,6,9.8
"15697",4170,7,0,5,8,1,17,5,12,10,30,1,3,21,6,0,1,1037902,"2023-12-13T00:00:00.000Z",17896075,9,"Cade Cunningham",0,27,34,28,13,37.7
"15698",4171,6,0,3,0,0,8,3,0,0,32,0,2,6,3,1,1,1037902,"2023-12-13T00:00:00.000Z",3547241,9,"Killian Hayes",1,9,15,12,9,20.6
"15699",4172,0,1,3,0,0,7,5,0,0,16,0,6,10,3,1,1,1037902,"2023-12-13T00:00:00.000Z",3547240,9,"James Wiseman",2,13,13,10,3,18.6
"15700",4173,0,0,3,2,0,4,1,0,0,27,0,1,2,3,1,0,1037902,"2023-12-13T00:00:00.000Z",17896071,9,"Isaiah Livers",1,5,5,2,3,8.6
"15701",4174,1,0,3,4,2,9,5,4,3,20,1,5,15,4,0,0,1037900,"2023-12-12T00:00:00.000Z",407,10,"Dario Saric",0,19,20,16,5,21.3
"15702",4175,5,0,6,4,2,14,9,1,0,29,5,2,20,11,1,3,1037900,"2023-12-12T00:00:00.000Z",56677858,10,"Brandin Podziemski",1,31,36,25,16,40.7
"15703",4176,0,0,0,0,0,0,0,0,0,0,0,0,0,0,0,0,1037828,"2023-11-25T00:00:00.000Z",17896022,13,"Brandon Boston Jr.",0,0,0,0,0,0
"15704",4177,0,0,0,0,0,0,0,0,0,0,0,0,0,0,0,0,1037828,"2023-11-25T00:00:00.000Z",56677856,13,"Jordan Miller",0,0,0,0,0,0
"15705",4178,0,0,0,0,0,0,0,0,0,0,0,0,0,0,0,0,1037828,"2023-11-25T00:00:00.000Z",24417679,13,"Xavier Moon",0,0,0,0,0,0
"15706",4179,0,0,0,0,0,0,0,0,0,0,0,0,0,0,0,0,1037828,"2023-11-25T00:00:00.000Z",371,13,"Mason Plumlee",0,0,0,0,0,0
"15707",4180,0,0,0,0,0,0,0,0,0,0,0,0,0,0,0,0,1037828,"2023-11-25T00:00:00.000Z",17896051,13,"Joshua Primo",0,0,0,0,0,0
"15708",4181,1,1,1,3,1,5,1,2,1,20,0,1,4,1,1,0,1037828,"2023-11-25T00:00:00.000Z",247,7,"Derrick Jones Jr.",2,5,6,5,2,12.7
"15709",4182,1,0,1,2,1,3,2,0,0,35,3,4,5,4,0,1,1037828,"2023-11-25T00:00:00.000Z",666965,7,"Grant Williams",0,9,10,6,5,10.3
"15710",4183,1,2,3,0,0,4,0,2,0,21,2,3,0,5,0,0,1037828,"2023-11-25T00:00:00.000Z",217,7,"Richaun Holmes",2,5,6,1,6,13.5
"15711",4184,3,0,6,7,3,22,11,1,1,32,0,3,26,6,1,1,1037828,"2023-11-25T00:00:00.000Z",228,7,"Kyrie Irving",1,32,35,29,9,39.7
"15712",4185,4,2,3,8,1,27,12,5,5,38,0,4,30,3,2,4,1037828,"2023-11-25T00:00:00.000Z",132,7,"Luka Doncic",4,33,37,34,7,47.6
"15713",4186,3,0,2,0,0,0,0,2,2,15,0,2,2,2,0,0,1037828,"2023-11-25T00:00:00.000Z",379,7,"Dwight Powell",0,4,7,5,5,8.9
"15714",4187,0,0,3,9,2,14,5,0,0,29,0,2,12,3,0,1,1037828,"2023-11-25T00:00:00.000Z",191,7,"Tim Hardaway Jr.",0,15,15,12,3,14.6
"15715",4188,1,0,1,1,0,2,0,0,0,9,0,2,0,1,0,0,1037828,"2023-11-25T00:00:00.000Z",3547258,7,"Josh Green",0,1,2,1,2,2.7
"15716",4189,2,0,5,1,0,4,1,0,0,18,3,1,2,8,1,1,1037828,"2023-11-25T00:00:00.000Z",151,7,"Dante Exum",1,10,12,4,10,16.6
"15717",4190,0,0,0,4,1,5,1,0,0,8,0,2,3,0,0,0,1037828,"2023-11-25T00:00:00.000Z",114,7,"Seth Curry",0,3,3,3,0,3
"15718",4191,1,0,2,1,0,3,1,2,2,8,2,0,4,4,0,1,1037828,"2023-11-25T00:00:00.000Z",38017679,7,"Jaden Hardy",0,8,9,5,5,9.3
"15719",4192,0,0,1,0,0,0,0,0,0,12,0,0,0,1,0,0,1037829,"2023-11-26T00:00:00.000Z",56677852,17,"Andre Jackson Jr.",0,1,1,0,1,1.2
"15720",4193,6,3,10,1,0,21,11,18,11,39,6,5,33,16,1,4,1037829,"2023-11-26T00:00:00.000Z",15,17,"Giannis Antetokounmpo",4,49,55,39,22,69.2
"15721",4194,3,4,5,6,2,11,4,0,0,31,1,3,10,6,3,0,1037829,"2023-11-26T00:00:00.000Z",283,17,"Brook Lopez",7,16,19,13,9,42.7
"15722",4195,0,0,5,11,4,14,5,0,0,36,1,1,14,6,3,2,1037829,"2023-11-26T00:00:00.000Z",38,17,"Malik Beasley",3,20,20,14,6,28.2
"15723",4196,4,0,4,12,4,21,7,14,13,37,1,2,31,5,2,3,1037829,"2023-11-26T00:00:00.000Z",278,17,"Damian Lillard",2,36,40,35,9,46
"15724",4197,1,0,2,2,1,4,2,0,0,20,2,1,5,4,1,2,1037829,"2023-11-26T00:00:00.000Z",105,17,"Pat Connaughton",1,9,10,6,5,12.3
"15725",4198,1,1,1,0,0,0,0,0,0,9,0,2,0,1,0,1,1037829,"2023-11-26T00:00:00.000Z",38017676,17,"MarJon Beauchamp",1,1,2,1,2,4.7
"15726",4199,3,0,2,3,1,4,1,0,0,17,0,2,3,2,1,3,1037829,"2023-11-26T00:00:00.000Z",368,17,"Cameron Payne",1,5,8,6,5,9.9
"15727",4200,0,0,0,2,0,2,0,0,0,4,1,1,0,1,0,0,1037829,"2023-11-26T00:00:00.000Z",38017733,17,"A.J. Green",0,1,1,0,1,1.2
"15728",4201,0,0,1,2,1,2,1,0,0,4,0,2,3,1,0,0,1038009,"2023-12-27T00:00:00.000Z",38017733,17,"A.J. Green",0,4,4,3,1,4.2
"15729",4202,0,2,2,1,0,8,3,2,2,30,1,4,8,3,2,3,1037945,"2023-12-18T00:00:00.000Z",56677785,16,"Jaime Jaquez Jr.",4,11,11,8,3,20.6
"15730",4203,3,0,4,4,2,6,4,3,3,26,0,2,13,4,0,1,1037945,"2023-12-18T00:00:00.000Z",391,16,"Josh Richardson",0,17,20,16,7,21.3
"15731",4204,3,0,5,8,4,9,5,0,0,22,0,2,14,5,1,2,1037945,"2023-12-18T00:00:00.000Z",397,16,"Duncan Robinson",1,19,22,17,8,25.5
"15732",4205,1,1,0,0,0,0,0,0,0,12,0,2,0,0,1,0,1037945,"2023-12-18T00:00:00.000Z",3092,16,"Haywood Highsmith",2,0,1,1,1,7.5
"15733",4206,0,0,0,0,0,0,0,0,0,0,0,0,0,0,0,0,1037945,"2023-12-18T00:00:00.000Z",38017696,16,"Nikola Jovic",0,0,0,0,0,0
"15734",4207,0,0,0,0,0,0,0,0,0,0,0,0,0,0,0,0,1037945,"2023-12-18T00:00:00.000Z",39398582,16,"Orlando Robinson",0,0,0,0,0,0
"15735",4208,0,0,0,0,0,0,0,0,0,0,0,0,0,0,0,0,1037945,"2023-12-18T00:00:00.000Z",38017734,16,"Jamal Cain",0,0,0,0,0,0
"15736",4209,0,0,0,0,0,0,0,0,0,0,0,0,0,0,0,0,1037945,"2023-12-18T00:00:00.000Z",286,16,"Kyle Lowry",0,0,0,0,0,0
"15737",4210,0,0,0,0,0,0,0,0,0,0,0,0,0,0,0,0,1037945,"2023-12-18T00:00:00.000Z",19465585,16,"Dru Smith",0,0,0,0,0,0
"15738",4211,0,0,0,0,0,0,0,0,0,0,0,0,0,0,0,0,1037945,"2023-12-18T00:00:00.000Z",38017736,16,"Cole Swider",0,0,0,0,0,0
"15739",4212,2,3,2,0,0,10,5,0,0,30,3,6,10,5,0,3,1037945,"2023-12-18T00:00:00.000Z",3547259,18,"Jaden McDaniels",3,15,17,12,7,25
"15740",4213,2,0,4,4,1,14,7,3,3,32,4,3,18,8,1,1,1037945,"2023-12-18T00:00:00.000Z",447,18,"Karl-Anthony Towns",1,26,28,20,10,32.6
"15741",4214,2,2,5,6,5,15,7,0,0,29,1,5,19,6,1,4,1037944,"2023-12-18T00:00:00.000Z",666656,1,"De'Andre Hunter",3,25,27,21,8,34.2
"15742",4215,1,0,2,7,2,15,8,5,3,42,2,1,21,4,2,1,1037944,"2023-12-18T00:00:00.000Z",3547256,1,"Saddiq Bey",2,25,26,22,5,32.3
"15743",4216,2,3,8,0,0,11,7,3,3,28,7,3,17,15,1,1,1037944,"2023-12-18T00:00:00.000Z",83,1,"Clint Capela",4,32,34,19,17,49
"15744",4217,3,1,3,5,3,13,8,2,1,33,0,2,20,3,1,1,1037944,"2023-12-18T00:00:00.000Z",334,1,"Dejounte Murray",2,23,26,23,6,33.1
"15745",4218,15,0,4,11,4,17,8,12,11,38,0,3,31,4,0,5,1037944,"2023-12-18T00:00:00.000Z",490,1,"Trae Young",0,35,50,46,19,53.3
"15746",4219,0,0,0,0,0,0,0,0,0,0,0,0,0,0,0,0,1037944,"2023-12-18T00:00:00.000Z",53,1,"Bogdan Bogdanovic",0,0,0,0,0,0
"15747",4220,0,0,0,0,0,0,0,0,0,0,0,0,0,0,0,0,1037944,"2023-12-18T00:00:00.000Z",666564,1,"Bruno Fernando",0,0,0,0,0,0
"15748",4221,0,0,0,0,0,0,0,0,0,0,0,0,0,0,0,0,1037944,"2023-12-18T00:00:00.000Z",3547297,1,"Trent Forrest",0,0,0,0,0,0
"15749",4222,0,0,0,0,0,3,1,0,0,13,1,4,2,1,0,2,1038012,"2023-12-27T00:00:00.000Z",444,6,"Tristan Thompson",0,3,3,2,1,1.2
"15750",4223,0,0,0,0,0,0,0,0,0,0,0,0,0,0,0,0,1038012,"2023-12-27T00:00:00.000Z",666581,6,"Darius Garland",0,0,0,0,0,0
"15751",4224,0,0,0,0,0,0,0,0,0,0,0,0,0,0,0,0,1038012,"2023-12-27T00:00:00.000Z",666676,6,"Ty Jerome",0,0,0,0,0,0
"15752",4225,0,0,0,0,0,0,0,0,0,0,0,0,0,0,0,0,1038012,"2023-12-27T00:00:00.000Z",322,6,"Donovan Mitchell",0,0,0,0,0,0
"15753",4226,0,0,0,0,0,1,1,0,0,2,0,0,2,0,0,0,1037913,"2023-12-14T00:00:00.000Z",17554004,7,"AJ Lawson",0,2,2,2,0,2
"15754",4227,0,0,0,0,0,0,0,0,0,0,0,0,0,0,0,0,1037912,"2023-12-14T00:00:00.000Z",38017736,16,"Cole Swider",0,0,0,0,0,0
"15755",4228,0,0,0,0,0,0,0,0,0,0,0,0,0,0,0,0,1037912,"2023-12-14T00:00:00.000Z",666633,16,"Tyler Herro",0,0,0,0,0,0
"15756",4229,0,0,4,6,1,8,1,0,0,30,0,3,3,4,2,0,1037913,"2023-12-14T00:00:00.000Z",247,7,"Derrick Jones Jr.",2,7,7,3,4,13.8
"15757",4230,1,0,3,7,1,11,2,0,0,36,0,3,5,3,1,1,1037913,"2023-12-14T00:00:00.000Z",666965,7,"Grant Williams",1,8,9,6,4,12.1
"15758",4231,0,2,3,0,0,9,7,2,1,32,3,3,15,6,1,2,1037913,"2023-12-14T00:00:00.000Z",56677840,7,"Dereck Lively II",3,21,21,15,6,29.2
"15759",4232,4,0,4,3,2,6,5,2,2,28,0,2,14,4,0,2,1037913,"2023-12-14T00:00:00.000Z",151,7,"Dante Exum",0,18,22,18,8,22.8
"15760",4233,13,0,5,7,2,27,15,7,7,39,1,2,39,6,2,8,1037913,"2023-12-14T00:00:00.000Z",132,7,"Luka Doncic",2,45,58,52,19,63.7
"15761",4234,1,0,0,0,0,0,0,0,0,2,0,0,0,0,0,0,1037913,"2023-12-14T00:00:00.000Z",17896028,7,"Greg Brown III",0,0,1,1,1,1.5
"15762",4235,0,0,0,0,0,0,0,0,0,0,0,0,0,0,0,0,1037913,"2023-12-14T00:00:00.000Z",56677873,7,"Dexter Dennis",0,0,0,0,0,0
"15763",4236,1,0,2,0,0,2,2,2,2,12,0,1,6,2,0,0,1037912,"2023-12-14T00:00:00.000Z",74,16,"Thomas Bryant",0,8,9,7,3,9.9
"15764",4237,1,1,1,2,0,3,1,2,2,9,0,3,4,1,1,0,1037911,"2023-12-14T00:00:00.000Z",3547279,2,"Lamar Stevens",2,5,6,5,2,12.7
"15765",4238,2,1,3,1,0,1,0,0,0,14,0,1,0,3,0,0,1037911,"2023-12-14T00:00:00.000Z",3547276,2,"Payton Pritchard",1,3,5,2,5,9.6
"15766",4239,1,0,4,4,1,8,3,2,2,24,2,0,9,6,1,0,1037914,"2023-12-14T00:00:00.000Z",375,8,"Michael Porter Jr.",1,15,16,10,7,20.7
"15767",4240,2,1,2,1,0,9,6,1,1,24,0,0,13,2,1,2,1037914,"2023-12-14T00:00:00.000Z",177,8,"Aaron Gordon",2,15,17,15,4,22.4
"15768",4241,10,0,14,2,0,12,8,12,10,30,1,2,26,15,1,1,1037914,"2023-12-14T00:00:00.000Z",246,8,"Nikola Jokic",1,41,51,36,25,61
"15769",4242,2,0,1,5,0,6,1,0,0,27,0,2,2,1,4,1,1037914,"2023-12-14T00:00:00.000Z",215,8,"Justin Holiday",4,3,5,4,3,17.2
"15770",4243,2,1,1,4,2,15,7,0,0,22,0,2,16,1,3,0,1037914,"2023-12-14T00:00:00.000Z",335,8,"Jamal Murray",4,17,19,18,3,32.2
"15771",4244,4,0,0,4,2,13,4,2,2,23,0,3,12,0,2,1,1037914,"2023-12-14T00:00:00.000Z",236,8,"Reggie Jackson",2,12,16,16,4,23
"15772",4245,2,2,3,3,1,10,4,1,1,24,1,0,10,4,1,1,1037914,"2023-12-14T00:00:00.000Z",38017709,8,"Christian Braun",3,14,16,12,6,25.8
"15773",4246,0,1,2,0,0,2,1,0,0,12,2,2,2,4,0,1,1037914,"2023-12-14T00:00:00.000Z",250,8,"DeAndre Jordan",1,6,6,2,4,8.8
"15774",4247,1,0,0,1,1,2,2,0,0,6,3,1,5,3,0,0,1037914,"2023-12-14T00:00:00.000Z",3547268,8,"Zeke Nnaji",0,8,9,6,4,10.1
"15775",4248,0,0,0,0,0,0,0,0,0,0,0,0,0,0,0,0,1037911,"2023-12-14T00:00:00.000Z",17896094,2,"Dalano Banton",0,0,0,0,0,0
"15776",4249,0,0,0,0,0,0,0,0,0,0,0,0,0,0,0,0,1037911,"2023-12-14T00:00:00.000Z",666468,2,"Oshae Brissett",0,0,0,0,0,0
"15777",4250,0,0,0,0,0,0,0,0,0,0,0,0,0,0,0,0,1037911,"2023-12-14T00:00:00.000Z",261,2,"Luke Kornet",0,0,0,0,0,0
"15778",4251,2,1,3,2,0,8,1,2,1,14,1,2,3,4,0,0,3277507,"2023-11-24T00:00:00.000Z",472,13,"Russell Westbrook",1,7,9,5,6,13.8
"15779",4252,0,0,2,7,3,11,6,1,0,24,0,2,15,2,1,0,3277504,"2023-11-24T00:00:00.000Z",414,30,"Landry Shamet",1,17,17,15,2,20.4
"15780",4253,0,0,0,0,0,0,0,0,0,0,0,0,0,0,0,0,3277504,"2023-11-24T00:00:00.000Z",38017704,30,"Patrick Baldwin Jr.",0,0,0,0,0,0
"15781",4254,0,0,0,0,0,0,0,0,0,0,0,0,0,0,0,0,3277504,"2023-11-24T00:00:00.000Z",18677954,30,"Jared Butler",0,0,0,0,0,0
"15782",4255,0,0,0,0,0,0,0,0,0,0,0,0,0,0,0,0,3277504,"2023-11-24T00:00:00.000Z",38124126,30,"John Butler Jr.",0,0,0,0,0,0
"15783",4256,3,1,1,5,2,8,4,0,0,25,1,1,10,2,0,0,3277505,"2023-11-24T00:00:00.000Z",221,26,"Kevin Huerter",1,12,15,13,5,19.9
"15784",4257,2,0,4,4,2,11,7,2,2,33,0,0,18,4,0,2,3277505,"2023-11-24T00:00:00.000Z",30,26,"Harrison Barnes",0,22,24,20,6,23.8
"15785",4258,5,3,6,1,1,15,7,1,0,39,5,6,15,11,3,2,3277505,"2023-11-24T00:00:00.000Z",406,26,"Domantas Sabonis",6,26,31,20,16,51.7
"15786",4259,0,0,3,2,0,3,0,0,0,22,2,3,0,5,1,2,3277505,"2023-11-24T00:00:00.000Z",17896030,26,"Chris Duarte",1,5,5,0,5,7
"15787",4260,0,0,0,0,0,0,0,0,0,0,0,0,0,0,0,0,3277505,"2023-11-24T00:00:00.000Z",56677862,26,"Jalen Slawson",0,0,0,0,0,0
"15788",4261,4,0,3,2,1,7,3,0,0,33,3,2,7,6,0,2,3277506,"2023-11-24T00:00:00.000Z",38017699,27,"Jeremy Sochan",0,13,17,11,10,18.2
"15789",4262,1,0,3,10,4,19,10,0,0,27,1,2,24,4,1,2,3277506,"2023-11-24T00:00:00.000Z",3547246,27,"Devin Vassell",1,28,29,25,5,31.3
"15790",4263,0,0,0,6,1,11,5,0,0,18,1,3,11,1,0,1,3277506,"2023-11-24T00:00:00.000Z",359,27,"Cedi Osman",0,12,12,11,1,11.2
"15791",4264,2,0,5,1,1,5,3,0,0,17,0,1,7,5,2,1,3277506,"2023-11-24T00:00:00.000Z",3547274,27,"Tre Jones",2,12,14,9,7,21
"15792",4265,2,1,0,0,0,0,0,0,0,7,0,0,0,0,0,0,3277506,"2023-11-24T00:00:00.000Z",17895854,27,"Charles Bassey",1,0,2,2,2,6
"15793",4266,4,0,0,3,1,6,3,0,0,19,1,0,7,1,3,0,3277506,"2023-11-24T00:00:00.000Z",305,27,"Doug McDermott",3,8,12,11,5,23.2
"15794",4267,0,0,0,0,0,0,0,0,0,0,0,0,0,0,0,0,3277506,"2023-11-24T00:00:00.000Z",38017649,27,"Julian Champagnie",0,0,0,0,0,0
"15795",4268,0,0,0,0,0,0,0,0,0,0,0,0,0,0,0,0,3277506,"2023-11-24T00:00:00.000Z",180,27,"Devonte' Graham",0,0,0,0,0,0
"15796",4269,0,0,0,0,0,0,0,0,0,0,0,0,0,0,0,0,3277506,"2023-11-24T00:00:00.000Z",17896059,27,"Sandro Mamukelashvili",0,0,0,0,0,0
"15797",4270,0,0,0,0,0,0,0,0,0,0,0,0,0,0,0,0,3277506,"2023-11-24T00:00:00.000Z",38017730,27,"Dominick Barlow",0,0,0,0,0,0
"15798",4271,0,0,0,0,0,0,0,0,0,0,0,0,0,0,0,0,3277507,"2023-11-24T00:00:00.000Z",56677856,13,"Jordan Miller",0,0,0,0,0,0
"15799",4272,0,0,0,0,0,0,0,0,0,0,0,0,0,0,0,0,3277507,"2023-11-24T00:00:00.000Z",24417679,13,"Xavier Moon",0,0,0,0,0,0
"15800",4273,0,0,0,0,0,0,0,0,0,0,0,0,0,0,0,0,3277507,"2023-11-24T00:00:00.000Z",371,13,"Mason Plumlee",0,0,0,0,0,0
"15801",4274,0,0,0,0,0,0,0,0,0,0,0,0,0,0,0,0,3277507,"2023-11-24T00:00:00.000Z",17896051,13,"Joshua Primo",0,0,0,0,0,0
"15802",4275,5,0,4,5,2,21,12,6,4,35,0,3,30,4,0,3,3277507,"2023-11-24T00:00:00.000Z",227,19,"Brandon Ingram",0,34,39,35,9,39.3
"15803",4276,0,0,0,0,0,0,0,0,0,0,0,0,0,0,0,0,1037690,"2023-11-06T00:00:00.000Z",17896089,20,"Duane Washington Jr.",0,0,0,0,0,0
"15804",4277,0,0,0,0,0,0,0,0,0,0,0,0,0,0,0,0,1037693,"2023-11-06T00:00:00.000Z",56677851,18,"Jaylen Clark",0,0,0,0,0,0
"15805",4278,0,0,0,0,0,0,0,0,0,0,0,0,0,0,0,0,1037693,"2023-11-06T00:00:00.000Z",17896056,18,"Luka Garza",0,0,0,0,0,0
"15806",4279,0,0,0,0,0,0,0,0,0,0,0,0,0,0,0,0,1037693,"2023-11-06T00:00:00.000Z",56677782,18,"Leonard Miller",0,0,0,0,0,0
"15807",4280,0,2,6,0,0,5,2,4,2,22,6,2,6,12,1,1,1037694,"2023-11-06T00:00:00.000Z",83,1,"Clint Capela",3,18,18,6,12,28.4
"15808",4281,6,0,2,9,6,16,7,10,9,33,2,4,29,4,1,3,1037694,"2023-11-06T00:00:00.000Z",334,1,"Dejounte Murray",1,33,39,35,10,42.8
"15809",4282,11,0,3,5,1,18,5,11,11,36,1,1,22,4,1,7,1037694,"2023-11-06T00:00:00.000Z",490,1,"Trae Young",1,26,37,33,15,39.3
"15810",4283,3,0,2,8,3,14,7,0,0,27,0,1,17,2,2,0,1037694,"2023-11-06T00:00:00.000Z",53,1,"Bogdan Bogdanovic",2,19,22,20,5,29.9
"15811",4284,2,0,4,6,3,11,6,0,0,26,4,1,15,8,0,2,1037694,"2023-11-06T00:00:00.000Z",3547256,1,"Saddiq Bey",0,23,25,17,10,25.6
"15812",4285,0,0,1,2,0,2,0,0,0,4,0,0,0,1,0,0,1037694,"2023-11-06T00:00:00.000Z",666754,1,"Garrison Mathews",0,1,1,0,1,1.2
"15813",4286,0,0,0,0,0,0,0,0,0,0,0,0,0,0,0,0,1037691,"2023-11-06T00:00:00.000Z",19465584,29,"Micah Potter",0,0,0,0,0,0
"15814",4287,0,0,0,0,0,0,0,0,0,0,0,0,0,0,0,0,1037691,"2023-11-06T00:00:00.000Z",56677842,29,"Brice Sensabaugh",0,0,0,0,0,0
"15815",4288,0,0,0,0,0,0,0,0,0,0,0,0,0,0,0,0,1037693,"2023-11-06T00:00:00.000Z",38017700,18,"Wendell Moore Jr.",0,0,0,0,0,0
"15816",4289,2,0,5,8,2,22,12,8,6,43,0,2,32,5,5,6,1037693,"2023-11-06T00:00:00.000Z",434,2,"Jayson Tatum",5,37,39,34,7,50
"15817",4290,4,1,6,0,0,7,4,1,1,25,0,2,9,6,0,1,1037689,"2023-11-06T00:00:00.000Z",117,14,"Anthony Davis",1,15,19,13,10,24.2
"15818",4291,9,0,7,8,3,14,9,3,2,40,3,1,23,10,1,4,1037689,"2023-11-06T00:00:00.000Z",17553995,14,"Austin Reaves",1,33,42,32,19,47.5
"15819",4292,6,1,4,3,1,10,6,0,0,29,0,2,13,4,0,3,1037689,"2023-11-06T00:00:00.000Z",405,14,"D'Angelo Russell",1,17,23,19,10,26.8
"15820",4293,0,0,0,0,0,0,0,0,0,0,0,0,0,0,0,0,1037689,"2023-11-06T00:00:00.000Z",56677738,14,"Colin Castleton",0,0,0,0,0,0
"15821",4294,4,0,3,4,1,5,1,0,0,36,2,4,3,5,1,2,1037693,"2023-11-06T00:00:00.000Z",219,2,"Al Horford",1,8,12,7,9,16
"15822",4295,0,0,0,0,0,0,0,0,0,0,0,0,0,0,0,0,1037694,"2023-11-06T00:00:00.000Z",666564,1,"Bruno Fernando",0,0,0,0,0,0
"15823",4296,0,0,0,0,0,0,0,0,0,0,0,0,0,0,0,0,1037694,"2023-11-06T00:00:00.000Z",3547297,1,"Trent Forrest",0,0,0,0,0,0
"15824",4297,0,0,0,0,0,0,0,0,0,0,0,0,0,0,0,0,1037694,"2023-11-06T00:00:00.000Z",38017689,1,"AJ Griffin",0,0,0,0,0,0
"15825",4298,0,0,0,0,0,0,0,0,0,0,0,0,0,0,0,0,1037694,"2023-11-06T00:00:00.000Z",56677806,1,"Mouhamed Gueye",0,0,0,0,0,0
"15826",4299,2,0,1,3,1,6,2,0,0,15,0,3,5,1,1,1,1037692,"2023-11-06T00:00:00.000Z",324,26,"Malik Monk",1,6,8,7,3,11.2
"15827",4300,1,0,2,0,0,6,4,2,2,13,3,1,10,5,0,0,1037692,"2023-11-06T00:00:00.000Z",56677845,26,"Colby Jones",0,15,16,11,6,17.5
"15828",4301,6,0,3,5,0,10,3,3,3,24,0,0,9,3,0,3,1038132,"2024-01-12T00:00:00.000Z",56677834,29,"Keyonte George",0,12,18,15,9,18.6
"15829",4302,1,2,4,7,2,8,3,0,0,22,1,1,8,5,0,0,1038132,"2024-01-12T00:00:00.000Z",38017620,29,"Ochai Agbaji",2,13,14,9,6,21.5
"15830",4303,5,0,8,2,1,7,4,4,2,21,2,3,11,10,1,1,1038132,"2024-01-12T00:00:00.000Z",358,29,"Kelly Olynyk",1,21,26,16,15,32.5
"15831",4304,0,0,1,0,0,2,1,2,2,6,0,2,4,1,0,1,1038132,"2024-01-12T00:00:00.000Z",666881,29,"Luka Samanic",0,5,5,4,1,4.2
"15832",4305,0,0,2,0,0,2,2,0,0,5,2,1,4,4,0,0,1038132,"2024-01-12T00:00:00.000Z",11891374,29,"Omer Yurtseven",0,8,8,4,4,8.8
"15833",4306,1,0,1,2,2,2,2,0,0,4,0,1,6,1,1,0,1038132,"2024-01-12T00:00:00.000Z",56677824,29,"Taylor Hendricks",1,7,8,7,2,11.7
"15834",4307,2,0,0,2,1,4,2,0,0,4,0,1,5,0,0,0,1038132,"2024-01-12T00:00:00.000Z",56677842,29,"Brice Sensabaugh",0,5,7,7,2,8
"15835",4308,0,0,0,0,0,0,0,0,0,0,0,0,0,0,0,0,1038132,"2024-01-12T00:00:00.000Z",666650,29,"Talen Horton-Tucker",0,0,0,0,0,0
"15836",4309,0,0,0,0,0,0,0,0,0,0,0,0,0,0,0,0,1038132,"2024-01-12T00:00:00.000Z",38017630,29,"Johnny Juzang",0,0,0,0,0,0
"15837",4310,0,0,0,0,0,0,0,0,0,0,0,0,0,0,0,0,1038132,"2024-01-12T00:00:00.000Z",19465584,29,"Micah Potter",0,0,0,0,0,0
"15838",4311,0,0,0,0,0,0,0,0,0,0,0,0,0,0,0,0,1038132,"2024-01-12T00:00:00.000Z",17896042,29,"Jason Preston",0,0,0,0,0,0
"15839",4312,2,3,7,2,0,9,2,0,0,30,0,4,4,7,1,2,1038132,"2024-01-12T00:00:00.000Z",666423,28,"RJ Barrett",4,11,13,6,9,25.4
"15840",4313,2,0,4,6,5,14,8,8,6,30,0,1,27,4,0,2,1038132,"2024-01-12T00:00:00.000Z",416,28,"Pascal Siakam",0,31,33,29,6,32.8
"15841",4314,2,0,2,0,0,1,0,0,0,12,0,5,0,2,0,0,1038132,"2024-01-12T00:00:00.000Z",489,28,"Thaddeus Young",0,2,4,2,4,5.4
"15842",4315,3,3,2,4,2,13,6,11,5,28,1,3,19,3,0,3,1038132,"2024-01-12T00:00:00.000Z",17896055,28,"Scottie Barnes",3,22,25,22,6,33.1
"15843",4316,0,0,2,3,3,8,4,4,4,25,1,1,15,3,0,1,1038132,"2024-01-12T00:00:00.000Z",3547269,28,"Immanuel Quickley",0,18,18,15,3,17.6
"15844",4317,6,2,4,4,1,8,3,2,2,31,2,1,9,6,2,0,1038132,"2024-01-12T00:00:00.000Z",2309958,28,"Jontay Porter",4,15,21,15,12,37.2
"15845",4318,2,0,0,2,1,6,2,0,0,22,1,1,5,1,0,1,1038132,"2024-01-12T00:00:00.000Z",3089,28,"Gary Trent Jr.",0,6,8,7,3,8.2
"15846",4319,4,0,0,7,4,9,4,0,0,23,0,2,12,0,1,1,1038132,"2024-01-12T00:00:00.000Z",409,28,"Dennis Schroder",1,12,16,16,4,20
"15847",4320,0,0,0,3,1,4,2,2,2,12,0,1,7,0,0,1,1038132,"2024-01-12T00:00:00.000Z",58,28,"Chris Boucher",0,7,7,7,0,6
"15848",4321,2,0,1,2,0,3,0,0,0,12,0,1,0,1,0,0,1038132,"2024-01-12T00:00:00.000Z",56677828,28,"Gradey Dick",0,1,3,2,3,4.2
"15849",4322,0,0,1,0,0,5,4,10,7,8,2,0,15,3,1,1,1038132,"2024-01-12T00:00:00.000Z",666762,28,"Jalen McDaniels",1,18,18,15,3,20.6
"15850",4323,2,0,0,1,0,1,0,0,0,7,1,1,0,1,0,1,1038132,"2024-01-12T00:00:00.000Z",436,28,"Garrett Temple",0,1,3,2,3,3.2
"15851",4324,0,0,0,0,0,0,0,0,0,0,0,0,0,0,0,0,1038132,"2024-01-12T00:00:00.000Z",56677805,28,"Javon Freeman-Liberty",0,0,0,0,0,0
"15852",4325,0,0,0,0,0,0,0,0,0,0,0,0,0,0,0,0,1038132,"2024-01-12T00:00:00.000Z",38017710,28,"Christian Koloko",0,0,0,0,0,0
"15853",4326,0,0,0,0,0,0,0,0,0,0,0,0,0,0,0,0,1038005,"2023-12-26T00:00:00.000Z",56677862,26,"Jalen Slawson",0,0,0,0,0,0
"15854",4327,2,1,0,0,0,0,0,0,0,9,0,1,0,0,0,0,1038005,"2023-12-26T00:00:00.000Z",38017714,26,"Keon Ellis",1,0,2,2,2,6
"15855",4328,2,2,2,0,0,0,0,0,0,14,0,1,0,2,0,0,1038005,"2023-12-26T00:00:00.000Z",290,26,"Trey Lyles",2,2,4,2,4,11.4
"15856",4329,0,0,0,0,0,0,0,0,0,0,0,0,0,0,0,0,1038006,"2023-12-26T00:00:00.000Z",17896031,13,"Nah'Shon Hyland",0,0,0,0,0,0
"15857",4330,0,0,0,0,0,0,0,0,0,0,0,0,0,0,0,0,1038006,"2023-12-26T00:00:00.000Z",56677856,13,"Jordan Miller",0,0,0,0,0,0
"15858",4331,0,0,0,0,0,0,0,0,0,0,0,0,0,0,0,0,1038006,"2023-12-26T00:00:00.000Z",24417679,13,"Xavier Moon",0,0,0,0,0,0
"15859",4332,0,0,0,0,0,0,0,0,0,0,0,0,0,0,0,0,1038006,"2023-12-26T00:00:00.000Z",450,13,"PJ Tucker",0,0,0,0,0,0
"15860",4333,0,0,0,0,0,0,0,0,0,0,0,0,0,0,0,0,1038006,"2023-12-26T00:00:00.000Z",38017725,13,"Moussa Diabate",0,0,0,0,0,0
"15861",4334,0,0,0,0,0,0,0,0,0,0,0,0,0,0,0,0,1038006,"2023-12-26T00:00:00.000Z",274,13,"Kawhi Leonard",0,0,0,0,0,0
"15862",4335,0,0,0,0,0,0,0,0,0,0,0,0,0,0,0,0,1038006,"2023-12-26T00:00:00.000Z",371,13,"Mason Plumlee",0,0,0,0,0,0
"15863",4336,0,0,0,0,0,0,0,0,0,0,0,0,0,0,0,0,1038006,"2023-12-26T00:00:00.000Z",17896051,13,"Joshua Primo",0,0,0,0,0,0
"15864",4337,5,0,1,2,0,8,3,2,2,24,1,2,8,2,1,1,1038006,"2023-12-26T00:00:00.000Z",204,4,"Gordon Hayward",1,10,15,13,7,19.9
"15865",4338,5,2,10,10,3,23,9,0,0,38,1,5,21,11,0,2,1038006,"2023-12-26T00:00:00.000Z",62,4,"Miles Bridges",2,32,37,26,16,45.7
"15866",4339,1,0,2,1,1,8,5,2,1,24,0,1,12,2,2,0,1038008,"2023-12-27T00:00:00.000Z",3547242,30,"Deni Avdija",2,14,15,13,3,21.9
"15867",4340,7,0,2,5,1,13,6,2,1,30,2,3,14,4,0,5,1038008,"2023-12-27T00:00:00.000Z",265,30,"Kyle Kuzma",0,18,25,21,11,24.3
"15868",4341,1,1,6,0,0,9,5,2,2,30,2,2,12,8,4,0,1038008,"2023-12-27T00:00:00.000Z",666577,30,"Daniel Gafford",5,20,21,13,9,38.1
"15869",4342,4,1,2,7,1,12,5,4,3,27,2,1,14,4,0,2,1038008,"2023-12-27T00:00:00.000Z",666848,30,"Jordan Poole",1,18,22,18,8,25.8
"15870",4343,5,0,1,6,1,12,5,0,0,31,1,2,11,2,2,1,1038008,"2023-12-27T00:00:00.000Z",249,30,"Tyus Jones",2,13,18,16,7,25.9
"15871",4344,2,0,1,5,2,8,5,1,1,21,1,2,13,2,1,2,1038008,"2023-12-27T00:00:00.000Z",17896045,30,"Corey Kispert",1,15,17,15,4,19.4
"15872",4345,2,0,4,4,1,8,4,2,1,25,0,2,10,4,0,1,1038008,"2023-12-27T00:00:00.000Z",56677844,30,"Bilal Coulibaly",0,14,16,12,6,16.8
"15873",4346,0,0,4,0,0,3,0,0,0,7,2,0,0,6,0,1,1038008,"2023-12-27T00:00:00.000Z",337,30,"Mike Muscala",0,6,6,0,6,6.2
"15874",4347,0,0,1,1,0,2,0,0,0,5,0,0,0,1,0,0,1038008,"2023-12-27T00:00:00.000Z",167,30,"Danilo Gallinari",0,1,1,0,1,1.2
"15875",4348,1,0,0,1,1,5,3,0,0,11,0,0,7,0,0,3,1038008,"2023-12-27T00:00:00.000Z",414,30,"Landry Shamet",0,7,8,8,1,5.5
"15876",4349,0,1,0,0,0,0,0,0,0,5,0,0,0,0,0,0,1038008,"2023-12-27T00:00:00.000Z",3547302,30,"Anthony Gill",1,0,0,0,0,3
"15877",4350,0,0,0,0,0,1,0,0,0,6,0,1,0,0,0,0,1038008,"2023-12-27T00:00:00.000Z",38017687,30,"Johnny Davis",0,0,0,0,0,0
"15878",4351,4,0,2,2,1,15,8,7,3,37,2,5,20,4,4,1,1037889,"2023-12-11T00:00:00.000Z",416,28,"Pascal Siakam",4,24,28,24,8,41.8
"15879",4352,0,0,0,1,0,2,1,0,0,14,0,1,2,0,0,0,1037892,"2023-12-11T00:00:00.000Z",38017676,17,"MarJon Beauchamp",0,2,2,2,0,2
"15880",4353,5,0,0,2,1,4,2,0,0,18,0,2,5,0,0,1,1037892,"2023-12-11T00:00:00.000Z",368,17,"Cameron Payne",0,5,10,10,5,11.5
"15881",4354,3,0,5,5,4,6,4,0,0,13,0,1,12,5,0,0,1037892,"2023-12-11T00:00:00.000Z",38017733,17,"A.J. Green",0,17,20,15,8,22.5
"15882",4355,0,0,0,0,0,0,0,0,0,0,0,0,0,0,0,0,1037892,"2023-12-11T00:00:00.000Z",2148,17,"Thanasis Antetokounmpo",0,0,0,0,0,0
"15883",4356,0,0,0,0,0,0,0,0,0,0,0,0,0,0,0,0,1037892,"2023-12-11T00:00:00.000Z",56677852,17,"Andre Jackson Jr.",0,0,0,0,0,0
"15884",4357,0,0,0,0,0,0,0,0,0,0,0,0,0,0,0,0,1037892,"2023-12-11T00:00:00.000Z",284,17,"Robin Lopez",0,0,0,0,0,0
"15885",4358,0,0,0,0,0,0,0,0,0,0,0,0,0,0,0,0,1037886,"2023-12-11T00:00:00.000Z",666885,22,"Admiral Schofield",0,0,0,0,0,0
"15886",4359,0,0,0,0,0,0,0,0,0,0,0,0,0,0,0,0,1037886,"2023-12-11T00:00:00.000Z",85,22,"Wendell Carter Jr.",0,0,0,0,0,0
"15887",4360,0,0,0,0,0,0,0,0,0,0,0,0,0,0,0,0,1037886,"2023-12-11T00:00:00.000Z",165,22,"Markelle Fultz",0,0,0,0,0,0
"15888",4361,0,1,1,0,0,2,1,2,1,20,1,2,3,2,0,0,1037888,"2023-12-11T00:00:00.000Z",38017721,8,"Peyton Watson",1,5,5,3,2,8.4
"15889",4362,0,0,0,0,0,0,0,0,0,0,0,0,0,0,0,0,1037888,"2023-12-11T00:00:00.000Z",56677871,8,"Hunter Tyson",0,0,0,0,0,0
"15890",4363,0,0,0,0,0,0,0,0,0,0,0,0,0,0,0,0,1037888,"2023-12-11T00:00:00.000Z",666489,8,"Vlatko Cancar",0,0,0,0,0,0
"15891",4364,0,0,0,0,0,0,0,0,0,0,0,0,0,0,0,0,1037888,"2023-12-11T00:00:00.000Z",38017727,8,"Collin Gillespie",0,0,0,0,0,0
"15892",4365,0,0,0,0,0,0,0,0,0,0,0,0,0,0,0,0,1037888,"2023-12-11T00:00:00.000Z",17896103,8,"Jay Huff",0,0,0,0,0,0
"15893",4366,0,0,0,0,0,0,0,0,0,0,0,0,0,0,0,0,1037888,"2023-12-11T00:00:00.000Z",17896007,8,"Braxton Key",0,0,0,0,0,0
"15894",4367,2,1,1,3,1,7,3,4,4,15,0,5,11,1,0,2,1037894,"2023-12-11T00:00:00.000Z",666650,29,"Talen Horton-Tucker",1,12,14,13,3,16.2
"15895",4368,0,1,3,0,0,2,1,0,0,10,2,3,2,5,0,3,1037894,"2023-12-11T00:00:00.000Z",11891374,29,"Omer Yurtseven",1,7,7,2,5,8
"15896",4369,2,1,2,4,1,6,3,1,1,26,0,2,8,2,1,0,1037894,"2023-12-11T00:00:00.000Z",56677824,29,"Taylor Hendricks",2,10,12,10,4,19.4
"15897",4370,2,0,2,4,1,13,7,6,5,26,2,1,20,4,2,0,1037894,"2023-12-11T00:00:00.000Z",413,29,"Collin Sexton",2,24,26,22,6,33.8
"15898",4371,1,0,7,4,1,10,6,1,1,17,0,3,14,7,0,2,1037894,"2023-12-11T00:00:00.000Z",666881,29,"Luka Samanic",0,21,22,15,8,21.9
"15899",4372,0,0,0,0,0,0,0,0,0,0,0,0,0,0,0,0,1037894,"2023-12-11T00:00:00.000Z",38017705,29,"Walker Kessler",0,0,0,0,0,0
"15900",4373,0,0,0,0,0,0,0,0,0,0,0,0,0,0,0,0,1037894,"2023-12-11T00:00:00.000Z",17896023,29,"Josh Christopher",0,0,0,0,0,0
"15901",4374,0,0,0,0,0,0,0,0,0,0,0,0,0,0,0,0,1037894,"2023-12-11T00:00:00.000Z",101,29,"John Collins",0,0,0,0,0,0
"15902",4375,0,0,0,0,0,0,0,0,0,0,0,0,0,0,0,0,1037894,"2023-12-11T00:00:00.000Z",38017630,29,"Johnny Juzang",0,0,0,0,0,0
"15903",4376,2,0,5,2,1,7,4,2,2,18,2,3,11,7,0,2,1037832,"2023-11-26T00:00:00.000Z",462,22,"Moritz Wagner",0,18,20,13,9,20.4
"15904",4377,7,1,6,3,1,16,9,12,11,32,1,3,30,7,2,2,1037832,"2023-11-26T00:00:00.000Z",3547251,22,"Cole Anthony",3,37,44,37,14,55.9
"15905",4378,0,0,1,2,1,2,1,3,3,12,1,2,6,2,0,0,1037832,"2023-11-26T00:00:00.000Z",38017724,22,"Caleb Houstan",0,8,8,6,2,8.4
"15906",4379,0,0,0,0,0,0,0,0,0,0,0,0,0,0,0,0,1037832,"2023-11-26T00:00:00.000Z",229,22,"Jonathan Isaac",0,0,0,0,0,0
"15907",4380,0,0,0,0,0,0,0,0,0,0,0,0,0,0,0,0,1037832,"2023-11-26T00:00:00.000Z",666818,22,"Chuma Okeke",0,0,0,0,0,0
"15908",4381,0,0,0,0,0,0,0,0,0,0,0,0,0,0,0,0,1037832,"2023-11-26T00:00:00.000Z",666885,22,"Admiral Schofield",0,0,0,0,0,0
"15909",4382,0,0,0,0,0,0,0,0,0,0,0,0,0,0,0,0,1037832,"2023-11-26T00:00:00.000Z",85,22,"Wendell Carter Jr.",0,0,0,0,0,0
"15910",4383,0,0,0,0,0,0,0,0,0,0,0,0,0,0,0,0,1037832,"2023-11-26T00:00:00.000Z",165,22,"Markelle Fultz",0,0,0,0,0,0
"15911",4384,0,0,0,0,0,0,0,0,0,0,0,0,0,0,0,0,1037832,"2023-11-26T00:00:00.000Z",38017607,22,"Kevon Harris",0,0,0,0,0,0
"15912",4385,0,0,0,0,0,0,0,0,0,0,0,0,0,0,0,0,1037832,"2023-11-26T00:00:00.000Z",56677839,22,"Jett Howard",0,0,0,0,0,0
"15913",4386,0,0,0,0,0,0,0,0,0,0,0,0,0,0,0,0,1037832,"2023-11-26T00:00:00.000Z",17553983,22,"Trevelin Queen",0,0,0,0,0,0
"15914",4387,2,1,5,4,2,11,4,2,0,33,0,1,10,5,0,3,1037832,"2023-11-26T00:00:00.000Z",204,4,"Gordon Hayward",1,15,17,12,7,19
"15915",4388,2,1,7,4,1,17,9,6,4,37,3,2,23,10,1,3,1037832,"2023-11-26T00:00:00.000Z",62,4,"Miles Bridges",2,33,35,25,12,41
"15916",4389,1,1,5,0,0,6,5,2,2,22,1,4,12,6,1,1,1037832,"2023-11-26T00:00:00.000Z",38017698,4,"Mark Williams",2,18,19,13,7,25.7
"15917",4390,9,1,1,4,2,15,9,4,2,37,0,4,22,1,1,5,1037832,"2023-11-26T00:00:00.000Z",403,4,"Terry Rozier",2,23,32,31,10,37.7
"15918",4391,2,0,1,3,1,6,3,0,0,14,0,0,7,1,0,1,1037832,"2023-11-26T00:00:00.000Z",3547239,4,"LaMelo Ball",0,8,10,9,3,10.2
"15919",4392,0,0,4,2,1,9,4,4,3,22,2,4,12,6,1,1,1037833,"2023-11-26T00:00:00.000Z",667378,18,"Naz Reid",1,18,18,12,6,21.2
"15920",4393,0,0,0,1,1,2,1,0,0,2,0,0,3,0,0,0,1037833,"2023-11-26T00:00:00.000Z",17895968,18,"Daishen Nix",0,3,3,3,0,3
"15921",4394,0,0,0,0,0,0,0,0,0,0,0,0,0,0,0,0,1037833,"2023-11-26T00:00:00.000Z",56677851,18,"Jaylen Clark",0,0,0,0,0,0
"15922",4395,0,0,0,0,0,0,0,0,0,0,0,0,0,0,0,0,1037833,"2023-11-26T00:00:00.000Z",17896056,18,"Luka Garza",0,0,0,0,0,0
"15923",4396,0,0,0,0,0,0,0,0,0,0,0,0,0,0,0,0,1037833,"2023-11-26T00:00:00.000Z",3547259,18,"Jaden McDaniels",0,0,0,0,0,0
"15924",4397,0,0,0,0,0,0,0,0,0,0,0,0,0,0,0,0,1037833,"2023-11-26T00:00:00.000Z",666767,18,"Jordan McLaughlin",0,0,0,0,0,0
"15925",4398,0,0,0,0,0,0,0,0,0,0,0,0,0,0,0,0,1037833,"2023-11-26T00:00:00.000Z",38017700,18,"Wendell Moore Jr.",0,0,0,0,0,0
"15926",4399,3,0,2,4,1,5,2,0,0,27,0,2,5,2,1,0,1037836,"2023-11-26T00:00:00.000Z",215,8,"Justin Holiday",1,7,10,8,5,14.9
"15927",4400,2,1,6,9,4,14,8,6,5,33,1,0,25,7,0,3,1037836,"2023-11-26T00:00:00.000Z",375,8,"Michael Porter Jr.",1,32,34,27,9,36.4
"15928",4401,0,0,0,0,0,0,0,0,0,0,0,0,0,0,0,0,1037726,"2023-11-12T00:00:00.000Z",18677954,30,"Jared Butler",0,0,0,0,0,0
"15929",4402,0,0,0,0,0,0,0,0,0,0,0,0,0,0,0,0,1037726,"2023-11-12T00:00:00.000Z",38017687,30,"Johnny Davis",0,0,0,0,0,0
"15930",4403,0,0,0,0,0,0,0,0,0,0,0,0,0,0,0,0,1037726,"2023-11-12T00:00:00.000Z",3547302,30,"Anthony Gill",0,0,0,0,0,0
"15931",4404,0,0,0,0,0,0,0,0,0,0,0,0,0,0,0,0,1037726,"2023-11-12T00:00:00.000Z",337,30,"Mike Muscala",0,0,0,0,0,0
"15932",4405,0,0,0,0,0,0,0,0,0,0,0,0,0,0,0,0,1037726,"2023-11-12T00:00:00.000Z",38017712,30,"Ryan Rollins",0,0,0,0,0,0
"15933",4406,0,0,0,0,0,0,0,0,0,0,0,0,0,0,0,0,1037726,"2023-11-12T00:00:00.000Z",38124126,30,"John Butler Jr.",0,0,0,0,0,0
"15934",4407,0,0,0,0,0,0,0,0,0,0,0,0,0,0,0,0,1037726,"2023-11-12T00:00:00.000Z",17896106,30,"Eugene Omoruyi",0,0,0,0,0,0
"15935",4408,0,0,0,0,0,0,0,0,0,0,0,0,0,0,0,0,1037726,"2023-11-12T00:00:00.000Z",487,30,"Delon Wright",0,0,0,0,0,0
"15936",4409,3,2,4,4,1,16,6,2,1,37,1,3,14,5,1,0,1037727,"2023-11-12T00:00:00.000Z",274,13,"Kawhi Leonard",3,19,22,17,8,33.5
"15937",4410,7,0,6,7,3,16,8,9,7,37,1,5,26,7,2,7,1037727,"2023-11-12T00:00:00.000Z",172,13,"Paul George",2,33,40,33,14,43.9
"15938",4411,1,0,6,0,0,4,2,2,2,23,0,3,6,6,1,1,1037727,"2023-11-12T00:00:00.000Z",493,13,"Ivica Zubac",1,12,13,7,7,16.7
"15939",4412,3,1,2,7,1,12,4,2,2,29,2,0,11,4,1,1,1037727,"2023-11-12T00:00:00.000Z",192,13,"James Harden",2,15,18,14,7,25.3
"15940",4413,5,0,8,4,1,13,5,2,1,31,1,3,12,9,3,4,1037727,"2023-11-12T00:00:00.000Z",472,13,"Russell Westbrook",3,21,26,17,14,35.3
"15941",4414,3,0,2,7,4,13,7,6,2,31,0,5,20,2,0,0,1037727,"2023-11-12T00:00:00.000Z",380,13,"Norman Powell",0,22,25,23,5,26.9
"15942",4415,0,0,2,0,0,2,1,0,0,12,1,1,2,3,0,0,1037727,"2023-11-12T00:00:00.000Z",38017725,13,"Moussa Diabate",0,5,5,2,3,5.6
"15943",4416,1,0,1,2,1,2,1,0,0,13,1,1,3,2,1,0,1037727,"2023-11-12T00:00:00.000Z",450,13,"PJ Tucker",1,5,6,4,3,9.9
"15944",4417,3,0,2,3,1,7,3,0,0,27,1,2,7,3,0,1,1037727,"2023-11-12T00:00:00.000Z",666743,13,"Terance Mann",0,10,13,10,6,14.1
"15945",4418,0,0,0,0,0,0,0,0,0,0,0,0,0,0,0,0,1037727,"2023-11-12T00:00:00.000Z",56677849,13,"Kobe Brown",0,0,0,0,0,0
"15946",4419,0,0,0,0,0,0,0,0,0,0,0,0,0,0,0,0,1037727,"2023-11-12T00:00:00.000Z",666511,13,"Amir Coffey",0,0,0,0,0,0
"15947",4420,0,0,0,0,0,0,0,0,0,0,0,0,0,0,0,0,1037727,"2023-11-12T00:00:00.000Z",17896031,13,"Nah'Shon Hyland",0,0,0,0,0,0
"15948",4421,0,0,0,0,0,0,0,0,0,0,0,0,0,0,0,0,1037727,"2023-11-12T00:00:00.000Z",17896022,13,"Brandon Boston Jr.",0,0,0,0,0,0
"15949",4422,0,0,0,0,0,0,0,0,0,0,0,0,0,0,0,0,1037727,"2023-11-12T00:00:00.000Z",56677856,13,"Jordan Miller",0,0,0,0,0,0
"15950",4423,0,0,0,0,0,0,0,0,0,0,0,0,0,0,0,0,1037727,"2023-11-12T00:00:00.000Z",371,13,"Mason Plumlee",0,0,0,0,0,0
"15951",4424,0,0,0,0,0,0,0,0,0,0,0,0,0,0,0,0,1037727,"2023-11-12T00:00:00.000Z",17896051,13,"Joshua Primo",0,0,0,0,0,0
"15952",4425,6,1,3,11,3,24,10,6,4,35,1,4,27,4,0,4,1037727,"2023-11-12T00:00:00.000Z",3547287,15,"Desmond Bane",1,31,37,33,10,39.8
"15953",4426,1,0,0,1,0,1,0,0,0,5,0,1,0,0,0,0,1037637,"2023-10-30T00:00:00.000Z",666762,28,"Jalen McDaniels",0,0,1,1,1,1.5
"15954",4427,3,0,1,3,1,6,2,0,0,13,0,2,5,1,0,1,1037633,"2023-10-30T00:00:00.000Z",130,3,"Spencer Dinwiddie",0,6,9,8,4,9.7
"15955",4428,8,1,7,0,0,6,5,2,1,35,3,1,11,10,0,2,1037633,"2023-10-30T00:00:00.000Z",417,3,"Ben Simmons",1,21,29,19,18,36
"15956",4429,4,1,5,7,3,13,6,6,4,29,0,1,19,5,1,0,1037633,"2023-10-30T00:00:00.000Z",464,3,"Lonnie Walker IV",2,24,28,23,9,37
"15957",4430,0,2,2,6,2,8,3,0,0,32,0,1,8,2,0,0,1037633,"2023-10-30T00:00:00.000Z",351,3,"Royce O'Neale",2,10,10,8,2,16.4
"15958",4431,2,0,3,1,0,4,1,2,1,14,1,2,3,4,1,1,1037633,"2023-10-30T00:00:00.000Z",421,3,"Dennis Smith Jr.",1,7,9,5,6,12.8
"15959",4432,1,1,4,0,0,8,5,3,1,10,4,5,11,8,0,1,1037633,"2023-10-30T00:00:00.000Z",17896038,3,"Day'Ron Sharpe",1,19,20,12,9,24.1
"15960",4433,0,0,0,0,0,0,0,0,0,0,0,0,0,0,0,0,1037633,"2023-10-30T00:00:00.000Z",666508,3,"Nicolas Claxton",0,0,0,0,0,0
"15961",4434,0,0,0,0,0,0,0,0,0,0,0,0,0,0,0,0,1037633,"2023-10-30T00:00:00.000Z",174,3,"Harry Giles III",0,0,0,0,0,0
"15962",4435,0,0,0,0,0,0,0,0,0,0,0,0,0,0,0,0,1037633,"2023-10-30T00:00:00.000Z",17896058,3,"Trendon Watford",0,0,0,0,0,0
"15963",4436,0,0,0,0,0,0,0,0,0,0,0,0,0,0,0,0,1037633,"2023-10-30T00:00:00.000Z",9051997,3,"Armoni Brooks",0,0,0,0,0,0
"15964",4437,2,0,4,5,3,10,6,2,1,30,0,0,16,4,1,0,1037636,"2023-10-30T00:00:00.000Z",666656,1,"De'Andre Hunter",1,20,22,18,6,26.8
"15965",4438,3,1,4,2,1,7,5,1,1,33,1,3,12,5,1,2,1037636,"2023-10-30T00:00:00.000Z",17896040,1,"Jalen Johnson",2,17,20,15,8,26.5
"15966",4439,1,5,4,0,0,3,0,2,2,23,1,3,2,5,0,1,1037636,"2023-10-30T00:00:00.000Z",83,1,"Clint Capela",5,7,8,3,6,23.5
"15967",4440,5,0,7,5,3,24,17,4,4,40,0,1,41,7,2,3,1037636,"2023-10-30T00:00:00.000Z",334,1,"Dejounte Murray",2,48,53,46,12,59.9
"15968",4441,8,0,1,7,1,22,9,5,5,35,0,1,24,1,1,1,1037636,"2023-10-30T00:00:00.000Z",490,1,"Trae Young",1,25,33,32,9,39.2
"15969",4442,4,0,1,7,2,10,3,0,0,21,0,1,8,1,1,1,1037636,"2023-10-30T00:00:00.000Z",53,1,"Bogdan Bogdanovic",1,9,13,12,5,17.2
"15970",4443,1,1,6,3,3,5,4,0,0,25,0,2,11,6,0,1,1037636,"2023-10-30T00:00:00.000Z",3547256,1,"Saddiq Bey",1,17,18,12,7,21.7
"15971",4444,1,0,0,1,1,1,1,0,0,6,0,0,3,0,0,0,1037636,"2023-10-30T00:00:00.000Z",38017689,1,"AJ Griffin",0,3,4,4,1,4.5
"15972",4445,3,0,5,0,0,3,3,4,4,24,2,1,10,7,0,0,1037636,"2023-10-30T00:00:00.000Z",3547244,1,"Onyeka Okongwu",0,17,20,13,10,22.9
"15973",4446,0,0,0,0,0,1,0,0,0,1,0,0,0,0,0,0,1037636,"2023-10-30T00:00:00.000Z",56677838,1,"Kobe Bufkin",0,0,0,0,0,0
"15974",4447,0,0,0,0,0,0,0,0,0,1,0,0,0,0,0,0,1037636,"2023-10-30T00:00:00.000Z",56677806,1,"Mouhamed Gueye",0,0,0,0,0,0
"15975",4448,0,0,0,0,0,0,0,0,0,1,0,0,0,0,0,0,1037636,"2023-10-30T00:00:00.000Z",666564,1,"Bruno Fernando",0,0,0,0,0,0
"15976",4449,0,0,0,0,0,0,0,0,0,0,0,0,0,0,0,0,1037636,"2023-10-30T00:00:00.000Z",3547297,1,"Trent Forrest",0,0,0,0,0,0
"15977",4450,0,0,0,0,0,0,0,0,0,0,0,0,0,0,0,0,1037636,"2023-10-30T00:00:00.000Z",666754,1,"Garrison Mathews",0,0,0,0,0,0
"15978",4451,0,0,4,4,2,10,6,6,5,19,1,1,19,5,0,0,1038070,"2024-01-04T00:00:00.000Z",38017721,8,"Peyton Watson",0,24,24,19,5,25
"15979",4452,1,0,0,1,0,1,0,0,0,9,1,0,0,1,1,0,1038070,"2024-01-04T00:00:00.000Z",56677776,8,"Julian Strawther",1,1,2,1,2,5.7
"15980",4453,1,0,2,0,0,1,1,0,0,6,1,0,2,3,0,0,1038070,"2024-01-04T00:00:00.000Z",3547268,8,"Zeke Nnaji",0,5,6,3,4,7.1
"15981",4454,0,0,0,0,0,0,0,0,0,0,0,0,0,0,0,0,1038070,"2024-01-04T00:00:00.000Z",38017727,8,"Collin Gillespie",0,0,0,0,0,0
"15982",4455,0,0,0,0,0,0,0,0,0,0,0,0,0,0,0,0,1038070,"2024-01-04T00:00:00.000Z",215,8,"Justin Holiday",0,0,0,0,0,0
"15983",4456,0,0,0,0,0,0,0,0,0,0,0,0,0,0,0,0,1038070,"2024-01-04T00:00:00.000Z",17896103,8,"Jay Huff",0,0,0,0,0,0
"15984",4457,0,0,0,0,0,0,0,0,0,0,0,0,0,0,0,0,1038070,"2024-01-04T00:00:00.000Z",250,8,"DeAndre Jordan",0,0,0,0,0,0
"15985",4458,0,0,0,0,0,0,0,0,0,0,0,0,0,0,0,0,1038070,"2024-01-04T00:00:00.000Z",17896007,8,"Braxton Key",0,0,0,0,0,0
"15986",4459,0,0,0,0,0,0,0,0,0,0,0,0,0,0,0,0,1038070,"2024-01-04T00:00:00.000Z",666489,8,"Vlatko Cancar",0,0,0,0,0,0
"15987",4460,0,0,0,0,0,0,0,0,0,0,0,0,0,0,0,0,1038070,"2024-01-04T00:00:00.000Z",56677582,8,"Jalen Pickett",0,0,0,0,0,0
"15988",4461,0,0,0,0,0,0,0,0,0,0,0,0,0,0,0,0,1038070,"2024-01-04T00:00:00.000Z",56677871,8,"Hunter Tyson",0,0,0,0,0,0
"15989",4462,0,0,5,0,0,3,2,0,0,20,3,4,4,8,1,0,1038088,"2024-01-06T00:00:00.000Z",3547301,11,"Jae'Sean Tate",1,12,12,4,8,16.6
"15990",4463,2,1,11,5,3,7,3,6,5,40,1,4,14,12,2,1,1038088,"2024-01-06T00:00:00.000Z",38017684,11,"Jabari Smith Jr.",3,26,28,16,14,39.4
"15991",4464,4,0,10,1,0,21,7,10,7,31,1,5,21,11,0,3,1038088,"2024-01-06T00:00:00.000Z",17896062,11,"Alperen Sengun",0,32,36,25,15,37.2
"15992",4465,2,0,4,6,1,12,5,5,5,28,0,1,16,4,1,1,1038088,"2024-01-06T00:00:00.000Z",17895966,11,"Jalen Green",1,20,22,18,6,25.8
"15993",4466,7,0,1,10,3,13,4,3,3,37,1,3,14,2,2,1,1038088,"2024-01-06T00:00:00.000Z",458,11,"Fred VanVleet",2,16,23,21,9,31.9
"15994",4467,0,0,1,5,3,7,4,0,0,21,0,1,11,1,0,2,1038088,"2024-01-06T00:00:00.000Z",213,11,"Aaron Holiday",0,12,12,11,1,10.2
"15995",4468,2,1,2,5,2,11,5,5,4,34,0,4,16,2,0,1,1038088,"2024-01-06T00:00:00.000Z",188,11,"Jeff Green",1,18,20,18,4,23.4
"15996",4469,0,0,0,0,0,0,0,0,0,0,0,0,0,0,0,0,1038088,"2024-01-06T00:00:00.000Z",75,11,"Reggie Bullock",0,0,0,0,0,0
"15997",4470,0,0,0,0,0,0,0,0,0,0,0,0,0,0,0,0,1038088,"2024-01-06T00:00:00.000Z",19465326,11,"Jock Landale",0,0,0,0,0,0
"15998",4471,0,0,0,0,0,0,0,0,0,0,0,0,0,0,0,0,1038087,"2024-01-06T00:00:00.000Z",19465584,29,"Micah Potter",0,0,0,0,0,0
"15999",4472,0,0,0,0,0,0,0,0,0,0,0,0,0,0,0,0,1038087,"2024-01-06T00:00:00.000Z",56677842,29,"Brice Sensabaugh",0,0,0,0,0,0
"16000",4473,3,1,2,2,1,11,7,0,0,22,0,3,15,2,1,2,1038072,"2024-01-05T00:00:00.000Z",3547250,12,"Aaron Nesmith",2,17,20,18,5,25.9
"16001",4474,2,0,2,3,1,7,5,0,0,23,0,2,11,2,0,0,1038072,"2024-01-05T00:00:00.000Z",3547264,12,"Jalen Smith",0,13,15,13,4,16.4
"16002",4475,3,1,3,3,2,14,10,5,5,22,2,0,27,5,1,1,1038072,"2024-01-05T00:00:00.000Z",452,12,"Myles Turner",2,32,35,30,8,42.5
"16003",4476,4,0,3,6,3,15,7,0,0,28,0,2,17,3,1,1,1037953,"2023-12-19T00:00:00.000Z",315,17,"Khris Middleton",1,20,24,21,7,28.6
"16004",4477,0,0,0,0,0,0,0,0,0,0,0,0,0,0,0,0,1037951,"2023-12-18T00:00:00.000Z",666474,20,"Charles Brown",0,0,0,0,0,0
"16005",4478,3,0,2,4,2,11,5,0,0,27,0,1,12,2,0,1,1037953,"2023-12-19T00:00:00.000Z",38017692,27,"Malaki Branham",0,14,17,15,5,17.9
"16006",4479,1,0,2,2,0,6,3,4,4,19,0,1,10,2,0,0,1037953,"2023-12-19T00:00:00.000Z",359,27,"Cedi Osman",0,12,13,11,3,13.9
"16007",4480,5,0,1,1,0,11,7,0,0,24,0,1,14,1,1,2,1037953,"2023-12-19T00:00:00.000Z",3547274,27,"Tre Jones",1,15,20,19,6,23.7
"16008",4481,2,0,2,1,0,2,0,0,0,13,0,3,0,2,0,0,1037953,"2023-12-19T00:00:00.000Z",305,27,"Doug McDermott",0,2,4,2,4,5.4
"16009",4482,3,2,7,4,1,5,1,0,0,15,1,1,3,8,1,2,1037953,"2023-12-19T00:00:00.000Z",17896059,27,"Sandro Mamukelashvili",3,11,14,6,11,24.1
"16010",4483,0,0,3,3,0,3,0,2,2,10,0,2,2,3,1,0,1037953,"2023-12-19T00:00:00.000Z",38017730,27,"Dominick Barlow",1,5,5,2,3,8.6
"16011",4484,0,0,0,0,0,1,1,0,0,2,0,0,2,0,0,0,1037953,"2023-12-19T00:00:00.000Z",38017649,27,"Julian Champagnie",0,2,2,2,0,2
"16012",4485,0,0,0,0,0,0,0,0,0,0,0,0,0,0,0,0,1037953,"2023-12-19T00:00:00.000Z",180,27,"Devonte' Graham",0,0,0,0,0,0
"16013",4486,0,0,0,0,0,0,0,0,0,0,0,0,0,0,0,0,1037953,"2023-12-19T00:00:00.000Z",17895854,27,"Charles Bassey",0,0,0,0,0,0
"16014",4487,0,0,0,0,0,0,0,0,0,0,0,0,0,0,0,0,1037953,"2023-12-19T00:00:00.000Z",56677865,27,"Charles Bediako",0,0,0,0,0,0
"16015",4488,0,0,0,0,0,0,0,0,0,0,0,0,0,0,0,0,1037953,"2023-12-19T00:00:00.000Z",56677817,27,"Sidy Cissoko",0,0,0,0,0,0
"16016",4489,0,0,0,0,0,0,0,0,0,0,0,0,0,0,0,0,1037953,"2023-12-19T00:00:00.000Z",17896049,27,"David Duke Jr.",0,0,0,0,0,0
"16017",4490,0,0,0,0,0,0,0,0,0,0,0,0,0,0,0,0,1037953,"2023-12-19T00:00:00.000Z",56677822,27,"Victor Wembanyama",0,0,0,0,0,0
"16018",4491,0,0,0,0,0,0,0,0,0,0,0,0,0,0,0,0,1037952,"2023-12-19T00:00:00.000Z",17896017,19,"Matt Ryan",0,0,0,0,0,0
"16019",4492,0,0,0,0,0,0,0,0,0,0,0,0,0,0,0,0,1037952,"2023-12-19T00:00:00.000Z",38017726,19,"Dereon Seabron",0,0,0,0,0,0
"16020",4493,0,0,0,0,0,0,0,0,0,0,0,0,0,0,0,0,1037954,"2023-12-19T00:00:00.000Z",185,10,"Draymond Green",0,0,0,0,0,0
"16021",4494,4,1,4,15,6,21,9,0,0,40,0,0,24,4,1,1,1037954,"2023-12-19T00:00:00.000Z",443,10,"Klay Thompson",2,28,32,28,8,39.8
"16022",4495,2,0,3,4,1,13,8,2,0,34,4,0,17,7,2,1,1037954,"2023-12-19T00:00:00.000Z",17553979,10,"Jonathan Kuminga",2,24,26,19,9,33.4
"16023",4496,2,0,5,0,0,2,1,1,1,14,1,0,3,6,0,1,1037954,"2023-12-19T00:00:00.000Z",282,10,"Kevon Looney",0,9,11,5,8,12.2
"16024",4497,1,0,4,3,1,4,2,0,0,16,1,2,5,5,1,1,1037954,"2023-12-19T00:00:00.000Z",56677858,10,"Brandin Podziemski",1,10,11,6,6,14.5
"16025",4498,6,0,3,11,6,21,11,5,5,38,0,5,33,3,0,4,1037954,"2023-12-19T00:00:00.000Z",115,10,"Stephen Curry",0,36,42,39,9,41.6
"16026",4499,0,1,6,1,1,4,2,0,0,21,3,3,5,9,3,2,1037955,"2023-12-19T00:00:00.000Z",56677850,25,"Toumani Camara",4,14,14,5,9,25.8
"16027",4500,4,2,1,4,3,15,8,3,3,36,0,2,22,1,0,2,1037955,"2023-12-19T00:00:00.000Z",182,25,"Jerami Grant",2,23,27,26,5,33.2
"16028",4501,0,0,0,0,0,0,0,0,0,0,0,0,0,0,0,0,7049313,"2023-12-06T00:00:00.000Z",56677847,6,"Emoni Bates",0,0,0,0,0,0
"16029",4502,0,0,0,0,0,0,0,0,0,0,0,0,0,0,0,0,1037877,"2023-12-02T00:00:00.000Z",303,19,"CJ McCollum",0,0,0,0,0,0
"16030",4503,2,0,6,5,2,6,2,0,0,25,1,1,6,7,0,0,1037879,"2023-12-02T00:00:00.000Z",3547272,21,"Isaiah Joe",0,13,15,8,9,17.4
"16031",4504,1,0,1,3,3,3,3,6,6,11,0,3,15,1,1,0,1037879,"2023-12-02T00:00:00.000Z",44,21,"Davis Bertans",1,16,17,16,2,20.7
"16032",4505,0,1,2,2,0,5,1,0,0,12,1,3,2,3,0,0,1037881,"2023-12-02T00:00:00.000Z",666881,29,"Luka Samanic",1,5,5,2,3,8.6
"16033",4506,0,0,0,0,0,0,0,0,0,0,0,0,0,0,0,0,1037881,"2023-12-02T00:00:00.000Z",38017630,29,"Johnny Juzang",0,0,0,0,0,0
"16034",4507,0,0,0,0,0,0,0,0,0,0,0,0,0,0,0,0,1037881,"2023-12-02T00:00:00.000Z",19465584,29,"Micah Potter",0,0,0,0,0,0
"16035",4508,1,0,0,1,0,2,0,2,2,14,1,2,2,1,0,0,1037879,"2023-12-02T00:00:00.000Z",56677859,7,"Olivier-Maxence Prosper",0,3,4,3,2,4.7
"16036",4509,0,0,0,0,0,0,0,0,0,0,0,0,0,0,0,0,1037879,"2023-12-02T00:00:00.000Z",151,7,"Dante Exum",0,0,0,0,0,0
"16037",4510,0,0,0,0,0,0,0,0,0,0,0,0,0,0,0,0,1037879,"2023-12-02T00:00:00.000Z",3547258,7,"Josh Green",0,0,0,0,0,0
"16038",4511,0,0,0,0,0,0,0,0,0,0,0,0,0,0,0,0,1037879,"2023-12-02T00:00:00.000Z",191,7,"Tim Hardaway Jr.",0,0,0,0,0,0
"16039",4512,5,1,4,8,1,12,3,0,0,35,1,2,7,5,0,2,1037881,"2023-12-02T00:00:00.000Z",38017739,29,"Simone Fontecchio",1,12,17,12,10,21.5
"16040",4513,3,3,7,4,1,14,6,6,5,35,2,2,18,9,1,2,1037881,"2023-12-02T00:00:00.000Z",101,29,"John Collins",4,27,30,21,12,43.3
"16041",4514,4,1,11,1,0,8,4,1,1,27,4,3,9,15,1,1,1037881,"2023-12-02T00:00:00.000Z",11891374,29,"Omer Yurtseven",2,24,28,13,19,38
"16042",4515,0,0,2,0,0,4,3,0,0,26,0,2,6,2,0,2,1037881,"2023-12-02T00:00:00.000Z",38017620,29,"Ochai Agbaji",0,8,8,6,2,6.4
"16043",4516,6,0,4,8,1,17,7,8,5,36,2,2,20,6,0,4,1037881,"2023-12-02T00:00:00.000Z",56677834,29,"Keyonte George",0,26,32,26,12,32.2
"16044",4517,0,2,4,0,0,6,6,0,0,25,4,1,12,8,0,2,1037881,"2023-12-02T00:00:00.000Z",38017705,29,"Walker Kessler",2,20,20,12,8,25.6
"16045",4518,0,2,1,4,1,7,2,0,0,18,1,1,5,2,0,0,1037881,"2023-12-02T00:00:00.000Z",56677824,29,"Taylor Hendricks",2,7,7,5,2,13.4
"16046",4519,0,0,0,0,0,0,0,0,0,0,0,0,0,0,0,0,1037879,"2023-12-02T00:00:00.000Z",228,7,"Kyrie Irving",0,0,0,0,0,0
"16047",4520,0,0,0,0,0,0,0,0,0,0,0,0,0,0,0,0,1037879,"2023-12-02T00:00:00.000Z",257,7,"Maxi Kleber",0,0,0,0,0,0
"16048",4521,3,0,4,6,1,13,4,2,1,32,1,4,10,5,0,2,1037879,"2023-12-02T00:00:00.000Z",666541,21,"Luguentz Dort",0,15,18,13,8,18.5
"16049",4522,4,0,2,5,3,8,5,2,1,21,0,3,14,2,3,1,1037881,"2023-12-02T00:00:00.000Z",666650,29,"Talen Horton-Tucker",3,16,20,18,6,30.4
"16050",4523,0,0,0,0,0,0,0,0,0,0,0,0,0,0,0,0,1037881,"2023-12-02T00:00:00.000Z",139,29,"Kris Dunn",0,0,0,0,0,0
"16051",4524,0,0,0,0,0,0,0,0,0,0,0,0,0,0,0,0,1037881,"2023-12-02T00:00:00.000Z",297,29,"Lauri Markkanen",0,0,0,0,0,0
"16052",4525,0,0,0,0,0,0,0,0,0,0,0,0,0,0,0,0,1037881,"2023-12-02T00:00:00.000Z",358,29,"Kelly Olynyk",0,0,0,0,0,0
"16053",4526,2,2,9,2,0,7,4,5,5,27,1,2,13,10,0,4,1037759,"2023-11-16T00:00:00.000Z",38017685,21,"Chet Holmgren",2,23,25,15,12,30
"16054",4527,0,0,0,1,0,4,0,2,1,8,1,1,1,1,1,0,1037759,"2023-11-16T00:00:00.000Z",2189,10,"Gary Payton II",1,2,2,1,1,5.2
"16055",4528,1,0,4,0,0,9,6,2,1,19,7,3,13,11,1,1,1037759,"2023-11-16T00:00:00.000Z",282,10,"Kevon Looney",1,24,25,14,12,29.7
"16056",4529,1,1,2,4,2,11,5,1,0,23,2,1,12,4,0,1,1037759,"2023-11-16T00:00:00.000Z",17553992,10,"Moses Moody",1,16,17,13,5,20.3
"16057",4530,0,0,0,2,0,3,0,0,0,4,0,1,0,0,0,0,1037759,"2023-11-16T00:00:00.000Z",45658838,10,"Lester Quinones",0,0,0,0,0,0
"16058",4531,0,0,1,1,0,3,1,0,0,4,2,0,2,3,0,0,1037759,"2023-11-16T00:00:00.000Z",57875092,10,"Gui Santos",0,5,5,2,3,5.6
"16059",4532,0,0,0,0,0,0,0,0,0,0,0,0,0,0,0,0,1037759,"2023-11-16T00:00:00.000Z",115,10,"Stephen Curry",0,0,0,0,0,0
"16060",4533,0,0,0,0,0,0,0,0,0,0,0,0,0,0,0,0,1037759,"2023-11-16T00:00:00.000Z",17896070,10,"Usman Garuba",0,0,0,0,0,0
"16061",4534,0,0,0,0,0,0,0,0,0,0,0,0,0,0,0,0,1037759,"2023-11-16T00:00:00.000Z",398,10,"Jerome Robinson",0,0,0,0,0,0
"16062",4535,0,0,2,3,1,5,2,0,0,24,0,2,5,2,1,1,1037759,"2023-11-16T00:00:00.000Z",666541,21,"Luguentz Dort",1,7,7,5,2,9.4
"16063",4536,5,0,3,3,2,13,6,2,2,29,0,3,16,3,2,2,1037759,"2023-11-16T00:00:00.000Z",38017703,21,"Jalen Williams",2,19,24,21,8,31.1
"16064",4537,0,0,0,0,0,0,0,0,0,0,0,0,0,0,0,0,3277445,"2023-11-17T00:00:00.000Z",56677866,4,"Leaky Black",0,0,0,0,0,0
"16065",4538,0,0,0,0,0,0,0,0,0,0,0,0,0,0,0,0,3277445,"2023-11-17T00:00:00.000Z",17896037,4,"James Bouknight",0,0,0,0,0,0
"16066",4539,0,0,0,0,0,0,0,0,0,0,0,0,0,0,0,0,3277445,"2023-11-17T00:00:00.000Z",666748,4,"Cody Martin",0,0,0,0,0,0
"16067",4540,0,0,0,0,0,0,0,0,0,0,0,0,0,0,0,0,3277445,"2023-11-17T00:00:00.000Z",347,4,"Frank Ntilikina",0,0,0,0,0,0
"16068",4541,0,0,0,0,0,0,0,0,0,0,0,0,0,0,0,0,3277445,"2023-11-17T00:00:00.000Z",403,4,"Terry Rozier",0,0,0,0,0,0
"16069",4542,1,0,5,7,2,11,4,2,2,22,1,3,12,6,1,1,3277445,"2023-11-17T00:00:00.000Z",315,17,"Khris Middleton",1,18,19,13,7,22.7
"16070",4543,2,1,4,4,2,11,7,2,2,32,0,4,18,4,1,3,3277446,"2023-11-17T00:00:00.000Z",3547242,30,"Deni Avdija",2,22,24,20,6,28.8
"16071",4544,5,0,4,8,3,21,8,0,0,32,0,3,19,4,0,2,3277446,"2023-11-17T00:00:00.000Z",265,30,"Kyle Kuzma",0,23,28,24,9,29.3
"16072",4545,0,0,3,0,0,8,4,2,2,28,4,4,10,7,1,1,3277446,"2023-11-17T00:00:00.000Z",666577,30,"Daniel Gafford",1,17,17,10,7,20.4
"16073",4546,5,0,3,2,1,7,4,2,2,30,0,0,11,3,1,1,3277446,"2023-11-17T00:00:00.000Z",249,30,"Tyus Jones",1,14,19,16,8,24.1
"16074",4547,4,0,1,6,0,11,2,4,4,29,0,2,8,1,0,5,3277446,"2023-11-17T00:00:00.000Z",666848,30,"Jordan Poole",0,9,13,12,5,10.2
"16075",4548,0,0,0,0,0,0,0,0,0,2,0,0,0,0,0,0,3277446,"2023-11-17T00:00:00.000Z",18677954,30,"Jared Butler",0,0,0,0,0,0
"16076",4549,4,1,3,3,0,7,2,3,2,31,0,1,6,3,0,2,3277446,"2023-11-17T00:00:00.000Z",56677844,30,"Bilal Coulibaly",1,9,13,10,7,16.6
"16077",4550,1,0,1,3,1,5,3,1,1,26,2,1,8,3,1,0,3277446,"2023-11-17T00:00:00.000Z",17896045,30,"Corey Kispert",1,11,12,9,4,16.1
"16078",4551,5,0,8,5,2,15,8,7,6,35,1,1,24,9,3,3,1037673,"2023-11-04T00:00:00.000Z",237,14,"LeBron James",3,33,38,29,14,48.3
"16079",4552,0,1,3,1,0,3,2,0,0,25,1,2,4,4,1,0,3277354,"2023-11-03T00:00:00.000Z",56677840,7,"Dereck Lively II",2,8,8,4,4,14.8
"16080",4553,8,1,7,11,6,24,11,7,6,38,3,2,34,10,0,9,3277354,"2023-11-03T00:00:00.000Z",132,7,"Luka Doncic",1,44,52,42,18,52
"16081",4554,7,2,1,5,1,15,9,4,3,35,0,1,22,1,4,3,3277354,"2023-11-03T00:00:00.000Z",228,7,"Kyrie Irving",6,23,30,29,8,48.7
"16082",4555,1,0,0,0,0,5,2,2,2,17,1,2,6,1,0,0,3277354,"2023-11-03T00:00:00.000Z",379,7,"Dwight Powell",0,7,8,7,2,8.7
"16083",4556,2,0,3,5,1,8,3,2,2,27,0,3,9,3,1,2,3277354,"2023-11-03T00:00:00.000Z",191,7,"Tim Hardaway Jr.",1,12,14,11,5,16.6
"16084",4557,2,0,4,5,3,8,5,0,0,27,1,2,13,5,2,0,3277354,"2023-11-03T00:00:00.000Z",3547258,7,"Josh Green",2,18,20,15,7,28
"16085",4558,3,0,2,4,2,6,2,0,0,14,1,2,6,3,0,0,3277354,"2023-11-03T00:00:00.000Z",38017679,7,"Jaden Hardy",0,9,12,9,6,14.1
"16086",4559,1,0,1,1,0,1,0,0,0,5,0,1,0,1,1,0,3277354,"2023-11-03T00:00:00.000Z",114,7,"Seth Curry",1,1,2,1,2,5.7
"16087",4560,0,0,0,0,0,0,0,0,0,1,0,0,0,0,0,0,3277354,"2023-11-03T00:00:00.000Z",151,7,"Dante Exum",0,0,0,0,0,0
"16088",4561,0,0,0,0,0,1,0,0,0,1,0,0,0,0,0,0,3277354,"2023-11-03T00:00:00.000Z",56677859,7,"Olivier-Maxence Prosper",0,0,0,0,0,0
"16089",4562,0,0,0,0,0,0,0,0,0,0,0,0,0,0,0,0,3277354,"2023-11-03T00:00:00.000Z",217,7,"Richaun Holmes",0,0,0,0,0,0
"16090",4563,0,0,0,0,0,0,0,0,0,0,0,0,0,0,0,0,3277354,"2023-11-03T00:00:00.000Z",17896028,7,"Greg Brown III",0,0,0,0,0,0
"16091",4564,0,0,0,0,0,0,0,0,0,0,0,0,0,0,0,0,3277354,"2023-11-03T00:00:00.000Z",56677873,7,"Dexter Dennis",0,0,0,0,0,0
"16092",4565,0,0,0,0,0,0,0,0,0,0,0,0,0,0,0,0,3277354,"2023-11-03T00:00:00.000Z",257,7,"Maxi Kleber",0,0,0,0,0,0
"16093",4566,0,0,0,0,0,0,0,0,0,0,0,0,0,0,0,0,3277354,"2023-11-03T00:00:00.000Z",17554004,7,"AJ Lawson",0,0,0,0,0,0
"16094",4567,1,0,1,5,1,8,3,2,2,15,0,0,9,1,1,1,3277355,"2023-11-03T00:00:00.000Z",3547289,25,"Skylar Mays",1,10,11,10,2,13.7
"16095",4568,0,1,6,0,0,4,3,3,2,20,4,1,8,10,2,1,3277355,"2023-11-03T00:00:00.000Z",476,25,"Robert Williams III",3,18,18,8,10,28
"16096",4569,0,1,3,0,0,2,0,0,0,9,1,2,0,4,0,0,3277355,"2023-11-03T00:00:00.000Z",38017711,25,"Jabari Walker",1,4,4,0,4,7.8
"16097",4570,0,0,0,0,0,0,0,0,0,0,0,0,0,0,0,0,3277355,"2023-11-03T00:00:00.000Z",47957121,25,"Justin Minaya",0,0,0,0,0,0
"16098",4571,0,0,0,0,0,0,0,0,0,0,0,0,0,0,0,0,3277355,"2023-11-03T00:00:00.000Z",56677791,25,"Kris Murray",0,0,0,0,0,0
"16099",4572,0,0,0,0,0,0,0,0,0,0,0,0,0,0,0,0,3277355,"2023-11-03T00:00:00.000Z",56677829,25,"Rayan Rupert",0,0,0,0,0,0
"16100",4573,0,0,0,0,0,0,0,0,0,0,0,0,0,0,0,0,3277355,"2023-11-03T00:00:00.000Z",56677747,25,"Scoot Henderson",0,0,0,0,0,0
"16101",4574,0,0,0,0,0,0,0,0,0,0,0,0,0,0,0,0,3277355,"2023-11-03T00:00:00.000Z",56783340,25,"Duop Reath",0,0,0,0,0,0
"16102",4575,0,0,0,0,0,0,0,0,0,0,0,0,0,0,0,0,3277355,"2023-11-03T00:00:00.000Z",419,25,"Anfernee Simons",0,0,0,0,0,0
"16103",4576,0,0,0,0,0,0,0,0,0,0,0,0,0,0,0,0,1038084,"2024-01-05T00:00:00.000Z",376,28,"Otto Porter Jr.",0,0,0,0,0,0
"16104",4577,10,1,2,1,0,8,3,4,4,29,0,6,10,2,2,1,1038090,"2024-01-07T00:00:00.000Z",421,3,"Dennis Smith Jr.",3,12,22,20,12,35.4
"16105",4578,2,1,3,0,0,7,4,4,3,17,3,3,11,6,0,0,1038090,"2024-01-07T00:00:00.000Z",17896038,3,"Day'Ron Sharpe",1,17,19,13,8,24.2
"16106",4579,0,0,1,2,0,3,0,0,0,6,0,2,0,1,0,0,1038090,"2024-01-07T00:00:00.000Z",464,3,"Lonnie Walker IV",0,1,1,0,1,1.2
"16107",4580,0,0,0,0,0,0,0,0,0,1,0,0,0,0,0,1,1038090,"2024-01-07T00:00:00.000Z",17896058,3,"Trendon Watford",0,0,0,0,0,-1
"16108",4581,0,0,0,0,0,0,0,0,0,0,0,0,0,0,0,0,1038090,"2024-01-07T00:00:00.000Z",174,3,"Harry Giles III",0,0,0,0,0,0
"16109",4582,0,0,0,0,0,0,0,0,0,0,0,0,0,0,0,0,1038090,"2024-01-07T00:00:00.000Z",56677843,3,"Noah Clowney",0,0,0,0,0,0
"16110",4583,0,0,0,0,0,0,0,0,0,0,0,0,0,0,0,0,1038090,"2024-01-07T00:00:00.000Z",17896041,3,"Keon Johnson",0,0,0,0,0,0
"16111",4584,0,0,0,0,0,0,0,0,0,0,0,0,0,0,0,0,1038090,"2024-01-07T00:00:00.000Z",417,3,"Ben Simmons",0,0,0,0,0,0
"16112",4585,0,0,0,0,0,0,0,0,0,0,0,0,0,0,0,0,1038083,"2024-01-05T00:00:00.000Z",3,15,"Steven Adams",0,0,0,0,0,0
"16113",4586,0,0,0,0,0,0,0,0,0,0,0,0,0,0,0,0,1038083,"2024-01-05T00:00:00.000Z",666505,15,"Brandon Clarke",0,0,0,0,0,0
"16114",4587,0,0,0,0,0,0,0,0,0,0,0,0,0,0,0,0,1038083,"2024-01-05T00:00:00.000Z",48248287,15,"Jacob Gilyard",0,0,0,0,0,0
"16115",4588,0,0,0,0,0,0,0,0,0,0,0,0,0,0,0,0,1038083,"2024-01-05T00:00:00.000Z",56677830,15,"GG Jackson",0,0,0,0,0,0
"16116",4589,2,0,1,8,5,12,5,2,1,34,3,3,16,4,0,1,1038084,"2024-01-05T00:00:00.000Z",30,26,"Harrison Barnes",0,20,22,18,6,22.8
"16117",4590,1,0,9,4,4,11,6,4,2,35,3,1,18,12,1,3,1038084,"2024-01-05T00:00:00.000Z",38017688,26,"Keegan Murray",1,30,31,19,13,33.9
"16118",4591,0,0,0,0,0,0,0,0,0,0,0,0,0,0,0,0,1038083,"2024-01-05T00:00:00.000Z",38017728,15,"Jake LaRavia",0,0,0,0,0,0
"16119",4592,0,0,0,0,0,0,0,0,0,0,0,0,0,0,0,0,1038083,"2024-01-05T00:00:00.000Z",38017731,15,"Vince Williams Jr.",0,0,0,0,0,0
"16120",4593,11,0,11,0,0,16,11,3,2,39,4,6,24,15,0,6,1038084,"2024-01-05T00:00:00.000Z",406,26,"Domantas Sabonis",0,39,50,35,26,52.5
"16121",4594,1,0,0,3,2,6,4,0,0,16,0,2,10,0,0,1,1038084,"2024-01-05T00:00:00.000Z",17896030,26,"Chris Duarte",0,10,11,11,1,10.5
"16122",4595,4,1,1,3,1,20,10,3,3,37,1,4,24,2,2,2,1038084,"2024-01-05T00:00:00.000Z",161,26,"De'Aaron Fox",3,26,30,28,6,39.4
"16123",4596,0,0,0,0,0,0,0,2,0,2,0,0,0,0,1,0,1038081,"2024-01-05T00:00:00.000Z",3547298,24,"Saben Lee",1,0,0,0,0,3
"16124",4597,0,0,0,0,0,0,0,0,0,0,0,0,0,0,0,0,1038081,"2024-01-05T00:00:00.000Z",3547095,24,"Udoka Azubuike",0,0,0,0,0,0
"16125",4598,0,0,0,0,0,0,0,0,0,0,0,0,0,0,0,0,1038081,"2024-01-05T00:00:00.000Z",140,24,"Kevin Durant",0,0,0,0,0,0
"16126",4599,0,0,0,0,0,0,0,0,0,0,0,0,0,0,0,0,1038081,"2024-01-05T00:00:00.000Z",178,24,"Eric Gordon",0,0,0,0,0,0
"16127",4600,0,0,0,0,0,0,0,0,0,0,0,0,0,0,0,0,1038081,"2024-01-05T00:00:00.000Z",272,24,"Damion Lee",0,0,0,0,0,0
"16128",4601,5,0,0,1,1,10,8,0,0,36,1,2,17,1,0,1,1037983,"2023-12-23T00:00:00.000Z",38017507,12,"Andrew Nembhard",0,18,23,22,6,24.7
"16129",4602,14,0,2,5,3,22,12,3,2,40,0,2,29,2,3,3,1037983,"2023-12-23T00:00:00.000Z",3547245,12,"Tyrese Haliburton",3,31,45,43,16,58.4
"16130",4603,1,0,2,2,0,5,1,0,0,16,0,1,2,2,0,1,1037983,"2023-12-23T00:00:00.000Z",38017686,12,"Bennedict Mathurin",0,4,5,3,3,4.9
"16131",4604,2,0,2,4,1,5,1,0,0,28,1,6,3,3,2,4,1037983,"2023-12-23T00:00:00.000Z",3547250,12,"Aaron Nesmith",2,6,8,5,5,11.6
"16132",4605,0,0,1,0,0,2,0,0,0,6,2,4,0,3,0,0,1037983,"2023-12-23T00:00:00.000Z",17896035,12,"Isaiah Jackson",0,3,3,0,3,3.6
"16133",4606,2,0,0,0,0,1,0,2,1,7,0,0,1,0,0,1,1037983,"2023-12-23T00:00:00.000Z",304,12,"T.J. McConnell",0,1,3,3,2,3
"16134",4607,0,0,0,0,0,0,0,0,0,0,0,0,0,0,0,0,1037983,"2023-12-23T00:00:00.000Z",69,12,"Bruce Brown",0,0,0,0,0,0
"16135",4608,0,0,0,0,0,0,0,0,0,0,0,0,0,0,0,0,1037983,"2023-12-23T00:00:00.000Z",242,12,"James Johnson",0,0,0,0,0,0
"16136",4609,0,0,0,0,0,0,0,0,0,0,0,0,0,0,0,0,1037975,"2023-12-22T00:00:00.000Z",17896041,3,"Keon Johnson",0,0,0,0,0,0
"16137",4610,0,0,0,0,0,0,0,0,0,0,0,0,0,0,0,0,1037975,"2023-12-22T00:00:00.000Z",417,3,"Ben Simmons",0,0,0,0,0,0
"16138",4611,0,0,0,0,0,0,0,0,0,0,0,0,0,0,0,0,1037975,"2023-12-22T00:00:00.000Z",464,3,"Lonnie Walker IV",0,0,0,0,0,0
"16139",4612,0,0,0,0,0,0,0,0,0,0,0,0,0,0,0,0,1037975,"2023-12-22T00:00:00.000Z",56677841,3,"Dariq Whitehead",0,0,0,0,0,0
"16140",4613,3,1,4,5,3,10,6,0,0,34,0,1,15,4,0,1,1037975,"2023-12-22T00:00:00.000Z",375,8,"Michael Porter Jr.",1,19,22,18,7,26.3
"16141",4614,2,0,3,0,0,6,5,9,8,32,2,1,18,5,1,1,1037975,"2023-12-22T00:00:00.000Z",177,8,"Aaron Gordon",1,23,25,20,7,29
"16142",4615,7,2,9,2,2,17,12,5,5,34,2,4,31,11,3,0,1037975,"2023-12-22T00:00:00.000Z",246,8,"Nikola Jokic",5,42,49,38,18,69.7
"16143",4616,4,0,4,2,1,6,1,0,0,30,1,3,3,5,2,1,1037975,"2023-12-22T00:00:00.000Z",81,8,"Kentavious Caldwell-Pope",2,8,12,7,9,20
"16144",4617,0,0,0,0,0,0,0,0,0,0,0,0,0,0,0,0,1037975,"2023-12-22T00:00:00.000Z",38017727,8,"Collin Gillespie",0,0,0,0,0,0
"16145",4618,0,0,0,0,0,0,0,0,0,0,0,0,0,0,0,0,1037975,"2023-12-22T00:00:00.000Z",17896103,8,"Jay Huff",0,0,0,0,0,0
"16146",4619,0,1,3,1,0,2,1,0,0,17,0,2,2,3,1,2,1037982,"2023-12-23T00:00:00.000Z",38017721,8,"Peyton Watson",2,5,5,2,3,9.6
"16147",4620,0,0,0,0,0,0,0,0,0,0,0,0,0,0,0,0,1037982,"2023-12-23T00:00:00.000Z",56677871,8,"Hunter Tyson",0,0,0,0,0,0
"16148",4621,0,0,0,0,0,0,0,0,0,0,0,0,0,0,0,0,1037982,"2023-12-23T00:00:00.000Z",666489,8,"Vlatko Cancar",0,0,0,0,0,0
"16149",4622,0,0,0,0,0,0,0,0,0,0,0,0,0,0,0,0,1037982,"2023-12-23T00:00:00.000Z",17896007,8,"Braxton Key",0,0,0,0,0,0
"16150",4623,0,0,0,0,0,0,0,0,0,0,0,0,0,0,0,0,1037982,"2023-12-23T00:00:00.000Z",56677582,8,"Jalen Pickett",0,0,0,0,0,0
"16151",4624,0,0,0,0,0,0,0,0,0,3,0,0,0,0,0,1,1037972,"2023-12-21T00:00:00.000Z",486,14,"Christian Wood",0,0,0,0,0,-1
"16152",4625,1,0,2,0,0,1,1,1,1,11,1,2,3,3,0,1,1037972,"2023-12-21T00:00:00.000Z",666626,14,"Jaxson Hayes",0,6,7,4,4,7.1
"16153",4626,0,2,6,0,0,5,3,5,2,19,4,4,8,10,0,3,7049317,"2023-12-06T00:00:00.000Z",17896038,3,"Day'Ron Sharpe",2,18,18,8,10,23
"16154",4627,0,0,0,0,0,0,0,0,0,0,0,0,0,0,0,0,7049318,"2023-12-06T00:00:00.000Z",56677851,18,"Jaylen Clark",0,0,0,0,0,0
"16155",4628,0,0,0,0,0,0,0,0,0,0,0,0,0,0,0,0,7049318,"2023-12-06T00:00:00.000Z",17896056,18,"Luka Garza",0,0,0,0,0,0
"16156",4629,0,0,0,0,0,0,0,0,0,0,0,0,0,0,0,0,7049318,"2023-12-06T00:00:00.000Z",3547259,18,"Jaden McDaniels",0,0,0,0,0,0
"16157",4630,0,0,0,0,0,0,0,0,0,0,0,0,0,0,0,0,7049318,"2023-12-06T00:00:00.000Z",666767,18,"Jordan McLaughlin",0,0,0,0,0,0
"16158",4631,0,0,0,0,0,0,0,0,0,0,0,0,0,0,0,0,7049318,"2023-12-06T00:00:00.000Z",56677782,18,"Leonard Miller",0,0,0,0,0,0
"16159",4632,6,0,6,3,0,8,3,2,0,32,2,2,6,8,2,1,7049318,"2023-12-06T00:00:00.000Z",359,27,"Cedi Osman",2,14,20,12,14,29.6
"16160",4633,1,1,7,2,0,13,4,6,4,33,3,1,12,10,1,2,7049318,"2023-12-06T00:00:00.000Z",56677822,27,"Victor Wembanyama",2,22,23,13,11,29.5
"16161",4634,4,0,4,6,0,20,6,0,0,30,4,3,12,8,0,3,7049318,"2023-12-06T00:00:00.000Z",102,27,"Zach Collins",0,20,24,16,12,24.6
"16162",4635,3,1,9,3,1,16,8,5,4,32,1,4,21,10,2,4,7049318,"2023-12-06T00:00:00.000Z",666682,27,"Keldon Johnson",3,31,34,24,13,42.5
"16163",4636,2,1,3,8,4,16,9,0,0,31,0,1,22,3,1,0,7049318,"2023-12-06T00:00:00.000Z",3547246,27,"Devin Vassell",2,25,27,24,5,34.6
"16164",4637,0,0,0,1,0,2,0,0,0,10,2,2,0,2,0,0,7049318,"2023-12-06T00:00:00.000Z",38017692,27,"Malaki Branham",0,2,2,0,2,2.4
"16165",4638,0,0,1,1,0,1,0,0,0,4,0,0,0,1,0,0,7049318,"2023-12-06T00:00:00.000Z",38017649,27,"Julian Champagnie",0,1,1,0,1,1.2
"16166",4639,0,0,0,0,0,0,0,0,0,0,0,0,0,0,0,0,7049318,"2023-12-06T00:00:00.000Z",17895854,27,"Charles Bassey",0,0,0,0,0,0
"16167",4640,0,0,0,0,0,0,0,0,0,0,0,0,0,0,0,0,7049320,"2023-12-06T00:00:00.000Z",19465326,11,"Jock Landale",0,0,0,0,0,0
"16168",4641,0,0,0,0,0,0,0,0,0,0,0,0,0,0,0,0,7049320,"2023-12-06T00:00:00.000Z",357,11,"Victor Oladipo",0,0,0,0,0,0
"16169",4642,0,0,0,0,0,0,0,0,0,0,0,0,0,0,0,0,7049320,"2023-12-06T00:00:00.000Z",56677809,11,"Jermaine Samuels Jr.",0,0,0,0,0,0
"16170",4643,0,0,0,0,0,0,0,0,0,0,0,0,0,0,0,0,7049320,"2023-12-06T00:00:00.000Z",56677825,11,"Amen Thompson",0,0,0,0,0,0
"16171",4644,0,0,0,0,0,0,0,0,0,0,0,0,0,0,0,0,7049320,"2023-12-06T00:00:00.000Z",56677831,11,"Cam Whitmore",0,0,0,0,0,0
"16172",4645,0,0,1,3,0,5,0,4,4,14,2,1,4,3,0,1,7049320,"2023-12-06T00:00:00.000Z",666541,21,"Luguentz Dort",0,7,7,4,3,6.6
"16173",4646,3,0,5,1,0,13,5,3,3,33,0,2,13,5,1,2,7049320,"2023-12-06T00:00:00.000Z",38017703,21,"Jalen Williams",1,18,21,16,8,24.5
"16174",4647,2,6,4,4,0,9,2,0,0,26,1,2,4,5,1,1,7049320,"2023-12-06T00:00:00.000Z",38017685,21,"Chet Holmgren",7,9,11,6,7,33
"16175",4648,6,0,3,5,2,11,3,0,0,25,1,3,8,4,1,0,7049320,"2023-12-06T00:00:00.000Z",17896065,21,"Josh Giddey",1,12,18,14,10,24.8
"16176",4649,6,1,3,0,0,18,13,9,7,37,0,4,33,3,6,2,7049320,"2023-12-06T00:00:00.000Z",175,21,"Shai Gilgeous-Alexander",7,36,42,39,9,64.6
"16177",4650,0,0,0,2,0,4,0,2,2,12,0,1,2,0,0,0,7049320,"2023-12-06T00:00:00.000Z",38017706,21,"Jaylin Williams",0,2,2,2,0,2
"16178",4651,0,0,0,0,0,0,0,0,0,0,0,0,0,0,0,0,1037808,"2023-11-22T00:00:00.000Z",38017716,21,"Ousmane Dieng",0,0,0,0,0,0
"16179",4652,0,0,0,0,0,0,0,0,0,0,0,0,0,0,0,0,1037808,"2023-11-22T00:00:00.000Z",17896036,21,"Tre Mann",0,0,0,0,0,0
"16180",4653,6,1,1,8,2,13,5,3,3,36,2,4,15,3,0,0,1037809,"2023-11-22T00:00:00.000Z",666682,27,"Keldon Johnson",1,18,24,21,9,30.6
"16181",4654,3,3,13,2,1,13,7,7,7,33,2,2,22,15,1,2,1037809,"2023-11-22T00:00:00.000Z",56677822,27,"Victor Wembanyama",4,37,40,25,18,54.5
"16182",4655,3,1,7,5,2,13,6,2,2,28,2,6,16,9,0,1,1037809,"2023-11-22T00:00:00.000Z",102,27,"Zach Collins",1,25,28,19,12,33.3
"16183",4656,1,0,0,3,0,6,0,0,0,21,1,0,0,1,0,0,1037809,"2023-11-22T00:00:00.000Z",38017692,27,"Malaki Branham",0,1,2,1,2,2.7
"16184",4657,7,0,3,5,2,15,6,6,5,31,2,3,19,5,0,1,1037809,"2023-11-22T00:00:00.000Z",38017699,27,"Jeremy Sochan",0,24,31,26,12,34.5
"16185",4658,0,0,0,0,0,0,0,0,0,2,0,0,0,0,0,3,1037809,"2023-11-22T00:00:00.000Z",17895854,27,"Charles Bassey",0,0,0,0,0,-3
"16186",4659,0,0,0,0,0,0,0,0,0,0,0,0,0,0,0,0,1037803,"2023-11-22T00:00:00.000Z",38017734,16,"Jamal Cain",0,0,0,0,0,0
"16187",4660,0,0,2,0,0,1,0,0,0,9,0,1,0,2,1,0,1037809,"2023-11-22T00:00:00.000Z",38017730,27,"Dominick Barlow",1,2,2,0,2,5.4
"16188",4661,0,0,0,0,0,0,0,0,0,0,0,0,0,0,0,0,1037809,"2023-11-22T00:00:00.000Z",38017649,27,"Julian Champagnie",0,0,0,0,0,0
"16189",4662,0,0,0,0,0,0,0,0,0,0,0,0,0,0,0,0,1037809,"2023-11-22T00:00:00.000Z",180,27,"Devonte' Graham",0,0,0,0,0,0
"16190",4663,0,0,0,0,0,0,0,0,0,0,0,0,0,0,0,0,1037803,"2023-11-22T00:00:00.000Z",3547257,16,"R.J. Hampton",0,0,0,0,0,0
"16191",4664,0,0,0,0,0,0,0,0,0,0,0,0,0,0,0,0,1037803,"2023-11-22T00:00:00.000Z",666633,16,"Tyler Herro",0,0,0,0,0,0
"16192",4665,0,0,0,0,0,0,0,0,0,0,0,0,0,0,0,0,1037803,"2023-11-22T00:00:00.000Z",38017696,16,"Nikola Jovic",0,0,0,0,0,0
"16193",4666,0,0,0,0,0,0,0,0,0,0,0,0,0,0,0,0,1037803,"2023-11-22T00:00:00.000Z",285,16,"Kevin Love",0,0,0,0,0,0
"16194",4667,0,0,0,0,0,0,0,0,0,0,0,0,0,0,0,0,1037803,"2023-11-22T00:00:00.000Z",38017736,16,"Cole Swider",0,0,0,0,0,0
"16195",4668,3,3,4,0,0,15,10,2,2,37,7,6,22,11,1,2,1037801,"2023-11-22T00:00:00.000Z",666508,3,"Nicolas Claxton",4,33,36,25,14,49.7
"16196",4669,4,0,7,6,2,31,16,12,11,44,3,2,45,10,2,1,1037801,"2023-11-22T00:00:00.000Z",61,3,"Mikal Bridges",2,55,59,49,14,68
"16197",4670,12,0,4,8,3,23,9,5,5,42,2,3,26,6,0,4,1037801,"2023-11-22T00:00:00.000Z",130,3,"Spencer Dinwiddie",0,32,44,38,18,47.2
"16198",4671,0,1,3,0,0,6,3,0,0,14,4,2,6,7,2,1,1037801,"2023-11-22T00:00:00.000Z",17896038,3,"Day'Ron Sharpe",3,13,13,6,7,22.4
"16199",4672,4,1,4,4,1,6,3,0,0,29,2,4,7,6,0,0,1037806,"2023-11-22T00:00:00.000Z",666400,18,"Nickeil Alexander-Walker",1,13,17,11,10,23.2
"16200",4673,3,2,11,2,1,19,9,5,4,36,0,5,23,11,2,4,1037806,"2023-11-22T00:00:00.000Z",447,18,"Karl-Anthony Towns",4,34,37,26,14,48.7
"16201",4674,3,3,8,0,0,8,6,2,1,31,3,3,13,11,0,2,1037806,"2023-11-22T00:00:00.000Z",176,18,"Rudy Gobert",3,24,27,16,14,37.7
"16202",4675,6,0,4,9,5,22,11,4,4,36,2,2,31,6,2,2,1037806,"2023-11-22T00:00:00.000Z",3547238,18,"Anthony Edwards",2,37,43,37,12,51.2
"16203",4676,0,0,0,0,0,0,0,0,0,0,0,0,0,0,0,0,1037697,"2023-11-08T00:00:00.000Z",56677832,12,"Jarace Walker",0,0,0,0,0,0
"16204",4677,0,0,0,0,0,0,0,0,0,0,0,0,0,0,0,0,1037697,"2023-11-08T00:00:00.000Z",38017701,12,"Kendall Brown",0,0,0,0,0,0
"16205",4678,0,0,0,0,0,0,0,0,0,0,0,0,0,0,0,0,1037697,"2023-11-08T00:00:00.000Z",56677842,29,"Brice Sensabaugh",0,0,0,0,0,0
"16206",4679,0,0,0,0,0,0,0,0,0,0,0,0,0,0,0,0,1037707,"2023-11-08T00:00:00.000Z",489,28,"Thaddeus Young",0,0,0,0,0,0
"16207",4680,0,0,0,0,0,0,0,0,0,0,0,0,0,0,0,0,1037707,"2023-11-08T00:00:00.000Z",3547249,28,"Precious Achiuwa",0,0,0,0,0,0
"16208",4681,0,0,0,0,0,0,0,0,0,0,0,0,0,0,0,0,1037707,"2023-11-08T00:00:00.000Z",56677805,28,"Javon Freeman-Liberty",0,0,0,0,0,0
"16209",4682,0,0,0,0,0,0,0,0,0,0,0,0,0,0,0,0,1037707,"2023-11-08T00:00:00.000Z",38017717,28,"Ron Harper Jr.",0,0,0,0,0,0
"16210",4683,0,0,0,0,0,0,0,0,0,0,0,0,0,0,0,0,1037707,"2023-11-08T00:00:00.000Z",38017710,28,"Christian Koloko",0,0,0,0,0,0
"16211",4684,0,0,0,0,0,0,0,0,0,0,0,0,0,0,0,0,1037707,"2023-11-08T00:00:00.000Z",56677869,28,"Markquis Nowell",0,0,0,0,0,0
"16212",4685,2,0,6,7,3,17,11,1,1,28,0,1,26,6,1,3,1037704,"2023-11-08T00:00:00.000Z",56677792,9,"Marcus Sasser",1,32,34,28,8,36.2
"16213",4686,0,0,0,0,0,0,0,0,0,0,0,0,0,0,0,0,1037704,"2023-11-08T00:00:00.000Z",259,9,"Kevin Knox",0,0,0,0,0,0
"16214",4687,0,0,0,0,0,0,0,0,0,0,0,0,0,0,0,0,1037704,"2023-11-08T00:00:00.000Z",17896071,9,"Isaiah Livers",0,0,0,0,0,0
"16215",4688,0,0,0,0,0,0,0,0,0,0,0,0,0,0,0,0,1037704,"2023-11-08T00:00:00.000Z",330,9,"Monte Morris",0,0,0,0,0,0
"16216",4689,0,0,1,0,0,2,1,2,2,13,2,2,4,3,1,2,1037703,"2023-11-08T00:00:00.000Z",38017729,15,"David Roddy",1,7,7,4,3,8.6
"16217",4690,0,0,0,0,0,0,0,0,0,0,0,0,0,0,0,0,1037703,"2023-11-08T00:00:00.000Z",38017731,15,"Vince Williams Jr.",0,0,0,0,0,0
"16218",4691,0,0,0,0,0,0,0,0,0,0,0,0,0,0,0,0,1037703,"2023-11-08T00:00:00.000Z",3,15,"Steven Adams",0,0,0,0,0,0
"16219",4692,0,0,0,0,0,0,0,0,0,0,0,0,0,0,0,0,1037703,"2023-11-08T00:00:00.000Z",666505,15,"Brandon Clarke",0,0,0,0,0,0
"16220",4693,0,0,0,0,0,0,0,0,0,0,0,0,0,0,0,0,1037703,"2023-11-08T00:00:00.000Z",666703,15,"John Konchar",0,0,0,0,0,0
"16221",4694,0,0,0,0,0,0,0,0,0,0,0,0,0,0,0,0,1037703,"2023-11-08T00:00:00.000Z",666786,15,"Ja Morant",0,0,0,0,0,0
"16222",4695,0,0,0,0,0,0,0,0,0,0,0,0,0,0,0,0,1037703,"2023-11-08T00:00:00.000Z",401,15,"Derrick Rose",0,0,0,0,0,0
"16223",4696,0,0,0,0,0,0,0,0,0,0,0,0,0,0,0,0,1037703,"2023-11-08T00:00:00.000Z",3547285,15,"Xavier Tillman",0,0,0,0,0,0
"16224",4697,2,0,2,4,2,13,5,3,3,35,1,1,15,3,1,1,1037703,"2023-11-08T00:00:00.000Z",79,16,"Jimmy Butler",1,18,20,17,5,23.6
"16225",4698,1,3,0,4,2,7,5,2,2,27,2,2,14,2,2,0,1037703,"2023-11-08T00:00:00.000Z",3092,16,"Haywood Highsmith",5,16,17,15,3,32.9
"16226",4699,1,0,3,2,1,7,1,0,0,21,1,0,3,4,1,1,1037701,"2023-11-08T00:00:00.000Z",3547248,5,"Patrick Williams",1,7,8,4,5,11.3
"16227",4700,0,0,0,0,0,0,0,0,0,0,0,0,0,0,0,0,1037701,"2023-11-08T00:00:00.000Z",27,5,"Lonzo Ball",0,0,0,0,0,0
"16228",4701,0,0,0,0,0,0,0,0,0,0,0,0,0,0,0,0,1037624,"2023-10-28T00:00:00.000Z",17554001,23,"Javonte Smart",0,0,0,0,0,0
"16229",4702,7,1,5,9,7,20,12,3,3,41,1,1,34,6,0,1,1037624,"2023-10-28T00:00:00.000Z",3547254,23,"Tyrese Maxey",1,40,47,41,13,53.7
"16230",4703,2,0,3,6,0,17,7,5,4,29,2,3,18,5,3,0,1037624,"2023-10-28T00:00:00.000Z",360,23,"Kelly Oubre Jr.",3,23,25,20,7,36
"16231",4704,2,0,2,0,0,2,1,0,0,17,3,2,2,5,0,1,1037624,"2023-10-28T00:00:00.000Z",45,23,"Patrick Beverley",0,7,9,4,7,10
"16232",4705,0,0,0,0,0,1,0,0,0,5,0,1,0,0,0,0,1037624,"2023-10-28T00:00:00.000Z",184,23,"Danny Green",0,0,0,0,0,0
"16233",4706,0,0,3,0,0,4,2,0,0,13,2,4,4,5,1,1,1037624,"2023-10-28T00:00:00.000Z",3547270,23,"Paul Reed",1,9,9,4,5,12
"16234",4707,0,1,2,1,0,3,1,0,0,11,0,1,2,2,0,0,1037624,"2023-10-28T00:00:00.000Z",2175,23,"Danuel House Jr.",1,4,4,2,2,7.4
"16235",4708,3,1,3,0,0,8,5,2,1,35,2,3,11,5,0,0,1037623,"2023-10-28T00:00:00.000Z",3547247,6,"Isaac Okoro",1,16,19,14,8,24.5
"16236",4709,3,1,3,5,2,5,2,0,0,37,0,2,6,3,0,0,1037623,"2023-10-28T00:00:00.000Z",666940,6,"Dean Wade",1,9,12,9,6,17.1
"16237",4710,3,3,9,1,1,22,12,10,8,33,5,4,33,14,0,2,1037623,"2023-10-28T00:00:00.000Z",17896076,6,"Evan Mobley",3,47,50,36,17,61.3
"16238",4711,6,0,10,9,4,20,7,3,3,42,1,2,21,11,0,1,1037623,"2023-10-28T00:00:00.000Z",666908,6,"Max Strus",0,32,38,27,17,42.2
"16239",4712,8,0,3,10,4,28,12,9,3,44,2,2,31,5,1,2,1037623,"2023-10-28T00:00:00.000Z",277,6,"Caris LeVert",1,36,44,39,13,50
"16240",4713,0,0,1,0,0,0,0,0,0,6,2,0,0,3,0,0,1037623,"2023-10-28T00:00:00.000Z",248,6,"Damian Jones",0,3,3,0,3,3.6
"16241",4714,0,0,0,0,0,0,0,0,0,0,0,0,0,0,0,0,1037621,"2023-10-28T00:00:00.000Z",38017731,15,"Vince Williams Jr.",0,0,0,0,0,0
"16242",4715,0,0,0,0,0,0,0,0,0,0,0,0,0,0,0,0,1037621,"2023-10-28T00:00:00.000Z",3,15,"Steven Adams",0,0,0,0,0,0
"16243",4716,0,0,0,0,0,0,0,0,0,0,0,0,0,0,0,0,1037621,"2023-10-28T00:00:00.000Z",17896067,15,"Santi Aldama",0,0,0,0,0,0
"16244",4717,0,0,0,0,0,0,0,0,0,0,0,0,0,0,0,0,1037621,"2023-10-28T00:00:00.000Z",666505,15,"Brandon Clarke",0,0,0,0,0,0
"16245",4718,0,0,0,1,0,1,0,0,0,6,0,0,0,0,0,0,1037623,"2023-10-28T00:00:00.000Z",56677847,6,"Emoni Bates",0,0,0,0,0,0
"16246",4719,0,0,0,0,0,0,0,0,0,3,0,0,0,0,0,0,1037624,"2023-10-28T00:00:00.000Z",666762,28,"Jalen McDaniels",0,0,0,0,0,0
"16247",4720,1,0,2,10,2,12,3,0,0,29,1,1,8,3,1,1,1037625,"2023-10-28T00:00:00.000Z",397,16,"Duncan Robinson",1,11,12,9,4,15.1
"16248",4721,4,0,1,1,1,4,2,0,0,22,0,1,5,1,1,1,1037625,"2023-10-28T00:00:00.000Z",19465585,16,"Dru Smith",1,6,10,9,5,14.2
"16249",4722,0,1,1,0,0,2,0,0,0,4,0,0,0,1,0,0,1037625,"2023-10-28T00:00:00.000Z",39398582,16,"Orlando Robinson",1,1,1,0,1,4.2
"16250",4723,8,0,1,0,0,5,3,2,2,19,1,1,8,2,0,0,1037623,"2023-10-28T00:00:00.000Z",304,12,"T.J. McConnell",0,10,18,16,10,22.4
"16251",4724,0,0,0,0,0,0,0,0,0,0,0,0,0,0,0,0,1037623,"2023-10-28T00:00:00.000Z",17896035,12,"Isaiah Jackson",0,0,0,0,0,0
"16252",4725,0,0,0,0,0,0,0,0,0,0,0,0,0,0,0,0,1037624,"2023-10-28T00:00:00.000Z",376,28,"Otto Porter Jr.",0,0,0,0,0,0
"16253",4726,7,0,4,5,2,8,2,2,1,31,1,1,7,5,1,3,1038054,"2024-01-02T00:00:00.000Z",214,2,"Jrue Holiday",1,12,19,14,12,23.5
"16254",4727,0,0,3,4,1,14,7,0,0,32,0,2,15,3,1,3,1038051,"2024-01-02T00:00:00.000Z",17895983,5,"Ayo Dosunmu",1,18,18,15,3,18.6
"16255",4728,1,0,1,8,3,11,3,0,0,23,0,0,9,1,3,0,1038051,"2024-01-02T00:00:00.000Z",87,5,"Jevon Carter",3,10,11,10,2,20.7
"16256",4729,1,1,1,2,0,5,0,0,0,20,4,2,0,5,1,4,1038051,"2024-01-02T00:00:00.000Z",17896116,5,"Terry Taylor",2,5,6,1,6,9.5
"16257",4730,7,1,7,3,0,7,2,2,2,21,1,4,6,8,0,3,1038051,"2024-01-02T00:00:00.000Z",38017719,5,"Dalen Terry",1,14,21,13,15,26.1
"16258",4731,0,0,1,3,2,3,2,0,0,10,0,0,6,1,0,0,1038054,"2024-01-02T00:00:00.000Z",17896060,2,"Sam Hauser",0,7,7,6,1,7.2
"16259",4732,3,5,2,3,1,5,3,0,0,20,0,0,7,2,1,0,1038054,"2024-01-02T00:00:00.000Z",219,2,"Al Horford",6,9,12,10,5,31.9
"16260",4733,4,0,2,4,1,5,2,0,0,25,1,1,5,3,2,0,1038054,"2024-01-02T00:00:00.000Z",3547276,2,"Payton Pritchard",2,8,12,9,7,20.6
"16261",4734,0,1,0,0,0,2,0,0,0,15,2,0,0,2,1,0,1038054,"2024-01-02T00:00:00.000Z",261,2,"Luke Kornet",2,2,2,0,2,8.4
"16262",4735,0,0,0,0,0,0,0,0,0,0,0,0,0,0,0,0,1038054,"2024-01-02T00:00:00.000Z",17896094,2,"Dalano Banton",0,0,0,0,0,0
"16263",4736,0,0,0,0,0,0,0,0,0,0,0,0,0,0,0,0,1038054,"2024-01-02T00:00:00.000Z",666468,2,"Oshae Brissett",0,0,0,0,0,0
"16264",4737,0,0,0,0,0,0,0,0,0,0,0,0,0,0,0,0,1038054,"2024-01-02T00:00:00.000Z",338,2,"Svi Mykhailiuk",0,0,0,0,0,0
"16265",4738,0,3,0,3,1,5,3,0,0,17,0,2,7,0,1,0,1038051,"2024-01-02T00:00:00.000Z",56677857,5,"Julian Phillips",4,7,7,7,0,19
"16266",4739,0,0,4,0,0,3,3,3,2,9,2,0,8,6,0,1,1038051,"2024-01-02T00:00:00.000Z",56677860,5,"Adama Sanogo",0,14,14,8,6,14.2
"16267",4740,0,0,0,0,0,0,0,0,0,0,0,0,0,0,0,0,1038051,"2024-01-02T00:00:00.000Z",110,5,"Torrey Craig",0,0,0,0,0,0
"16268",4741,0,0,0,0,0,0,0,0,0,0,0,0,0,0,0,0,1038051,"2024-01-02T00:00:00.000Z",27,5,"Lonzo Ball",0,0,0,0,0,0
"16269",4742,0,0,0,0,0,0,0,0,0,0,0,0,0,0,0,0,1038051,"2024-01-02T00:00:00.000Z",56677874,5,"Onuralp Bitim",0,0,0,0,0,0
"16270",4744,0,0,0,0,0,0,0,0,0,0,0,0,0,0,0,0,1038051,"2024-01-02T00:00:00.000Z",268,5,"Zach LaVine",0,0,0,0,0,0
"16271",4745,0,0,0,0,0,0,0,0,0,0,0,0,0,0,0,0,1038051,"2024-01-02T00:00:00.000Z",460,5,"Nikola Vucevic",0,0,0,0,0,0
"16272",4746,3,1,1,2,1,8,3,5,4,34,1,2,11,2,1,2,1038052,"2024-01-02T00:00:00.000Z",3547246,27,"Devin Vassell",2,13,16,14,5,21.9
"16273",4747,1,0,1,0,0,5,1,0,0,8,0,1,2,1,0,0,1038052,"2024-01-02T00:00:00.000Z",38017692,27,"Malaki Branham",0,3,4,3,2,4.7
"16274",4748,4,0,5,4,1,16,7,5,4,31,1,4,19,6,1,3,1038052,"2024-01-02T00:00:00.000Z",666682,27,"Keldon Johnson",1,25,29,23,10,32.2
"16275",4749,2,0,3,0,0,6,2,0,0,14,4,4,4,7,0,2,1038052,"2024-01-02T00:00:00.000Z",38017730,27,"Dominick Barlow",0,11,13,6,9,13.4
"16276",4750,2,0,6,2,0,3,0,0,0,13,0,2,0,6,0,2,1038052,"2024-01-02T00:00:00.000Z",359,27,"Cedi Osman",0,6,8,2,8,8.2
"16277",4751,0,0,0,0,0,0,0,0,0,0,0,0,0,0,0,0,1037935,"2023-12-16T00:00:00.000Z",59421201,20,"Jaylen Martin",0,0,0,0,0,0
"16278",4752,4,0,2,0,0,7,1,4,3,25,1,1,5,3,1,0,1037937,"2023-12-17T00:00:00.000Z",38017699,27,"Jeremy Sochan",1,8,12,9,7,17.6
"16279",4753,2,0,4,1,0,3,1,0,0,16,1,2,2,5,0,0,1037937,"2023-12-17T00:00:00.000Z",102,27,"Zach Collins",0,7,9,4,7,11
"16280",4754,1,2,0,6,5,6,5,0,0,14,1,0,15,1,0,0,1037937,"2023-12-17T00:00:00.000Z",38017649,27,"Julian Champagnie",2,16,17,16,2,23.7
"16281",4755,2,0,0,3,2,3,2,2,1,7,0,1,7,0,0,0,1037937,"2023-12-17T00:00:00.000Z",180,27,"Devonte' Graham",0,7,9,9,2,10
"16282",4756,0,0,2,2,1,3,1,4,3,12,0,3,6,2,0,0,1037936,"2023-12-17T00:00:00.000Z",462,22,"Moritz Wagner",0,8,8,6,2,8.4
"16283",4757,1,0,0,0,0,0,0,0,0,2,0,0,0,0,0,0,1037936,"2023-12-17T00:00:00.000Z",666885,22,"Admiral Schofield",0,0,1,1,1,1.5
"16284",4758,0,0,0,0,0,0,0,0,0,0,0,0,0,0,0,0,1037936,"2023-12-17T00:00:00.000Z",85,22,"Wendell Carter Jr.",0,0,0,0,0,0
"16285",4759,0,0,0,0,0,0,0,0,0,0,0,0,0,0,0,0,1037936,"2023-12-17T00:00:00.000Z",165,22,"Markelle Fultz",0,0,0,0,0,0
"16286",4760,0,0,0,0,0,0,0,0,0,0,0,0,0,0,0,0,1037936,"2023-12-17T00:00:00.000Z",38017607,22,"Kevon Harris",0,0,0,0,0,0
"16287",4761,0,0,0,0,0,0,0,0,0,0,0,0,0,0,0,0,1037936,"2023-12-17T00:00:00.000Z",17553983,22,"Trevelin Queen",0,0,0,0,0,0
"16288",4762,0,0,3,2,1,7,5,4,3,17,0,2,14,3,0,1,1037937,"2023-12-17T00:00:00.000Z",359,27,"Cedi Osman",0,17,17,14,3,16.6
"16289",4763,5,0,0,2,0,5,2,0,0,16,0,1,4,0,0,0,1037937,"2023-12-17T00:00:00.000Z",3547274,27,"Tre Jones",0,4,9,9,5,11.5
"16290",4764,1,0,1,5,1,7,2,2,2,15,1,1,7,2,0,0,1037937,"2023-12-17T00:00:00.000Z",305,27,"Doug McDermott",0,9,10,8,3,10.9
"16291",4765,2,0,0,3,0,4,1,0,0,8,0,0,2,0,0,1,1037937,"2023-12-17T00:00:00.000Z",17896059,27,"Sandro Mamukelashvili",0,2,4,4,2,4
"16292",4766,0,0,0,0,0,0,0,0,0,0,0,0,0,0,0,0,1037937,"2023-12-17T00:00:00.000Z",38017730,27,"Dominick Barlow",0,0,0,0,0,0
"16293",4767,0,0,0,0,0,0,0,0,0,0,0,0,0,0,0,0,1037937,"2023-12-17T00:00:00.000Z",17895854,27,"Charles Bassey",0,0,0,0,0,0
"16294",4768,0,0,0,0,0,0,0,0,0,0,0,0,0,0,0,0,1037937,"2023-12-17T00:00:00.000Z",56677865,27,"Charles Bediako",0,0,0,0,0,0
"16295",4769,0,0,0,0,0,0,0,0,0,0,0,0,0,0,0,0,1037937,"2023-12-17T00:00:00.000Z",56677817,27,"Sidy Cissoko",0,0,0,0,0,0
"16296",4770,0,0,0,0,0,0,0,0,0,0,0,0,0,0,0,0,1037937,"2023-12-17T00:00:00.000Z",17896049,27,"David Duke Jr.",0,0,0,0,0,0
"16297",4771,0,0,0,0,0,0,0,0,0,0,0,0,0,0,0,0,1037937,"2023-12-17T00:00:00.000Z",38017693,27,"Blake Wesley",0,0,0,0,0,0
"16298",4772,4,1,3,7,5,17,10,1,1,27,0,1,26,3,1,1,1037937,"2023-12-17T00:00:00.000Z",227,19,"Brandon Ingram",2,29,33,30,7,40.6
"16299",4773,3,1,3,1,0,12,7,4,1,26,5,2,15,8,2,1,1037937,"2023-12-17T00:00:00.000Z",666969,19,"Zion Williamson",3,23,26,18,11,37.1
"16300",4774,3,1,12,4,1,13,6,3,2,23,4,3,15,16,1,1,1037937,"2023-12-17T00:00:00.000Z",455,19,"Jonas Valanciunas",2,31,34,18,19,43.7
"16301",4775,3,0,0,3,0,5,0,2,2,19,1,3,2,1,1,2,1037937,"2023-12-17T00:00:00.000Z",17896024,19,"Herbert Jones",1,3,6,5,4,8.7
"16302",4776,0,0,0,0,0,0,0,0,0,0,0,0,0,0,0,0,1037854,"2023-11-29T00:00:00.000Z",17896021,19,"Jeremiah Robinson-Earl",0,0,0,0,0,0
"16303",4777,0,0,0,0,0,0,0,0,0,0,0,0,0,0,0,0,1037854,"2023-11-29T00:00:00.000Z",38017663,19,"E.J. Liddell",0,0,0,0,0,0
"16304",4778,0,0,0,0,0,0,0,0,0,0,0,0,0,0,0,0,1037854,"2023-11-29T00:00:00.000Z",18677986,19,"Trey Murphy III",0,0,0,0,0,0
"16305",4779,0,0,0,0,0,0,0,0,0,0,0,0,0,0,0,0,1037854,"2023-11-29T00:00:00.000Z",340,19,"Larry Nance Jr.",0,0,0,0,0,0
"16306",4780,0,0,0,0,0,0,0,0,0,0,0,0,0,0,0,0,1037854,"2023-11-29T00:00:00.000Z",17896017,19,"Matt Ryan",0,0,0,0,0,0
"16307",4781,0,0,0,0,0,0,0,0,0,0,0,0,0,0,0,0,1037854,"2023-11-29T00:00:00.000Z",38017726,19,"Dereon Seabron",0,0,0,0,0,0
"16308",4782,0,0,1,1,1,1,1,0,0,14,0,1,3,1,0,1,1037854,"2023-11-29T00:00:00.000Z",33,23,"Nicolas Batum",0,4,4,3,1,3.2
"16309",4783,2,0,4,2,0,10,5,2,2,29,0,2,12,4,0,5,1037854,"2023-11-29T00:00:00.000Z",200,23,"Tobias Harris",0,16,18,14,6,14.8
"16310",4784,2,1,2,3,1,7,3,0,0,17,1,4,7,3,1,1,1037854,"2023-11-29T00:00:00.000Z",328,23,"Marcus Morris",2,10,12,9,5,18.6
"16311",4785,0,0,0,0,0,0,0,0,0,0,0,0,0,0,0,0,1037853,"2023-11-29T00:00:00.000Z",56677842,29,"Brice Sensabaugh",0,0,0,0,0,0
"16312",4786,0,0,0,0,0,0,0,0,0,0,0,0,0,0,0,0,1037855,"2023-11-29T00:00:00.000Z",666489,8,"Vlatko Cancar",0,0,0,0,0,0
"16313",4787,0,0,0,0,0,0,0,0,0,0,0,0,0,0,0,0,1037855,"2023-11-29T00:00:00.000Z",177,8,"Aaron Gordon",0,0,0,0,0,0
"16314",4788,0,0,0,0,0,0,0,0,0,0,0,0,0,0,0,0,1037855,"2023-11-29T00:00:00.000Z",17896103,8,"Jay Huff",0,0,0,0,0,0
"16315",4789,2,0,0,4,1,7,4,3,2,23,1,4,11,1,0,4,1037855,"2023-11-29T00:00:00.000Z",66,11,"Dillon Brooks",0,12,14,13,3,11.2
"16316",4790,2,1,6,7,2,14,6,2,1,32,1,3,15,7,0,0,1037855,"2023-11-29T00:00:00.000Z",38017684,11,"Jabari Smith Jr.",1,22,24,17,9,29.4
"16317",4791,4,0,5,6,2,18,10,0,0,28,2,3,22,7,1,1,1037855,"2023-11-29T00:00:00.000Z",17896062,11,"Alperen Sengun",1,29,33,26,11,38.4
"16318",4792,9,1,6,8,5,12,8,6,5,34,0,0,26,6,0,2,1037855,"2023-11-29T00:00:00.000Z",17895966,11,"Jalen Green",1,32,41,35,15,47.7
"16319",4793,5,0,3,5,0,10,4,1,1,35,0,2,9,3,0,0,1037855,"2023-11-29T00:00:00.000Z",213,11,"Aaron Holiday",0,12,17,14,8,20.1
"16320",4794,0,0,1,1,0,4,2,2,2,14,0,2,6,1,1,1,1037855,"2023-11-29T00:00:00.000Z",19465326,11,"Jock Landale",1,7,7,6,1,9.2
"16321",4795,0,0,0,2,2,2,2,0,0,12,1,3,6,1,0,0,1037855,"2023-11-29T00:00:00.000Z",75,11,"Reggie Bullock",0,7,7,6,1,7.2
"16322",4796,0,2,0,1,0,5,2,0,0,17,2,0,4,2,0,0,1037855,"2023-11-29T00:00:00.000Z",38017695,11,"Tari Eason",2,6,6,4,2,12.4
"16323",4797,2,1,2,3,2,6,4,3,2,22,0,1,12,2,1,0,1037855,"2023-11-29T00:00:00.000Z",188,11,"Jeff Green",2,14,16,14,4,23.4
"16324",4798,2,0,2,1,0,1,0,0,0,6,0,0,0,2,0,0,1037855,"2023-11-29T00:00:00.000Z",56677809,11,"Jermaine Samuels Jr.",0,2,4,2,4,5.4
"16325",4799,0,0,2,2,1,4,3,2,1,6,0,1,8,2,0,0,1037855,"2023-11-29T00:00:00.000Z",56677831,11,"Cam Whitmore",0,10,10,8,2,10.4
"16326",4800,1,0,0,0,0,2,1,0,0,6,0,1,2,0,0,0,1037855,"2023-11-29T00:00:00.000Z",47738533,11,"Jeenathan Williams",0,2,3,3,1,3.5
"16327",4801,0,0,1,2,1,3,1,0,0,10,1,1,3,2,0,0,3277453,"2023-11-17T00:00:00.000Z",470,24,"Yuta Watanabe",0,5,5,3,2,5.4
"16328",4802,0,2,1,5,4,6,5,4,4,23,0,4,18,1,2,1,3277451,"2023-11-17T00:00:00.000Z",89,5,"Alex Caruso",4,19,19,18,1,30.2
"16329",4803,6,0,7,3,0,16,4,2,2,30,3,4,10,10,0,1,3277451,"2023-11-17T00:00:00.000Z",460,5,"Nikola Vucevic",0,20,26,16,16,30
"16330",4804,3,0,6,11,4,20,12,7,6,41,0,4,34,6,2,3,3277451,"2023-11-17T00:00:00.000Z",268,5,"Zach LaVine",2,40,43,37,9,48.7
"16331",4805,4,0,1,3,0,6,2,1,0,30,0,2,4,1,0,2,3277451,"2023-11-17T00:00:00.000Z",666956,5,"Coby White",0,5,9,8,5,9.2
"16332",4806,1,0,1,0,0,0,0,0,0,10,0,0,0,1,0,0,3277451,"2023-11-17T00:00:00.000Z",87,5,"Jevon Carter",0,1,2,1,2,2.7
"16333",4807,4,1,5,1,0,14,6,4,1,32,3,3,13,8,0,7,3277451,"2023-11-17T00:00:00.000Z",38017683,22,"Paolo Banchero",1,21,25,17,12,24.6
"16334",4808,0,2,4,0,0,1,0,4,2,21,0,4,2,4,1,1,3277451,"2023-11-17T00:00:00.000Z",666442,22,"Goga Bitadze",3,6,6,2,4,14.8
"16335",4809,2,2,4,7,3,10,5,2,2,29,2,3,15,6,1,0,3277451,"2023-11-17T00:00:00.000Z",196,22,"Gary Harris",3,21,23,17,8,34.2
"16336",4810,0,0,0,0,0,2,1,1,0,11,0,0,2,0,0,3,3277451,"2023-11-17T00:00:00.000Z",56677827,22,"Anthony Black",0,2,2,2,0,-1
"16337",4811,5,0,1,7,2,8,3,0,0,26,0,1,8,1,1,1,3277451,"2023-11-17T00:00:00.000Z",226,22,"Joe Ingles",1,9,14,13,6,18.7
"16338",4812,7,0,6,5,1,12,3,4,4,37,2,4,11,8,1,2,3277451,"2023-11-17T00:00:00.000Z",3547251,22,"Cole Anthony",1,19,26,18,15,32.1
"16339",4813,1,1,6,4,2,8,6,4,4,20,3,2,18,9,1,1,3277451,"2023-11-17T00:00:00.000Z",229,22,"Jonathan Isaac",2,27,28,19,10,35.3
"16340",4814,3,1,4,1,0,5,4,2,2,23,0,3,10,4,0,0,3277451,"2023-11-17T00:00:00.000Z",462,22,"Moritz Wagner",1,14,17,13,7,22.3
"16341",4815,0,0,2,1,1,1,1,0,0,6,0,0,3,2,0,0,3277451,"2023-11-17T00:00:00.000Z",38017724,22,"Caleb Houstan",0,5,5,3,2,5.4
"16342",4816,0,0,1,4,2,5,3,0,0,15,0,2,8,1,0,1,3277453,"2023-11-17T00:00:00.000Z",38017739,29,"Simone Fontecchio",0,9,9,8,1,8.2
"16343",4817,0,0,0,0,0,0,0,0,0,1,0,0,0,0,0,0,3277453,"2023-11-17T00:00:00.000Z",139,29,"Kris Dunn",0,0,0,0,0,0
"16344",4818,0,0,0,0,0,0,0,0,0,0,0,0,0,0,0,0,3277453,"2023-11-17T00:00:00.000Z",56677824,29,"Taylor Hendricks",0,0,0,0,0,0
"16345",4819,0,0,0,0,0,0,0,0,0,0,0,0,0,0,0,0,3277448,"2023-11-17T00:00:00.000Z",54,9,"Bojan Bogdanovic",0,0,0,0,0,0
"16346",4820,0,0,0,0,0,0,0,0,0,0,0,0,0,0,0,0,3277448,"2023-11-17T00:00:00.000Z",56677729,9,"Malcolm Cazalon",0,0,0,0,0,0
"16347",4821,0,0,0,0,0,0,0,0,0,0,0,0,0,0,0,0,3277448,"2023-11-17T00:00:00.000Z",197,9,"Joe Harris",0,0,0,0,0,0
"16348",4822,0,0,0,0,0,0,0,0,0,0,0,0,0,0,0,0,3277448,"2023-11-17T00:00:00.000Z",330,9,"Monte Morris",0,0,0,0,0,0
"16349",4823,0,0,0,0,0,0,0,0,0,0,0,0,0,0,0,0,3277448,"2023-11-17T00:00:00.000Z",42097199,9,"Jared Rhoden",0,0,0,0,0,0
"16350",4824,0,1,4,6,1,8,3,5,3,36,2,3,10,6,2,1,3277454,"2023-11-17T00:00:00.000Z",56677850,25,"Toumani Camara",3,16,16,10,6,25.2
"16351",4825,3,0,4,9,4,20,8,4,4,40,0,0,24,4,1,1,3277454,"2023-11-17T00:00:00.000Z",182,25,"Jerami Grant",1,28,31,27,7,35.3
"16352",4826,0,0,0,0,0,0,0,0,0,0,0,0,0,0,0,0,1037686,"2023-11-06T00:00:00.000Z",165,22,"Markelle Fultz",0,0,0,0,0,0
"16353",4827,0,0,0,0,0,0,0,0,0,0,0,0,0,0,0,0,1037688,"2023-11-06T00:00:00.000Z",174,3,"Harry Giles III",0,0,0,0,0,0
"16354",4828,4,0,5,4,2,16,9,6,6,31,1,1,26,6,0,5,1037690,"2023-11-06T00:00:00.000Z",666423,20,"RJ Barrett",0,32,36,30,10,34.2
"16355",4829,3,0,8,8,3,21,9,6,6,37,2,3,27,10,0,6,1037690,"2023-11-06T00:00:00.000Z",387,20,"Julius Randle",0,37,40,30,13,37.5
"16356",4830,0,0,6,0,0,10,6,1,1,35,9,2,13,15,4,0,1037690,"2023-11-06T00:00:00.000Z",399,20,"Mitchell Robinson",4,28,28,13,15,43
"16357",4831,0,0,0,0,0,0,0,0,0,0,0,0,0,0,0,0,1037686,"2023-11-06T00:00:00.000Z",257,7,"Maxi Kleber",0,0,0,0,0,0
"16358",4832,6,0,5,3,2,9,6,3,3,21,0,0,17,5,0,0,1037684,"2023-11-06T00:00:00.000Z",367,10,"Chris Paul",0,22,28,23,11,32
"16359",4833,2,0,1,2,0,6,2,0,0,19,1,0,4,2,3,0,1037684,"2023-11-06T00:00:00.000Z",17553992,10,"Moses Moody",3,6,8,6,4,18.4
"16360",4834,0,0,0,0,0,0,0,0,0,1,0,0,0,0,0,0,1037684,"2023-11-06T00:00:00.000Z",56677858,10,"Brandin Podziemski",0,0,0,0,0,0
"16361",4835,0,0,0,0,0,0,0,0,0,0,0,0,0,0,0,0,1037684,"2023-11-06T00:00:00.000Z",17896070,10,"Usman Garuba",0,0,0,0,0,0
"16362",4836,0,0,0,0,0,0,0,0,0,0,0,0,0,0,0,0,1037684,"2023-11-06T00:00:00.000Z",45658838,10,"Lester Quinones",0,0,0,0,0,0
"16363",4837,0,0,0,0,0,0,0,0,0,0,0,0,0,0,0,0,1037684,"2023-11-06T00:00:00.000Z",398,10,"Jerome Robinson",0,0,0,0,0,0
"16364",4838,0,0,0,0,0,0,0,0,0,0,0,0,0,0,0,0,1037686,"2023-11-06T00:00:00.000Z",17554004,7,"AJ Lawson",0,0,0,0,0,0
"16365",4839,3,2,7,5,2,10,6,5,5,32,2,1,19,9,0,2,1037694,"2023-11-06T00:00:00.000Z",666541,21,"Luguentz Dort",2,28,31,22,12,38.3
"16366",4840,2,1,3,5,2,13,8,3,3,36,0,5,21,3,0,2,1037694,"2023-11-06T00:00:00.000Z",38017703,21,"Jalen Williams",1,24,26,23,5,28.6
"16367",4841,6,0,1,3,1,12,2,2,2,35,2,1,7,3,3,4,1037690,"2023-11-06T00:00:00.000Z",73,20,"Jalen Brunson",3,10,16,13,9,24.6
"16368",4842,0,0,1,4,1,4,1,0,0,21,0,1,3,1,1,1,1037690,"2023-11-06T00:00:00.000Z",17895858,20,"Quentin Grimes",1,4,4,3,1,6.2
"16369",4843,1,1,4,5,3,6,4,2,1,16,2,1,12,6,1,1,1037690,"2023-11-06T00:00:00.000Z",131,20,"Donte DiVincenzo",2,18,19,13,7,25.7
"16370",4844,0,0,0,0,0,0,0,0,0,0,0,0,0,0,0,0,1037690,"2023-11-06T00:00:00.000Z",19,20,"Ryan Arcidiacono",0,0,0,0,0,0
"16371",4845,0,0,0,0,0,0,0,0,0,0,0,0,0,0,0,0,1037690,"2023-11-06T00:00:00.000Z",160,20,"Evan Fournier",0,0,0,0,0,0
"16372",4846,3,3,9,3,1,14,4,7,7,34,3,3,16,12,1,1,1037694,"2023-11-06T00:00:00.000Z",38017685,21,"Chet Holmgren",4,28,31,19,15,45.9
"16373",4847,4,0,4,0,0,13,4,0,0,27,3,3,8,7,0,4,1037694,"2023-11-06T00:00:00.000Z",17896065,21,"Josh Giddey",0,15,19,12,11,18.4
"16374",4848,6,0,7,7,3,20,11,6,5,37,1,5,30,8,1,2,1037694,"2023-11-06T00:00:00.000Z",175,21,"Shai Gilgeous-Alexander",1,38,44,36,14,49.6
"16375",4849,3,0,3,8,4,8,4,0,0,20,0,1,12,3,0,0,1037694,"2023-11-06T00:00:00.000Z",3547272,21,"Isaiah Joe",0,15,18,15,6,20.1
"16376",4850,0,0,1,2,1,4,1,0,0,10,1,0,3,2,0,1,1037694,"2023-11-06T00:00:00.000Z",38017716,21,"Ousmane Dieng",0,5,5,3,2,4.4
"16377",4851,0,0,1,8,4,18,8,1,1,25,1,3,21,2,1,0,1038117,"2024-01-10T00:00:00.000Z",17553992,10,"Moses Moody",1,23,23,21,2,26.4
"16378",4852,2,0,2,3,1,8,2,0,0,23,0,2,5,2,0,1,1038117,"2024-01-10T00:00:00.000Z",475,10,"Andrew Wiggins",0,7,9,7,4,9.4
"16379",4853,1,0,0,3,1,4,1,0,0,8,1,0,3,1,0,0,1038117,"2024-01-10T00:00:00.000Z",45658838,10,"Lester Quinones",0,4,5,4,2,5.7
"16380",4854,0,0,0,0,0,0,0,0,0,0,0,0,0,0,0,0,1038117,"2024-01-10T00:00:00.000Z",185,10,"Draymond Green",0,0,0,0,0,0
"16381",4855,8,1,3,7,2,13,5,2,2,26,0,0,14,3,2,0,1038117,"2024-01-10T00:00:00.000Z",303,19,"CJ McCollum",3,17,25,22,11,38.6
"16382",4856,1,0,4,5,2,12,6,2,2,33,1,1,16,5,2,1,1038115,"2024-01-10T00:00:00.000Z",56677831,11,"Cam Whitmore",2,21,22,17,6,28.5
"16383",4857,3,0,2,3,0,7,3,0,0,14,0,2,6,2,1,2,1038115,"2024-01-10T00:00:00.000Z",56677825,11,"Amen Thompson",1,8,11,9,5,13.9
"16384",4858,0,0,0,0,0,0,0,0,0,0,0,0,0,0,0,0,1038115,"2024-01-10T00:00:00.000Z",66,11,"Dillon Brooks",0,0,0,0,0,0
"16385",4859,0,0,0,0,0,0,0,0,0,0,0,0,0,0,0,0,1038115,"2024-01-10T00:00:00.000Z",38017695,11,"Tari Eason",0,0,0,0,0,0
"16386",4860,0,0,0,0,0,0,0,0,0,0,0,0,0,0,0,0,1038115,"2024-01-10T00:00:00.000Z",3547281,11,"Nate Hinton",0,0,0,0,0,0
"16387",4861,0,0,0,0,0,0,0,0,0,0,0,0,0,0,0,0,1038115,"2024-01-10T00:00:00.000Z",357,11,"Victor Oladipo",0,0,0,0,0,0
"16388",4862,0,0,0,0,0,0,0,0,0,0,0,0,0,0,0,0,1038115,"2024-01-10T00:00:00.000Z",56677809,11,"Jermaine Samuels Jr.",0,0,0,0,0,0
"16389",4863,0,0,0,0,0,0,0,0,0,0,0,0,0,0,0,0,1038115,"2024-01-10T00:00:00.000Z",47738533,11,"Jeenathan Williams",0,0,0,0,0,0
"16390",4864,2,0,7,2,1,6,3,2,2,20,0,0,9,7,1,2,1038114,"2024-01-10T00:00:00.000Z",17896065,21,"Josh Giddey",1,16,18,11,9,21.4
"16391",4865,8,1,2,5,2,17,11,5,4,34,0,3,28,2,1,3,1038114,"2024-01-10T00:00:00.000Z",175,21,"Shai Gilgeous-Alexander",2,30,38,36,10,45.4
"16392",4866,4,2,4,7,4,7,4,0,0,23,1,1,12,5,1,1,1038117,"2024-01-10T00:00:00.000Z",17896024,19,"Herbert Jones",3,17,21,16,9,32
"16393",4867,6,1,1,11,4,13,6,0,0,24,3,2,16,4,0,0,1038117,"2024-01-10T00:00:00.000Z",18677986,19,"Trey Murphy III",1,20,26,22,10,32.8
"16394",4868,3,0,3,2,1,4,3,2,1,23,0,2,8,3,1,1,1038117,"2024-01-10T00:00:00.000Z",38017677,19,"Dyson Daniels",1,11,14,11,6,18.1
"16395",4869,1,1,4,1,1,1,1,4,3,19,1,0,6,5,2,1,1038117,"2024-01-10T00:00:00.000Z",340,19,"Larry Nance Jr.",3,11,12,7,6,21.5
"16396",4870,2,0,1,5,4,9,5,0,0,21,0,1,14,1,0,0,1038117,"2024-01-10T00:00:00.000Z",56677837,19,"Jordan Hawkins",0,15,17,16,3,18.2
"16397",4871,2,0,3,0,0,6,5,2,2,13,0,1,12,3,1,1,1038117,"2024-01-10T00:00:00.000Z",3547293,19,"Naji Marshall",1,15,17,14,5,20.6
"16398",4872,1,0,1,0,0,3,3,0,0,8,2,2,6,3,0,1,1038117,"2024-01-10T00:00:00.000Z",491,19,"Cody Zeller",0,9,10,7,4,10.1
"16399",4873,0,1,1,0,0,0,0,0,0,6,0,0,0,1,0,0,1038117,"2024-01-10T00:00:00.000Z",17896021,19,"Jeremiah Robinson-Earl",1,1,1,0,1,4.2
"16400",4874,0,0,0,1,0,1,0,0,0,3,0,0,0,0,0,0,1038117,"2024-01-10T00:00:00.000Z",38017663,19,"E.J. Liddell",0,0,0,0,0,0
"16401",4875,0,0,0,0,0,0,0,0,0,0,0,0,0,0,0,0,1038117,"2024-01-10T00:00:00.000Z",17896097,19,"Jose Alvarado",0,0,0,0,0,0
"16402",4876,0,1,4,4,1,7,2,2,2,18,0,1,7,4,0,3,1038004,"2023-12-26T00:00:00.000Z",101,29,"John Collins",1,11,11,7,4,11.8
"16403",4877,0,0,0,0,0,2,2,0,0,8,1,2,4,1,0,0,1038000,"2023-12-26T00:00:00.000Z",17896116,5,"Terry Taylor",0,5,5,4,1,5.2
"16404",4878,0,0,0,1,0,1,0,0,0,7,0,1,0,0,0,1,1038000,"2023-12-26T00:00:00.000Z",38017719,5,"Dalen Terry",0,0,0,0,0,-1
"16405",4879,0,0,0,0,0,0,0,0,0,0,0,0,0,0,0,0,1038000,"2023-12-26T00:00:00.000Z",56677857,5,"Julian Phillips",0,0,0,0,0,0
"16406",4880,0,0,0,0,0,0,0,0,0,0,0,0,0,0,0,0,1038000,"2023-12-26T00:00:00.000Z",56677860,5,"Adama Sanogo",0,0,0,0,0,0
"16407",4881,0,0,0,0,0,0,0,0,0,0,0,0,0,0,0,0,1038000,"2023-12-26T00:00:00.000Z",27,5,"Lonzo Ball",0,0,0,0,0,0
"16408",4882,0,0,0,0,0,0,0,0,0,0,0,0,0,0,0,0,1038000,"2023-12-26T00:00:00.000Z",56677874,5,"Onuralp Bitim",0,0,0,0,0,0
"16409",4884,0,0,0,0,0,0,0,0,0,0,0,0,0,0,0,0,1038000,"2023-12-26T00:00:00.000Z",268,5,"Zach LaVine",0,0,0,0,0,0
"16410",4885,0,0,0,0,0,0,0,0,0,0,0,0,0,0,0,0,1038000,"2023-12-26T00:00:00.000Z",460,5,"Nikola Vucevic",0,0,0,0,0,0
"16411",4886,3,3,6,4,1,4,1,4,3,27,2,0,6,8,1,2,1038002,"2023-12-26T00:00:00.000Z",38017731,15,"Vince Williams Jr.",4,14,17,9,11,30.1
"16412",4887,1,1,1,2,0,2,0,2,2,12,0,1,2,1,1,2,1038002,"2023-12-26T00:00:00.000Z",17896027,15,"Ziaire Williams",2,3,4,3,2,8.7
"16413",4888,0,5,5,1,0,3,1,0,0,28,3,1,2,8,1,0,1038002,"2023-12-26T00:00:00.000Z",3547285,15,"Xavier Tillman",6,10,10,2,8,29.6
"16414",4889,1,0,3,5,2,7,3,0,0,16,1,0,8,4,0,0,1038002,"2023-12-26T00:00:00.000Z",38017729,15,"David Roddy",0,12,13,9,5,14.3
"16415",4890,0,0,0,0,0,0,0,0,0,0,0,0,0,0,0,0,1038002,"2023-12-26T00:00:00.000Z",666703,15,"John Konchar",0,0,0,0,0,0
"16416",4891,0,0,0,0,0,0,0,0,0,0,0,0,0,0,0,0,1038002,"2023-12-26T00:00:00.000Z",3,15,"Steven Adams",0,0,0,0,0,0
"16417",4892,0,0,0,0,0,0,0,0,0,0,0,0,0,0,0,0,1038002,"2023-12-26T00:00:00.000Z",666505,15,"Brandon Clarke",0,0,0,0,0,0
"16418",4893,0,0,2,0,0,5,3,1,1,12,2,1,7,4,2,1,1038001,"2023-12-26T00:00:00.000Z",56677825,11,"Amen Thompson",2,11,11,7,4,16.8
"16419",4894,0,0,1,0,0,3,2,2,1,14,0,1,5,1,1,0,1038001,"2023-12-26T00:00:00.000Z",3547301,11,"Jae'Sean Tate",1,6,6,5,1,9.2
"16420",4895,1,0,3,6,3,10,6,0,0,25,0,1,15,3,1,1,1038001,"2023-12-26T00:00:00.000Z",213,11,"Aaron Holiday",1,18,19,16,4,22.1
"16421",4896,0,0,0,0,0,0,0,0,0,0,0,0,0,0,0,0,1038001,"2023-12-26T00:00:00.000Z",19465326,11,"Jock Landale",0,0,0,0,0,0
"16422",4897,0,0,0,0,0,0,0,0,0,0,0,0,0,0,0,0,1037998,"2023-12-26T00:00:00.000Z",56677843,3,"Noah Clowney",0,0,0,0,0,0
"16423",4898,0,0,0,0,0,0,0,0,0,0,0,0,0,0,0,0,1038001,"2023-12-26T00:00:00.000Z",296,11,"Boban Marjanovic",0,0,0,0,0,0
"16424",4899,0,0,0,0,0,0,0,0,0,0,0,0,0,0,0,0,1038001,"2023-12-26T00:00:00.000Z",56677831,11,"Cam Whitmore",0,0,0,0,0,0
"16425",4900,0,0,0,0,0,0,0,0,0,0,0,0,0,0,0,0,1038001,"2023-12-26T00:00:00.000Z",357,11,"Victor Oladipo",0,0,0,0,0,0
"16426",4901,0,0,0,0,0,0,0,0,0,0,0,0,0,0,0,0,1037891,"2023-12-11T00:00:00.000Z",191,7,"Tim Hardaway Jr.",0,0,0,0,0,0
"16427",4902,0,0,0,0,0,0,0,0,0,0,0,0,0,0,0,0,1037886,"2023-12-11T00:00:00.000Z",38017724,22,"Caleb Houstan",0,0,0,0,0,0
"16428",4903,0,0,0,0,0,0,0,0,0,0,0,0,0,0,0,0,1037886,"2023-12-11T00:00:00.000Z",56677839,22,"Jett Howard",0,0,0,0,0,0
"16429",4904,0,0,0,0,0,0,0,0,0,0,0,0,0,0,0,0,1037886,"2023-12-11T00:00:00.000Z",666818,22,"Chuma Okeke",0,0,0,0,0,0
"16430",4905,0,0,0,0,0,0,0,0,0,0,0,0,0,0,0,0,1037886,"2023-12-11T00:00:00.000Z",56677872,6,"Craig Porter",0,0,0,0,0,0
"16431",4906,10,0,2,4,2,12,6,7,6,33,0,2,20,2,4,0,1037889,"2023-12-11T00:00:00.000Z",409,28,"Dennis Schroder",4,22,32,30,12,49.4
"16432",4907,0,0,0,0,0,0,0,0,0,0,0,0,0,0,0,0,1037889,"2023-12-11T00:00:00.000Z",56677869,28,"Markquis Nowell",0,0,0,0,0,0
"16433",4908,0,0,0,0,0,0,0,0,0,0,0,0,0,0,0,0,1037889,"2023-12-11T00:00:00.000Z",2309958,28,"Jontay Porter",0,0,0,0,0,0
"16434",4909,0,0,0,0,0,0,0,0,0,0,0,0,0,0,0,0,1037889,"2023-12-11T00:00:00.000Z",376,28,"Otto Porter Jr.",0,0,0,0,0,0
"16435",4910,0,0,0,0,0,0,0,0,0,0,0,0,0,0,0,0,1037886,"2023-12-11T00:00:00.000Z",56677847,6,"Emoni Bates",0,0,0,0,0,0
"16436",4911,0,0,0,0,0,0,0,0,0,0,0,0,0,0,0,0,1037886,"2023-12-11T00:00:00.000Z",666676,6,"Ty Jerome",0,0,0,0,0,0
"16437",4912,0,0,0,0,0,0,0,0,0,0,0,0,0,0,0,0,1037886,"2023-12-11T00:00:00.000Z",277,6,"Caris LeVert",0,0,0,0,0,0
"16438",4913,0,0,0,0,0,0,0,0,0,0,0,0,0,0,0,0,1037886,"2023-12-11T00:00:00.000Z",17896076,6,"Evan Mobley",0,0,0,0,0,0
"16439",4914,0,0,0,0,0,0,0,0,0,0,0,0,0,0,0,0,1037891,"2023-12-11T00:00:00.000Z",228,7,"Kyrie Irving",0,0,0,0,0,0
"16440",4915,0,0,0,0,0,0,0,0,0,0,0,0,0,0,0,0,1037893,"2023-12-11T00:00:00.000Z",38017663,19,"E.J. Liddell",0,0,0,0,0,0
"16441",4916,0,0,0,0,0,0,0,0,0,0,0,0,0,0,0,0,1037893,"2023-12-11T00:00:00.000Z",340,19,"Larry Nance Jr.",0,0,0,0,0,0
"16442",4917,0,0,0,0,0,0,0,0,0,0,0,0,0,0,0,0,1037893,"2023-12-11T00:00:00.000Z",17896017,19,"Matt Ryan",0,0,0,0,0,0
"16443",4918,0,0,0,0,0,0,0,0,0,0,0,0,0,0,0,0,1037893,"2023-12-11T00:00:00.000Z",38017726,19,"Dereon Seabron",0,0,0,0,0,0
"16444",4919,5,1,1,4,1,7,2,2,2,24,0,4,7,1,1,4,1037893,"2023-12-11T00:00:00.000Z",666400,18,"Nickeil Alexander-Walker",2,8,13,12,6,17.7
"16445",4920,1,0,9,3,1,11,5,7,6,33,3,6,17,12,0,1,1037893,"2023-12-11T00:00:00.000Z",447,18,"Karl-Anthony Towns",0,29,30,18,13,31.9
"16446",4921,0,2,6,0,0,8,4,0,0,25,2,4,8,8,0,1,1037893,"2023-12-11T00:00:00.000Z",176,18,"Rudy Gobert",2,16,16,8,8,22.6
"16447",4922,0,0,0,0,0,0,0,0,0,0,0,0,0,0,0,0,1037892,"2023-12-11T00:00:00.000Z",27,5,"Lonzo Ball",0,0,0,0,0,0
"16448",4923,0,0,0,0,0,0,0,0,0,0,0,0,0,0,0,0,1037892,"2023-12-11T00:00:00.000Z",56677874,5,"Onuralp Bitim",0,0,0,0,0,0
"16449",4924,0,0,0,0,0,0,0,0,0,0,0,0,0,0,0,0,1037892,"2023-12-11T00:00:00.000Z",268,5,"Zach LaVine",0,0,0,0,0,0
"16450",4925,0,0,0,0,0,0,0,0,0,0,0,0,0,0,0,0,1037892,"2023-12-11T00:00:00.000Z",45969255,5,"Justin Lewis",0,0,0,0,0,0
"16451",4926,0,0,0,0,0,0,0,0,0,0,0,0,0,0,0,0,1037812,"2023-11-22T00:00:00.000Z",56677868,14,"D'Moi Hodge",0,0,0,0,0,0
"16452",4927,4,0,4,3,2,9,6,5,3,22,2,4,17,6,2,1,1037810,"2023-11-22T00:00:00.000Z",407,10,"Dario Saric",2,23,27,21,10,35.2
"16453",4928,2,0,1,1,0,7,3,2,1,21,0,5,7,1,1,0,1037810,"2023-11-22T00:00:00.000Z",17553979,10,"Jonathan Kuminga",1,8,10,9,3,14.2
"16454",4929,2,0,2,3,1,9,4,2,1,23,2,1,10,4,3,0,1037810,"2023-11-22T00:00:00.000Z",56677858,10,"Brandin Podziemski",3,14,16,12,6,26.8
"16455",4930,0,0,2,0,0,3,2,5,2,15,2,3,6,4,1,1,1037810,"2023-11-22T00:00:00.000Z",56677799,10,"Trayce Jackson-Davis",1,10,10,6,4,12.8
"16456",4931,4,0,0,2,0,3,1,2,1,16,0,3,3,0,2,1,1037810,"2023-11-22T00:00:00.000Z",251,10,"Cory Joseph",2,3,7,7,4,14
"16457",4932,0,0,1,0,0,1,1,0,0,8,0,2,2,1,0,2,1037810,"2023-11-22T00:00:00.000Z",57875092,10,"Gui Santos",0,3,3,2,1,1.2
"16458",4933,0,0,0,0,0,0,0,0,0,0,0,0,0,0,0,0,1037810,"2023-11-22T00:00:00.000Z",185,10,"Draymond Green",0,0,0,0,0,0
"16459",4934,0,0,0,0,0,0,0,0,0,0,0,0,0,0,0,0,1037810,"2023-11-22T00:00:00.000Z",17896070,10,"Usman Garuba",0,0,0,0,0,0
"16460",4935,0,0,0,0,0,0,0,0,0,0,0,0,0,0,0,0,1037810,"2023-11-22T00:00:00.000Z",2189,10,"Gary Payton II",0,0,0,0,0,0
"16461",4936,0,0,0,0,0,0,0,0,0,0,0,0,0,0,0,0,1037810,"2023-11-22T00:00:00.000Z",45658838,10,"Lester Quinones",0,0,0,0,0,0
"16462",4937,0,0,0,0,0,0,0,2,0,5,0,2,0,0,0,0,3277498,"2023-11-24T00:00:00.000Z",666468,2,"Oshae Brissett",0,0,0,0,0,0
"16463",4938,0,0,0,0,0,1,0,0,0,1,0,0,0,0,0,0,3277498,"2023-11-24T00:00:00.000Z",17896094,2,"Dalano Banton",0,0,0,0,0,0
"16464",4939,0,0,0,0,0,0,0,0,0,0,0,0,0,0,0,0,3277498,"2023-11-24T00:00:00.000Z",338,2,"Svi Mykhailiuk",0,0,0,0,0,0
"16465",4940,2,0,4,1,1,3,2,0,0,21,1,1,5,5,0,2,3277498,"2023-11-24T00:00:00.000Z",226,22,"Joe Ingles",0,10,12,7,7,12
"16466",4941,0,0,4,1,0,2,1,4,3,16,3,3,5,7,0,0,3277498,"2023-11-24T00:00:00.000Z",229,22,"Jonathan Isaac",0,12,12,5,7,13.4
"16467",4942,0,0,1,3,1,13,9,9,8,24,2,5,27,3,0,1,3277498,"2023-11-24T00:00:00.000Z",462,22,"Moritz Wagner",0,30,30,27,3,29.6
"16468",4943,0,0,1,0,0,0,0,0,0,9,1,0,0,2,1,0,3277498,"2023-11-24T00:00:00.000Z",38017724,22,"Caleb Houstan",1,2,2,0,2,5.4
"16469",4944,0,0,0,0,0,0,0,0,0,0,0,0,0,0,0,0,3277498,"2023-11-24T00:00:00.000Z",56677839,22,"Jett Howard",0,0,0,0,0,0
"16470",4945,0,0,0,0,0,0,0,0,0,0,0,0,0,0,0,0,3277498,"2023-11-24T00:00:00.000Z",666818,22,"Chuma Okeke",0,0,0,0,0,0
"16471",4946,0,0,0,0,0,0,0,0,0,0,0,0,0,0,0,0,3277498,"2023-11-24T00:00:00.000Z",666885,22,"Admiral Schofield",0,0,0,0,0,0
"16472",4947,0,0,0,0,0,0,0,0,0,0,0,0,0,0,0,0,3277498,"2023-11-24T00:00:00.000Z",85,22,"Wendell Carter Jr.",0,0,0,0,0,0
"16473",4948,0,0,0,0,0,0,0,0,0,0,0,0,0,0,0,0,3277498,"2023-11-24T00:00:00.000Z",165,22,"Markelle Fultz",0,0,0,0,0,0
"16474",4949,0,0,0,0,0,0,0,0,0,0,0,0,0,0,0,0,3277498,"2023-11-24T00:00:00.000Z",38017607,22,"Kevon Harris",0,0,0,0,0,0
"16475",4950,0,0,0,0,0,0,0,0,0,0,0,0,0,0,0,0,3277498,"2023-11-24T00:00:00.000Z",17553983,22,"Trevelin Queen",0,0,0,0,0,0
"16476",4951,3,0,6,6,5,15,11,4,1,22,1,3,28,7,1,1,1037702,"2023-11-08T00:00:00.000Z",17895966,11,"Jalen Green",1,35,38,31,10,42.9
"16477",4952,2,0,2,0,0,0,0,2,1,13,0,2,1,2,1,2,1037706,"2023-11-08T00:00:00.000Z",444,6,"Tristan Thompson",1,3,5,3,4,7.4
"16478",4953,0,0,0,0,0,0,0,0,0,0,0,0,0,0,0,0,1037706,"2023-11-08T00:00:00.000Z",3547247,6,"Isaac Okoro",0,0,0,0,0,0
"16479",4954,0,0,0,0,0,0,0,0,0,0,0,0,0,0,0,0,1037706,"2023-11-08T00:00:00.000Z",56677872,6,"Craig Porter",0,0,0,0,0,0
"16480",4955,0,0,3,0,0,5,4,2,1,11,3,3,9,6,0,1,1037702,"2023-11-08T00:00:00.000Z",188,11,"Jeff Green",0,15,15,9,6,15.2
"16481",4956,3,0,2,2,1,6,3,0,0,23,0,3,7,2,0,0,1037702,"2023-11-08T00:00:00.000Z",213,11,"Aaron Holiday",0,9,12,10,5,13.9
"16482",4957,1,1,0,6,2,10,6,0,0,27,1,3,14,1,0,0,1037702,"2023-11-08T00:00:00.000Z",3547301,11,"Jae'Sean Tate",1,15,16,15,2,19.7
"16483",4958,0,1,2,1,0,3,1,0,0,12,1,0,2,3,0,1,1037702,"2023-11-08T00:00:00.000Z",19465326,11,"Jock Landale",1,5,5,2,3,7.6
"16484",4959,1,0,0,1,0,4,2,2,1,8,0,0,5,0,1,0,1037702,"2023-11-08T00:00:00.000Z",47738533,11,"Jeenathan Williams",1,5,6,6,1,9.5
"16485",4960,0,0,5,0,0,4,3,1,0,6,2,1,6,7,0,0,1037702,"2023-11-08T00:00:00.000Z",296,11,"Boban Marjanovic",0,13,13,6,7,14.4
"16486",4961,0,0,0,0,0,0,0,0,0,0,0,0,0,0,0,0,1037702,"2023-11-08T00:00:00.000Z",3547281,11,"Nate Hinton",0,0,0,0,0,0
"16487",4962,0,0,0,0,0,0,0,0,0,0,0,0,0,0,0,0,1037702,"2023-11-08T00:00:00.000Z",357,11,"Victor Oladipo",0,0,0,0,0,0
"16488",4963,0,0,0,0,0,0,0,0,0,0,0,0,0,0,0,0,1037702,"2023-11-08T00:00:00.000Z",56677809,11,"Jermaine Samuels Jr.",0,0,0,0,0,0
"16489",4964,0,0,0,0,0,0,0,0,0,0,0,0,0,0,0,0,1037702,"2023-11-08T00:00:00.000Z",56677825,11,"Amen Thompson",0,0,0,0,0,0
"16490",4965,2,0,0,0,0,3,1,0,0,14,2,5,2,2,0,0,1037702,"2023-11-08T00:00:00.000Z",56677738,14,"Colin Castleton",0,4,6,4,4,7.4
"16491",4966,0,0,0,0,0,0,0,0,0,0,0,0,0,0,0,0,1037702,"2023-11-08T00:00:00.000Z",117,14,"Anthony Davis",0,0,0,0,0,0
"16492",4967,0,0,0,0,0,0,0,0,0,0,0,0,0,0,0,0,1037699,"2023-11-08T00:00:00.000Z",666679,3,"Cameron Johnson",0,0,0,0,0,0
"16493",4968,0,0,0,0,0,0,0,0,0,0,0,0,0,0,0,0,1037699,"2023-11-08T00:00:00.000Z",17896041,3,"Keon Johnson",0,0,0,0,0,0
"16494",4969,0,0,0,0,0,0,0,0,0,0,0,0,0,0,0,0,1037699,"2023-11-08T00:00:00.000Z",417,3,"Ben Simmons",0,0,0,0,0,0
"16495",4970,3,1,3,1,0,3,1,1,1,21,3,3,3,6,1,0,1037699,"2023-11-08T00:00:00.000Z",450,13,"PJ Tucker",2,9,12,6,9,20.7
"16496",4971,0,0,1,2,0,6,2,0,0,6,1,0,4,2,0,1,1037699,"2023-11-08T00:00:00.000Z",17896031,13,"Nah'Shon Hyland",0,6,6,4,2,5.4
"16497",4972,1,0,4,2,0,2,0,0,0,19,0,1,0,4,0,2,1037699,"2023-11-08T00:00:00.000Z",666743,13,"Terance Mann",0,4,5,1,5,4.3
"16498",4973,1,2,1,5,2,8,4,0,0,23,0,2,10,1,3,1,1037699,"2023-11-08T00:00:00.000Z",380,13,"Norman Powell",5,11,12,11,2,26.7
"16499",4974,0,0,0,0,0,0,0,0,0,0,0,0,0,0,0,0,1037699,"2023-11-08T00:00:00.000Z",17896022,13,"Brandon Boston Jr.",0,0,0,0,0,0
"16500",4975,0,0,0,0,0,0,0,0,0,0,0,0,0,0,0,0,1037699,"2023-11-08T00:00:00.000Z",56677856,13,"Jordan Miller",0,0,0,0,0,0
"16501",4976,0,0,0,1,1,2,1,0,0,4,0,0,3,0,0,0,1037596,"2023-10-25T00:00:00.000Z",18677954,30,"Jared Butler",0,3,3,3,0,3
"16502",4977,0,0,0,0,0,0,0,0,0,0,0,0,0,0,0,0,1037596,"2023-10-25T00:00:00.000Z",38124126,30,"John Butler Jr.",0,0,0,0,0,0
"16503",4978,0,0,0,0,0,0,0,0,0,0,0,0,0,0,0,0,1037596,"2023-10-25T00:00:00.000Z",38017687,30,"Johnny Davis",0,0,0,0,0,0
"16504",4979,0,0,0,0,0,0,0,0,0,0,0,0,0,0,0,0,1037596,"2023-10-25T00:00:00.000Z",3547302,30,"Anthony Gill",0,0,0,0,0,0
"16505",4980,0,0,0,0,0,0,0,0,0,0,0,0,0,0,0,0,1037596,"2023-10-25T00:00:00.000Z",414,30,"Landry Shamet",0,0,0,0,0,0
"16506",4981,0,0,0,0,0,0,0,0,0,0,0,0,0,0,0,0,1037601,"2023-10-25T00:00:00.000Z",58,28,"Chris Boucher",0,0,0,0,0,0
"16507",4982,1,0,2,1,0,2,0,0,0,4,0,0,0,2,0,0,1037602,"2023-10-25T00:00:00.000Z",38017719,5,"Dalen Terry",0,2,3,1,3,3.9
"16508",4983,0,0,0,0,0,0,0,0,0,0,0,0,0,0,0,0,1037602,"2023-10-25T00:00:00.000Z",27,5,"Lonzo Ball",0,0,0,0,0,0
"16509",4984,0,0,0,0,0,0,0,0,0,0,0,0,0,0,0,0,1037602,"2023-10-25T00:00:00.000Z",56677874,5,"Onuralp Bitim",0,0,0,0,0,0
"16510",4985,0,0,0,0,0,0,0,0,0,0,0,0,0,0,0,0,1037602,"2023-10-25T00:00:00.000Z",45969255,5,"Justin Lewis",0,0,0,0,0,0
"16511",4986,0,0,0,0,0,0,0,0,0,0,0,0,0,0,0,0,1037602,"2023-10-25T00:00:00.000Z",56677860,5,"Adama Sanogo",0,0,0,0,0,0
"16512",4987,2,1,7,5,2,8,3,0,0,32,0,1,8,7,2,2,1037602,"2023-10-25T00:00:00.000Z",666541,21,"Luguentz Dort",3,15,17,10,9,26.4
"16513",4988,5,0,3,6,2,11,5,4,4,32,0,3,16,3,1,2,1037602,"2023-10-25T00:00:00.000Z",38017703,21,"Jalen Williams",1,19,24,21,8,28.1
"16514",4989,3,0,4,3,2,7,4,3,1,25,0,3,11,4,1,1,1037602,"2023-10-25T00:00:00.000Z",38017685,21,"Chet Holmgren",1,15,18,14,7,22.3
"16515",4990,6,0,5,3,2,14,7,0,0,32,1,1,16,6,0,3,1037602,"2023-10-25T00:00:00.000Z",17896065,21,"Josh Giddey",0,22,28,22,12,29.2
"16516",4991,0,0,0,0,0,0,0,0,0,0,0,0,0,0,0,0,1037595,"2023-10-25T00:00:00.000Z",62,4,"Miles Bridges",0,0,0,0,0,0
"16517",4992,0,0,0,0,0,0,0,0,0,0,0,0,0,0,0,0,1037595,"2023-10-25T00:00:00.000Z",666748,4,"Cody Martin",0,0,0,0,0,0
"16518",4993,0,0,0,0,0,0,0,0,0,0,0,0,0,0,0,0,1037595,"2023-10-25T00:00:00.000Z",38017708,4,"Bryce McGowens",0,0,0,0,0,0
"16519",4994,0,0,0,0,0,0,0,0,0,0,0,0,0,0,0,0,1037595,"2023-10-25T00:00:00.000Z",347,4,"Frank Ntilikina",0,0,0,0,0,0
"16520",4995,0,0,0,0,0,0,0,0,0,0,0,0,0,0,0,0,1037595,"2023-10-25T00:00:00.000Z",422,4,"Ish Smith",0,0,0,0,0,0
"16521",4996,1,0,2,4,1,9,4,1,0,31,2,6,9,4,0,0,1037595,"2023-10-25T00:00:00.000Z",666656,1,"De'Andre Hunter",0,13,14,10,5,15.3
"16522",4997,0,0,2,4,1,12,6,2,2,29,3,1,15,5,5,2,1037595,"2023-10-25T00:00:00.000Z",3547256,1,"Saddiq Bey",5,20,20,15,5,34
"16523",4998,0,0,7,0,0,10,6,4,3,29,6,1,15,13,1,2,1037595,"2023-10-25T00:00:00.000Z",83,1,"Clint Capela",1,28,28,15,13,31.6
"16524",4999,6,0,2,3,0,14,3,6,5,33,0,0,11,2,0,1,1037595,"2023-10-25T00:00:00.000Z",334,1,"Dejounte Murray",0,13,19,17,8,21.4
"16525",5000,1,0,3,2,0,8,3,4,4,24,1,0,10,4,0,1,1037601,"2023-10-25T00:00:00.000Z",667378,18,"Naz Reid",0,14,15,11,5,15.3
"16526",5001,0,0,0,0,0,0,0,0,0,0,0,0,0,0,0,0,1038063,"2024-01-03T00:00:00.000Z",3547260,19,"Kira Lewis Jr.",0,0,0,0,0,0
"16527",5002,0,0,0,0,0,0,0,0,0,0,0,0,0,0,0,0,1038063,"2024-01-03T00:00:00.000Z",17896021,19,"Jeremiah Robinson-Earl",0,0,0,0,0,0
"16528",5003,0,0,0,0,0,0,0,0,0,0,0,0,0,0,0,0,1038063,"2024-01-03T00:00:00.000Z",38017663,19,"E.J. Liddell",0,0,0,0,0,0
"16529",5004,0,0,0,0,0,0,0,0,0,0,0,0,0,0,0,0,1038063,"2024-01-03T00:00:00.000Z",18677986,19,"Trey Murphy III",0,0,0,0,0,0
"16530",5005,0,0,0,0,0,0,0,0,0,0,0,0,0,0,0,0,1038063,"2024-01-03T00:00:00.000Z",17896017,19,"Matt Ryan",0,0,0,0,0,0
"16531",5006,0,0,0,0,0,0,0,0,0,0,0,0,0,0,0,0,1038063,"2024-01-03T00:00:00.000Z",38017726,19,"Dereon Seabron",0,0,0,0,0,0
"16532",5007,0,0,2,2,0,4,1,0,0,14,0,4,2,2,1,0,1038063,"2024-01-03T00:00:00.000Z",3547293,19,"Naji Marshall",1,4,4,2,2,7.4
"16533",5008,2,1,6,0,0,6,4,0,0,22,3,1,8,9,1,0,1038063,"2024-01-03T00:00:00.000Z",340,19,"Larry Nance Jr.",2,17,19,10,11,27.8
"16534",5009,1,0,0,0,0,0,0,0,0,2,1,0,0,1,0,0,1038063,"2024-01-03T00:00:00.000Z",491,19,"Cody Zeller",0,1,2,1,2,2.7
"16535",5010,1,2,0,0,0,3,2,2,1,23,0,2,5,0,2,1,1038064,"2024-01-03T00:00:00.000Z",247,7,"Derrick Jones Jr.",4,5,6,6,1,17.5
"16536",5011,4,3,3,0,0,1,0,0,0,19,1,1,0,4,2,0,1038064,"2024-01-03T00:00:00.000Z",56677840,7,"Dereck Lively II",5,4,8,4,8,25.8
"16537",5012,5,0,8,8,4,19,10,6,5,29,1,0,29,9,2,1,1038064,"2024-01-03T00:00:00.000Z",228,7,"Kyrie Irving",2,38,43,34,14,52.3
"16538",5013,5,0,6,7,4,21,13,14,11,31,0,1,41,6,1,4,1038064,"2024-01-03T00:00:00.000Z",132,7,"Luka Doncic",1,47,52,46,11,54.7
"16539",5014,0,0,3,5,2,10,5,2,2,23,0,2,14,3,0,0,1038064,"2024-01-03T00:00:00.000Z",191,7,"Tim Hardaway Jr.",0,17,17,14,3,17.6
"16540",5015,2,0,1,0,0,1,0,0,0,15,0,0,0,1,0,0,1038064,"2024-01-03T00:00:00.000Z",114,7,"Seth Curry",0,1,3,2,3,4.2
"16541",5016,2,0,2,0,0,1,1,6,3,13,1,2,5,3,0,1,1038064,"2024-01-03T00:00:00.000Z",379,7,"Dwight Powell",0,8,10,7,5,10.6
"16542",5017,2,0,1,0,0,2,1,0,0,15,1,2,2,2,0,3,1038064,"2024-01-03T00:00:00.000Z",666965,7,"Grant Williams",0,4,6,4,4,4.4
"16543",5018,1,1,3,1,1,3,1,0,0,12,0,2,3,3,0,1,1038064,"2024-01-03T00:00:00.000Z",329,7,"Markieff Morris",1,6,7,4,4,10.1
"16544",5019,1,1,2,6,1,10,4,3,2,11,0,0,11,2,0,0,1038064,"2024-01-03T00:00:00.000Z",38017679,7,"Jaden Hardy",1,13,14,12,3,17.9
"16545",5020,0,0,0,1,1,4,1,0,0,8,0,1,3,0,1,0,1038064,"2024-01-03T00:00:00.000Z",17554004,7,"AJ Lawson",1,3,3,3,0,6
"16546",5021,1,1,3,0,0,3,1,4,3,8,2,1,5,5,0,0,1038064,"2024-01-03T00:00:00.000Z",56677859,7,"Olivier-Maxence Prosper",1,10,11,6,6,15.5
"16547",5022,0,0,1,0,0,1,0,2,0,6,1,0,0,2,1,0,1038064,"2024-01-03T00:00:00.000Z",24489167,7,"Brandon Williams",1,2,2,0,2,5.4
"16548",5023,0,0,0,0,0,0,0,0,0,0,0,0,0,0,0,0,1038064,"2024-01-03T00:00:00.000Z",17896028,7,"Greg Brown III",0,0,0,0,0,0
"16549",5024,2,0,2,3,0,6,2,1,1,17,0,1,5,2,0,0,1038064,"2024-01-03T00:00:00.000Z",65,25,"Malcolm Brogdon",0,7,9,7,4,10.4
"16550",5025,0,0,0,0,0,0,0,0,0,0,0,0,0,0,0,0,1038062,"2024-01-03T00:00:00.000Z",401,15,"Derrick Rose",0,0,0,0,0,0
"16551",5026,0,0,0,0,0,0,0,0,0,0,0,0,0,0,0,0,1037961,"2023-12-20T00:00:00.000Z",376,28,"Otto Porter Jr.",0,0,0,0,0,0
"16552",5027,0,0,0,0,0,0,0,0,0,0,0,0,0,0,0,0,1037961,"2023-12-20T00:00:00.000Z",436,28,"Garrett Temple",0,0,0,0,0,0
"16553",5028,0,0,0,0,0,0,0,0,0,0,0,0,0,0,0,0,1037961,"2023-12-20T00:00:00.000Z",489,28,"Thaddeus Young",0,0,0,0,0,0
"16554",5029,0,0,0,0,0,0,0,0,0,0,0,0,0,0,0,0,1037961,"2023-12-20T00:00:00.000Z",56677805,28,"Javon Freeman-Liberty",0,0,0,0,0,0
"16555",5030,6,3,5,10,2,11,2,0,0,28,1,2,6,6,1,2,1037960,"2023-12-20T00:00:00.000Z",351,3,"Royce O'Neale",4,12,18,12,12,32.2
"16556",5031,0,1,0,0,0,1,0,0,0,4,0,1,0,0,0,1,1037960,"2023-12-20T00:00:00.000Z",174,3,"Harry Giles III",1,0,0,0,0,2
"16557",5032,0,0,0,0,0,0,0,0,0,0,0,0,0,0,0,0,1037961,"2023-12-20T00:00:00.000Z",38017710,28,"Christian Koloko",0,0,0,0,0,0
"16558",5033,0,0,0,0,0,0,0,0,0,0,0,0,0,0,0,0,1037961,"2023-12-20T00:00:00.000Z",56677869,28,"Markquis Nowell",0,0,0,0,0,0
"16559",5034,0,0,0,0,0,0,0,0,0,0,0,0,0,0,0,0,1037961,"2023-12-20T00:00:00.000Z",2309958,28,"Jontay Porter",0,0,0,0,0,0
"16560",5035,2,0,5,7,2,13,5,0,0,32,1,1,12,6,1,0,1037961,"2023-12-20T00:00:00.000Z",375,8,"Michael Porter Jr.",1,18,20,14,8,25.2
"16561",5036,0,0,0,0,0,0,0,0,0,0,0,0,0,0,0,0,1037961,"2023-12-20T00:00:00.000Z",38017727,8,"Collin Gillespie",0,0,0,0,0,0
"16562",5037,0,0,0,0,0,0,0,0,0,0,0,0,0,0,0,0,1037961,"2023-12-20T00:00:00.000Z",215,8,"Justin Holiday",0,0,0,0,0,0
"16563",5038,0,0,0,0,0,0,0,0,0,0,0,0,0,0,0,0,1037956,"2023-12-20T00:00:00.000Z",56677842,29,"Brice Sensabaugh",0,0,0,0,0,0
"16564",5039,7,0,7,10,2,26,10,3,3,34,2,0,25,9,1,1,1037957,"2023-12-20T00:00:00.000Z",403,4,"Terry Rozier",1,34,41,32,16,48.3
"16565",5040,2,0,3,8,1,21,4,6,6,33,2,0,15,5,2,2,1037960,"2023-12-20T00:00:00.000Z",61,3,"Mikal Bridges",2,20,22,17,7,28
"16566",5041,2,0,4,6,4,14,8,1,0,28,0,3,20,4,0,0,1037960,"2023-12-20T00:00:00.000Z",666679,3,"Cameron Johnson",0,24,26,22,6,27.8
"16567",5042,2,4,4,0,0,5,3,0,0,26,4,5,6,8,0,0,1037960,"2023-12-20T00:00:00.000Z",666508,3,"Nicolas Claxton",4,14,16,8,10,30.6
"16568",5043,5,0,1,7,4,18,8,1,0,32,1,2,20,2,0,1,1037960,"2023-12-20T00:00:00.000Z",17896048,3,"Cam Thomas",0,22,27,25,7,28.9
"16569",5044,2,0,2,8,2,11,3,2,2,30,0,0,10,2,1,2,1037960,"2023-12-20T00:00:00.000Z",130,3,"Spencer Dinwiddie",1,12,14,12,4,16.4
"16570",5045,0,0,0,0,0,0,0,0,0,0,0,0,0,0,0,0,1037957,"2023-12-20T00:00:00.000Z",56677861,12,"Ben Sheppard",0,0,0,0,0,0
"16571",5046,3,0,11,3,2,5,2,4,4,31,2,2,10,13,1,2,1037960,"2023-12-20T00:00:00.000Z",202,20,"Josh Hart",1,23,26,13,16,31.1
"16572",5047,2,1,0,6,4,12,7,4,1,24,0,0,19,0,1,1,1037960,"2023-12-20T00:00:00.000Z",3547269,20,"Immanuel Quickley",2,19,21,21,2,27
"16573",5048,0,1,1,4,1,7,2,0,0,18,0,1,5,1,1,0,1037960,"2023-12-20T00:00:00.000Z",17895858,20,"Quentin Grimes",2,6,6,5,1,12.2
"16574",5049,0,2,2,0,0,2,1,0,0,13,0,3,2,2,0,0,1037960,"2023-12-20T00:00:00.000Z",173,20,"Taj Gibson",2,4,4,2,2,10.4
"16575",5050,0,0,0,0,0,3,2,0,0,3,0,1,4,0,0,0,1037960,"2023-12-20T00:00:00.000Z",666675,20,"DaQuan Jeffries",0,4,4,4,0,4
"16576",5051,0,0,0,0,0,0,0,0,0,0,0,0,0,0,0,0,1037894,"2023-12-11T00:00:00.000Z",24572055,21,"Olivier Sarr",0,0,0,0,0,0
"16577",5052,0,1,0,2,0,2,0,0,0,9,0,0,0,0,1,0,1037884,"2023-12-11T00:00:00.000Z",18678001,4,"JT Thor",2,0,0,0,0,6
"16578",5053,0,0,0,0,0,0,0,0,0,0,0,0,0,0,0,0,1037884,"2023-12-11T00:00:00.000Z",56677866,4,"Leaky Black",0,0,0,0,0,0
"16579",5054,0,0,0,0,0,0,0,0,0,0,0,0,0,0,0,0,1037884,"2023-12-11T00:00:00.000Z",17896037,4,"James Bouknight",0,0,0,0,0,0
"16580",5055,0,0,0,0,0,0,0,0,0,0,0,0,0,0,0,0,1037884,"2023-12-11T00:00:00.000Z",3547253,4,"Theo Maledon",0,0,0,0,0,0
"16581",5056,0,0,0,0,0,0,0,0,0,0,0,0,0,0,0,0,1037884,"2023-12-11T00:00:00.000Z",56677848,4,"Amari Bailey",0,0,0,0,0,0
"16582",5057,0,0,0,0,0,0,0,0,0,0,0,0,0,0,0,0,1037884,"2023-12-11T00:00:00.000Z",3547239,4,"LaMelo Ball",0,0,0,0,0,0
"16583",5058,0,0,0,0,0,0,0,0,0,0,0,0,0,0,0,0,1037884,"2023-12-11T00:00:00.000Z",666748,4,"Cody Martin",0,0,0,0,0,0
"16584",5059,0,0,0,0,0,0,0,0,0,0,0,0,0,0,0,0,1037884,"2023-12-11T00:00:00.000Z",347,4,"Frank Ntilikina",0,0,0,0,0,0
"16585",5060,0,0,0,0,0,0,0,0,0,0,0,0,0,0,0,0,1037884,"2023-12-11T00:00:00.000Z",56677846,4,"Nick Smith Jr.",0,0,0,0,0,0
"16586",5061,2,2,3,4,2,8,4,0,0,25,0,4,10,3,1,0,1037894,"2023-12-11T00:00:00.000Z",56677833,21,"Cason Wallace",3,13,15,12,5,25.6
"16587",5062,3,0,2,2,2,10,5,3,3,22,1,1,15,3,0,2,1037894,"2023-12-11T00:00:00.000Z",38017703,21,"Jalen Williams",0,18,21,18,6,21.1
"16588",5063,2,2,6,3,2,9,6,2,2,25,2,2,16,8,1,3,1037894,"2023-12-11T00:00:00.000Z",38017685,21,"Chet Holmgren",3,24,26,18,10,34.6
"16589",5064,8,1,8,3,2,11,5,0,0,24,2,1,12,10,1,3,1037894,"2023-12-11T00:00:00.000Z",17896065,21,"Josh Giddey",2,22,30,20,18,39
"16590",5065,7,0,3,1,0,17,12,6,6,28,1,1,30,4,3,1,1037894,"2023-12-11T00:00:00.000Z",175,21,"Shai Gilgeous-Alexander",3,34,41,37,11,53.3
"16591",5066,1,0,1,1,1,2,2,2,2,10,0,0,7,1,1,1,1037894,"2023-12-11T00:00:00.000Z",38017706,21,"Jaylin Williams",1,8,9,8,2,11.7
"16592",5067,1,1,0,7,3,8,3,0,0,14,0,1,9,0,0,0,1037894,"2023-12-11T00:00:00.000Z",3547272,21,"Isaiah Joe",1,9,10,10,1,13.5
"16593",5068,3,0,3,4,3,7,6,4,3,26,0,2,18,3,0,1,1037894,"2023-12-11T00:00:00.000Z",38017716,21,"Ousmane Dieng",0,21,24,21,6,25.1
"16594",5069,5,0,1,3,0,5,1,0,0,16,0,0,2,1,1,0,1037894,"2023-12-11T00:00:00.000Z",4197029,21,"Vasilije Micic",1,3,8,7,6,13.7
"16595",5070,0,0,0,1,1,4,1,0,0,4,1,0,3,1,0,0,1037894,"2023-12-11T00:00:00.000Z",17896078,21,"Aaron Wiggins",0,4,4,3,1,4.2
"16596",5071,1,0,2,0,0,1,1,0,0,7,0,0,2,2,1,0,1037894,"2023-12-11T00:00:00.000Z",480,21,"Kenrich Williams",1,4,5,3,3,8.9
"16597",5072,0,0,2,1,0,6,2,0,0,13,0,2,4,2,0,1,1037894,"2023-12-11T00:00:00.000Z",17896036,21,"Tre Mann",0,6,6,4,2,5.4
"16598",5073,1,1,0,2,1,2,1,0,0,9,0,1,3,0,0,0,1037894,"2023-12-11T00:00:00.000Z",44,21,"Davis Bertans",1,3,4,4,1,7.5
"16599",5074,0,0,1,2,0,2,0,0,0,9,0,0,0,1,0,0,1037894,"2023-12-11T00:00:00.000Z",3547271,21,"Aleksej Pokusevski",0,1,1,0,1,1.2
"16600",5075,1,0,0,4,1,4,1,0,0,8,0,2,3,0,0,0,1037894,"2023-12-11T00:00:00.000Z",27924547,21,"Lindy Waters III",0,3,4,4,1,4.5
"16601",5076,0,3,1,0,0,3,2,0,0,19,2,3,4,3,0,1,3277527,"2023-11-28T00:00:00.000Z",261,2,"Luke Kornet",3,7,7,4,3,15.6
"16602",5077,0,0,0,0,0,0,0,0,0,2,0,0,0,0,0,0,3277527,"2023-11-28T00:00:00.000Z",338,2,"Svi Mykhailiuk",0,0,0,0,0,0
"16603",5078,0,0,0,0,0,0,0,0,0,0,0,0,0,0,0,0,3277527,"2023-11-28T00:00:00.000Z",666468,2,"Oshae Brissett",0,0,0,0,0,0
"16604",5079,1,0,1,3,2,11,6,0,0,26,0,2,14,1,1,0,3277530,"2023-11-28T00:00:00.000Z",666747,16,"Caleb Martin",1,15,16,15,2,19.7
"16605",5080,0,0,0,0,0,0,0,0,0,0,0,0,0,0,0,0,3277530,"2023-11-28T00:00:00.000Z",39398582,16,"Orlando Robinson",0,0,0,0,0,0
"16606",5081,0,0,0,0,0,0,0,0,0,0,0,0,0,0,0,0,3277530,"2023-11-28T00:00:00.000Z",38017736,16,"Cole Swider",0,0,0,0,0,0
"16607",5082,1,1,1,1,1,4,2,0,0,13,1,2,5,2,2,0,3277528,"2023-11-28T00:00:00.000Z",666762,28,"Jalen McDaniels",3,7,8,6,3,17.9
"16608",5083,0,0,0,4,3,7,5,0,0,12,1,0,13,1,1,0,3277528,"2023-11-28T00:00:00.000Z",58,28,"Chris Boucher",1,14,14,13,1,17.2
"16609",5084,0,0,0,0,0,0,0,0,0,0,0,0,0,0,0,0,3277528,"2023-11-28T00:00:00.000Z",376,28,"Otto Porter Jr.",0,0,0,0,0,0
"16610",5085,0,0,0,0,0,0,0,0,0,0,0,0,0,0,0,0,3277528,"2023-11-28T00:00:00.000Z",436,28,"Garrett Temple",0,0,0,0,0,0
"16611",5086,0,0,0,0,0,0,0,0,0,0,0,0,0,0,0,0,3277528,"2023-11-28T00:00:00.000Z",489,28,"Thaddeus Young",0,0,0,0,0,0
"16612",5087,0,0,0,0,0,0,0,0,0,0,0,0,0,0,0,0,3277528,"2023-11-28T00:00:00.000Z",56677828,28,"Gradey Dick",0,0,0,0,0,0
"16613",5088,0,0,0,0,0,0,0,0,0,0,0,0,0,0,0,0,3277528,"2023-11-28T00:00:00.000Z",56677805,28,"Javon Freeman-Liberty",0,0,0,0,0,0
"16614",5089,0,0,0,0,0,0,0,0,0,0,0,0,0,0,0,0,3277528,"2023-11-28T00:00:00.000Z",38017717,28,"Ron Harper Jr.",0,0,0,0,0,0
"16615",5090,3,0,1,5,3,12,7,2,2,30,0,0,19,1,0,0,3277527,"2023-11-28T00:00:00.000Z",666956,5,"Coby White",0,20,23,22,4,24.7
"16616",5091,1,0,1,5,1,7,1,0,0,26,1,2,3,2,0,2,3277532,"2023-11-28T00:00:00.000Z",666400,18,"Nickeil Alexander-Walker",0,5,6,4,3,4.9
"16617",5092,3,0,10,3,1,8,2,8,8,32,0,4,13,10,0,6,3277532,"2023-11-28T00:00:00.000Z",447,18,"Karl-Anthony Towns",0,23,26,16,13,23.5
"16618",5093,0,4,10,0,0,10,6,6,5,36,6,1,17,16,1,1,3277532,"2023-11-28T00:00:00.000Z",176,18,"Rudy Gobert",5,33,33,17,16,50.2
"16619",5094,1,1,5,6,3,16,7,6,4,28,0,2,21,5,0,2,3277532,"2023-11-28T00:00:00.000Z",3547238,18,"Anthony Edwards",1,26,27,22,6,29.5
"16620",5095,2,0,0,3,1,10,4,2,1,24,0,3,10,0,1,0,3277527,"2023-11-28T00:00:00.000Z",17895983,5,"Ayo Dosunmu",1,10,12,12,2,16
"16621",5096,2,0,1,6,2,9,3,0,0,19,1,2,8,2,3,1,3277527,"2023-11-28T00:00:00.000Z",89,5,"Alex Caruso",3,10,12,10,4,21.4
"16622",5097,0,1,1,1,1,1,1,0,0,13,0,0,3,1,1,0,3277527,"2023-11-28T00:00:00.000Z",110,5,"Torrey Craig",2,4,4,3,1,10.2
"16623",5098,0,1,4,0,0,5,2,6,1,13,2,1,5,6,0,0,3277527,"2023-11-28T00:00:00.000Z",137,5,"Andre Drummond",1,11,11,5,6,15.2
"16624",5099,2,1,1,1,0,7,4,0,0,17,0,0,8,1,0,1,3277527,"2023-11-28T00:00:00.000Z",87,5,"Jevon Carter",1,9,11,10,3,14.2
"16625",5100,1,0,2,1,0,2,0,2,1,10,0,0,1,2,0,1,3277527,"2023-11-28T00:00:00.000Z",56677857,5,"Julian Phillips",0,3,4,2,3,3.9
"16626",5101,0,0,0,0,0,0,0,0,0,0,0,0,0,0,0,0,1037754,"2023-11-15T00:00:00.000Z",17553983,22,"Trevelin Queen",0,0,0,0,0,0
"16627",5102,3,3,3,5,2,19,12,11,10,35,2,0,36,5,1,4,1037758,"2023-11-16T00:00:00.000Z",79,16,"Jimmy Butler",4,41,44,39,8,54.5
"16628",5103,0,0,1,3,0,5,2,2,2,23,0,3,6,1,0,1,1037758,"2023-11-16T00:00:00.000Z",3092,16,"Haywood Highsmith",0,7,7,6,1,6.2
"16629",5104,4,1,5,0,0,15,8,4,4,33,2,2,20,7,2,2,1037758,"2023-11-16T00:00:00.000Z",4,16,"Bam Adebayo",3,27,31,24,11,41.4
"16630",5105,2,0,0,10,6,14,8,4,4,38,0,3,26,0,0,0,1037758,"2023-11-16T00:00:00.000Z",397,16,"Duncan Robinson",0,26,28,28,2,29
"16631",5106,3,0,2,1,1,4,1,0,0,24,1,3,3,3,3,0,1037758,"2023-11-16T00:00:00.000Z",286,16,"Kyle Lowry",3,6,9,6,6,20.1
"16632",5107,7,0,4,11,6,16,10,2,2,37,0,2,28,4,2,0,1037756,"2023-11-15T00:00:00.000Z",221,26,"Kevin Huerter",2,32,39,35,11,49.3
"16633",5108,5,0,2,9,3,22,10,7,5,38,3,3,28,5,4,3,1037756,"2023-11-15T00:00:00.000Z",161,26,"De'Aaron Fox",4,33,38,33,10,50.5
"16634",5109,5,0,5,5,1,8,1,0,0,20,0,1,3,5,1,3,1037756,"2023-11-15T00:00:00.000Z",324,26,"Malik Monk",1,8,13,8,10,16.5
"16635",5110,1,0,1,2,0,3,0,0,0,9,1,2,0,2,0,0,1037756,"2023-11-15T00:00:00.000Z",38017714,26,"Keon Ellis",0,2,3,1,3,3.9
"16636",5111,1,0,4,0,0,3,3,2,1,9,2,3,7,6,2,2,1037756,"2023-11-15T00:00:00.000Z",306,26,"JaVale McGee",2,13,14,8,7,19.7
"16637",5112,0,0,0,0,0,0,0,0,0,2,0,0,0,0,0,0,1037757,"2023-11-15T00:00:00.000Z",3547299,6,"Sam Merrill",0,0,0,0,0,0
"16638",5113,0,0,1,0,0,0,0,0,0,2,0,0,0,1,0,0,1037757,"2023-11-15T00:00:00.000Z",444,6,"Tristan Thompson",0,1,1,0,1,1.2
"16639",5114,0,0,1,0,0,0,0,0,0,1,0,0,0,1,0,0,1037757,"2023-11-15T00:00:00.000Z",56677847,6,"Emoni Bates",0,1,1,0,1,1.2
"16640",5115,0,0,0,0,0,0,0,0,0,1,0,0,0,0,0,0,1037757,"2023-11-15T00:00:00.000Z",248,6,"Damian Jones",0,0,0,0,0,0
"16641",5116,0,0,0,0,0,0,0,0,0,0,0,0,0,0,0,0,1037757,"2023-11-15T00:00:00.000Z",666581,6,"Darius Garland",0,0,0,0,0,0
"16642",5117,5,0,4,5,2,9,4,0,0,33,0,3,10,4,0,1,1037758,"2023-11-16T00:00:00.000Z",56677785,16,"Jaime Jaquez Jr.",0,14,19,15,9,21.3
"16643",5118,4,0,8,3,1,4,2,2,2,16,1,2,7,9,0,0,1037758,"2023-11-16T00:00:00.000Z",285,16,"Kevin Love",0,16,20,11,13,23.8
"16644",5119,0,0,0,0,0,0,0,0,0,0,0,0,0,0,0,0,1037757,"2023-11-15T00:00:00.000Z",666676,6,"Ty Jerome",0,0,0,0,0,0
"16645",5120,0,0,0,0,0,0,0,0,0,0,0,0,0,0,0,0,1037757,"2023-11-15T00:00:00.000Z",38017662,6,"Isaiah Mobley",0,0,0,0,0,0
"16646",5121,0,0,0,0,0,0,0,0,0,0,0,0,0,0,0,0,1037757,"2023-11-15T00:00:00.000Z",3547247,6,"Isaac Okoro",0,0,0,0,0,0
"16647",5122,0,0,0,0,0,0,0,0,0,0,0,0,0,0,0,0,1037757,"2023-11-15T00:00:00.000Z",404,6,"Ricky Rubio",0,0,0,0,0,0
"16648",5123,0,0,0,0,0,0,0,0,0,0,0,0,0,0,0,0,1037758,"2023-11-16T00:00:00.000Z",74,16,"Thomas Bryant",0,0,0,0,0,0
"16649",5124,0,0,0,0,0,0,0,0,0,0,0,0,0,0,0,0,1037758,"2023-11-16T00:00:00.000Z",38017696,16,"Nikola Jovic",0,0,0,0,0,0
"16650",5125,3,0,2,5,1,7,3,1,1,26,0,2,8,2,2,0,1037758,"2023-11-16T00:00:00.000Z",391,16,"Josh Richardson",2,10,13,11,5,20.9
"16651",5126,0,0,0,0,0,0,0,0,0,0,0,0,0,0,0,0,1037685,"2023-11-06T00:00:00.000Z",56677865,27,"Charles Bediako",0,0,0,0,0,0
"16652",5127,0,1,1,0,0,2,1,1,1,6,0,0,3,1,0,0,1037687,"2023-11-06T00:00:00.000Z",328,23,"Marcus Morris",1,4,4,3,1,7.2
"16653",5128,1,0,1,0,0,1,0,0,0,4,0,0,0,1,0,0,1037687,"2023-11-06T00:00:00.000Z",3547294,23,"Kenyon Martin Jr.",0,1,2,1,2,2.7
"16654",5129,0,0,1,2,0,2,0,1,1,4,0,0,1,1,0,0,1037687,"2023-11-06T00:00:00.000Z",167,30,"Danilo Gallinari",0,2,2,1,1,2.2
"16655",5130,0,2,0,1,0,3,2,2,1,8,1,0,5,1,1,0,1037687,"2023-11-06T00:00:00.000Z",3547302,30,"Anthony Gill",3,6,6,5,1,15.2
"16656",5131,4,0,5,4,1,13,5,2,1,33,0,3,12,5,1,1,1037686,"2023-11-06T00:00:00.000Z",17896026,22,"Franz Wagner",1,17,21,16,9,26
"16657",5132,0,0,3,0,0,3,0,0,0,11,0,0,0,3,0,0,1037684,"2023-11-06T00:00:00.000Z",3547240,9,"James Wiseman",0,3,3,0,3,3.6
"16658",5133,0,0,3,5,4,8,5,1,1,16,0,3,15,3,0,1,1037684,"2023-11-06T00:00:00.000Z",44477024,9,"Stanley Umude",0,18,18,15,3,17.6
"16659",5134,0,0,0,0,0,0,0,0,0,0,0,0,0,0,0,0,1037684,"2023-11-06T00:00:00.000Z",54,9,"Bojan Bogdanovic",0,0,0,0,0,0
"16660",5135,0,0,0,0,0,0,0,0,0,0,0,0,0,0,0,0,1037684,"2023-11-06T00:00:00.000Z",77,9,"Alec Burks",0,0,0,0,0,0
"16661",5136,0,0,0,0,0,0,0,0,0,0,0,0,0,0,0,0,1037684,"2023-11-06T00:00:00.000Z",17896071,9,"Isaiah Livers",0,0,0,0,0,0
"16662",5137,0,0,0,0,0,0,0,0,0,0,0,0,0,0,0,0,1037684,"2023-11-06T00:00:00.000Z",330,9,"Monte Morris",0,0,0,0,0,0
"16663",5138,1,1,3,2,0,9,2,2,0,21,3,0,4,6,1,2,1037684,"2023-11-06T00:00:00.000Z",475,10,"Andrew Wiggins",2,10,11,5,7,16.7
"16664",5139,8,0,6,1,0,4,2,2,2,27,3,2,6,9,0,2,1037684,"2023-11-06T00:00:00.000Z",185,10,"Draymond Green",0,15,23,14,17,26.8
"16665",5140,6,0,4,1,0,18,8,6,6,37,1,5,22,5,0,6,1037686,"2023-11-06T00:00:00.000Z",38017683,22,"Paolo Banchero",0,27,33,28,11,31
"16666",5141,0,1,4,1,0,5,3,1,1,22,2,3,7,6,2,1,1037686,"2023-11-06T00:00:00.000Z",666442,22,"Goga Bitadze",3,13,13,7,6,22.2
"16667",5142,7,1,3,6,1,12,4,2,1,24,1,3,10,4,1,4,1037686,"2023-11-06T00:00:00.000Z",17896073,22,"Jalen Suggs",2,14,21,17,11,27.3
"16668",5143,2,0,3,4,2,7,3,0,0,33,2,2,8,5,0,1,1037686,"2023-11-06T00:00:00.000Z",56677827,22,"Anthony Black",0,13,15,10,7,16
"16669",5144,3,0,5,0,0,2,1,0,0,21,0,1,2,5,0,2,1037686,"2023-11-06T00:00:00.000Z",226,22,"Joe Ingles",0,7,10,5,8,10.5
"16670",5145,5,2,2,5,2,13,7,5,3,30,0,3,19,2,1,3,1037686,"2023-11-06T00:00:00.000Z",3547251,22,"Cole Anthony",3,21,26,24,7,34.9
"16671",5146,6,0,2,4,3,15,9,7,7,37,2,0,28,4,2,3,1037689,"2023-11-06T00:00:00.000Z",79,16,"Jimmy Butler",2,32,38,34,10,44.8
"16672",5147,0,1,1,5,1,6,2,0,0,22,0,2,5,1,1,0,1037689,"2023-11-06T00:00:00.000Z",3092,16,"Haywood Highsmith",2,6,6,5,1,12.2
"16673",5148,10,2,15,1,1,20,9,5,3,38,5,2,22,20,2,4,1037689,"2023-11-06T00:00:00.000Z",4,16,"Bam Adebayo",4,42,52,32,30,69
"16674",5149,5,0,4,10,2,20,8,4,4,35,1,1,22,5,3,6,1037689,"2023-11-06T00:00:00.000Z",666633,16,"Tyler Herro",3,27,32,27,10,38.5
"16675",5150,5,0,2,5,1,6,2,0,0,33,2,2,5,4,1,0,1037689,"2023-11-06T00:00:00.000Z",286,16,"Kyle Lowry",1,9,14,10,9,20.3
"16676",5151,0,0,6,4,1,6,2,0,0,29,0,5,5,6,0,2,1037616,"2023-10-27T00:00:00.000Z",666965,7,"Grant Williams",0,11,11,5,6,10.2
"16677",5152,0,1,1,0,0,4,4,2,1,17,1,0,9,2,0,1,1037616,"2023-10-27T00:00:00.000Z",56677840,7,"Dereck Lively II",1,11,11,9,2,13.4
"16678",5153,6,0,6,4,1,17,6,4,4,34,1,2,17,7,0,0,1037616,"2023-10-27T00:00:00.000Z",228,7,"Kyrie Irving",0,24,30,23,13,34.4
"16679",5154,7,0,9,14,9,25,16,10,8,36,1,1,49,10,0,0,1037616,"2023-10-27T00:00:00.000Z",132,7,"Luka Doncic",0,59,66,56,17,71.5
"16680",5155,2,0,2,3,0,7,2,6,3,28,1,2,7,3,3,3,1037616,"2023-10-27T00:00:00.000Z",3547258,7,"Josh Green",3,10,12,9,5,19.6
"16681",5156,1,0,3,7,3,17,6,4,4,30,1,2,19,4,0,1,1037616,"2023-10-27T00:00:00.000Z",191,7,"Tim Hardaway Jr.",0,23,24,20,5,24.3
"16682",5157,2,0,4,0,0,3,0,0,0,26,1,1,0,5,0,0,1037616,"2023-10-27T00:00:00.000Z",257,7,"Maxi Kleber",0,5,7,2,7,9
"16683",5158,0,1,0,1,0,2,1,0,0,4,0,0,2,0,1,0,1037616,"2023-10-27T00:00:00.000Z",151,7,"Dante Exum",2,2,2,2,0,8
"16684",5159,1,0,0,0,0,1,1,0,0,9,0,1,2,0,0,1,1037616,"2023-10-27T00:00:00.000Z",114,7,"Seth Curry",0,2,3,3,1,2.5
"16685",5160,0,0,0,0,0,0,0,0,0,0,0,0,0,0,0,0,1037616,"2023-10-27T00:00:00.000Z",38017679,7,"Jaden Hardy",0,0,0,0,0,0
"16686",5161,0,0,0,0,0,0,0,0,0,0,0,0,0,0,0,0,1037616,"2023-10-27T00:00:00.000Z",217,7,"Richaun Holmes",0,0,0,0,0,0
"16687",5162,0,0,0,0,0,6,3,2,2,12,2,2,8,2,0,2,1037614,"2023-10-27T00:00:00.000Z",137,5,"Andre Drummond",0,10,10,8,2,8.4
"16688",5163,0,0,0,0,0,0,0,0,0,0,0,0,0,0,0,0,1037614,"2023-10-27T00:00:00.000Z",56677857,5,"Julian Phillips",0,0,0,0,0,0
"16689",5164,0,0,0,0,0,0,0,0,0,0,0,0,0,0,0,0,1037614,"2023-10-27T00:00:00.000Z",17896116,5,"Terry Taylor",0,0,0,0,0,0
"16690",5165,0,0,0,0,0,0,0,0,0,0,0,0,0,0,0,0,1037614,"2023-10-27T00:00:00.000Z",38017719,5,"Dalen Terry",0,0,0,0,0,0
"16691",5166,0,0,0,0,0,0,0,0,0,0,0,0,0,0,0,0,1037614,"2023-10-27T00:00:00.000Z",27,5,"Lonzo Ball",0,0,0,0,0,0
"16692",5167,0,0,0,0,0,0,0,0,0,0,0,0,0,0,0,0,1037614,"2023-10-27T00:00:00.000Z",56677874,5,"Onuralp Bitim",0,0,0,0,0,0
"16693",5168,0,0,0,0,0,0,0,0,0,0,0,0,0,0,0,0,1037614,"2023-10-27T00:00:00.000Z",45969255,5,"Justin Lewis",0,0,0,0,0,0
"16694",5169,0,0,0,0,0,0,0,0,0,0,0,0,0,0,0,0,1037614,"2023-10-27T00:00:00.000Z",56677860,5,"Adama Sanogo",0,0,0,0,0,0
"16695",5170,10,2,9,2,1,14,9,4,3,38,1,5,22,10,0,7,1037614,"2023-10-27T00:00:00.000Z",17896055,28,"Scottie Barnes",2,32,42,32,20,48
"16696",5171,2,0,7,5,1,15,7,5,3,41,1,4,18,8,0,3,1037614,"2023-10-27T00:00:00.000Z",416,28,"Pascal Siakam",0,26,28,20,10,27.6
"16697",5172,0,0,6,0,0,5,4,0,0,19,0,6,8,6,0,3,1037614,"2023-10-27T00:00:00.000Z",373,28,"Jakob Poeltl",0,14,14,8,6,12.2
"16698",5173,0,0,3,4,1,8,5,1,0,28,0,2,11,3,2,1,1037614,"2023-10-27T00:00:00.000Z",18,28,"OG Anunoby",2,14,14,11,3,19.6
"16699",5174,2,1,1,6,4,9,5,0,0,21,0,3,14,1,0,2,1037616,"2023-10-27T00:00:00.000Z",464,3,"Lonnie Walker IV",1,15,17,16,3,19.2
"16700",5175,0,0,2,0,0,2,1,0,0,3,2,1,2,4,1,2,1037616,"2023-10-27T00:00:00.000Z",17896038,3,"Day'Ron Sharpe",1,6,6,2,4,7.8
"16701",5176,0,0,0,0,0,0,0,0,0,0,0,0,0,0,0,0,1038079,"2024-01-05T00:00:00.000Z",476,25,"Robert Williams III",0,0,0,0,0,0
"16702",5177,0,0,0,0,0,0,0,0,0,0,0,0,0,0,0,0,1038088,"2024-01-06T00:00:00.000Z",666453,17,"Marques Bolden",0,0,0,0,0,0
"16703",5178,0,0,0,0,0,0,0,0,0,0,0,0,0,0,0,0,1038088,"2024-01-06T00:00:00.000Z",112,17,"Jae Crowder",0,0,0,0,0,0
"16704",5179,0,0,0,0,0,0,0,0,0,0,0,0,0,0,0,0,1038088,"2024-01-06T00:00:00.000Z",56677854,17,"Chris Livingston",0,0,0,0,0,0
"16705",5180,0,0,0,0,0,0,0,0,0,0,0,0,0,0,0,0,1038088,"2024-01-06T00:00:00.000Z",38017691,17,"TyTy Washington Jr.",0,0,0,0,0,0
"16706",5181,0,0,0,0,0,0,0,0,0,0,0,0,0,0,0,0,1038088,"2024-01-06T00:00:00.000Z",666960,17,"Lindell Wigginton",0,0,0,0,0,0
"16707",5182,1,0,3,3,1,3,1,0,0,24,1,0,3,4,0,0,1038081,"2024-01-05T00:00:00.000Z",38017696,16,"Nikola Jovic",0,7,8,4,5,9.3
"16708",5183,1,1,9,0,0,19,11,7,6,36,2,2,28,11,0,1,1038081,"2024-01-05T00:00:00.000Z",4,16,"Bam Adebayo",1,39,40,29,12,44.7
"16709",5184,6,0,4,7,1,17,4,0,0,35,0,2,9,4,0,1,1038081,"2024-01-05T00:00:00.000Z",666633,16,"Tyler Herro",0,13,19,15,10,21.8
"16710",5185,4,0,2,6,2,7,2,0,0,23,1,2,6,3,0,4,1038081,"2024-01-05T00:00:00.000Z",286,16,"Kyle Lowry",0,9,13,10,7,11.6
"16711",5186,2,0,4,6,3,9,6,6,5,20,3,4,20,7,0,2,1038081,"2024-01-05T00:00:00.000Z",285,16,"Kevin Love",0,27,29,22,9,29.4
"16712",5187,1,0,3,6,4,14,9,0,0,31,0,2,22,3,2,0,1038080,"2024-01-05T00:00:00.000Z",375,8,"Michael Porter Jr.",2,25,26,23,4,33.1
"16713",5188,3,1,1,6,1,7,1,2,1,27,0,3,4,1,1,3,1038081,"2024-01-05T00:00:00.000Z",397,16,"Duncan Robinson",2,5,8,7,4,12.7
"16714",5189,7,0,7,6,1,9,2,5,5,29,1,3,10,8,2,0,1038081,"2024-01-05T00:00:00.000Z",391,16,"Josh Richardson",2,18,25,17,15,36.1
"16715",5190,0,0,0,1,1,5,2,2,2,5,2,0,7,2,0,0,1038081,"2024-01-05T00:00:00.000Z",38017734,16,"Jamal Cain",0,9,9,7,2,9.4
"16716",5191,1,0,0,0,0,0,0,0,0,2,0,1,0,0,0,0,1038081,"2024-01-05T00:00:00.000Z",3547257,16,"R.J. Hampton",0,0,1,1,1,1.5
"16717",5192,3,0,5,4,2,8,5,5,4,36,3,4,16,8,0,1,1038080,"2024-01-05T00:00:00.000Z",177,8,"Aaron Gordon",0,24,27,19,11,29.1
"16718",5193,8,0,4,1,0,19,13,4,3,37,0,3,29,4,3,2,1038080,"2024-01-05T00:00:00.000Z",246,8,"Nikola Jokic",3,33,41,37,12,52.8
"16719",5194,2,0,2,2,1,5,3,0,0,14,0,1,7,2,0,0,1038076,"2024-01-05T00:00:00.000Z",87,5,"Jevon Carter",0,9,11,9,4,12.4
"16720",5195,0,1,0,1,0,3,2,1,1,9,0,2,5,0,0,1,1038076,"2024-01-05T00:00:00.000Z",17896116,5,"Terry Taylor",1,5,5,5,0,7
"16721",5196,0,0,0,0,0,0,0,0,0,0,0,0,0,0,0,0,1038076,"2024-01-05T00:00:00.000Z",89,5,"Alex Caruso",0,0,0,0,0,0
"16722",5197,0,0,0,0,0,0,0,0,0,0,0,0,0,0,0,0,1038076,"2024-01-05T00:00:00.000Z",110,5,"Torrey Craig",0,0,0,0,0,0
"16723",5198,0,0,0,0,0,0,0,0,0,0,0,0,0,0,0,0,1038076,"2024-01-05T00:00:00.000Z",56677857,5,"Julian Phillips",0,0,0,0,0,0
"16724",5199,2,1,2,3,0,4,1,4,4,29,1,1,6,3,1,3,1038080,"2024-01-05T00:00:00.000Z",81,8,"Kentavious Caldwell-Pope",2,9,11,8,5,15.6
"16725",5200,9,0,6,6,0,23,9,2,2,34,1,3,20,7,1,3,1038080,"2024-01-05T00:00:00.000Z",335,8,"Jamal Murray",1,27,36,29,16,41.9
"16726",5201,1,0,1,4,3,5,4,1,0,15,1,5,11,2,0,2,1037983,"2023-12-23T00:00:00.000Z",3547264,12,"Jalen Smith",0,13,14,12,3,12.9
"16727",5202,0,0,0,0,0,0,0,0,0,0,0,0,0,0,0,0,1037983,"2023-12-23T00:00:00.000Z",3547207,12,"Jordan Nwora",0,0,0,0,0,0
"16728",5203,0,0,0,0,0,0,0,0,0,0,0,0,0,0,0,0,1037983,"2023-12-23T00:00:00.000Z",56677861,12,"Ben Sheppard",0,0,0,0,0,0
"16729",5204,0,0,0,0,0,0,0,0,0,0,0,0,0,0,0,0,1037983,"2023-12-23T00:00:00.000Z",56677832,12,"Jarace Walker",0,0,0,0,0,0
"16730",5205,0,0,0,0,0,0,0,0,0,0,0,0,0,0,0,0,1037983,"2023-12-23T00:00:00.000Z",38017701,12,"Kendall Brown",0,0,0,0,0,0
"16731",5206,0,0,0,0,0,0,0,0,0,0,0,0,0,0,0,0,1037983,"2023-12-23T00:00:00.000Z",56677778,12,"Oscar Tshiebwe",0,0,0,0,0,0
"16732",5207,0,0,0,0,0,0,0,0,0,0,0,0,0,0,0,0,1037983,"2023-12-23T00:00:00.000Z",56677794,12,"Isaiah Wong",0,0,0,0,0,0
"16733",5208,1,2,3,1,0,7,4,2,1,26,4,3,9,7,1,0,1037976,"2023-12-22T00:00:00.000Z",3547244,1,"Onyeka Okongwu",3,16,17,10,8,27.9
"16734",5209,0,0,1,1,0,1,0,0,0,7,0,1,0,1,0,0,1037976,"2023-12-22T00:00:00.000Z",301,1,"Wesley Matthews",0,1,1,0,1,1.2
"16735",5210,0,0,0,0,0,0,0,0,0,0,0,0,0,0,0,0,1037976,"2023-12-22T00:00:00.000Z",666564,1,"Bruno Fernando",0,0,0,0,0,0
"16736",5211,0,0,0,0,0,0,0,0,0,0,0,0,0,0,0,0,1037976,"2023-12-22T00:00:00.000Z",3547297,1,"Trent Forrest",0,0,0,0,0,0
"16737",5212,0,0,0,0,0,0,0,0,0,0,0,0,0,0,0,0,1037976,"2023-12-22T00:00:00.000Z",56677838,1,"Kobe Bufkin",0,0,0,0,0,0
"16738",5213,0,0,0,0,0,0,0,0,0,0,0,0,0,0,0,0,1037976,"2023-12-22T00:00:00.000Z",38017689,1,"AJ Griffin",0,0,0,0,0,0
"16739",5214,0,0,0,0,0,0,0,0,0,0,0,0,0,0,0,0,1037976,"2023-12-22T00:00:00.000Z",56677806,1,"Mouhamed Gueye",0,0,0,0,0,0
"16740",5215,0,0,0,0,0,0,0,0,0,0,0,0,0,0,0,0,1037976,"2023-12-22T00:00:00.000Z",666656,1,"De'Andre Hunter",0,0,0,0,0,0
"16741",5216,0,0,0,0,0,0,0,0,0,0,0,0,0,0,0,0,1037976,"2023-12-22T00:00:00.000Z",17896040,1,"Jalen Johnson",0,0,0,0,0,0
"16742",5217,0,0,0,0,0,0,0,0,0,0,0,0,0,0,0,0,1037976,"2023-12-22T00:00:00.000Z",4197387,1,"Vit Krejci",0,0,0,0,0,0
"16743",5218,0,0,0,0,0,0,0,0,0,0,0,0,0,0,0,0,1037976,"2023-12-22T00:00:00.000Z",56677855,1,"Seth Lundy",0,0,0,0,0,0
"16744",5219,2,0,7,3,2,14,9,9,8,34,0,0,28,7,1,7,1037979,"2023-12-22T00:00:00.000Z",140,24,"Kevin Durant",1,35,37,30,9,35.4
"16745",5220,0,0,1,0,0,3,1,0,0,15,1,2,2,2,1,2,1037979,"2023-12-22T00:00:00.000Z",147,24,"Drew Eubanks",1,4,4,2,2,5.4
"16746",5221,2,1,2,6,3,10,4,0,0,30,2,1,11,4,3,1,1037979,"2023-12-22T00:00:00.000Z",8,24,"Grayson Allen",4,15,17,13,6,29.8
"16747",5222,7,0,2,3,0,20,9,9,6,36,2,1,24,4,0,0,1037979,"2023-12-22T00:00:00.000Z",57,24,"Devin Booker",0,28,35,31,11,39.3
"16748",5223,0,0,0,0,0,0,0,0,0,0,0,0,0,0,0,0,1037979,"2023-12-22T00:00:00.000Z",272,24,"Damion Lee",0,0,0,0,0,0
"16749",5224,0,0,0,0,0,0,0,0,0,0,0,0,0,0,0,0,1037979,"2023-12-22T00:00:00.000Z",3547253,24,"Theo Maledon",0,0,0,0,0,0
"16750",5225,0,1,1,7,2,15,7,2,2,25,0,3,18,1,0,1,1037978,"2023-12-22T00:00:00.000Z",17896045,30,"Corey Kispert",1,19,19,18,1,21.2
"16751",5226,3,0,2,4,2,9,5,2,2,29,0,2,14,2,1,1,1037913,"2023-12-14T00:00:00.000Z",104,18,"Mike Conley",1,16,19,17,5,22.9
"16752",5227,1,0,2,0,0,2,2,2,2,12,0,1,6,2,0,0,1037912,"2023-12-14T00:00:00.000Z",74,16,"Thomas Bryant",0,8,9,7,3,9.9
"16753",5228,1,1,1,2,0,3,1,2,2,9,0,3,4,1,1,0,1037911,"2023-12-14T00:00:00.000Z",3547279,2,"Lamar Stevens",2,5,6,5,2,12.7
"16754",5229,2,1,3,1,0,1,0,0,0,14,0,1,0,3,0,0,1037911,"2023-12-14T00:00:00.000Z",3547276,2,"Payton Pritchard",1,3,5,2,5,9.6
"16755",5230,1,0,4,4,1,8,3,2,2,24,2,0,9,6,1,0,1037914,"2023-12-14T00:00:00.000Z",375,8,"Michael Porter Jr.",1,15,16,10,7,20.7
"16756",5231,2,1,2,1,0,9,6,1,1,24,0,0,13,2,1,2,1037914,"2023-12-14T00:00:00.000Z",177,8,"Aaron Gordon",2,15,17,15,4,22.4
"16757",5232,10,0,14,2,0,12,8,12,10,30,1,2,26,15,1,1,1037914,"2023-12-14T00:00:00.000Z",246,8,"Nikola Jokic",1,41,51,36,25,61
"16758",5233,2,0,1,5,0,6,1,0,0,27,0,2,2,1,4,1,1037914,"2023-12-14T00:00:00.000Z",215,8,"Justin Holiday",4,3,5,4,3,17.2
"16759",5234,2,1,1,4,2,15,7,0,0,22,0,2,16,1,3,0,1037914,"2023-12-14T00:00:00.000Z",335,8,"Jamal Murray",4,17,19,18,3,32.2
"16760",5235,4,0,0,4,2,13,4,2,2,23,0,3,12,0,2,1,1037914,"2023-12-14T00:00:00.000Z",236,8,"Reggie Jackson",2,12,16,16,4,23
"16761",5236,2,2,3,3,1,10,4,1,1,24,1,0,10,4,1,1,1037914,"2023-12-14T00:00:00.000Z",38017709,8,"Christian Braun",3,14,16,12,6,25.8
"16762",5237,0,1,2,0,0,2,1,0,0,12,2,2,2,4,0,1,1037914,"2023-12-14T00:00:00.000Z",250,8,"DeAndre Jordan",1,6,6,2,4,8.8
"16763",5238,1,0,0,1,1,2,2,0,0,6,3,1,5,3,0,0,1037914,"2023-12-14T00:00:00.000Z",3547268,8,"Zeke Nnaji",0,8,9,6,4,10.1
"16764",5239,0,0,0,0,0,0,0,0,0,0,0,0,0,0,0,0,1037911,"2023-12-14T00:00:00.000Z",17896094,2,"Dalano Banton",0,0,0,0,0,0
"16765",5240,0,0,0,0,0,0,0,0,0,0,0,0,0,0,0,0,1037911,"2023-12-14T00:00:00.000Z",666468,2,"Oshae Brissett",0,0,0,0,0,0
"16766",5241,0,0,0,0,0,0,0,0,0,0,0,0,0,0,0,0,1037911,"2023-12-14T00:00:00.000Z",261,2,"Luke Kornet",0,0,0,0,0,0
"16767",5242,0,0,0,0,0,0,0,0,0,0,0,0,0,0,0,0,1037911,"2023-12-14T00:00:00.000Z",338,2,"Svi Mykhailiuk",0,0,0,0,0,0
"16768",5243,0,0,0,0,0,0,0,0,0,0,0,0,0,0,0,0,1037913,"2023-12-14T00:00:00.000Z",228,7,"Kyrie Irving",0,0,0,0,0,0
"16769",5244,0,0,0,0,0,0,0,0,0,0,0,0,0,0,0,0,1037913,"2023-12-14T00:00:00.000Z",257,7,"Maxi Kleber",0,0,0,0,0,0
"16770",5245,1,1,1,2,0,9,5,1,1,24,1,3,11,2,0,0,1037913,"2023-12-14T00:00:00.000Z",3547259,18,"Jaden McDaniels",1,13,14,12,3,17.9
"16771",5246,2,0,8,0,0,9,5,0,0,17,1,5,10,9,0,2,1037914,"2023-12-14T00:00:00.000Z",666508,3,"Nicolas Claxton",0,19,21,12,11,21.8
"16772",5247,0,0,3,2,0,13,5,6,3,27,0,3,13,3,0,0,1037914,"2023-12-14T00:00:00.000Z",17896048,3,"Cam Thomas",0,16,16,13,3,16.6
"16773",5248,8,0,4,4,1,11,5,7,6,24,0,3,17,4,1,2,1037914,"2023-12-14T00:00:00.000Z",130,3,"Spencer Dinwiddie",1,21,29,25,12,34.8
"16774",5249,6,2,2,1,0,9,4,0,0,22,2,2,8,4,0,2,1037914,"2023-12-14T00:00:00.000Z",17896058,3,"Trendon Watford",2,12,18,14,10,25.8
"16775",5250,5,1,9,1,0,9,4,0,0,26,4,4,8,13,0,3,1037914,"2023-12-14T00:00:00.000Z",17896038,3,"Day'Ron Sharpe",1,21,26,13,18,31.1
"16776",5251,0,0,0,0,0,0,0,0,0,0,0,0,0,0,0,0,3277533,"2023-11-28T00:00:00.000Z",56677831,11,"Cam Whitmore",0,0,0,0,0,0
"16777",5252,2,2,9,9,3,14,6,6,5,36,0,2,20,9,1,3,3277534,"2023-11-28T00:00:00.000Z",443,10,"Klay Thompson",3,29,31,22,11,39.8
"16778",5253,6,1,7,12,4,20,8,9,9,37,3,5,29,10,0,5,3277534,"2023-11-28T00:00:00.000Z",115,10,"Stephen Curry",1,39,45,35,16,48
"16779",5254,1,1,4,1,0,4,3,1,1,16,1,3,7,5,2,1,3277534,"2023-11-28T00:00:00.000Z",2189,10,"Gary Payton II",3,12,13,8,6,22.5
"16780",5255,3,0,1,4,2,7,3,2,2,17,1,3,10,2,0,0,3277534,"2023-11-28T00:00:00.000Z",407,10,"Dario Saric",0,12,15,13,5,16.9
"16781",5256,0,0,0,2,1,2,1,0,0,5,0,1,3,0,2,0,3277534,"2023-11-28T00:00:00.000Z",367,10,"Chris Paul",2,3,3,3,0,9
"16782",5257,0,0,1,1,0,3,0,0,0,10,0,3,0,1,0,2,3277534,"2023-11-28T00:00:00.000Z",17553979,10,"Jonathan Kuminga",0,1,1,0,1,-0.8
"16783",5258,3,0,4,0,0,2,1,2,2,8,0,0,4,4,0,0,3277534,"2023-11-28T00:00:00.000Z",251,10,"Cory Joseph",0,8,11,7,7,13.3
"16784",5259,2,0,0,3,3,4,4,0,0,13,1,1,11,1,0,0,3277534,"2023-11-28T00:00:00.000Z",17553992,10,"Moses Moody",0,12,14,13,3,15.2
"16785",5260,0,0,0,0,0,0,0,0,0,0,0,0,0,0,0,0,3277534,"2023-11-28T00:00:00.000Z",56677799,10,"Trayce Jackson-Davis",0,0,0,0,0,0
"16786",5261,0,0,0,0,0,0,0,0,0,0,0,0,0,0,0,0,3277534,"2023-11-28T00:00:00.000Z",56677858,10,"Brandin Podziemski",0,0,0,0,0,0
"16787",5262,0,0,0,0,0,0,0,0,0,0,0,0,0,0,0,0,3277534,"2023-11-28T00:00:00.000Z",57875092,10,"Gui Santos",0,0,0,0,0,0
"16788",5263,0,0,0,0,0,0,0,0,0,0,0,0,0,0,0,0,3277534,"2023-11-28T00:00:00.000Z",17896070,10,"Usman Garuba",0,0,0,0,0,0
"16789",5264,0,0,0,0,0,0,0,0,0,0,0,0,0,0,0,0,3277534,"2023-11-28T00:00:00.000Z",45658838,10,"Lester Quinones",0,0,0,0,0,0
"16790",5265,3,1,3,6,4,14,11,6,5,31,3,1,31,6,0,2,1037851,"2023-11-29T00:00:00.000Z",17896026,22,"Franz Wagner",1,37,40,34,9,43.7
"16791",5266,4,0,3,0,0,8,2,3,2,27,1,2,6,4,0,4,1037851,"2023-11-29T00:00:00.000Z",38017683,22,"Paolo Banchero",0,10,14,10,8,12.8
"16792",5267,0,0,0,0,0,0,0,0,0,0,0,0,0,0,0,0,3277534,"2023-11-28T00:00:00.000Z",398,10,"Jerome Robinson",0,0,0,0,0,0
"16793",5268,2,1,6,0,0,5,2,4,4,24,1,1,8,7,0,1,1037851,"2023-11-29T00:00:00.000Z",666442,22,"Goga Bitadze",1,15,17,10,9,21.4
"16794",5269,3,0,2,6,3,15,9,1,1,29,1,4,22,3,2,2,1037851,"2023-11-29T00:00:00.000Z",17896073,22,"Jalen Suggs",2,25,28,25,6,34.1
"16795",5270,3,1,5,2,1,5,3,0,0,27,0,1,7,5,0,2,1037851,"2023-11-29T00:00:00.000Z",56677827,22,"Anthony Black",1,12,15,10,8,18.5
"16796",5271,6,0,4,1,1,7,5,1,1,20,0,1,12,4,1,2,1037851,"2023-11-29T00:00:00.000Z",226,22,"Joe Ingles",1,16,22,18,10,26.8
"16797",5272,4,0,2,2,2,2,2,3,2,19,0,3,8,2,2,1,1037851,"2023-11-29T00:00:00.000Z",196,22,"Gary Harris",2,10,14,12,6,21.4
"16798",5273,5,2,3,5,3,16,9,5,4,26,3,4,25,6,0,1,1037851,"2023-11-29T00:00:00.000Z",3547251,22,"Cole Anthony",2,31,36,30,11,44.7
"16799",5274,1,0,3,3,3,3,3,0,0,10,0,3,9,3,0,1,1037851,"2023-11-29T00:00:00.000Z",38017724,22,"Caleb Houstan",0,12,13,10,4,13.1
"16800",5275,2,0,0,1,0,2,0,0,0,5,0,0,0,0,0,0,1037851,"2023-11-29T00:00:00.000Z",666818,22,"Chuma Okeke",0,0,2,2,2,3
"16801",5276,1,0,2,2,1,8,6,6,5,18,1,1,18,3,1,0,1037778,"2023-11-19T00:00:00.000Z",17896073,22,"Jalen Suggs",1,21,22,19,4,26.1
"16802",5277,0,0,0,0,0,0,0,0,0,0,0,0,0,0,0,0,1037779,"2023-11-19T00:00:00.000Z",404,6,"Ricky Rubio",0,0,0,0,0,0
"16803",5278,0,0,5,9,5,15,7,2,2,27,1,2,21,6,1,2,1037779,"2023-11-19T00:00:00.000Z",375,8,"Michael Porter Jr.",1,27,27,21,6,29.2
"16804",5279,5,2,2,2,0,11,4,6,3,32,2,2,11,4,1,1,1037779,"2023-11-19T00:00:00.000Z",177,8,"Aaron Gordon",3,15,20,16,9,31.3
"16805",5280,7,1,9,0,0,13,8,5,2,28,1,5,18,10,1,3,1037779,"2023-11-19T00:00:00.000Z",246,8,"Nikola Jokic",2,28,35,25,17,43.5
"16806",5281,2,1,0,5,1,9,2,4,4,31,2,1,9,2,1,1,1037779,"2023-11-19T00:00:00.000Z",81,8,"Kentavious Caldwell-Pope",2,11,13,11,4,19.4
"16807",5282,1,0,0,1,1,5,3,0,0,21,0,2,7,0,2,2,1037779,"2023-11-19T00:00:00.000Z",236,8,"Reggie Jackson",2,7,8,8,1,12.5
"16808",5283,6,0,8,15,6,27,11,0,0,39,4,2,28,12,2,1,1037782,"2023-11-19T00:00:00.000Z",17896067,15,"Santi Aldama",2,40,46,34,18,56.4
"16809",5284,1,1,6,3,1,12,5,7,6,34,2,5,17,8,1,2,1037782,"2023-11-19T00:00:00.000Z",231,15,"Jaren Jackson Jr.",2,25,26,18,9,32.1
"16810",5285,0,1,1,0,0,2,1,0,0,15,1,5,2,2,0,0,1037782,"2023-11-19T00:00:00.000Z",48,15,"Bismack Biyombo",1,4,4,2,2,7.4
"16811",5286,3,1,3,0,0,3,1,0,0,26,2,2,2,5,1,1,1037782,"2023-11-19T00:00:00.000Z",666703,15,"John Konchar",2,7,10,5,8,17.5
"16812",5287,8,0,0,14,7,27,11,1,1,37,2,2,30,2,1,2,1037782,"2023-11-19T00:00:00.000Z",3547287,15,"Desmond Bane",1,32,40,38,10,45.4
"16813",5288,5,0,1,2,1,2,1,0,0,15,1,1,3,2,2,1,1037782,"2023-11-19T00:00:00.000Z",48248287,15,"Jacob Gilyard",2,5,10,8,7,17.9
"16814",5289,0,0,0,0,0,0,0,0,0,0,0,0,0,0,0,0,1037782,"2023-11-19T00:00:00.000Z",56677830,15,"GG Jackson",0,0,0,0,0,0
"16815",5290,1,0,1,0,0,0,0,0,0,13,0,1,0,1,1,2,1037781,"2023-11-19T00:00:00.000Z",379,7,"Dwight Powell",1,1,2,1,2,3.7
"16816",5291,0,0,0,2,1,4,1,2,1,10,0,2,4,0,1,1,1037781,"2023-11-19T00:00:00.000Z",38017679,7,"Jaden Hardy",1,4,4,4,0,6
"16817",5292,0,0,3,1,0,1,0,0,0,5,0,0,0,3,0,0,1037781,"2023-11-19T00:00:00.000Z",56677859,7,"Olivier-Maxence Prosper",0,3,3,0,3,3.6
"16818",5293,0,0,0,0,0,3,3,2,1,5,2,1,7,2,0,0,1037781,"2023-11-19T00:00:00.000Z",217,7,"Richaun Holmes",0,9,9,7,2,9.4
"16819",5294,1,1,0,2,0,4,1,0,0,5,0,0,2,0,0,0,1037781,"2023-11-19T00:00:00.000Z",329,7,"Markieff Morris",1,2,3,3,1,6.5
"16820",5295,0,0,0,0,0,0,0,0,0,0,0,0,0,0,0,0,1037781,"2023-11-19T00:00:00.000Z",17896028,7,"Greg Brown III",0,0,0,0,0,0
"16821",5296,0,0,0,0,0,0,0,0,0,0,0,0,0,0,0,0,1037781,"2023-11-19T00:00:00.000Z",114,7,"Seth Curry",0,0,0,0,0,0
"16822",5297,0,0,0,0,0,0,0,0,0,0,0,0,0,0,0,0,1037781,"2023-11-19T00:00:00.000Z",56677873,7,"Dexter Dennis",0,0,0,0,0,0
"16823",5298,0,0,0,0,0,0,0,0,0,0,0,0,0,0,0,0,1037781,"2023-11-19T00:00:00.000Z",257,7,"Maxi Kleber",0,0,0,0,0,0
"16824",5299,0,0,0,0,0,0,0,0,0,0,0,0,0,0,0,0,1037781,"2023-11-19T00:00:00.000Z",17554004,7,"AJ Lawson",0,0,0,0,0,0
"16825",5300,1,0,0,0,0,1,0,0,0,9,1,0,0,1,0,0,1037781,"2023-11-19T00:00:00.000Z",17896044,26,"Kessler Edwards",0,1,2,1,2,2.7
"16826",5301,7,0,3,5,0,17,6,13,12,30,0,3,24,3,0,6,1037681,"2023-11-05T00:00:00.000Z",666581,6,"Darius Garland",0,27,34,31,10,32.1
"16827",5302,4,0,2,2,0,2,0,0,0,14,1,1,0,3,0,1,1037680,"2023-11-05T00:00:00.000Z",56677828,28,"Gradey Dick",0,3,7,4,7,8.6
"16828",5303,4,1,2,2,1,3,1,2,2,15,1,1,5,3,0,0,1037680,"2023-11-05T00:00:00.000Z",3547275,28,"Malachi Flynn",1,8,12,9,7,17.6
"16829",5304,0,0,1,1,0,3,0,0,0,5,0,0,0,1,0,1,1037680,"2023-11-05T00:00:00.000Z",666762,28,"Jalen McDaniels",0,1,1,0,1,0.2
"16830",5305,0,1,4,4,2,4,2,0,0,19,0,2,6,4,0,0,1037680,"2023-11-05T00:00:00.000Z",376,28,"Otto Porter Jr.",1,10,10,6,4,13.8
"16831",5306,0,0,0,0,0,0,0,0,0,0,0,0,0,0,0,0,1037681,"2023-11-05T00:00:00.000Z",404,6,"Ricky Rubio",0,0,0,0,0,0
"16832",5307,1,0,2,2,1,9,3,4,1,26,3,1,8,5,0,0,1037681,"2023-11-05T00:00:00.000Z",475,10,"Andrew Wiggins",0,13,14,9,6,15.5
"16833",5308,8,1,3,3,2,11,5,6,6,29,0,0,18,3,3,1,1037681,"2023-11-05T00:00:00.000Z",185,10,"Draymond Green",4,21,29,26,11,44.6
"16834",5309,5,0,6,0,0,2,1,0,0,15,5,1,2,11,0,0,1037681,"2023-11-05T00:00:00.000Z",282,10,"Kevon Looney",0,13,18,7,16,22.7
"16835",5310,2,0,1,9,3,14,5,2,2,32,2,2,15,3,1,2,1037681,"2023-11-05T00:00:00.000Z",443,10,"Klay Thompson",1,18,20,17,5,22.6
"16836",5311,4,0,2,11,7,16,8,6,5,31,0,0,28,2,1,6,1037681,"2023-11-05T00:00:00.000Z",115,10,"Stephen Curry",1,30,34,32,6,33.4
"16837",5312,0,0,4,1,0,3,0,0,0,13,1,2,0,5,0,1,1037681,"2023-11-05T00:00:00.000Z",407,10,"Dario Saric",0,5,5,0,5,5
"16838",5313,1,0,0,3,1,7,2,0,0,12,2,2,5,2,0,0,1037681,"2023-11-05T00:00:00.000Z",2189,10,"Gary Payton II",0,7,8,6,3,8.9
"16839",5314,2,0,1,5,1,10,2,0,0,25,0,3,5,1,1,0,1037681,"2023-11-05T00:00:00.000Z",367,10,"Chris Paul",1,6,8,7,3,12.2
"16840",5315,1,1,0,1,0,2,0,0,0,17,0,1,0,0,1,1,1037682,"2023-11-05T00:00:00.000Z",247,7,"Derrick Jones Jr.",2,0,1,1,1,6.5
"16841",5316,3,1,4,5,4,9,7,1,0,31,0,3,18,4,0,0,1037682,"2023-11-05T00:00:00.000Z",666965,7,"Grant Williams",1,22,25,21,7,30.3
"16842",5317,1,1,11,0,0,9,7,2,1,32,3,4,15,14,0,2,1037682,"2023-11-05T00:00:00.000Z",56677840,7,"Dereck Lively II",1,29,30,16,15,34.3
"16843",5318,10,1,3,6,2,14,6,4,4,34,0,3,18,3,1,2,1037682,"2023-11-05T00:00:00.000Z",228,7,"Kyrie Irving",2,21,31,28,13,40.6
"16844",5319,9,1,11,9,1,19,8,7,6,36,1,3,23,12,0,4,1037682,"2023-11-05T00:00:00.000Z",132,7,"Luka Doncic",1,35,44,32,21,49.9
"16845",5320,0,0,1,1,1,2,1,0,0,3,0,1,3,1,0,0,1037682,"2023-11-05T00:00:00.000Z",151,7,"Dante Exum",0,4,4,3,1,4.2
"16846",5321,0,0,0,0,0,0,0,0,0,0,0,0,0,0,0,0,1037682,"2023-11-05T00:00:00.000Z",114,7,"Seth Curry",0,0,0,0,0,0
"16847",5322,0,0,3,3,1,3,1,0,0,13,1,1,3,4,3,0,1037681,"2023-11-05T00:00:00.000Z",666940,6,"Dean Wade",3,7,7,3,4,16.8
"16848",5323,0,0,0,0,0,0,0,0,0,1,0,0,0,0,0,0,1037681,"2023-11-05T00:00:00.000Z",3547299,6,"Sam Merrill",0,0,0,0,0,0
"16849",5324,0,0,0,0,0,0,0,0,0,1,0,0,0,0,0,0,1037681,"2023-11-05T00:00:00.000Z",248,6,"Damian Jones",0,0,0,0,0,0
"16850",5325,0,0,0,0,0,0,0,0,0,0,0,0,0,0,0,0,1037681,"2023-11-05T00:00:00.000Z",56677847,6,"Emoni Bates",0,0,0,0,0,0
"16851",5326,2,0,1,3,1,11,5,3,1,16,1,1,12,2,0,1,1038129,"2024-01-12T00:00:00.000Z",472,13,"Russell Westbrook",0,14,16,14,4,16.4
"16852",5327,0,0,1,2,1,3,1,0,0,14,0,1,3,1,2,0,1038130,"2024-01-12T00:00:00.000Z",666923,25,"Matisse Thybulle",2,4,4,3,1,10.2
"16853",5328,3,0,11,2,1,11,6,4,4,32,2,4,17,13,1,4,1038130,"2024-01-12T00:00:00.000Z",38017711,25,"Jabari Walker",1,30,33,20,16,36.1
"16854",5329,1,0,3,10,7,18,12,6,6,35,0,3,37,3,2,4,1038129,"2024-01-12T00:00:00.000Z",172,13,"Paul George",2,40,41,38,4,44.1
"16855",5330,1,0,0,0,0,1,0,2,2,9,0,0,2,0,1,0,1038130,"2024-01-12T00:00:00.000Z",56677791,25,"Kris Murray",1,2,3,3,1,6.5
"16856",5331,2,1,0,1,1,1,1,0,0,9,0,0,3,0,1,0,1038130,"2024-01-12T00:00:00.000Z",47957121,25,"Justin Minaya",2,3,5,5,2,12
"16857",5332,1,0,1,0,0,2,1,2,1,7,0,0,3,1,0,0,1038130,"2024-01-12T00:00:00.000Z",56677829,25,"Rayan Rupert",0,4,5,4,2,5.7
"16858",5333,0,0,0,0,0,0,0,0,0,0,0,0,0,0,0,0,1038130,"2024-01-12T00:00:00.000Z",22,25,"Deandre Ayton",0,0,0,0,0,0
"16859",5334,0,0,4,0,0,5,0,0,0,17,0,0,0,4,0,1,1038124,"2024-01-12T00:00:00.000Z",328,23,"Marcus Morris",0,4,4,0,4,3.8
"16860",5335,0,0,0,0,0,1,1,0,0,3,0,0,2,0,0,0,1038124,"2024-01-12T00:00:00.000Z",3547294,23,"Kenyon Martin Jr.",0,2,2,2,0,2
"16861",5336,0,0,1,0,0,3,1,0,0,3,0,1,2,1,0,0,1038124,"2024-01-12T00:00:00.000Z",17896025,23,"Jaden Springer",0,3,3,2,1,3.2
"16862",5337,1,0,0,2,1,3,1,0,0,3,0,0,3,0,1,0,1038124,"2024-01-12T00:00:00.000Z",260,23,"Furkan Korkmaz",1,3,4,4,1,7.5
"16863",5338,0,0,0,0,0,0,0,0,0,0,0,0,0,0,0,0,1038124,"2024-01-12T00:00:00.000Z",360,23,"Kelly Oubre Jr.",0,0,0,0,0,0
"16864",5339,0,0,0,0,0,0,0,0,0,0,0,0,0,0,0,0,1038124,"2024-01-12T00:00:00.000Z",56913527,23,"Ricky Council IV",0,0,0,0,0,0
"16865",5340,0,0,0,0,0,0,0,0,0,0,0,0,0,0,0,0,1038124,"2024-01-12T00:00:00.000Z",108,23,"Robert Covington",0,0,0,0,0,0
"16866",5341,0,0,0,0,0,0,0,0,0,0,0,0,0,0,0,0,1038124,"2024-01-12T00:00:00.000Z",145,23,"Joel Embiid",0,0,0,0,0,0
"16867",5342,3,0,2,0,0,3,2,0,0,16,0,3,4,2,1,0,1038133,"2024-01-12T00:00:00.000Z",38017693,27,"Blake Wesley",1,6,9,7,5,13.9
"16868",5343,0,0,0,0,0,0,0,0,0,0,0,0,0,0,0,0,1038133,"2024-01-12T00:00:00.000Z",17895854,27,"Charles Bassey",0,0,0,0,0,0
"16869",5344,0,0,0,0,0,0,0,0,0,0,0,0,0,0,0,0,1038133,"2024-01-12T00:00:00.000Z",56677817,27,"Sidy Cissoko",0,0,0,0,0,0
"16870",5345,0,0,0,0,0,0,0,0,0,0,0,0,0,0,0,0,1038133,"2024-01-12T00:00:00.000Z",102,27,"Zach Collins",0,0,0,0,0,0
"16871",5346,0,0,0,0,0,0,0,0,0,0,0,0,0,0,0,0,1038133,"2024-01-12T00:00:00.000Z",17896049,27,"David Duke Jr.",0,0,0,0,0,0
"16872",5348,0,0,0,1,0,2,1,0,0,7,0,1,2,0,0,0,1038133,"2024-01-12T00:00:00.000Z",56677866,4,"Leaky Black",0,2,2,2,0,2
"16873",5349,4,3,3,1,1,4,2,4,2,22,2,2,7,5,2,0,1038129,"2024-01-12T00:00:00.000Z",439,13,"Daniel Theis",5,12,16,11,9,34
"16874",5350,0,0,0,1,0,3,0,0,0,4,0,2,0,0,0,0,1038129,"2024-01-12T00:00:00.000Z",17896022,13,"Brandon Boston Jr.",0,0,0,0,0,0
"16875",5351,0,0,0,0,0,0,0,0,0,0,0,0,0,0,0,0,1038031,"2023-12-30T00:00:00.000Z",38017736,16,"Cole Swider",0,0,0,0,0,0
"16876",5352,0,0,0,0,0,0,0,0,0,0,0,0,0,0,0,0,1038031,"2023-12-30T00:00:00.000Z",19465584,29,"Micah Potter",0,0,0,0,0,0
"16877",5353,0,0,1,2,0,4,2,2,2,12,0,1,6,1,0,0,1038032,"2023-12-30T00:00:00.000Z",56677826,9,"Ausar Thompson",0,7,7,6,1,7.2
"16878",5354,1,0,1,2,1,2,1,0,0,17,0,3,3,1,0,1,1038032,"2023-12-30T00:00:00.000Z",17896071,9,"Isaiah Livers",0,4,5,4,2,4.7
"16879",5355,0,3,4,0,0,4,4,0,0,13,0,1,8,4,0,0,1038032,"2023-12-30T00:00:00.000Z",3547240,9,"James Wiseman",3,12,12,8,4,21.8
"16880",5356,0,0,0,0,0,0,0,0,0,0,0,0,0,0,0,0,1038032,"2023-12-30T00:00:00.000Z",56677792,9,"Marcus Sasser",0,0,0,0,0,0
"16881",5357,0,0,0,0,0,0,0,0,0,0,0,0,0,0,0,0,1038032,"2023-12-30T00:00:00.000Z",56677729,9,"Malcolm Cazalon",0,0,0,0,0,0
"16882",5358,0,0,0,0,0,0,0,0,0,0,0,0,0,0,0,0,1038032,"2023-12-30T00:00:00.000Z",330,9,"Monte Morris",0,0,0,0,0,0
"16883",5359,0,0,0,0,0,0,0,0,0,0,0,0,0,0,0,0,1038032,"2023-12-30T00:00:00.000Z",42097199,9,"Jared Rhoden",0,0,0,0,0,0
"16884",5360,0,0,0,0,0,0,0,0,0,0,0,0,0,0,0,0,1038032,"2023-12-30T00:00:00.000Z",3547267,9,"Isaiah Stewart",0,0,0,0,0,0
"16885",5361,0,0,0,0,0,0,0,0,0,0,0,0,0,0,0,0,1038032,"2023-12-30T00:00:00.000Z",44477024,9,"Stanley Umude",0,0,0,0,0,0
"16886",5362,2,1,7,5,1,20,8,5,5,36,2,4,22,9,2,1,1038032,"2023-12-30T00:00:00.000Z",17896055,28,"Scottie Barnes",3,31,33,24,11,43.8
"16887",5363,4,0,4,2,2,24,14,8,5,40,1,5,35,5,0,2,1038032,"2023-12-30T00:00:00.000Z",416,28,"Pascal Siakam",0,40,44,39,9,45
"16888",5364,5,3,12,0,0,4,2,0,0,35,2,4,4,14,1,0,1038032,"2023-12-30T00:00:00.000Z",373,28,"Jakob Poeltl",4,18,23,9,19,40.3
"16889",5365,4,1,1,9,6,16,8,2,2,39,0,3,24,1,4,0,1038032,"2023-12-30T00:00:00.000Z",3089,28,"Gary Trent Jr.",5,25,29,28,5,46.2
"16890",5366,2,0,1,11,7,13,8,2,2,31,0,2,25,1,1,2,1038033,"2023-12-30T00:00:00.000Z",3547250,12,"Aaron Nesmith",1,26,28,27,3,30.2
"16891",5367,2,2,4,2,1,5,3,4,2,21,0,5,9,4,0,1,1038033,"2023-12-30T00:00:00.000Z",3547264,12,"Jalen Smith",2,13,15,11,6,21.8
"16892",5368,2,0,7,8,6,17,10,3,2,31,1,0,28,8,0,1,1038033,"2023-12-30T00:00:00.000Z",452,12,"Myles Turner",0,36,38,30,10,39.6
"16893",5369,5,0,2,4,2,10,5,2,2,33,3,4,14,5,2,4,1038033,"2023-12-30T00:00:00.000Z",38017507,12,"Andrew Nembhard",2,19,24,19,10,29.5
"16894",5370,23,1,4,9,2,16,8,4,4,36,1,0,22,5,2,2,1038033,"2023-12-30T00:00:00.000Z",3547245,12,"Tyrese Haliburton",3,27,50,45,28,69.5
"16895",5371,0,0,0,5,3,10,7,3,3,26,0,0,20,0,0,2,1038033,"2023-12-30T00:00:00.000Z",38017686,12,"Bennedict Mathurin",0,20,20,20,0,18
"16896",5372,1,0,2,2,1,3,2,1,1,18,0,1,6,2,1,1,1038033,"2023-12-30T00:00:00.000Z",210,12,"Buddy Hield",1,8,9,7,3,11.9
"16897",5373,3,0,0,0,0,3,2,1,1,12,0,0,5,0,0,2,1038033,"2023-12-30T00:00:00.000Z",304,12,"T.J. McConnell",0,5,8,8,3,7.5
"16898",5374,0,1,1,0,0,1,1,0,0,9,0,2,2,1,0,1,1038033,"2023-12-30T00:00:00.000Z",17896035,12,"Isaiah Jackson",1,3,3,2,1,5.2
"16899",5375,2,3,6,1,1,6,4,1,0,20,2,4,9,8,0,0,1038033,"2023-12-30T00:00:00.000Z",3547243,12,"Obi Toppin",3,17,19,11,10,30.6
"16900",5376,0,1,9,4,2,12,6,1,1,29,1,2,15,10,1,4,1037936,"2023-12-17T00:00:00.000Z",378,2,"Kristaps Porzingis",2,25,25,15,10,29
"16901",5377,4,3,5,5,1,9,4,1,1,27,0,1,10,5,1,2,1037936,"2023-12-17T00:00:00.000Z",473,2,"Derrick White",4,15,19,14,9,32
"16902",5378,0,2,5,5,2,12,6,0,0,34,1,2,14,6,0,3,1037936,"2023-12-17T00:00:00.000Z",214,2,"Jrue Holiday",2,20,20,14,6,24.2
"16903",5379,2,1,7,3,2,7,3,0,0,24,1,2,8,8,0,0,1037936,"2023-12-17T00:00:00.000Z",219,2,"Al Horford",1,16,18,10,10,23.6
"16904",5380,0,0,1,3,0,5,2,0,0,17,1,0,4,2,1,1,1037936,"2023-12-17T00:00:00.000Z",17896060,2,"Sam Hauser",1,6,6,4,2,8.4
"16905",5381,3,1,4,1,1,5,2,0,0,21,2,3,5,6,0,1,1037936,"2023-12-17T00:00:00.000Z",3547276,2,"Payton Pritchard",1,11,14,8,9,18.7
"16906",5382,0,0,3,0,0,2,1,0,0,16,0,1,2,3,0,0,1037936,"2023-12-17T00:00:00.000Z",17553967,2,"Neemias Queta",0,5,5,2,3,5.6
"16907",5383,0,0,2,0,0,0,0,0,0,3,0,0,0,2,0,0,1037936,"2023-12-17T00:00:00.000Z",666468,2,"Oshae Brissett",0,2,2,0,2,2.4
"16908",5384,0,0,0,1,0,2,1,0,0,2,0,0,2,0,0,0,1037936,"2023-12-17T00:00:00.000Z",17896094,2,"Dalano Banton",0,2,2,2,0,2
"16909",5385,0,0,0,0,0,0,0,0,0,2,0,1,0,0,0,0,1037936,"2023-12-17T00:00:00.000Z",3547279,2,"Lamar Stevens",0,0,0,0,0,0
"16910",5386,0,0,0,0,0,0,0,0,0,0,0,0,0,0,0,0,1037936,"2023-12-17T00:00:00.000Z",338,2,"Svi Mykhailiuk",0,0,0,0,0,0
"16911",5387,0,0,0,0,0,0,0,0,0,0,0,0,0,0,0,0,1037936,"2023-12-17T00:00:00.000Z",38017707,2,"JD Davison",0,0,0,0,0,0
"16912",5388,0,0,0,0,0,0,0,0,0,0,0,0,0,0,0,0,1037936,"2023-12-17T00:00:00.000Z",261,2,"Luke Kornet",0,0,0,0,0,0
"16913",5390,0,0,0,0,0,0,0,0,0,0,0,0,0,0,0,0,1037936,"2023-12-17T00:00:00.000Z",56677864,2,"Jordan Walsh",0,0,0,0,0,0
"16914",5391,6,0,6,4,0,14,3,2,2,37,2,2,8,8,0,0,1037936,"2023-12-17T00:00:00.000Z",17896026,22,"Franz Wagner",0,16,22,14,14,26.6
"16915",5392,1,0,8,10,4,30,14,6,4,36,2,0,36,10,2,4,1037936,"2023-12-17T00:00:00.000Z",38017683,22,"Paolo Banchero",2,46,47,37,11,51.5
"16916",5393,1,3,6,0,0,6,2,0,0,26,2,3,4,8,2,1,1037936,"2023-12-17T00:00:00.000Z",666442,22,"Goga Bitadze",5,12,13,5,9,29.1
"16917",5394,0,0,5,4,1,9,5,2,2,28,0,4,13,5,1,2,1037936,"2023-12-17T00:00:00.000Z",17896073,22,"Jalen Suggs",1,18,18,13,5,20
"16918",5395,3,0,1,3,1,5,2,3,0,17,1,1,5,2,1,0,1037936,"2023-12-17T00:00:00.000Z",56677827,22,"Anthony Black",1,7,10,8,5,14.9
"16919",5396,0,0,1,3,1,4,2,3,3,16,2,2,8,3,0,0,1037936,"2023-12-17T00:00:00.000Z",38017724,22,"Caleb Houstan",0,11,11,8,3,11.6
"16920",5397,2,0,1,3,0,3,0,0,0,26,0,1,0,1,0,0,1037936,"2023-12-17T00:00:00.000Z",196,22,"Gary Harris",0,1,3,2,3,4.2
"16921",5398,4,0,0,2,0,8,2,2,2,19,1,0,6,1,0,1,1037936,"2023-12-17T00:00:00.000Z",3547251,22,"Cole Anthony",0,7,11,10,5,12.2
"16922",5399,2,0,1,0,0,4,2,0,0,11,0,2,4,1,2,0,1037935,"2023-12-16T00:00:00.000Z",17896033,20,"Miles McBride",2,5,7,6,3,14.2
"16923",5400,0,0,0,0,0,0,0,0,0,0,0,0,0,0,0,0,1037935,"2023-12-16T00:00:00.000Z",666474,20,"Charles Brown",0,0,0,0,0,0
"16924",5401,3,0,6,6,2,8,3,4,3,22,5,2,11,11,1,3,7050288,"2023-12-08T00:00:00.000Z",407,10,"Dario Saric",1,22,25,14,14,28.7
"16925",5402,0,0,0,0,0,0,0,0,0,0,0,0,0,0,0,0,7050288,"2023-12-08T00:00:00.000Z",17896070,10,"Usman Garuba",0,0,0,0,0,0
"16926",5403,0,0,0,0,0,0,0,0,0,0,0,0,0,0,0,0,7050288,"2023-12-08T00:00:00.000Z",45658838,10,"Lester Quinones",0,0,0,0,0,0
"16927",5404,0,0,0,0,0,0,0,0,0,0,0,0,0,0,0,0,7050288,"2023-12-08T00:00:00.000Z",398,10,"Jerome Robinson",0,0,0,0,0,0
"16928",5405,0,0,0,0,0,0,0,0,0,0,0,0,0,0,0,0,7050288,"2023-12-08T00:00:00.000Z",57875092,10,"Gui Santos",0,0,0,0,0,0
"16929",5406,0,0,4,0,0,1,1,0,0,13,0,0,2,4,1,1,7050283,"2023-12-08T00:00:00.000Z",666818,22,"Chuma Okeke",1,6,6,2,4,8.8
"16930",5407,0,0,0,0,0,0,0,0,0,0,0,0,0,0,0,0,7050285,"2023-12-08T00:00:00.000Z",17896041,3,"Keon Johnson",0,0,0,0,0,0
"16931",5408,0,0,0,0,0,0,0,0,0,0,0,0,0,0,0,0,7050285,"2023-12-08T00:00:00.000Z",417,3,"Ben Simmons",0,0,0,0,0,0
"16932",5409,0,0,0,0,0,0,0,0,0,0,0,0,0,0,0,0,7050285,"2023-12-08T00:00:00.000Z",56677841,3,"Dariq Whitehead",0,0,0,0,0,0
"16933",5410,0,0,0,0,0,0,0,0,0,0,0,0,0,0,0,0,7050285,"2023-12-08T00:00:00.000Z",56677722,3,"Jalen Wilson",0,0,0,0,0,0
"16934",5411,4,2,7,4,1,9,6,3,2,27,0,1,15,7,1,0,7050285,"2023-12-08T00:00:00.000Z",3547242,30,"Deni Avdija",3,22,26,19,11,38.4
"16935",5412,2,0,4,0,0,4,2,0,0,16,1,1,4,5,0,2,7050283,"2023-12-08T00:00:00.000Z",462,22,"Moritz Wagner",0,9,11,6,7,11
"16936",5413,0,0,2,0,0,2,1,0,0,4,0,3,2,2,0,2,7050283,"2023-12-08T00:00:00.000Z",666885,22,"Admiral Schofield",0,4,4,2,2,2.4
"16937",5414,0,0,0,0,0,0,0,0,0,0,0,0,0,0,0,0,7050283,"2023-12-08T00:00:00.000Z",85,22,"Wendell Carter Jr.",0,0,0,0,0,0
"16938",5415,0,0,0,0,0,0,0,0,0,0,0,0,0,0,0,0,7050283,"2023-12-08T00:00:00.000Z",165,22,"Markelle Fultz",0,0,0,0,0,0
"16939",5416,0,0,0,0,0,0,0,0,0,0,0,0,0,0,0,0,7050283,"2023-12-08T00:00:00.000Z",38017607,22,"Kevon Harris",0,0,0,0,0,0
"16940",5417,0,0,0,0,0,0,0,0,0,0,0,0,0,0,0,0,7050283,"2023-12-08T00:00:00.000Z",229,22,"Jonathan Isaac",0,0,0,0,0,0
"16941",5418,0,0,0,0,0,0,0,0,0,0,0,0,0,0,0,0,7050283,"2023-12-08T00:00:00.000Z",17553983,22,"Trevelin Queen",0,0,0,0,0,0
"16942",5419,2,0,1,5,0,12,2,2,1,20,1,3,5,2,1,0,7050283,"2023-12-08T00:00:00.000Z",56677826,9,"Ausar Thompson",1,7,9,7,4,13.4
"16943",5420,0,0,3,0,0,0,0,4,2,16,2,2,2,5,0,1,7050283,"2023-12-08T00:00:00.000Z",3547240,9,"James Wiseman",0,7,7,2,5,7
"16944",5421,4,1,0,5,2,13,7,1,1,27,0,5,17,0,1,2,7981426,"2023-12-08T00:00:00.000Z",70,2,"Jaylen Brown",2,17,21,21,4,27
"16945",5422,5,0,6,9,3,18,8,8,6,38,0,3,25,6,1,0,7981426,"2023-12-08T00:00:00.000Z",434,2,"Jayson Tatum",1,31,36,30,11,42.7
"16946",5423,1,0,2,6,3,13,7,4,4,29,1,2,21,3,2,2,7981426,"2023-12-08T00:00:00.000Z",378,2,"Kristaps Porzingis",2,24,25,22,4,30.1
"16947",5424,3,2,1,10,6,16,10,4,4,32,2,4,30,3,2,0,7981426,"2023-12-08T00:00:00.000Z",473,2,"Derrick White",4,33,36,33,6,50.1
"16948",5425,5,1,6,3,1,11,7,1,1,35,0,1,16,6,2,1,7981426,"2023-12-08T00:00:00.000Z",214,2,"Jrue Holiday",3,22,27,21,11,38.7
"16949",5426,0,0,0,0,0,0,0,0,0,0,0,0,0,0,0,0,1037825,"2023-11-25T00:00:00.000Z",38017712,30,"Ryan Rollins",0,0,0,0,0,0
"16950",5427,3,2,9,0,0,12,9,4,3,37,5,3,21,14,3,2,1037826,"2023-11-25T00:00:00.000Z",9,6,"Jarrett Allen",5,35,38,24,17,55.3
"16951",5428,6,0,5,6,2,18,4,13,12,35,0,0,22,5,1,1,1037826,"2023-11-25T00:00:00.000Z",322,6,"Donovan Mitchell",1,27,33,28,11,39
"16952",5429,3,0,1,1,0,6,2,2,2,14,0,1,6,1,1,2,1037826,"2023-11-25T00:00:00.000Z",666581,6,"Darius Garland",1,7,10,9,4,12.7
"16953",5430,8,0,1,4,0,9,3,0,0,26,0,2,6,1,1,0,1037826,"2023-11-25T00:00:00.000Z",277,6,"Caris LeVert",1,7,15,14,9,22.2
"16954",5431,1,0,2,9,3,13,5,0,0,23,0,2,13,2,2,1,1037826,"2023-11-25T00:00:00.000Z",344,6,"Georges Niang",2,15,16,14,3,21.9
"16955",5432,0,0,0,0,0,0,0,0,0,0,0,0,0,0,0,0,1037826,"2023-11-25T00:00:00.000Z",248,6,"Damian Jones",0,0,0,0,0,0
"16956",5433,0,0,0,0,0,0,0,0,0,0,0,0,0,0,0,0,1037826,"2023-11-25T00:00:00.000Z",3547299,6,"Sam Merrill",0,0,0,0,0,0
"16957",5434,10,0,6,8,5,17,9,3,3,30,0,1,26,6,2,2,1037825,"2023-11-25T00:00:00.000Z",490,1,"Trae Young",2,32,42,36,16,52.2
"16958",5435,0,0,0,0,0,0,0,0,0,0,0,0,0,0,0,0,1037824,"2023-11-25T00:00:00.000Z",417,3,"Ben Simmons",0,0,0,0,0,0
"16959",5436,0,0,0,0,0,0,0,0,0,0,0,0,0,0,0,0,1037824,"2023-11-25T00:00:00.000Z",421,3,"Dennis Smith Jr.",0,0,0,0,0,0
"16960",5437,0,0,0,0,0,0,0,0,0,0,0,0,0,0,0,0,1037824,"2023-11-25T00:00:00.000Z",17896048,3,"Cam Thomas",0,0,0,0,0,0
"16961",5438,0,0,0,0,0,0,0,0,0,0,0,0,0,0,0,0,1037824,"2023-11-25T00:00:00.000Z",56677722,3,"Jalen Wilson",0,0,0,0,0,0
"16962",5439,4,0,4,3,2,15,8,0,0,31,1,1,18,5,1,2,1037824,"2023-11-25T00:00:00.000Z",56677785,16,"Jaime Jaquez Jr.",1,23,27,22,9,31
"16963",5440,0,1,3,3,2,7,3,0,0,15,1,2,8,4,0,1,1037824,"2023-11-25T00:00:00.000Z",3092,16,"Haywood Highsmith",1,12,12,8,4,14.8
"16964",5441,0,1,3,7,2,8,3,2,2,26,0,1,10,3,0,2,1037827,"2023-11-25T00:00:00.000Z",38017739,29,"Simone Fontecchio",1,13,13,10,3,14.6
"16965",5442,0,0,7,2,0,11,5,2,2,24,2,1,12,9,0,3,1037827,"2023-11-25T00:00:00.000Z",101,29,"John Collins",0,21,21,12,9,19.8
"16966",5443,0,2,5,3,0,6,3,0,0,27,2,0,6,7,1,0,1037827,"2023-11-25T00:00:00.000Z",11891374,29,"Omer Yurtseven",3,13,13,6,7,23.4
"16967",5444,2,0,2,0,0,7,4,0,0,19,1,3,8,3,2,2,1037827,"2023-11-25T00:00:00.000Z",139,29,"Kris Dunn",2,11,13,10,5,18.6
"16968",5445,5,0,6,9,4,13,4,5,3,27,0,2,15,6,0,5,1037827,"2023-11-25T00:00:00.000Z",56677834,29,"Keyonte George",0,21,26,20,11,24.7
"16969",5446,6,0,1,8,3,13,5,4,3,28,2,0,16,3,0,2,1037827,"2023-11-25T00:00:00.000Z",413,29,"Collin Sexton",0,19,25,22,9,26.6
"16970",5447,0,2,5,1,0,10,5,1,1,21,6,5,11,11,1,3,1037827,"2023-11-25T00:00:00.000Z",38017705,29,"Walker Kessler",3,22,22,11,11,30.2
"16971",5448,4,0,3,3,1,5,2,0,0,22,0,1,5,3,0,2,1037827,"2023-11-25T00:00:00.000Z",666650,29,"Talen Horton-Tucker",0,8,12,9,7,12.6
"16972",5449,3,0,1,7,2,8,3,1,1,22,0,1,9,1,3,1,1037827,"2023-11-25T00:00:00.000Z",38017620,29,"Ochai Agbaji",3,10,13,12,4,22.7
"16973",5450,3,1,5,3,3,6,4,2,2,24,1,0,13,6,1,3,1037827,"2023-11-25T00:00:00.000Z",358,29,"Kelly Olynyk",2,19,22,16,9,27.7
"16974",5451,2,0,3,6,1,17,7,2,2,32,0,2,17,3,2,3,1037757,"2023-11-15T00:00:00.000Z",182,25,"Jerami Grant",2,20,22,19,5,26.6
"16975",5452,3,0,1,3,0,4,0,0,0,22,0,1,0,1,2,1,1037757,"2023-11-15T00:00:00.000Z",56677850,25,"Toumani Camara",2,1,4,3,4,10.7
"16976",5453,0,0,4,0,0,10,3,0,0,26,2,3,6,6,0,2,1037757,"2023-11-15T00:00:00.000Z",22,25,"Deandre Ayton",0,12,12,6,6,11.2
"16977",5454,5,0,4,5,1,12,2,7,6,27,3,3,11,7,0,0,1037757,"2023-11-15T00:00:00.000Z",38017690,25,"Shaedon Sharpe",0,18,23,16,12,26.9
"16978",5455,4,0,1,4,2,13,4,3,3,31,0,4,13,1,1,2,1037757,"2023-11-15T00:00:00.000Z",3547289,25,"Skylar Mays",1,14,18,17,5,21.2
"16979",5456,0,0,2,3,0,6,1,0,0,9,0,1,2,2,0,0,1037757,"2023-11-15T00:00:00.000Z",44477062,25,"Jamaree Bouyea",0,4,4,2,2,4.4
"16980",5457,3,0,0,5,2,10,6,2,2,20,2,2,16,2,0,1,1037757,"2023-11-15T00:00:00.000Z",56783340,25,"Duop Reath",0,18,21,19,5,21.9
"16981",5458,3,0,2,3,1,5,2,0,0,17,0,1,5,2,1,0,1037757,"2023-11-15T00:00:00.000Z",56677791,25,"Kris Murray",1,7,10,8,5,14.9
"16982",5459,0,0,0,0,0,0,0,0,0,2,0,0,0,0,0,0,1037757,"2023-11-15T00:00:00.000Z",47957121,25,"Justin Minaya",0,0,0,0,0,0
"16983",5460,0,0,0,0,0,0,0,0,0,0,0,0,0,0,0,0,1037757,"2023-11-15T00:00:00.000Z",666476,25,"Moses Brown",0,0,0,0,0,0
"16984",5461,0,0,0,0,0,0,0,0,0,0,0,0,0,0,0,0,1037753,"2023-11-15T00:00:00.000Z",38017717,28,"Ron Harper Jr.",0,0,0,0,0,0
"16985",5462,0,0,0,0,0,0,0,0,0,0,0,0,0,0,0,0,1037753,"2023-11-15T00:00:00.000Z",38017710,28,"Christian Koloko",0,0,0,0,0,0
"16986",5463,0,0,0,0,0,0,0,0,0,0,0,0,0,0,0,0,1037753,"2023-11-15T00:00:00.000Z",3089,28,"Gary Trent Jr.",0,0,0,0,0,0
"16987",5464,4,0,4,2,1,9,5,0,0,20,1,3,11,5,2,4,1037753,"2023-11-15T00:00:00.000Z",315,17,"Khris Middleton",2,16,20,15,9,25
"16988",5465,1,0,0,0,0,1,0,0,0,17,2,2,0,2,0,2,1037753,"2023-11-15T00:00:00.000Z",56677852,17,"Andre Jackson Jr.",0,2,3,1,3,1.9
"16989",5466,4,7,6,3,1,10,4,1,1,33,2,2,10,8,1,0,1037753,"2023-11-15T00:00:00.000Z",283,17,"Brook Lopez",8,18,22,14,12,49.6
"16990",5467,3,3,3,5,2,19,12,11,10,35,2,0,36,5,1,4,1037758,"2023-11-16T00:00:00.000Z",79,16,"Jimmy Butler",4,41,44,39,8,54.5
"16991",5468,0,0,1,3,0,5,2,2,2,23,0,3,6,1,0,1,1037758,"2023-11-16T00:00:00.000Z",3092,16,"Haywood Highsmith",0,7,7,6,1,6.2
"16992",5469,4,1,5,0,0,15,8,4,4,33,2,2,20,7,2,2,1037758,"2023-11-16T00:00:00.000Z",4,16,"Bam Adebayo",3,27,31,24,11,41.4
"16993",5470,2,0,0,10,6,14,8,4,4,38,0,3,26,0,0,0,1037758,"2023-11-16T00:00:00.000Z",397,16,"Duncan Robinson",0,26,28,28,2,29
"16994",5471,3,0,2,1,1,4,1,0,0,24,1,3,3,3,3,0,1037758,"2023-11-16T00:00:00.000Z",286,16,"Kyle Lowry",3,6,9,6,6,20.1
"16995",5472,7,0,4,11,6,16,10,2,2,37,0,2,28,4,2,0,1037756,"2023-11-15T00:00:00.000Z",221,26,"Kevin Huerter",2,32,39,35,11,49.3
"16996",5473,5,0,2,9,3,22,10,7,5,38,3,3,28,5,4,3,1037756,"2023-11-15T00:00:00.000Z",161,26,"De'Aaron Fox",4,33,38,33,10,50.5
"16997",5474,5,0,5,5,1,8,1,0,0,20,0,1,3,5,1,3,1037756,"2023-11-15T00:00:00.000Z",324,26,"Malik Monk",1,8,13,8,10,16.5
"16998",5475,1,0,1,2,0,3,0,0,0,9,1,2,0,2,0,0,1037756,"2023-11-15T00:00:00.000Z",38017714,26,"Keon Ellis",0,2,3,1,3,3.9
"16999",5476,1,2,6,5,0,11,4,7,6,36,1,2,14,7,0,2,1037696,"2023-11-08T00:00:00.000Z",666950,4,"P.J. Washington",2,21,22,15,8,27.9
"17000",5477,0,1,5,0,0,5,5,6,4,18,2,4,14,7,0,1,1037696,"2023-11-08T00:00:00.000Z",38017698,4,"Mark Williams",1,21,21,14,7,24.4
"17001",5478,2,0,3,2,1,11,5,3,2,30,2,2,13,5,1,2,1037696,"2023-11-08T00:00:00.000Z",56677823,4,"Brandon Miller",1,18,20,15,7,23
"17002",5479,7,0,1,9,3,22,13,7,5,36,3,3,34,4,1,6,1037696,"2023-11-08T00:00:00.000Z",3547239,4,"LaMelo Ball",1,38,45,41,11,46.3
"17003",5480,1,0,6,0,0,3,2,4,3,16,0,2,7,6,0,0,1037696,"2023-11-08T00:00:00.000Z",3547282,4,"Nick Richards",0,13,14,8,7,15.7
"17004",5481,1,0,3,0,0,0,0,2,2,15,0,2,2,3,0,2,1037696,"2023-11-08T00:00:00.000Z",38017708,4,"Bryce McGowens",0,5,6,3,4,5.1
"17005",5482,0,0,1,2,1,7,4,0,0,18,0,2,9,1,1,1,1037696,"2023-11-08T00:00:00.000Z",3547253,4,"Theo Maledon",1,10,10,9,1,12.2
"17006",5483,1,1,3,2,0,3,0,0,0,21,2,3,0,5,0,0,1037696,"2023-11-08T00:00:00.000Z",18678001,4,"JT Thor",1,5,6,1,6,10.5
"17007",5484,0,0,1,0,0,0,0,0,0,10,0,0,0,1,1,2,1037696,"2023-11-08T00:00:00.000Z",422,4,"Ish Smith",1,1,1,0,1,2.2
"17008",5485,0,0,1,1,1,2,2,0,0,4,0,0,5,1,1,1,1037696,"2023-11-08T00:00:00.000Z",56677846,4,"Nick Smith Jr.",1,6,6,5,1,8.2
"17009",5486,0,1,0,0,0,1,0,0,0,4,0,0,0,0,0,0,1037696,"2023-11-08T00:00:00.000Z",56677866,4,"Leaky Black",1,0,0,0,0,3
"17010",5487,0,0,0,0,0,0,0,0,0,0,0,0,0,0,0,0,1037696,"2023-11-08T00:00:00.000Z",56677848,4,"Amari Bailey",0,0,0,0,0,0
"17011",5488,0,0,0,0,0,0,0,0,0,0,0,0,0,0,0,0,1037696,"2023-11-08T00:00:00.000Z",17896037,4,"James Bouknight",0,0,0,0,0,0
"17012",5489,0,0,0,0,0,0,0,0,0,0,0,0,0,0,0,0,1037696,"2023-11-08T00:00:00.000Z",62,4,"Miles Bridges",0,0,0,0,0,0
"17013",5490,0,0,0,0,0,0,0,0,0,0,0,0,0,0,0,0,1037696,"2023-11-08T00:00:00.000Z",666748,4,"Cody Martin",0,0,0,0,0,0
"17014",5491,0,0,0,0,0,0,0,0,0,0,0,0,0,0,0,0,1037696,"2023-11-08T00:00:00.000Z",347,4,"Frank Ntilikina",0,0,0,0,0,0
"17015",5492,0,0,0,0,0,0,0,0,0,0,0,0,0,0,0,0,1037696,"2023-11-08T00:00:00.000Z",403,4,"Terry Rozier",0,0,0,0,0,0
"17016",5493,4,0,6,11,4,24,13,3,3,31,3,1,33,9,0,2,1037696,"2023-11-08T00:00:00.000Z",265,30,"Kyle Kuzma",0,42,46,37,13,47.8
"17017",5494,0,1,4,6,3,8,5,0,0,19,0,0,13,4,1,0,1037698,"2023-11-08T00:00:00.000Z",17896060,2,"Sam Hauser",2,17,17,13,4,23.8
"17018",5495,3,2,5,6,1,6,1,0,0,26,0,1,3,5,0,1,1037698,"2023-11-08T00:00:00.000Z",219,2,"Al Horford",2,8,11,6,8,18.5
"17019",5496,4,0,0,2,0,4,0,0,0,16,2,0,0,2,0,1,1037698,"2023-11-08T00:00:00.000Z",3547276,2,"Payton Pritchard",0,2,6,4,6,7.4
"17020",5497,0,0,0,0,0,0,0,0,0,3,0,0,0,0,0,0,1037698,"2023-11-08T00:00:00.000Z",261,2,"Luke Kornet",0,0,0,0,0,0
"17021",5498,0,0,0,0,0,0,0,0,0,0,0,0,0,0,0,0,1037698,"2023-11-08T00:00:00.000Z",338,2,"Svi Mykhailiuk",0,0,0,0,0,0
"17022",5499,0,0,0,0,0,0,0,0,0,0,0,0,0,0,0,0,1037698,"2023-11-08T00:00:00.000Z",3547279,2,"Lamar Stevens",0,0,0,0,0,0
"17023",5500,0,0,0,0,0,0,0,0,0,0,0,0,0,0,0,0,1037698,"2023-11-08T00:00:00.000Z",38017707,2,"JD Davison",0,0,0,0,0,0
"17024",5501,1,0,9,7,4,27,8,6,6,38,5,1,26,14,0,2,1037601,"2023-10-25T00:00:00.000Z",3547238,18,"Anthony Edwards",0,40,41,27,15,42.3
"17025",5502,3,1,3,4,1,9,4,2,2,31,1,1,11,4,1,1,1037601,"2023-10-25T00:00:00.000Z",104,18,"Mike Conley",2,15,18,14,7,25.3
"17026",5503,6,0,2,8,1,24,10,1,1,36,0,3,22,2,1,2,1037605,"2023-10-25T00:00:00.000Z",228,7,"Kyrie Irving",1,24,30,28,8,34.4
"17027",5504,4,0,4,10,3,14,5,4,4,28,2,0,17,6,1,1,1037605,"2023-10-25T00:00:00.000Z",191,7,"Tim Hardaway Jr.",1,23,27,21,10,32.2
"17028",5505,1,1,5,0,0,8,7,3,2,31,5,4,16,10,1,1,1037605,"2023-10-25T00:00:00.000Z",56677840,7,"Dereck Lively II",2,26,27,17,11,34.5
"17029",5506,1,0,0,2,2,5,3,4,3,30,2,4,11,2,1,0,1037605,"2023-10-25T00:00:00.000Z",3547258,7,"Josh Green",1,13,14,12,3,17.9
"17030",5507,0,0,1,1,0,2,1,1,1,8,0,1,3,1,0,0,1037605,"2023-10-25T00:00:00.000Z",151,7,"Dante Exum",0,4,4,3,1,4.2
"17031",5508,0,0,0,0,0,0,0,0,0,4,0,0,0,0,0,0,1037605,"2023-10-25T00:00:00.000Z",114,7,"Seth Curry",0,0,0,0,0,0
"17032",5509,0,0,3,2,0,9,2,7,5,20,0,3,9,3,0,3,1037604,"2023-10-25T00:00:00.000Z",413,29,"Collin Sexton",0,12,12,9,3,9.6
"17033",5510,2,0,2,3,1,5,3,1,1,19,0,0,8,2,0,1,1037604,"2023-10-25T00:00:00.000Z",56677834,29,"Keyonte George",0,10,12,10,4,12.4
"17034",5511,0,0,1,0,0,0,0,2,1,2,0,0,1,1,0,0,1037604,"2023-10-25T00:00:00.000Z",56677824,29,"Taylor Hendricks",0,2,2,1,1,2.2
"17035",5512,0,0,0,0,0,2,0,0,0,2,1,0,0,1,0,0,1037604,"2023-10-25T00:00:00.000Z",56677842,29,"Brice Sensabaugh",0,1,1,0,1,1.2
"17036",5513,1,0,3,5,2,6,2,2,2,23,0,0,8,3,0,2,1037606,"2023-10-25T00:00:00.000Z",380,13,"Norman Powell",0,11,12,9,4,11.1
"17037",5514,2,0,5,0,0,4,2,4,2,17,3,0,6,8,0,0,1037606,"2023-10-25T00:00:00.000Z",371,13,"Mason Plumlee",0,14,16,8,10,18.6
"17038",5515,0,0,0,0,0,0,0,0,0,0,0,0,0,0,0,0,1037606,"2023-10-25T00:00:00.000Z",17896022,13,"Brandon Boston Jr.",0,0,0,0,0,0
"17039",5516,0,0,0,0,0,0,0,0,0,0,0,0,0,0,0,0,1037606,"2023-10-25T00:00:00.000Z",666743,13,"Terance Mann",0,0,0,0,0,0
"17040",5517,0,0,0,0,0,0,0,0,0,0,0,0,0,0,0,0,1037606,"2023-10-25T00:00:00.000Z",328,13,"Marcus Morris",0,0,0,0,0,0
"17041",5518,0,0,0,0,0,0,0,0,0,0,0,0,0,0,0,0,1037606,"2023-10-25T00:00:00.000Z",17896051,13,"Joshua Primo",0,0,0,0,0,0
"17042",5519,1,0,0,6,2,7,3,0,0,20,1,0,8,1,1,2,1037606,"2023-10-25T00:00:00.000Z",666923,25,"Matisse Thybulle",1,9,10,9,2,11.7
"17043",5520,1,1,1,4,0,12,5,4,3,30,2,1,13,3,0,3,1037606,"2023-10-25T00:00:00.000Z",182,25,"Jerami Grant",1,16,17,14,4,18.1
"17044",5521,0,0,0,0,0,0,0,0,0,0,0,0,0,0,0,0,1037603,"2023-10-25T00:00:00.000Z",17896097,19,"Jose Alvarado",0,0,0,0,0,0
"17045",5522,0,0,0,0,0,0,0,0,0,0,0,0,0,0,0,0,1037603,"2023-10-25T00:00:00.000Z",3547293,19,"Naji Marshall",0,0,0,0,0,0
"17046",5523,0,0,0,0,0,0,0,0,0,0,0,0,0,0,0,0,1037605,"2023-10-25T00:00:00.000Z",38017679,7,"Jaden Hardy",0,0,0,0,0,0
"17047",5524,0,0,0,0,0,0,0,0,0,0,0,0,0,0,0,0,1037605,"2023-10-25T00:00:00.000Z",217,7,"Richaun Holmes",0,0,0,0,0,0
"17048",5525,0,0,0,0,0,0,0,0,0,0,0,0,0,0,0,0,1037605,"2023-10-25T00:00:00.000Z",329,7,"Markieff Morris",0,0,0,0,0,0
"17049",5527,3,1,1,2,1,8,3,5,4,34,1,2,11,2,1,2,1038052,"2024-01-02T00:00:00.000Z",3547246,27,"Devin Vassell",2,13,16,14,5,21.9
"17050",5528,1,0,1,0,0,5,1,0,0,8,0,1,2,1,0,0,1038052,"2024-01-02T00:00:00.000Z",38017692,27,"Malaki Branham",0,3,4,3,2,4.7
"17051",5529,4,0,5,4,1,16,7,5,4,31,1,4,19,6,1,3,1038052,"2024-01-02T00:00:00.000Z",666682,27,"Keldon Johnson",1,25,29,23,10,32.2
"17052",5530,2,0,3,0,0,6,2,0,0,14,4,4,4,7,0,2,1038052,"2024-01-02T00:00:00.000Z",38017730,27,"Dominick Barlow",0,11,13,6,9,13.4
"17053",5531,2,0,6,2,0,3,0,0,0,13,0,2,0,6,0,2,1038052,"2024-01-02T00:00:00.000Z",359,27,"Cedi Osman",0,6,8,2,8,8.2
"17054",5532,4,0,4,3,0,6,1,0,0,25,0,2,2,4,1,0,1038052,"2024-01-02T00:00:00.000Z",3547274,27,"Tre Jones",1,6,10,6,8,15.8
"17055",5533,0,0,0,4,1,4,1,0,0,16,0,0,3,0,0,0,1038052,"2024-01-02T00:00:00.000Z",305,27,"Doug McDermott",0,3,3,3,0,3
"17056",5534,0,1,0,1,1,1,1,0,0,2,0,0,3,0,0,1,1038052,"2024-01-02T00:00:00.000Z",17896059,27,"Sandro Mamukelashvili",1,3,3,3,0,5
"17057",5535,1,0,1,2,0,8,5,2,0,21,0,4,10,1,2,1,1038052,"2024-01-02T00:00:00.000Z",38017693,27,"Blake Wesley",2,11,12,11,2,17.7
"17058",5536,0,0,0,0,0,0,0,0,0,0,0,0,0,0,0,0,1038052,"2024-01-02T00:00:00.000Z",3547163,27,"Mamadi Diakite",0,0,0,0,0,0
"17059",5537,0,0,0,0,0,0,0,0,0,0,0,0,0,0,0,0,1038052,"2024-01-02T00:00:00.000Z",180,27,"Devonte' Graham",0,0,0,0,0,0
"17060",5538,0,0,0,0,0,0,0,0,0,0,0,0,0,0,0,0,1038052,"2024-01-02T00:00:00.000Z",17895854,27,"Charles Bassey",0,0,0,0,0,0
"17061",5539,0,0,0,0,0,0,0,0,0,0,0,0,0,0,0,0,1038052,"2024-01-02T00:00:00.000Z",56677817,27,"Sidy Cissoko",0,0,0,0,0,0
"17062",5540,0,0,0,0,0,0,0,0,0,0,0,0,0,0,0,0,1038052,"2024-01-02T00:00:00.000Z",102,27,"Zach Collins",0,0,0,0,0,0
"17063",5541,0,0,0,0,0,0,0,0,0,0,0,0,0,0,0,0,1038052,"2024-01-02T00:00:00.000Z",17896049,27,"David Duke Jr.",0,0,0,0,0,0
"17064",5542,0,0,0,0,0,0,0,0,0,0,0,0,0,0,0,0,1038054,"2024-01-02T00:00:00.000Z",3547271,21,"Aleksej Pokusevski",0,0,0,0,0,0
"17065",5543,2,1,0,2,0,4,2,0,0,21,2,4,4,2,1,2,1038051,"2024-01-02T00:00:00.000Z",17896025,23,"Jaden Springer",2,6,8,6,4,13.4
"17066",5544,0,0,4,0,0,3,1,0,0,13,0,2,2,4,2,0,1038051,"2024-01-02T00:00:00.000Z",3547270,23,"Paul Reed",2,6,6,2,4,12.8
"17067",5545,1,0,0,0,0,3,0,0,0,9,0,0,0,0,0,0,1038051,"2024-01-02T00:00:00.000Z",3547294,23,"Kenyon Martin Jr.",0,0,1,1,1,1.5
"17068",5546,0,0,2,0,0,1,0,0,0,7,0,3,0,2,1,2,1038051,"2024-01-02T00:00:00.000Z",28,23,"Mo Bamba",1,2,2,0,2,3.4
"17069",5547,0,0,0,1,0,1,0,0,0,6,0,0,0,0,0,0,1038051,"2024-01-02T00:00:00.000Z",56913527,23,"Ricky Council IV",0,0,0,0,0,0
"17070",5548,0,0,2,0,0,2,0,0,0,4,0,0,0,2,0,2,1038051,"2024-01-02T00:00:00.000Z",38017732,23,"Kenneth Lofton Jr.",0,2,2,0,2,0.4
"17071",5549,0,0,0,0,0,0,0,0,0,0,0,0,0,0,0,0,1038051,"2024-01-02T00:00:00.000Z",108,23,"Robert Covington",0,0,0,0,0,0
"17072",5550,5,1,4,2,2,9,5,0,0,25,1,2,12,5,0,1,1038053,"2024-01-02T00:00:00.000Z",227,19,"Brandon Ingram",1,17,22,17,10,27.5
"17073",5551,6,3,5,10,2,11,2,0,0,28,1,2,6,6,1,2,1037960,"2023-12-20T00:00:00.000Z",351,3,"Royce O'Neale",4,12,18,12,12,32.2
"17074",5552,0,1,0,0,0,1,0,0,0,4,0,1,0,0,0,1,1037960,"2023-12-20T00:00:00.000Z",174,3,"Harry Giles III",1,0,0,0,0,2
"17075",5553,0,0,0,0,0,0,0,0,0,0,0,0,0,0,0,0,1037961,"2023-12-20T00:00:00.000Z",38017710,28,"Christian Koloko",0,0,0,0,0,0
"17076",5554,0,0,0,0,0,0,0,0,0,0,0,0,0,0,0,0,1037961,"2023-12-20T00:00:00.000Z",56677869,28,"Markquis Nowell",0,0,0,0,0,0
"17077",5555,0,0,0,0,0,0,0,0,0,0,0,0,0,0,0,0,1037961,"2023-12-20T00:00:00.000Z",2309958,28,"Jontay Porter",0,0,0,0,0,0
"17078",5556,2,0,5,7,2,13,5,0,0,32,1,1,12,6,1,0,1037961,"2023-12-20T00:00:00.000Z",375,8,"Michael Porter Jr.",1,18,20,14,8,25.2
"17079",5557,0,0,0,0,0,0,0,0,0,0,0,0,0,0,0,0,1037961,"2023-12-20T00:00:00.000Z",38017727,8,"Collin Gillespie",0,0,0,0,0,0
"17080",5558,0,0,0,0,0,0,0,0,0,0,0,0,0,0,0,0,1037961,"2023-12-20T00:00:00.000Z",215,8,"Justin Holiday",0,0,0,0,0,0
"17081",5559,0,0,0,0,0,0,0,0,0,0,0,0,0,0,0,0,1037956,"2023-12-20T00:00:00.000Z",56677842,29,"Brice Sensabaugh",0,0,0,0,0,0
"17082",5560,7,0,7,10,2,26,10,3,3,34,2,0,25,9,1,1,1037957,"2023-12-20T00:00:00.000Z",403,4,"Terry Rozier",1,34,41,32,16,48.3
"17083",5561,2,0,3,8,1,21,4,6,6,33,2,0,15,5,2,2,1037960,"2023-12-20T00:00:00.000Z",61,3,"Mikal Bridges",2,20,22,17,7,28
"17084",5562,2,0,4,6,4,14,8,1,0,28,0,3,20,4,0,0,1037960,"2023-12-20T00:00:00.000Z",666679,3,"Cameron Johnson",0,24,26,22,6,27.8
"17085",5563,2,4,4,0,0,5,3,0,0,26,4,5,6,8,0,0,1037960,"2023-12-20T00:00:00.000Z",666508,3,"Nicolas Claxton",4,14,16,8,10,30.6
"17086",5564,5,0,1,7,4,18,8,1,0,32,1,2,20,2,0,1,1037960,"2023-12-20T00:00:00.000Z",17896048,3,"Cam Thomas",0,22,27,25,7,28.9
"17087",5565,2,0,2,8,2,11,3,2,2,30,0,0,10,2,1,2,1037960,"2023-12-20T00:00:00.000Z",130,3,"Spencer Dinwiddie",1,12,14,12,4,16.4
"17088",5566,0,0,0,0,0,0,0,0,0,0,0,0,0,0,0,0,1037957,"2023-12-20T00:00:00.000Z",56677861,12,"Ben Sheppard",0,0,0,0,0,0
"17089",5567,3,0,11,3,2,5,2,4,4,31,2,2,10,13,1,2,1037960,"2023-12-20T00:00:00.000Z",202,20,"Josh Hart",1,23,26,13,16,31.1
"17090",5568,2,1,0,6,4,12,7,4,1,24,0,0,19,0,1,1,1037960,"2023-12-20T00:00:00.000Z",3547269,20,"Immanuel Quickley",2,19,21,21,2,27
"17091",5569,0,1,1,4,1,7,2,0,0,18,0,1,5,1,1,0,1037960,"2023-12-20T00:00:00.000Z",17895858,20,"Quentin Grimes",2,6,6,5,1,12.2
"17092",5570,0,2,2,0,0,2,1,0,0,13,0,3,2,2,0,0,1037960,"2023-12-20T00:00:00.000Z",173,20,"Taj Gibson",2,4,4,2,2,10.4
"17093",5571,0,0,0,0,0,3,2,0,0,3,0,1,4,0,0,0,1037960,"2023-12-20T00:00:00.000Z",666675,20,"DaQuan Jeffries",0,4,4,4,0,4
"17094",5572,0,0,0,1,0,1,0,0,0,3,0,0,0,0,0,0,1037960,"2023-12-20T00:00:00.000Z",17896033,20,"Miles McBride",0,0,0,0,0,0
"17095",5573,0,0,0,0,0,0,0,0,0,0,0,0,0,0,0,0,1037960,"2023-12-20T00:00:00.000Z",666474,20,"Charles Brown",0,0,0,0,0,0
"17096",5574,0,0,0,0,0,0,0,0,0,0,0,0,0,0,0,0,1037960,"2023-12-20T00:00:00.000Z",59421201,20,"Jaylen Martin",0,0,0,0,0,0
"17097",5575,0,0,0,0,0,0,0,0,0,0,0,0,0,0,0,0,1037960,"2023-12-20T00:00:00.000Z",399,20,"Mitchell Robinson",0,0,0,0,0,0
"17098",5576,0,0,0,0,0,0,0,0,0,0,0,0,0,0,0,0,7050289,"2023-12-08T00:00:00.000Z",56677817,27,"Sidy Cissoko",0,0,0,0,0,0
"17099",5577,0,0,0,0,0,0,0,0,0,0,0,0,0,0,0,0,7050289,"2023-12-08T00:00:00.000Z",56677870,27,"Sir'Jabari Rice",0,0,0,0,0,0
"17100",5578,10,0,5,2,0,24,7,10,6,39,1,2,20,6,3,2,7050289,"2023-12-08T00:00:00.000Z",125,5,"DeMar DeRozan",3,26,36,30,16,49.2
"17101",5579,3,1,5,3,2,11,8,4,2,34,1,3,20,6,1,0,7050289,"2023-12-08T00:00:00.000Z",3547248,5,"Patrick Williams",2,26,29,23,9,37.7
"17102",5580,2,1,6,2,0,22,9,3,3,36,10,2,21,16,0,0,7050289,"2023-12-08T00:00:00.000Z",460,5,"Nikola Vucevic",1,37,39,23,18,46.2
"17103",5581,2,0,2,2,0,5,2,0,0,18,1,2,4,3,1,2,7050289,"2023-12-08T00:00:00.000Z",89,5,"Alex Caruso",1,7,9,6,5,11.6
"17104",5582,1,0,0,1,0,1,0,0,0,4,0,0,0,0,0,0,7050287,"2023-12-08T00:00:00.000Z",38017700,18,"Wendell Moore Jr.",0,0,1,1,1,1.5
"17105",5583,0,0,0,0,0,0,0,0,0,0,0,0,0,0,0,0,7050287,"2023-12-08T00:00:00.000Z",56677851,18,"Jaylen Clark",0,0,0,0,0,0
"17106",5584,1,0,1,2,0,4,1,0,0,14,0,3,2,1,2,1,7050290,"2023-12-08T00:00:00.000Z",38017709,8,"Christian Braun",2,3,4,3,2,9.7
"17107",5585,6,0,4,7,5,15,9,1,1,39,0,0,24,4,1,3,7050289,"2023-12-08T00:00:00.000Z",666956,5,"Coby White",1,28,34,30,10,37.8
"17108",5586,3,0,3,2,0,5,2,0,0,26,0,1,4,3,1,0,7050289,"2023-12-08T00:00:00.000Z",17895983,5,"Ayo Dosunmu",1,7,10,7,6,15.1
"17109",5587,0,0,0,0,0,0,0,0,0,0,0,0,0,0,0,0,7050289,"2023-12-08T00:00:00.000Z",17896116,5,"Terry Taylor",0,0,0,0,0,0
"17110",5588,0,0,0,0,0,0,0,0,0,0,0,0,0,0,0,0,7050289,"2023-12-08T00:00:00.000Z",38017719,5,"Dalen Terry",0,0,0,0,0,0
"17111",5589,0,0,0,0,0,0,0,0,0,0,0,0,0,0,0,0,7050289,"2023-12-08T00:00:00.000Z",27,5,"Lonzo Ball",0,0,0,0,0,0
"17112",5590,0,0,0,0,0,0,0,0,0,0,0,0,0,0,0,0,7050289,"2023-12-08T00:00:00.000Z",56677874,5,"Onuralp Bitim",0,0,0,0,0,0
"17113",5591,0,0,0,0,0,0,0,0,0,0,0,0,0,0,0,0,7050289,"2023-12-08T00:00:00.000Z",268,5,"Zach LaVine",0,0,0,0,0,0
"17114",5592,0,0,0,0,0,0,0,0,0,0,0,0,0,0,0,0,7050289,"2023-12-08T00:00:00.000Z",45969255,5,"Justin Lewis",0,0,0,0,0,0
"17115",5593,0,0,0,0,0,0,0,0,0,0,0,0,0,0,0,0,7050289,"2023-12-08T00:00:00.000Z",56677860,5,"Adama Sanogo",0,0,0,0,0,0
"17116",5594,3,2,0,3,0,5,0,0,0,29,2,3,0,2,2,1,7996365,"2023-12-08T00:00:00.000Z",356,24,"Josh Okogie",4,2,5,3,5,17.9
"17117",5595,2,0,3,3,1,6,2,2,0,17,1,0,5,4,0,0,7996365,"2023-12-08T00:00:00.000Z",32,24,"Keita Bates-Diop",0,9,11,7,6,12.8
"17118",5596,3,0,8,4,2,13,6,4,1,30,1,3,15,9,1,0,7996365,"2023-12-08T00:00:00.000Z",349,24,"Jusuf Nurkic",1,24,27,18,12,33.3
"17119",5597,3,1,0,7,3,13,7,2,2,38,0,3,19,0,2,4,7996365,"2023-12-08T00:00:00.000Z",178,24,"Eric Gordon",3,19,22,22,3,28.5
"17120",5598,7,0,7,2,2,14,10,9,6,37,0,4,28,7,1,3,7996365,"2023-12-08T00:00:00.000Z",57,24,"Devin Booker",1,35,42,35,14,46.9
"17121",5599,6,0,3,1,0,6,3,2,2,20,2,2,8,5,0,2,7996365,"2023-12-08T00:00:00.000Z",18678058,24,"Jordan Goodwin",0,13,19,14,11,21
"17122",5600,1,2,4,4,0,9,4,2,2,23,0,1,10,4,2,0,7996365,"2023-12-08T00:00:00.000Z",314,24,"Chimezie Metu",4,14,15,11,5,28.3
"17123",5601,0,0,4,4,2,10,4,0,0,25,0,3,10,4,0,3,3277506,"2023-11-24T00:00:00.000Z",475,10,"Andrew Wiggins",0,14,14,10,4,11.8
"17124",5602,0,0,0,0,0,0,0,0,0,0,0,0,0,0,0,0,3277500,"2023-11-24T00:00:00.000Z",666474,20,"Charles Brown",0,0,0,0,0,0
"17125",5603,0,0,0,0,0,0,0,0,0,0,0,0,0,0,0,0,3277500,"2023-11-24T00:00:00.000Z",56677795,20,"Jacob Toppin",0,0,0,0,0,0
"17126",5604,0,0,0,0,0,0,0,0,0,0,0,0,0,0,0,0,3277500,"2023-11-24T00:00:00.000Z",17896089,20,"Duane Washington Jr.",0,0,0,0,0,0
"17127",5605,0,0,0,0,0,0,0,0,0,0,0,0,0,0,0,0,3277505,"2023-11-24T00:00:00.000Z",38017688,26,"Keegan Murray",0,0,0,0,0,0
"17128",5606,2,3,3,0,0,6,3,0,0,14,3,1,6,6,0,1,3277502,"2023-11-24T00:00:00.000Z",24,9,"Marvin Bagley III",3,12,14,8,8,24.2
"17129",5607,3,1,0,6,1,16,9,9,6,32,2,3,25,2,1,3,3277502,"2023-11-24T00:00:00.000Z",38017682,9,"Jaden Ivey",2,27,30,28,5,34.9
"17130",5608,5,0,3,4,2,26,10,9,9,38,0,0,31,3,0,4,3277502,"2023-11-24T00:00:00.000Z",17896075,9,"Cade Cunningham",0,34,39,36,8,38.1
"17131",5609,4,1,9,1,0,10,5,4,3,29,4,5,13,13,1,2,3277502,"2023-11-24T00:00:00.000Z",38017694,9,"Jalen Duren",2,26,30,17,17,38.6
"17132",5610,0,0,2,4,2,5,3,0,0,26,0,2,8,2,0,0,3277502,"2023-11-24T00:00:00.000Z",17896071,9,"Isaiah Livers",0,10,10,8,2,10.4
"17133",5611,1,1,2,3,2,6,2,0,0,14,0,1,6,2,1,2,3277502,"2023-11-24T00:00:00.000Z",77,9,"Alec Burks",2,8,9,7,3,13.9
"17134",5612,3,0,1,0,0,6,3,0,0,17,0,0,6,1,0,0,3277502,"2023-11-24T00:00:00.000Z",3547241,9,"Killian Hayes",0,7,10,9,4,11.7
"17135",5613,0,2,1,0,0,1,0,0,0,8,1,3,0,2,1,1,3277502,"2023-11-24T00:00:00.000Z",44477024,9,"Stanley Umude",3,2,2,0,2,10.4
"17136",5614,0,0,0,0,0,1,0,0,0,5,0,0,0,0,0,0,3277502,"2023-11-24T00:00:00.000Z",56677792,9,"Marcus Sasser",0,0,0,0,0,0
"17137",5615,0,0,0,0,0,0,0,0,0,0,0,0,0,0,0,0,3277502,"2023-11-24T00:00:00.000Z",259,9,"Kevin Knox",0,0,0,0,0,0
"17138",5616,1,0,5,10,6,12,7,0,0,33,0,3,20,5,0,3,3277504,"2023-11-24T00:00:00.000Z",17896045,30,"Corey Kispert",0,25,26,21,6,24.5
"17139",5617,1,0,4,2,1,5,2,2,2,18,0,2,7,4,0,0,3277504,"2023-11-24T00:00:00.000Z",167,30,"Danilo Gallinari",0,11,12,8,5,13.3
"17140",5618,0,0,2,7,3,11,6,1,0,24,0,2,15,2,1,0,3277504,"2023-11-24T00:00:00.000Z",414,30,"Landry Shamet",1,17,17,15,2,20.4
"17141",5619,0,0,0,0,0,0,0,0,0,0,0,0,0,0,0,0,3277504,"2023-11-24T00:00:00.000Z",38017704,30,"Patrick Baldwin Jr.",0,0,0,0,0,0
"17142",5620,0,0,0,0,0,0,0,0,0,0,0,0,0,0,0,0,3277504,"2023-11-24T00:00:00.000Z",18677954,30,"Jared Butler",0,0,0,0,0,0
"17143",5621,0,0,0,0,0,0,0,0,0,0,0,0,0,0,0,0,3277504,"2023-11-24T00:00:00.000Z",38124126,30,"John Butler Jr.",0,0,0,0,0,0
"17144",5622,3,1,7,7,1,17,8,4,3,34,1,0,20,8,1,1,3277507,"2023-11-24T00:00:00.000Z",274,13,"Kawhi Leonard",2,28,31,23,11,39.1
"17145",5623,2,0,7,12,4,30,14,3,2,39,1,3,34,8,0,2,3277507,"2023-11-24T00:00:00.000Z",172,13,"Paul George",0,42,44,36,10,44.6
"17146",5624,0,1,2,0,0,6,5,1,1,21,3,4,11,5,0,4,3277507,"2023-11-24T00:00:00.000Z",493,13,"Ivica Zubac",1,16,16,11,5,16
"17147",5625,5,1,2,1,1,4,3,0,0,24,0,5,7,2,2,0,3277507,"2023-11-24T00:00:00.000Z",666743,13,"Terance Mann",3,9,14,12,7,25.9
"17148",5626,0,0,0,0,0,0,0,0,0,0,0,0,0,0,0,0,3277447,"2023-11-17T00:00:00.000Z",56677806,1,"Mouhamed Gueye",0,0,0,0,0,0
"17149",5627,0,0,0,0,0,0,0,0,0,0,0,0,0,0,0,0,3277447,"2023-11-17T00:00:00.000Z",56677855,1,"Seth Lundy",0,0,0,0,0,0
"17150",5628,0,0,0,0,0,0,0,0,0,0,0,0,0,0,0,0,3277447,"2023-11-17T00:00:00.000Z",56677875,1,"Miles Norris",0,0,0,0,0,0
"17151",5629,3,1,3,2,2,4,2,0,0,21,4,4,6,7,1,1,3277447,"2023-11-17T00:00:00.000Z",108,23,"Robert Covington",2,13,16,9,10,23.9
"17152",5630,3,0,9,5,3,20,12,2,2,38,1,1,29,10,1,1,3277447,"2023-11-17T00:00:00.000Z",200,23,"Tobias Harris",1,39,42,32,13,47.5
"17153",5631,8,1,5,3,1,19,10,11,11,37,2,3,32,7,2,4,3277447,"2023-11-17T00:00:00.000Z",145,23,"Joel Embiid",3,39,47,40,15,57.4
"17154",5632,5,1,3,7,3,13,5,2,1,36,1,2,14,4,1,3,3277447,"2023-11-17T00:00:00.000Z",313,23,"De'Anthony Melton",2,18,23,19,9,29.3
"17155",5633,8,0,4,6,3,13,5,6,6,40,0,1,19,4,2,2,3277447,"2023-11-17T00:00:00.000Z",3547254,23,"Tyrese Maxey",2,23,31,27,12,39.8
"17156",5634,1,0,2,1,0,1,0,2,2,14,0,3,2,2,0,0,3277447,"2023-11-17T00:00:00.000Z",45,23,"Patrick Beverley",0,4,5,3,3,5.9
"17157",5635,1,0,2,4,1,8,5,3,3,18,1,1,14,3,0,1,3277447,"2023-11-17T00:00:00.000Z",2175,23,"Danuel House Jr.",0,17,18,15,4,18.1
"17158",5636,0,0,1,0,0,0,0,0,0,2,0,1,0,1,0,0,3277447,"2023-11-17T00:00:00.000Z",328,23,"Marcus Morris",0,1,1,0,1,1.2
"17159",5637,2,2,0,2,0,7,3,2,2,22,3,3,8,3,2,3,3277447,"2023-11-17T00:00:00.000Z",17896025,23,"Jaden Springer",4,11,13,10,5,23.6
"17160",5638,0,0,1,0,0,3,1,0,0,12,1,1,2,2,0,0,3277447,"2023-11-17T00:00:00.000Z",3547270,23,"Paul Reed",0,4,4,2,2,4.4
"17161",5639,0,0,0,0,0,0,0,0,0,0,0,0,0,0,0,0,3277447,"2023-11-17T00:00:00.000Z",28,23,"Mo Bamba",0,0,0,0,0,0
"17162",5640,0,0,0,0,0,0,0,0,0,0,0,0,0,0,0,0,3277447,"2023-11-17T00:00:00.000Z",260,23,"Furkan Korkmaz",0,0,0,0,0,0
"17163",5641,0,0,0,0,0,0,0,0,0,0,0,0,0,0,0,0,3277447,"2023-11-17T00:00:00.000Z",3547294,23,"Kenyon Martin Jr.",0,0,0,0,0,0
"17164",5642,0,0,0,0,0,0,0,0,0,0,0,0,0,0,0,0,3277447,"2023-11-17T00:00:00.000Z",33,23,"Nicolas Batum",0,0,0,0,0,0
"17165",5643,0,0,0,0,0,0,0,0,0,0,0,0,0,0,0,0,3277447,"2023-11-17T00:00:00.000Z",56913527,23,"Ricky Council IV",0,0,0,0,0,0
"17166",5644,0,0,0,0,0,0,0,0,0,0,0,0,0,0,0,0,3277447,"2023-11-17T00:00:00.000Z",360,23,"Kelly Oubre Jr.",0,0,0,0,0,0
"17167",5645,0,0,0,0,0,0,0,0,0,0,0,0,0,0,0,0,3277447,"2023-11-17T00:00:00.000Z",17554001,23,"Javonte Smart",0,0,0,0,0,0
"17168",5646,0,0,0,0,0,0,0,0,0,0,0,0,0,0,0,0,3277447,"2023-11-17T00:00:00.000Z",56677788,23,"Terquavion Smith",0,0,0,0,0,0
"17169",5647,0,0,1,1,1,1,1,0,0,22,0,1,3,1,0,0,3277448,"2023-11-17T00:00:00.000Z",666940,6,"Dean Wade",0,4,4,3,1,4.2
"17170",5648,5,0,6,0,0,12,8,4,2,35,4,4,18,10,1,2,3277448,"2023-11-17T00:00:00.000Z",17896076,6,"Evan Mobley",1,28,33,23,15,38.5
"17171",5649,2,5,6,0,0,8,4,3,2,32,1,1,10,7,0,2,3277448,"2023-11-17T00:00:00.000Z",9,6,"Jarrett Allen",5,17,19,12,9,34.4
"17172",5650,3,1,6,8,4,15,7,0,0,39,1,1,18,7,4,2,3277448,"2023-11-17T00:00:00.000Z",666908,6,"Max Strus",5,25,28,21,10,43.9
"17173",5651,0,0,0,0,0,1,0,0,0,1,0,0,0,0,0,0,3277354,"2023-11-03T00:00:00.000Z",56677859,7,"Olivier-Maxence Prosper",0,0,0,0,0,0
"17174",5652,0,0,0,0,0,0,0,0,0,0,0,0,0,0,0,0,3277354,"2023-11-03T00:00:00.000Z",217,7,"Richaun Holmes",0,0,0,0,0,0
"17175",5653,0,0,0,0,0,0,0,0,0,0,0,0,0,0,0,0,3277354,"2023-11-03T00:00:00.000Z",17896028,7,"Greg Brown III",0,0,0,0,0,0
"17176",5654,0,0,0,0,0,0,0,0,0,0,0,0,0,0,0,0,3277354,"2023-11-03T00:00:00.000Z",56677873,7,"Dexter Dennis",0,0,0,0,0,0
"17177",5655,0,0,0,0,0,0,0,0,0,0,0,0,0,0,0,0,3277354,"2023-11-03T00:00:00.000Z",257,7,"Maxi Kleber",0,0,0,0,0,0
"17178",5656,0,0,0,0,0,0,0,0,0,0,0,0,0,0,0,0,3277354,"2023-11-03T00:00:00.000Z",17554004,7,"AJ Lawson",0,0,0,0,0,0
"17179",5657,1,0,1,5,1,8,3,2,2,15,0,0,9,1,1,1,3277355,"2023-11-03T00:00:00.000Z",3547289,25,"Skylar Mays",1,10,11,10,2,13.7
"17180",5658,0,1,6,0,0,4,3,3,2,20,4,1,8,10,2,1,3277355,"2023-11-03T00:00:00.000Z",476,25,"Robert Williams III",3,18,18,8,10,28
"17181",5659,0,1,3,0,0,2,0,0,0,9,1,2,0,4,0,0,3277355,"2023-11-03T00:00:00.000Z",38017711,25,"Jabari Walker",1,4,4,0,4,7.8
"17182",5660,0,0,0,0,0,0,0,0,0,0,0,0,0,0,0,0,3277355,"2023-11-03T00:00:00.000Z",47957121,25,"Justin Minaya",0,0,0,0,0,0
"17183",5661,0,0,0,0,0,0,0,0,0,0,0,0,0,0,0,0,3277355,"2023-11-03T00:00:00.000Z",56677791,25,"Kris Murray",0,0,0,0,0,0
"17184",5662,0,0,0,0,0,0,0,0,0,0,0,0,0,0,0,0,3277355,"2023-11-03T00:00:00.000Z",56677829,25,"Rayan Rupert",0,0,0,0,0,0
"17185",5663,0,0,0,0,0,0,0,0,0,0,0,0,0,0,0,0,3277355,"2023-11-03T00:00:00.000Z",56677747,25,"Scoot Henderson",0,0,0,0,0,0
"17186",5664,0,0,0,0,0,0,0,0,0,0,0,0,0,0,0,0,3277355,"2023-11-03T00:00:00.000Z",56783340,25,"Duop Reath",0,0,0,0,0,0
"17187",5665,0,0,0,0,0,0,0,0,0,0,0,0,0,0,0,0,3277355,"2023-11-03T00:00:00.000Z",419,25,"Anfernee Simons",0,0,0,0,0,0
"17188",5666,0,0,0,0,0,0,0,0,0,0,0,0,0,0,0,0,3277355,"2023-11-03T00:00:00.000Z",17896120,25,"Ish Wainright",0,0,0,0,0,0
"17189",5667,3,1,6,1,1,8,5,2,2,27,0,6,13,6,1,2,3277355,"2023-11-03T00:00:00.000Z",17896027,15,"Ziaire Williams",2,19,22,16,9,28.7
"17190",5668,0,0,2,4,0,14,8,0,0,32,1,4,16,3,0,0,3277355,"2023-11-03T00:00:00.000Z",38017729,15,"David Roddy",0,19,19,16,3,19.6
"17191",5669,3,3,8,8,5,17,11,6,3,38,2,1,30,10,1,4,3277355,"2023-11-03T00:00:00.000Z",231,15,"Jaren Jackson Jr.",4,40,43,33,13,54.5
"17192",5670,7,3,7,9,3,26,13,5,4,45,1,5,33,8,4,3,3277355,"2023-11-03T00:00:00.000Z",3547287,15,"Desmond Bane",7,41,48,40,15,71.1
"17193",5671,4,0,2,5,0,12,4,0,0,39,1,2,8,3,1,5,3277355,"2023-11-03T00:00:00.000Z",420,15,"Marcus Smart",1,11,15,12,7,15.6
"17194",5672,3,0,7,4,1,7,2,0,0,27,1,1,5,8,0,0,3277355,"2023-11-03T00:00:00.000Z",254,15,"Luke Kennard",0,13,16,8,11,19.1
"17195",5673,0,1,1,0,0,2,1,0,0,10,0,0,2,1,0,0,3277355,"2023-11-03T00:00:00.000Z",666703,15,"John Konchar",1,3,3,2,1,6.2
"17196",5674,3,0,0,0,0,0,0,0,0,12,0,0,0,0,0,1,3277355,"2023-11-03T00:00:00.000Z",48248287,15,"Jacob Gilyard",0,0,3,3,3,3.5
"17197",5675,0,0,0,0,0,0,0,0,0,1,0,0,0,0,0,0,3277355,"2023-11-03T00:00:00.000Z",48,15,"Bismack Biyombo",0,0,0,0,0,0
"17198",5676,0,0,0,0,0,0,0,0,0,0,0,0,0,0,0,0,1038132,"2024-01-12T00:00:00.000Z",17896042,29,"Jason Preston",0,0,0,0,0,0
"17199",5677,0,0,0,0,0,0,0,0,0,0,0,0,0,0,0,0,1038133,"2024-01-12T00:00:00.000Z",347,4,"Frank Ntilikina",0,0,0,0,0,0
"17200",5678,0,0,0,0,0,0,0,0,0,0,0,0,0,0,0,0,1038133,"2024-01-12T00:00:00.000Z",666950,4,"P.J. Washington",0,0,0,0,0,0
"17201",5679,0,0,0,0,0,0,0,0,0,0,0,0,0,0,0,0,1038133,"2024-01-12T00:00:00.000Z",38017698,4,"Mark Williams",0,0,0,0,0,0
"17202",5680,0,3,0,4,0,5,1,0,0,14,0,3,2,0,0,0,1038127,"2024-01-12T00:00:00.000Z",17896073,22,"Jalen Suggs",3,2,2,2,0,11
"17203",5681,3,1,1,0,0,2,1,2,1,17,2,2,3,3,2,2,1038127,"2024-01-12T00:00:00.000Z",165,22,"Markelle Fultz",3,6,9,6,6,18.1
"17204",5682,0,1,2,2,0,8,2,2,1,27,1,1,5,3,2,0,1038127,"2024-01-12T00:00:00.000Z",3547251,22,"Cole Anthony",3,8,8,5,3,17.6
"17205",5683,6,0,0,8,4,10,5,1,0,20,0,2,14,0,3,2,1038127,"2024-01-12T00:00:00.000Z",226,22,"Joe Ingles",3,14,20,20,6,30
"17206",5684,1,0,3,0,0,1,0,2,1,9,0,0,1,3,1,0,1038127,"2024-01-12T00:00:00.000Z",56677827,22,"Anthony Black",1,4,5,2,4,9.1
"17207",5685,0,0,1,0,0,0,0,0,0,2,0,1,0,1,0,0,1038131,"2024-01-12T00:00:00.000Z",17896103,8,"Jay Huff",0,1,1,0,1,1.2
"17208",5686,0,0,0,1,0,3,1,0,0,14,1,1,2,1,1,0,1038125,"2024-01-12T00:00:00.000Z",319,1,"Patty Mills",1,3,3,2,1,6.2
"17209",5687,0,0,0,1,0,1,0,2,2,4,0,0,2,0,0,0,1038125,"2024-01-12T00:00:00.000Z",56677855,1,"Seth Lundy",0,2,2,2,0,2
"17210",5688,0,0,0,1,0,2,1,0,0,4,0,0,2,0,0,0,1038125,"2024-01-12T00:00:00.000Z",38017689,1,"AJ Griffin",0,2,2,2,0,2
"17211",5689,0,0,1,1,0,1,0,0,0,4,0,0,0,1,0,0,1038125,"2024-01-12T00:00:00.000Z",666564,1,"Bruno Fernando",0,1,1,0,1,1.2
"17212",5690,0,0,0,0,0,0,0,0,0,0,0,0,0,0,0,0,1038125,"2024-01-12T00:00:00.000Z",666754,1,"Garrison Mathews",0,0,0,0,0,0
"17213",5691,1,1,9,5,2,12,8,3,2,33,1,2,20,10,1,1,1038131,"2024-01-12T00:00:00.000Z",375,8,"Michael Porter Jr.",2,30,31,21,11,38.5
"17214",5692,2,0,2,2,0,12,7,3,1,31,3,2,15,5,0,2,1038131,"2024-01-12T00:00:00.000Z",177,8,"Aaron Gordon",0,20,22,17,7,22
"17215",5693,14,1,7,2,1,17,11,4,4,32,3,4,27,10,0,2,1038131,"2024-01-12T00:00:00.000Z",246,8,"Nikola Jokic",1,37,51,41,24,61
"17216",5694,3,0,2,6,3,9,4,0,0,31,0,0,11,2,2,0,1038131,"2024-01-12T00:00:00.000Z",81,8,"Kentavious Caldwell-Pope",2,13,16,14,5,23.9
"17217",5695,9,0,2,5,3,15,8,1,1,34,0,3,20,2,0,2,1038131,"2024-01-12T00:00:00.000Z",335,8,"Jamal Murray",0,22,31,29,11,33.9
"17218",5696,0,0,5,4,1,4,1,2,1,17,1,2,4,6,0,3,1038131,"2024-01-12T00:00:00.000Z",38017709,8,"Christian Braun",0,10,10,4,6,8.2
"17219",5697,0,0,0,0,0,0,0,0,0,2,0,0,0,0,0,1,1038131,"2024-01-12T00:00:00.000Z",215,8,"Justin Holiday",0,0,0,0,0,-1
"17220",5698,0,0,0,0,0,1,1,0,0,2,0,1,2,0,0,0,1038131,"2024-01-12T00:00:00.000Z",38017727,8,"Collin Gillespie",0,2,2,2,0,2
"17221",5699,0,0,2,5,2,10,5,0,0,24,0,1,12,2,1,3,1038131,"2024-01-12T00:00:00.000Z",236,8,"Reggie Jackson",1,14,14,12,2,14.4
"17222",5700,0,1,2,4,2,7,3,0,0,15,1,1,8,3,1,0,1038131,"2024-01-12T00:00:00.000Z",38017721,8,"Peyton Watson",2,11,11,8,3,17.6
"17223",5701,7,4,3,5,3,9,5,2,1,33,0,1,14,3,0,1,1038054,"2024-01-02T00:00:00.000Z",38017685,21,"Chet Holmgren",4,17,24,21,10,39.1
"17224",5702,6,0,7,7,4,14,8,3,3,27,1,0,23,8,0,3,1038054,"2024-01-02T00:00:00.000Z",17896065,21,"Josh Giddey",0,31,37,29,14,38.6
"17225",5703,7,0,6,5,3,22,14,8,5,37,0,5,36,6,1,0,1038054,"2024-01-02T00:00:00.000Z",175,21,"Shai Gilgeous-Alexander",1,42,49,43,13,56.7
"17226",5704,0,0,3,3,2,5,4,0,0,13,0,1,10,3,0,1,1038054,"2024-01-02T00:00:00.000Z",3547272,21,"Isaiah Joe",0,13,13,10,3,12.6
"17227",5705,0,0,0,0,0,0,0,0,0,0,0,0,0,0,0,0,1038054,"2024-01-02T00:00:00.000Z",44,21,"Davis Bertans",0,0,0,0,0,0
"17228",5706,0,0,0,0,0,0,0,0,0,0,0,0,0,0,0,0,1038054,"2024-01-02T00:00:00.000Z",17896036,21,"Tre Mann",0,0,0,0,0,0
"17229",5707,0,0,0,0,0,0,0,0,0,0,0,0,0,0,0,0,1038054,"2024-01-02T00:00:00.000Z",38017716,21,"Ousmane Dieng",0,0,0,0,0,0
"17230",5708,0,0,0,0,0,0,0,0,0,0,0,0,0,0,0,0,1038054,"2024-01-02T00:00:00.000Z",56677853,21,"Keyontae Johnson",0,0,0,0,0,0
"17231",5709,0,0,0,0,0,0,0,0,0,0,0,0,0,0,0,0,1038054,"2024-01-02T00:00:00.000Z",24572055,21,"Olivier Sarr",0,0,0,0,0,0
"17232",5710,0,0,0,0,0,0,0,0,0,0,0,0,0,0,0,0,1038054,"2024-01-02T00:00:00.000Z",27924547,21,"Lindy Waters III",0,0,0,0,0,0
"17233",5711,0,0,0,0,0,0,0,0,0,0,0,0,0,0,0,0,1037993,"2023-12-25T00:00:00.000Z",38017733,17,"A.J. Green",0,0,0,0,0,0
"17234",5712,0,0,0,0,0,0,0,0,0,0,0,0,0,0,0,0,1037993,"2023-12-25T00:00:00.000Z",56677854,17,"Chris Livingston",0,0,0,0,0,0
"17235",5713,0,0,0,0,0,0,0,0,0,0,0,0,0,0,0,0,1037993,"2023-12-25T00:00:00.000Z",284,17,"Robin Lopez",0,0,0,0,0,0
"17236",5714,0,0,0,0,0,0,0,0,0,0,0,0,0,0,0,0,1037993,"2023-12-25T00:00:00.000Z",666453,17,"Marques Bolden",0,0,0,0,0,0
"17237",5715,0,0,0,0,0,0,0,0,0,0,0,0,0,0,0,0,1037993,"2023-12-25T00:00:00.000Z",112,17,"Jae Crowder",0,0,0,0,0,0
"17238",5716,0,0,0,0,0,0,0,0,0,0,0,0,0,0,0,0,1037993,"2023-12-25T00:00:00.000Z",38017691,17,"TyTy Washington Jr.",0,0,0,0,0,0
"17239",5717,0,0,0,0,0,0,0,0,0,0,0,0,0,0,0,0,1037993,"2023-12-25T00:00:00.000Z",666960,17,"Lindell Wigginton",0,0,0,0,0,0
"17240",5718,3,0,1,4,0,7,1,4,3,29,1,3,5,2,0,3,1038052,"2024-01-02T00:00:00.000Z",420,15,"Marcus Smart",0,7,10,8,5,8.9
"17241",5719,1,4,6,4,1,14,3,4,3,32,1,4,10,7,3,1,1038052,"2024-01-02T00:00:00.000Z",231,15,"Jaren Jackson Jr.",7,17,18,11,8,39.9
"17242",5720,1,3,6,0,0,4,2,0,0,28,2,4,4,8,1,2,1038052,"2024-01-02T00:00:00.000Z",48,15,"Bismack Biyombo",4,12,13,5,9,25.1
"17243",5721,2,0,3,6,2,17,11,0,0,34,0,1,24,3,0,3,1038052,"2024-01-02T00:00:00.000Z",3547287,15,"Desmond Bane",0,27,29,26,5,27.6
"17244",5722,10,0,5,9,3,15,7,12,9,35,0,3,26,5,1,4,1038052,"2024-01-02T00:00:00.000Z",666786,15,"Ja Morant",1,31,41,36,15,46
"17245",5723,0,1,9,2,1,6,5,2,2,28,2,1,13,11,0,0,1038052,"2024-01-02T00:00:00.000Z",17896067,15,"Santi Aldama",1,24,24,13,11,29.2
"17246",5724,3,0,4,7,3,7,3,3,3,20,1,2,12,5,0,0,1038052,"2024-01-02T00:00:00.000Z",254,15,"Luke Kennard",0,17,20,15,8,22.5
"17247",5725,2,0,0,1,0,4,2,0,0,8,0,0,4,0,0,0,1038052,"2024-01-02T00:00:00.000Z",401,15,"Derrick Rose",0,4,6,6,2,7
"17248",5726,0,0,0,0,0,0,0,0,0,0,0,0,0,0,0,0,1037976,"2023-12-22T00:00:00.000Z",38017734,16,"Jamal Cain",0,0,0,0,0,0
"17249",5727,0,0,0,0,0,0,0,0,0,0,0,0,0,0,0,0,1037977,"2023-12-22T00:00:00.000Z",357,11,"Victor Oladipo",0,0,0,0,0,0
"17250",5728,0,0,2,2,1,3,1,2,1,13,0,0,4,2,0,0,1037973,"2023-12-21T00:00:00.000Z",167,30,"Danilo Gallinari",0,6,6,4,2,6.4
"17251",5729,0,0,0,0,0,0,0,0,0,1,0,0,0,0,0,0,1037973,"2023-12-21T00:00:00.000Z",3547302,30,"Anthony Gill",0,0,0,0,0,0
"17252",5730,0,0,0,0,0,0,0,0,0,0,0,0,0,0,0,0,1037973,"2023-12-21T00:00:00.000Z",38017704,30,"Patrick Baldwin Jr.",0,0,0,0,0,0
"17253",5731,0,0,0,0,0,0,0,0,0,0,0,0,0,0,0,0,1037973,"2023-12-21T00:00:00.000Z",18677954,30,"Jared Butler",0,0,0,0,0,0
"17254",5732,0,0,0,1,0,2,0,0,0,2,1,0,0,1,0,0,1037979,"2023-12-22T00:00:00.000Z",17896030,26,"Chris Duarte",0,1,1,0,1,1.2
"17255",5733,0,0,0,1,0,1,0,0,0,2,0,0,0,0,0,0,1037979,"2023-12-22T00:00:00.000Z",17896044,26,"Kessler Edwards",0,0,0,0,0,0
"17256",5734,2,0,3,10,4,17,8,0,0,27,0,0,20,3,0,2,1037978,"2023-12-22T00:00:00.000Z",443,10,"Klay Thompson",0,23,25,22,5,24.6
"17257",5735,3,0,2,2,1,11,9,3,3,27,2,2,22,4,1,1,1037978,"2023-12-22T00:00:00.000Z",17553979,10,"Jonathan Kuminga",1,26,29,25,7,33.3
"17258",5736,0,0,3,0,0,3,2,1,1,11,2,2,5,5,0,0,1037978,"2023-12-22T00:00:00.000Z",282,10,"Kevon Looney",0,10,10,5,5,11
"17259",5737,5,0,4,5,2,9,3,2,2,29,3,2,10,7,1,1,1037978,"2023-12-22T00:00:00.000Z",56677858,10,"Brandin Podziemski",1,17,22,15,12,27.9
"17260",5738,7,1,4,13,8,18,9,5,4,27,0,0,30,4,0,2,1037978,"2023-12-22T00:00:00.000Z",115,10,"Stephen Curry",1,34,41,37,11,46.3
"17261",5739,10,0,7,3,0,7,2,1,0,25,0,2,4,7,1,1,1037978,"2023-12-22T00:00:00.000Z",367,10,"Chris Paul",1,11,21,14,17,29.4
"17262",5740,3,1,10,0,0,7,5,0,0,25,5,2,10,15,0,1,1037978,"2023-12-22T00:00:00.000Z",56677799,10,"Trayce Jackson-Davis",1,25,28,13,18,34.5
"17263",5741,0,0,2,3,0,4,1,4,3,19,1,1,5,3,1,2,1037978,"2023-12-22T00:00:00.000Z",17553992,10,"Moses Moody",1,8,8,5,3,9.6
"17264",5742,0,0,1,1,0,3,0,0,0,14,0,3,0,1,1,1,1037978,"2023-12-22T00:00:00.000Z",251,10,"Cory Joseph",1,1,1,0,1,3.2
"17265",5743,1,0,0,0,0,1,0,0,0,2,0,0,0,0,0,0,1037978,"2023-12-22T00:00:00.000Z",17896070,10,"Usman Garuba",0,0,1,1,1,1.5
"17266",5744,0,1,1,8,4,10,5,6,5,37,0,2,19,1,2,0,1037979,"2023-12-22T00:00:00.000Z",30,26,"Harrison Barnes",3,20,20,19,1,29.2
"17267",5745,2,0,4,7,3,13,8,2,2,33,1,3,21,5,0,1,1037979,"2023-12-22T00:00:00.000Z",38017688,26,"Keegan Murray",0,26,28,23,7,29
"17268",5746,11,0,10,2,0,15,12,5,4,35,1,3,28,11,0,3,1037979,"2023-12-22T00:00:00.000Z",406,26,"Domantas Sabonis",0,39,50,39,22,54.7
"17269",5747,5,0,1,6,2,9,5,1,1,27,1,1,13,2,1,1,1037979,"2023-12-22T00:00:00.000Z",221,26,"Kevin Huerter",1,15,20,18,7,24.9
"17270",5748,7,2,6,6,2,17,9,4,3,32,0,2,23,6,3,2,1037979,"2023-12-22T00:00:00.000Z",161,26,"De'Aaron Fox",5,29,36,30,13,53.7
"17271",5749,1,1,2,2,0,3,0,2,1,17,1,3,1,3,1,0,1037979,"2023-12-22T00:00:00.000Z",38017714,26,"Keon Ellis",2,4,5,2,4,12.1
"17272",5750,0,0,1,0,0,2,1,4,3,11,0,3,5,1,0,1,1037979,"2023-12-22T00:00:00.000Z",306,26,"JaVale McGee",0,6,6,5,1,5.2
"17273",5751,2,0,1,4,1,4,1,0,0,14,0,1,3,1,1,0,1037895,"2023-12-11T00:00:00.000Z",38017714,26,"Keon Ellis",1,4,6,5,3,10.2
"17274",5752,1,1,6,6,5,7,6,0,0,23,0,0,17,6,0,0,1037895,"2023-12-11T00:00:00.000Z",290,26,"Trey Lyles",1,23,24,18,7,28.7
"17275",5753,2,0,1,0,0,2,0,0,0,8,2,3,0,3,0,1,1037895,"2023-12-11T00:00:00.000Z",306,26,"JaVale McGee",0,3,5,2,5,5.6
"17276",5754,0,0,0,0,0,0,0,0,0,3,0,0,0,0,0,0,1037895,"2023-12-11T00:00:00.000Z",17896044,26,"Kessler Edwards",0,0,0,0,0,0
"17277",5755,1,0,0,1,0,1,0,0,0,3,0,0,0,0,0,0,1037895,"2023-12-11T00:00:00.000Z",17896030,26,"Chris Duarte",0,0,1,1,1,1.5
"17278",5756,0,0,0,0,0,0,0,0,0,1,0,1,0,0,0,0,1037895,"2023-12-11T00:00:00.000Z",56677845,26,"Colby Jones",0,0,0,0,0,0
"17279",5757,0,0,0,0,0,0,0,0,0,0,0,0,0,0,0,0,1037890,"2023-12-11T00:00:00.000Z",56677831,11,"Cam Whitmore",0,0,0,0,0,0
"17280",5758,2,0,3,9,1,16,5,5,3,31,3,1,14,6,0,1,1037890,"2023-12-11T00:00:00.000Z",3547246,27,"Devin Vassell",0,20,22,16,8,23.2
"17281",5759,2,0,5,9,0,14,3,6,6,37,2,1,12,7,4,3,1037890,"2023-12-11T00:00:00.000Z",666682,27,"Keldon Johnson",4,19,21,14,9,32.4
"17282",5760,3,5,16,6,1,15,7,1,0,33,2,3,15,18,0,5,1037890,"2023-12-11T00:00:00.000Z",56677822,27,"Victor Wembanyama",5,33,36,18,21,51.1
"17283",5761,7,0,6,3,0,13,6,1,1,34,0,0,13,6,1,3,1037890,"2023-12-11T00:00:00.000Z",38017692,27,"Malaki Branham",1,19,26,20,13,30.7
"17284",5762,2,0,4,5,1,11,3,0,0,35,2,2,7,6,1,1,1037890,"2023-12-11T00:00:00.000Z",38017699,27,"Jeremy Sochan",1,13,15,9,8,19.2
"17285",5763,0,1,4,2,1,5,3,0,0,13,1,0,7,5,0,0,1037892,"2023-12-11T00:00:00.000Z",87,5,"Jevon Carter",1,12,12,7,5,16
"17286",5764,1,1,4,5,1,9,2,4,2,29,1,6,7,5,0,0,1037892,"2023-12-11T00:00:00.000Z",110,5,"Torrey Craig",1,12,13,8,6,17.5
"17287",5765,0,0,0,0,0,0,0,0,0,4,0,0,0,0,0,0,1037892,"2023-12-11T00:00:00.000Z",56677857,5,"Julian Phillips",0,0,0,0,0,0
"17288",5766,1,0,5,0,0,12,3,3,3,14,11,1,9,16,1,0,1037892,"2023-12-11T00:00:00.000Z",137,5,"Andre Drummond",1,25,26,10,17,32.7
"17289",5767,1,1,0,2,1,2,1,0,0,11,0,2,3,0,0,0,1037892,"2023-12-11T00:00:00.000Z",38017719,5,"Dalen Terry",1,3,4,4,1,7.5
"17290",5768,0,0,0,0,0,0,0,0,0,0,0,0,0,0,0,0,1037892,"2023-12-11T00:00:00.000Z",89,5,"Alex Caruso",0,0,0,0,0,0
"17291",5769,0,0,0,0,0,0,0,0,0,0,0,0,0,0,0,0,1037892,"2023-12-11T00:00:00.000Z",17896116,5,"Terry Taylor",0,0,0,0,0,0
"17292",5770,1,1,2,4,3,7,5,1,1,27,0,1,14,2,0,1,1037895,"2023-12-11T00:00:00.000Z",30,26,"Harrison Barnes",1,16,17,15,3,19.9
"17293",5771,3,0,2,4,4,13,9,2,2,34,1,4,24,3,0,0,1037895,"2023-12-11T00:00:00.000Z",38017688,26,"Keegan Murray",0,27,30,27,6,32.1
"17294",5772,9,0,12,1,1,14,6,4,2,34,4,2,15,16,2,4,1037895,"2023-12-11T00:00:00.000Z",406,26,"Domantas Sabonis",2,31,40,24,25,49.7
"17295",5773,1,0,1,5,2,6,2,0,0,17,0,4,6,1,0,0,1037895,"2023-12-11T00:00:00.000Z",221,26,"Kevin Huerter",0,7,8,7,2,8.7
"17296",5774,8,0,3,10,5,22,10,6,4,33,0,4,29,3,0,3,1037895,"2023-12-11T00:00:00.000Z",161,26,"De'Aaron Fox",0,32,40,37,11,41.6
"17297",5775,0,0,0,0,0,0,0,0,0,0,0,0,0,0,0,0,1037888,"2023-12-11T00:00:00.000Z",666656,1,"De'Andre Hunter",0,0,0,0,0,0
"17298",5776,1,1,2,5,2,12,4,3,1,34,5,1,11,7,0,1,1037835,"2023-11-26T00:00:00.000Z",18,28,"OG Anunoby",1,18,19,12,8,22.9
"17299",5777,0,0,0,0,0,0,0,0,0,0,0,0,0,0,0,0,1037835,"2023-11-26T00:00:00.000Z",248,6,"Damian Jones",0,0,0,0,0,0
"17300",5778,0,0,0,0,0,0,0,0,0,0,0,0,0,0,0,0,1037835,"2023-11-26T00:00:00.000Z",3547299,6,"Sam Merrill",0,0,0,0,0,0
"17301",5779,0,0,0,0,0,0,0,0,0,0,0,0,0,0,0,0,1037834,"2023-11-26T00:00:00.000Z",17896041,3,"Keon Johnson",0,0,0,0,0,0
"17302",5780,0,0,0,0,0,0,0,0,0,0,0,0,0,0,0,0,1037834,"2023-11-26T00:00:00.000Z",417,3,"Ben Simmons",0,0,0,0,0,0
"17303",5781,0,0,0,0,0,0,0,0,0,0,0,0,0,0,0,0,1037834,"2023-11-26T00:00:00.000Z",421,3,"Dennis Smith Jr.",0,0,0,0,0,0
"17304",5782,0,0,0,0,0,0,0,0,0,0,0,0,0,0,0,0,1037834,"2023-11-26T00:00:00.000Z",17896048,3,"Cam Thomas",0,0,0,0,0,0
"17305",5783,0,0,0,0,0,0,0,0,0,0,0,0,0,0,0,0,1037834,"2023-11-26T00:00:00.000Z",56677841,3,"Dariq Whitehead",0,0,0,0,0,0
"17306",5784,6,0,4,4,2,22,11,5,3,38,2,2,27,6,1,1,1037834,"2023-11-26T00:00:00.000Z",125,5,"DeMar DeRozan",1,33,39,33,12,45.2
"17307",5785,0,0,3,5,4,9,7,2,2,35,1,2,20,4,0,1,1037834,"2023-11-26T00:00:00.000Z",3547248,5,"Patrick Williams",0,24,24,20,4,23.8
"17308",5786,5,1,8,3,0,9,3,0,0,37,1,5,6,9,1,2,1037834,"2023-11-26T00:00:00.000Z",460,5,"Nikola Vucevic",2,15,20,11,14,28.3
"17309",5787,0,0,0,2,0,2,0,0,0,8,0,0,0,0,0,1,1037834,"2023-11-26T00:00:00.000Z",87,5,"Jevon Carter",0,0,0,0,0,-1
"17310",5788,0,0,1,0,0,2,1,2,2,20,2,0,4,3,0,2,1037834,"2023-11-26T00:00:00.000Z",110,5,"Torrey Craig",0,7,7,4,3,5.6
"17311",5789,1,1,3,5,3,10,5,1,0,33,0,3,13,3,3,0,1037852,"2023-11-29T00:00:00.000Z",18,28,"OG Anunoby",4,16,17,14,4,30.1
"17312",5790,3,0,6,5,1,21,9,3,3,36,3,4,22,9,1,3,1037852,"2023-11-29T00:00:00.000Z",416,28,"Pascal Siakam",1,31,34,25,12,37.3
"17313",5791,1,1,2,0,0,9,8,2,1,30,2,4,17,4,0,2,1037852,"2023-11-29T00:00:00.000Z",373,28,"Jakob Poeltl",1,21,22,18,5,24.3
"17314",5792,4,3,5,3,1,15,7,8,8,38,2,4,23,7,0,0,1037852,"2023-11-29T00:00:00.000Z",17896055,28,"Scottie Barnes",3,30,34,27,11,46.4
"17315",5793,4,1,2,4,0,8,3,0,0,24,1,2,6,3,0,2,1037850,"2023-11-29T00:00:00.000Z",17553995,14,"Austin Reaves",1,9,13,10,7,16.6
"17316",5794,2,0,3,2,0,3,0,0,0,20,0,2,0,3,0,1,1037850,"2023-11-29T00:00:00.000Z",666860,14,"Cameron Reddish",0,3,5,2,5,5.6
"17317",5795,0,2,9,4,0,9,4,4,4,25,0,1,12,9,1,1,1037850,"2023-11-29T00:00:00.000Z",486,14,"Christian Wood",3,21,21,12,9,30.8
"17318",5796,1,0,1,2,1,4,3,6,3,11,0,2,10,1,1,1,1037850,"2023-11-29T00:00:00.000Z",56677835,14,"Jalen Hood-Schifino",1,11,12,11,2,14.7
"17319",5797,2,0,0,0,0,0,0,0,0,7,0,1,0,0,2,0,1037850,"2023-11-29T00:00:00.000Z",56677836,14,"Maxwell Lewis",2,0,2,2,2,9
"17320",5798,0,0,0,2,1,3,1,0,0,5,0,1,3,0,0,0,1037850,"2023-11-29T00:00:00.000Z",56677868,14,"D'Moi Hodge",0,3,3,3,0,3
"17321",5799,0,0,0,0,0,0,0,0,0,0,0,0,0,0,0,0,1037850,"2023-11-29T00:00:00.000Z",56677738,14,"Colin Castleton",0,0,0,0,0,0
"17322",5800,0,0,0,0,0,0,0,0,0,0,0,0,0,0,0,0,1037850,"2023-11-29T00:00:00.000Z",666609,14,"Rui Hachimura",0,0,0,0,0,0
"17323",5801,0,0,0,0,0,0,0,0,0,0,0,0,0,0,0,0,1037774,"2023-11-18T00:00:00.000Z",38017676,17,"MarJon Beauchamp",0,0,0,0,0,0
"17324",5802,0,0,0,0,0,0,0,0,0,0,0,0,0,0,0,0,1037780,"2023-11-19T00:00:00.000Z",197,9,"Joe Harris",0,0,0,0,0,0
"17325",5803,0,0,0,0,0,0,0,0,0,0,0,0,0,0,0,0,1037780,"2023-11-19T00:00:00.000Z",330,9,"Monte Morris",0,0,0,0,0,0
"17326",5804,0,0,0,0,0,0,0,0,0,0,0,0,0,0,0,0,1037780,"2023-11-19T00:00:00.000Z",42097199,9,"Jared Rhoden",0,0,0,0,0,0
"17327",5805,2,1,2,5,1,12,3,2,2,28,3,2,9,5,0,2,1037777,"2023-11-19T00:00:00.000Z",666679,3,"Cameron Johnson",1,14,16,11,7,19
"17328",5806,2,0,2,3,1,7,2,0,0,27,1,2,5,3,0,1,1037777,"2023-11-19T00:00:00.000Z",158,3,"Dorian Finney-Smith",0,8,10,7,5,10.6
"17329",5807,1,1,9,0,0,6,5,3,0,23,0,3,10,9,0,2,1037777,"2023-11-19T00:00:00.000Z",666508,3,"Nicolas Claxton",1,19,20,11,10,23.3
"17330",5808,3,0,1,2,2,12,8,0,0,29,0,0,18,1,0,2,1037777,"2023-11-19T00:00:00.000Z",61,3,"Mikal Bridges",0,19,22,21,4,21.7
"17331",5809,5,1,4,4,1,10,3,6,5,28,0,0,12,4,0,2,1037777,"2023-11-19T00:00:00.000Z",130,3,"Spencer Dinwiddie",1,16,21,17,9,25.3
"17332",5810,2,2,6,0,0,3,3,0,0,20,2,1,6,8,0,2,1037777,"2023-11-19T00:00:00.000Z",17896038,3,"Day'Ron Sharpe",2,14,16,8,10,22.6
"17333",5811,2,0,6,11,6,17,9,2,2,32,0,1,26,6,0,2,1037777,"2023-11-19T00:00:00.000Z",464,3,"Lonnie Walker IV",0,32,34,28,8,34.2
"17334",5812,3,2,3,0,0,2,0,0,0,25,1,1,0,4,1,1,1037777,"2023-11-19T00:00:00.000Z",351,3,"Royce O'Neale",3,4,7,3,7,17.3
"17335",5813,4,1,2,2,0,9,3,2,2,22,2,3,8,4,1,1,1037777,"2023-11-19T00:00:00.000Z",17896058,3,"Trendon Watford",2,12,16,12,8,23.8
"17336",5814,0,0,1,1,0,3,2,1,1,6,0,1,5,1,0,0,1037777,"2023-11-19T00:00:00.000Z",174,3,"Harry Giles III",0,6,6,5,1,6.2
"17337",5815,0,0,0,0,0,0,0,0,0,0,0,0,0,0,0,0,1037777,"2023-11-19T00:00:00.000Z",421,3,"Dennis Smith Jr.",0,0,0,0,0,0
"17338",5816,0,0,0,0,0,0,0,0,0,0,0,0,0,0,0,0,1037777,"2023-11-19T00:00:00.000Z",17896048,3,"Cam Thomas",0,0,0,0,0,0
"17339",5817,0,0,0,0,0,0,0,0,0,0,0,0,0,0,0,0,1037777,"2023-11-19T00:00:00.000Z",9051997,3,"Armoni Brooks",0,0,0,0,0,0
"17340",5818,0,0,0,0,0,0,0,0,0,0,0,0,0,0,0,0,1037777,"2023-11-19T00:00:00.000Z",56677843,3,"Noah Clowney",0,0,0,0,0,0
"17341",5819,0,0,0,0,0,0,0,0,0,0,0,0,0,0,0,0,1037777,"2023-11-19T00:00:00.000Z",17896041,3,"Keon Johnson",0,0,0,0,0,0
"17342",5820,0,0,0,0,0,0,0,0,0,0,0,0,0,0,0,0,1037777,"2023-11-19T00:00:00.000Z",417,3,"Ben Simmons",0,0,0,0,0,0
"17343",5821,0,0,0,0,0,0,0,0,0,0,0,0,0,0,0,0,1037777,"2023-11-19T00:00:00.000Z",56677841,3,"Dariq Whitehead",0,0,0,0,0,0
"17344",5822,0,0,0,0,0,0,0,0,0,0,0,0,0,0,0,0,1037777,"2023-11-19T00:00:00.000Z",56677722,3,"Jalen Wilson",0,0,0,0,0,0
"17345",5823,3,0,3,1,1,1,1,0,0,24,0,2,3,3,0,0,1037777,"2023-11-19T00:00:00.000Z",33,23,"Nicolas Batum",0,6,9,6,6,11.1
"17346",5824,1,0,4,4,0,13,5,0,0,32,1,0,10,5,2,0,1037777,"2023-11-19T00:00:00.000Z",200,23,"Tobias Harris",2,15,16,11,6,23.5
"17347",5825,9,1,10,2,1,24,11,10,9,31,2,3,32,12,0,1,1037777,"2023-11-19T00:00:00.000Z",145,23,"Joel Embiid",1,44,53,41,21,61.9
"17348",5826,6,0,1,3,2,7,3,0,0,18,1,3,8,2,0,0,3277403,"2023-11-10T00:00:00.000Z",151,7,"Dante Exum",0,10,16,14,8,19.4
"17349",5827,0,2,2,3,1,7,3,0,0,18,1,1,7,3,0,0,3277402,"2023-11-10T00:00:00.000Z",667378,18,"Naz Reid",2,10,10,7,3,16.6
"17350",5828,0,0,0,0,0,0,0,0,0,0,0,0,0,0,0,0,3277402,"2023-11-10T00:00:00.000Z",38017715,18,"Josh Minott",0,0,0,0,0,0
"17351",5829,0,0,0,0,0,0,0,0,0,0,0,0,0,0,0,0,3277402,"2023-11-10T00:00:00.000Z",17895968,18,"Daishen Nix",0,0,0,0,0,0
"17352",5830,0,0,0,0,0,0,0,0,0,0,0,0,0,0,0,0,3277402,"2023-11-10T00:00:00.000Z",56677851,18,"Jaylen Clark",0,0,0,0,0,0
"17353",5831,0,0,0,0,0,0,0,0,0,0,0,0,0,0,0,0,3277402,"2023-11-10T00:00:00.000Z",17896056,18,"Luka Garza",0,0,0,0,0,0
"17354",5832,0,0,0,0,0,0,0,0,0,0,0,0,0,0,0,0,3277402,"2023-11-10T00:00:00.000Z",666767,18,"Jordan McLaughlin",0,0,0,0,0,0
"17355",5833,0,0,0,0,0,0,0,0,0,0,0,0,0,0,0,0,3277402,"2023-11-10T00:00:00.000Z",56677782,18,"Leonard Miller",0,0,0,0,0,0
"17356",5834,0,0,0,0,0,0,0,0,0,0,0,0,0,0,0,0,3277402,"2023-11-10T00:00:00.000Z",38017700,18,"Wendell Moore Jr.",0,0,0,0,0,0
"17357",5835,0,0,0,0,0,1,0,0,0,3,1,0,0,1,0,0,3277399,"2023-11-10T00:00:00.000Z",17896094,2,"Dalano Banton",0,1,1,0,1,1.2
"17358",5836,0,0,0,0,0,0,0,0,0,0,0,0,0,0,0,0,3277399,"2023-11-10T00:00:00.000Z",3547279,2,"Lamar Stevens",0,0,0,0,0,0
"17359",5837,0,0,0,0,0,0,0,0,0,0,0,0,0,0,0,0,3277399,"2023-11-10T00:00:00.000Z",38017707,2,"JD Davison",0,0,0,0,0,0
"17360",5838,0,0,0,0,0,0,0,0,0,0,0,0,0,0,0,0,3277403,"2023-11-10T00:00:00.000Z",56677873,7,"Dexter Dennis",0,0,0,0,0,0
"17361",5839,0,0,0,0,0,0,0,0,0,0,0,0,0,0,0,0,3277403,"2023-11-10T00:00:00.000Z",257,7,"Maxi Kleber",0,0,0,0,0,0
"17362",5840,0,0,0,0,0,0,0,0,0,0,0,0,0,0,0,0,3277403,"2023-11-10T00:00:00.000Z",17554004,7,"AJ Lawson",0,0,0,0,0,0
"17363",5841,2,0,3,7,1,12,3,1,1,23,0,3,8,3,1,2,3277403,"2023-11-10T00:00:00.000Z",172,13,"Paul George",1,11,13,10,5,15.6
"17364",5842,4,0,2,4,2,15,8,8,8,29,1,2,26,3,0,2,3277403,"2023-11-10T00:00:00.000Z",274,13,"Kawhi Leonard",0,29,33,30,7,33.6
"17365",5843,1,2,3,0,0,9,5,4,2,22,5,3,12,8,0,1,3277403,"2023-11-10T00:00:00.000Z",493,13,"Ivica Zubac",2,20,21,13,9,28.1
"17366",5844,3,0,1,7,2,10,5,2,1,30,4,1,13,5,1,0,3277399,"2023-11-10T00:00:00.000Z",3547276,2,"Payton Pritchard",1,18,21,16,8,26.5
"17367",5845,5,0,3,1,0,10,6,1,1,27,1,1,13,4,0,4,3277405,"2023-11-10T00:00:00.000Z",17896065,21,"Josh Giddey",0,17,22,18,9,21.3
"17368",5846,6,2,7,2,0,25,14,6,5,38,0,1,33,7,2,2,3277405,"2023-11-10T00:00:00.000Z",175,21,"Shai Gilgeous-Alexander",4,40,46,39,13,60.4
"17369",5847,2,0,4,2,0,2,0,2,1,18,0,3,1,4,1,0,3277405,"2023-11-10T00:00:00.000Z",38017706,21,"Jaylin Williams",1,5,7,3,6,11.8
"17370",5848,2,1,2,5,2,7,3,0,0,24,1,1,8,3,0,0,3277405,"2023-11-10T00:00:00.000Z",56677833,21,"Cason Wallace",1,11,13,10,5,17.6
"17371",5849,2,0,0,2,0,2,0,0,0,19,0,1,0,0,0,0,3277405,"2023-11-10T00:00:00.000Z",27924547,21,"Lindy Waters III",0,0,2,2,2,3
"17372",5850,0,0,0,0,0,0,0,0,0,0,0,0,0,0,0,0,3277405,"2023-11-10T00:00:00.000Z",17896036,21,"Tre Mann",0,0,0,0,0,0
"17373",5851,0,0,0,0,0,0,0,0,0,0,0,0,0,0,0,0,1037656,"2023-11-01T00:00:00.000Z",329,7,"Markieff Morris",0,0,0,0,0,0
"17374",5852,0,1,1,4,0,8,1,4,4,17,2,0,6,3,2,0,1037648,"2023-11-01T00:00:00.000Z",283,17,"Brook Lopez",3,9,9,6,3,18.6
"17375",5853,0,0,2,9,6,10,7,0,0,25,0,2,20,2,2,0,1037648,"2023-11-01T00:00:00.000Z",38,17,"Malik Beasley",2,22,22,20,2,28.4
"17376",5854,6,0,2,4,1,9,4,7,6,31,0,1,15,2,0,2,1037648,"2023-11-01T00:00:00.000Z",278,17,"Damian Lillard",0,17,23,21,8,24.4
"17377",5855,1,0,2,9,5,17,7,3,3,36,0,2,22,2,2,0,1037656,"2023-11-01T00:00:00.000Z",268,5,"Zach LaVine",2,24,25,23,3,31.9
"17378",5856,4,0,1,6,1,12,4,2,1,33,0,3,10,1,0,3,1037656,"2023-11-01T00:00:00.000Z",666956,5,"Coby White",0,11,15,14,5,14.2
"17379",5857,1,1,2,3,0,6,3,0,0,22,2,4,6,4,1,2,1037656,"2023-11-01T00:00:00.000Z",89,5,"Alex Caruso",2,10,11,7,5,16.3
"17380",5858,1,0,3,1,0,2,1,0,0,17,2,3,2,5,0,0,1037656,"2023-11-01T00:00:00.000Z",110,5,"Torrey Craig",0,7,8,3,6,9.5
"17381",5859,0,0,2,0,0,5,4,0,0,12,1,2,8,3,2,0,1037656,"2023-11-01T00:00:00.000Z",137,5,"Andre Drummond",2,11,11,8,3,17.6
"17382",5860,2,1,1,2,2,7,5,0,0,15,0,0,12,1,1,1,1037656,"2023-11-01T00:00:00.000Z",87,5,"Jevon Carter",2,13,15,14,3,21.2
"17383",5861,0,0,3,4,1,6,2,0,0,11,0,0,5,3,0,0,1037650,"2023-11-01T00:00:00.000Z",338,2,"Svi Mykhailiuk",0,8,8,5,3,8.6
"17384",5862,2,0,0,0,0,4,2,0,0,7,2,2,4,2,0,0,1037650,"2023-11-01T00:00:00.000Z",3547279,2,"Lamar Stevens",0,6,8,6,4,9.4
"17385",5863,0,0,1,0,0,1,1,0,0,6,1,0,2,2,0,0,1037650,"2023-11-01T00:00:00.000Z",261,2,"Luke Kornet",0,4,4,2,2,4.4
"17386",5864,1,0,3,0,0,4,4,3,3,8,0,2,11,3,1,0,1037650,"2023-11-01T00:00:00.000Z",17896094,2,"Dalano Banton",1,14,15,12,4,19.1
"17387",5865,0,0,0,0,0,0,0,0,0,0,0,0,0,0,0,0,1037650,"2023-11-01T00:00:00.000Z",38017707,2,"JD Davison",0,0,0,0,0,0
"17388",5866,0,0,0,0,0,0,0,0,0,0,0,0,0,0,0,0,1037650,"2023-11-01T00:00:00.000Z",3547295,2,"Nathan Knight",0,0,0,0,0,0
"17389",5867,8,0,3,3,0,5,1,0,0,28,1,2,2,4,1,0,1037658,"2023-11-01T00:00:00.000Z",367,10,"Chris Paul",1,6,14,10,12,21.8
"17390",5868,2,0,6,5,3,9,6,0,0,20,0,1,15,6,0,3,1037658,"2023-11-01T00:00:00.000Z",407,10,"Dario Saric",0,21,23,17,8,22.2
"17391",5869,1,0,2,0,0,4,2,0,0,22,0,0,4,2,1,1,1037658,"2023-11-01T00:00:00.000Z",2189,10,"Gary Payton II",1,6,7,5,3,9.9
"17392",5870,1,0,1,2,1,9,4,3,3,17,0,2,12,1,1,1,1037658,"2023-11-01T00:00:00.000Z",17553979,10,"Jonathan Kuminga",1,13,14,13,2,16.7
"17393",5871,0,1,3,2,0,3,0,2,1,15,0,1,1,3,0,0,1037658,"2023-11-01T00:00:00.000Z",17553992,10,"Moses Moody",1,4,4,1,3,7.6
"17394",5872,0,0,0,0,0,0,0,0,0,0,0,0,0,0,0,0,1037658,"2023-11-01T00:00:00.000Z",251,10,"Cory Joseph",0,0,0,0,0,0
"17395",5873,0,0,0,0,0,0,0,0,0,0,0,0,0,0,0,0,1037658,"2023-11-01T00:00:00.000Z",56677858,10,"Brandin Podziemski",0,0,0,0,0,0
"17396",5874,0,0,0,0,0,0,0,0,0,0,0,0,0,0,0,0,1037658,"2023-11-01T00:00:00.000Z",17896070,10,"Usman Garuba",0,0,0,0,0,0
"17397",5875,0,0,0,0,0,0,0,0,0,0,0,0,0,0,0,0,1037658,"2023-11-01T00:00:00.000Z",45658838,10,"Lester Quinones",0,0,0,0,0,0
"17398",5876,0,0,0,0,0,0,0,0,0,0,0,0,0,0,0,0,1037604,"2023-10-25T00:00:00.000Z",17896023,29,"Josh Christopher",0,0,0,0,0,0
"17399",5877,0,0,0,0,0,0,0,0,0,0,0,0,0,0,0,0,1037603,"2023-10-25T00:00:00.000Z",3,15,"Steven Adams",0,0,0,0,0,0
"17400",5878,0,0,0,0,0,0,0,0,0,0,0,0,0,0,0,0,1037603,"2023-10-25T00:00:00.000Z",17896067,15,"Santi Aldama",0,0,0,0,0,0
"17401",5879,0,1,0,2,0,3,0,0,0,11,0,1,0,0,0,1,1037603,"2023-10-25T00:00:00.000Z",3547260,19,"Kira Lewis Jr.",1,0,0,0,0,2
"17402",5880,0,0,7,0,0,2,1,0,0,15,1,1,2,8,1,2,1037603,"2023-10-25T00:00:00.000Z",340,19,"Larry Nance Jr.",1,10,10,2,8,12.6
"17403",5881,2,0,0,2,1,2,1,0,0,9,0,2,3,0,0,0,1037603,"2023-10-25T00:00:00.000Z",56677837,19,"Jordan Hawkins",0,3,5,5,2,6
"17404",5882,1,0,1,6,3,6,3,0,0,14,0,2,9,1,0,0,1037603,"2023-10-25T00:00:00.000Z",17896017,19,"Matt Ryan",0,10,11,10,2,11.7
"17405",5883,0,0,0,0,0,0,0,0,0,0,0,0,0,0,0,0,1037603,"2023-10-25T00:00:00.000Z",666584,19,"Kaiser Gates",0,0,0,0,0,0
"17406",5884,0,0,0,0,0,0,0,0,0,0,0,0,0,0,0,0,1037603,"2023-10-25T00:00:00.000Z",38017663,19,"E.J. Liddell",0,0,0,0,0,0
"17407",5885,0,0,0,0,0,0,0,0,0,0,0,0,0,0,0,0,1037603,"2023-10-25T00:00:00.000Z",491,19,"Cody Zeller",0,0,0,0,0,0
"17408",5886,1,2,6,9,4,13,5,1,1,30,2,4,15,8,1,0,1037604,"2023-10-25T00:00:00.000Z",38017688,26,"Keegan Murray",3,23,24,16,9,35.1
"17409",5887,0,0,0,4,2,5,3,0,0,16,0,0,8,0,0,0,1037615,"2023-10-27T00:00:00.000Z",305,27,"Doug McDermott",0,8,8,8,0,8
"17410",5888,0,0,0,0,0,0,0,0,0,0,0,0,0,0,0,0,1037615,"2023-10-27T00:00:00.000Z",17896059,27,"Sandro Mamukelashvili",0,0,0,0,0,0
"17411",5889,3,1,1,1,0,4,2,2,0,13,0,1,4,1,0,1,1037615,"2023-10-27T00:00:00.000Z",56677825,11,"Amen Thompson",1,5,8,7,4,11.7
"17412",5890,0,0,0,1,0,2,1,1,1,14,0,1,3,0,3,1,1037615,"2023-10-27T00:00:00.000Z",3547301,11,"Jae'Sean Tate",3,3,3,3,0,11
"17413",5891,2,1,3,4,1,5,2,0,0,23,1,2,5,4,3,0,1037606,"2023-10-25T00:00:00.000Z",108,13,"Robert Covington",4,9,11,7,6,24.8
"17414",5892,0,0,0,1,0,1,0,0,0,3,0,0,0,0,0,0,1037602,"2023-10-25T00:00:00.000Z",27924547,21,"Lindy Waters III",0,0,0,0,0,0
"17415",5893,0,0,2,1,0,1,0,0,0,2,0,0,0,2,0,0,1037602,"2023-10-25T00:00:00.000Z",3547271,21,"Aleksej Pokusevski",0,2,2,0,2,2.4
"17416",5894,1,0,0,0,0,0,0,0,0,2,0,0,0,0,0,0,1037602,"2023-10-25T00:00:00.000Z",17896036,21,"Tre Mann",0,0,1,1,1,1.5
"17417",5895,0,0,0,0,0,0,0,0,0,0,0,0,0,0,0,0,1037602,"2023-10-25T00:00:00.000Z",44,21,"Davis Bertans",0,0,0,0,0,0
"17418",5896,0,0,0,0,0,0,0,0,0,0,0,0,0,0,0,0,1037602,"2023-10-25T00:00:00.000Z",4197029,21,"Vasilije Micic",0,0,0,0,0,0
"17419",5897,0,0,0,0,0,0,0,0,0,0,0,0,0,0,0,0,1037602,"2023-10-25T00:00:00.000Z",56677853,21,"Keyontae Johnson",0,0,0,0,0,0
"17420",5898,0,0,0,0,0,0,0,0,0,0,0,0,0,0,0,0,1037602,"2023-10-25T00:00:00.000Z",38017706,21,"Jaylin Williams",0,0,0,0,0,0
"17421",5899,0,0,0,0,0,0,0,0,0,0,0,0,0,0,0,0,1037602,"2023-10-25T00:00:00.000Z",480,21,"Kenrich Williams",0,0,0,0,0,0
"17422",5900,6,1,4,5,5,17,9,0,0,29,1,2,23,5,1,4,1037606,"2023-10-25T00:00:00.000Z",274,13,"Kawhi Leonard",2,28,34,29,11,40
"17423",5901,0,0,0,0,0,0,0,0,0,0,0,0,0,0,0,0,1038066,"2024-01-03T00:00:00.000Z",56677792,9,"Marcus Sasser",0,0,0,0,0,0
"17424",5902,0,0,0,0,0,0,0,0,0,0,0,0,0,0,0,0,1038066,"2024-01-03T00:00:00.000Z",56677729,9,"Malcolm Cazalon",0,0,0,0,0,0
"17425",5903,0,0,0,0,0,0,0,0,0,0,0,0,0,0,0,0,1038066,"2024-01-03T00:00:00.000Z",330,9,"Monte Morris",0,0,0,0,0,0
"17426",5904,2,0,1,3,0,3,0,0,0,13,1,1,0,2,0,0,1038087,"2024-01-06T00:00:00.000Z",17896025,23,"Jaden Springer",0,2,4,2,4,5.4
"17427",5905,1,0,1,1,0,7,4,2,1,17,1,4,9,2,1,0,1038087,"2024-01-06T00:00:00.000Z",3547294,23,"Kenyon Martin Jr.",1,11,12,10,3,15.9
"17428",5906,0,0,0,0,0,0,0,0,0,0,0,0,0,0,0,0,1038087,"2024-01-06T00:00:00.000Z",56913527,23,"Ricky Council IV",0,0,0,0,0,0
"17429",5907,0,0,0,0,0,0,0,0,0,0,0,0,0,0,0,0,1038087,"2024-01-06T00:00:00.000Z",108,23,"Robert Covington",0,0,0,0,0,0
"17430",5908,0,0,0,0,0,0,0,0,0,0,0,0,0,0,0,0,1038087,"2024-01-06T00:00:00.000Z",145,23,"Joel Embiid",0,0,0,0,0,0
"17431",5909,0,0,0,0,0,0,0,0,0,0,0,0,0,0,0,0,1038087,"2024-01-06T00:00:00.000Z",2175,23,"Danuel House Jr.",0,0,0,0,0,0
"17432",5910,0,0,0,0,0,0,0,0,0,0,0,0,0,0,0,0,1038087,"2024-01-06T00:00:00.000Z",56677788,23,"Terquavion Smith",0,0,0,0,0,0
"17433",5911,0,0,0,0,0,0,0,0,0,0,0,0,0,0,0,0,1038087,"2024-01-06T00:00:00.000Z",200,23,"Tobias Harris",0,0,0,0,0,0
"17434",5912,0,0,0,0,0,0,0,0,0,0,0,0,0,0,0,0,1038087,"2024-01-06T00:00:00.000Z",260,23,"Furkan Korkmaz",0,0,0,0,0,0
"17435",5913,0,0,0,0,0,0,0,0,0,0,0,0,0,0,0,0,1038087,"2024-01-06T00:00:00.000Z",38017732,23,"Kenneth Lofton Jr.",0,0,0,0,0,0
"17436",5914,0,0,0,0,0,0,0,0,0,0,0,0,0,0,0,0,1038061,"2024-01-03T00:00:00.000Z",357,11,"Victor Oladipo",0,0,0,0,0,0
"17437",5915,0,0,0,0,0,0,0,0,0,0,0,0,0,0,0,0,1038061,"2024-01-03T00:00:00.000Z",56677809,11,"Jermaine Samuels Jr.",0,0,0,0,0,0
"17438",5916,0,0,0,0,0,0,0,0,0,0,0,0,0,0,0,0,1038061,"2024-01-03T00:00:00.000Z",47738533,11,"Jeenathan Williams",0,0,0,0,0,0
"17439",5917,5,1,6,6,3,13,6,2,0,32,0,0,15,6,0,0,1038061,"2024-01-03T00:00:00.000Z",666679,3,"Cameron Johnson",1,21,26,20,11,32.7
"17440",5918,2,1,1,11,1,16,4,0,0,20,1,2,9,2,0,2,1038061,"2024-01-03T00:00:00.000Z",158,3,"Dorian Finney-Smith",1,11,13,11,4,15.4
"17441",5919,0,2,8,0,0,8,6,0,0,28,5,5,12,13,1,1,1038061,"2024-01-03T00:00:00.000Z",666508,3,"Nicolas Claxton",3,25,25,12,13,35.6
"17442",5920,3,1,4,12,3,18,5,3,2,36,0,1,15,4,1,1,1038061,"2024-01-03T00:00:00.000Z",61,3,"Mikal Bridges",2,19,22,18,7,29.3
"17443",5921,5,0,1,3,2,5,3,5,3,28,0,1,11,1,2,1,1038061,"2024-01-03T00:00:00.000Z",130,3,"Spencer Dinwiddie",2,12,17,16,6,24.7
"17444",5922,3,0,3,8,2,13,5,2,1,30,1,3,13,4,2,1,1038061,"2024-01-03T00:00:00.000Z",351,3,"Royce O'Neale",2,17,20,16,7,27.3
"17445",5923,1,1,8,0,0,7,4,6,3,20,4,5,11,12,1,1,1038061,"2024-01-03T00:00:00.000Z",17896038,3,"Day'Ron Sharpe",2,23,24,12,13,31.9
"17446",5924,0,0,0,0,0,0,0,0,0,5,0,0,0,0,1,0,1038061,"2024-01-03T00:00:00.000Z",56677722,3,"Jalen Wilson",1,0,0,0,0,3
"17447",5925,5,0,0,2,0,7,0,4,4,18,0,1,4,0,1,1,1038061,"2024-01-03T00:00:00.000Z",17896048,3,"Cam Thomas",1,4,9,9,5,13.5
"17448",5926,0,0,0,0,0,0,0,0,0,0,0,0,0,0,0,0,1038013,"2023-12-28T00:00:00.000Z",338,2,"Svi Mykhailiuk",0,0,0,0,0,0
"17449",5927,6,0,2,10,4,16,8,3,2,32,1,2,22,3,2,2,1038016,"2023-12-28T00:00:00.000Z",303,19,"CJ McCollum",2,25,31,28,9,38.6
"17450",5928,0,0,0,2,1,4,3,0,0,12,0,2,7,0,0,1,1038016,"2023-12-28T00:00:00.000Z",17896097,19,"Jose Alvarado",0,7,7,7,0,6
"17451",5929,0,0,0,0,0,0,0,0,0,0,0,0,0,0,0,0,1038014,"2023-12-28T00:00:00.000Z",242,12,"James Johnson",0,0,0,0,0,0
"17452",5930,0,0,0,0,0,0,0,0,0,0,0,0,0,0,0,0,1038014,"2023-12-28T00:00:00.000Z",304,12,"T.J. McConnell",0,0,0,0,0,0
"17453",5931,0,0,0,0,0,0,0,0,0,0,0,0,0,0,0,0,1038014,"2023-12-28T00:00:00.000Z",3547207,12,"Jordan Nwora",0,0,0,0,0,0
"17454",5932,0,0,0,0,0,0,0,0,0,0,0,0,0,0,0,0,1038014,"2023-12-28T00:00:00.000Z",56677861,12,"Ben Sheppard",0,0,0,0,0,0
"17455",5933,0,0,0,0,0,0,0,0,0,0,0,0,0,0,0,0,1038014,"2023-12-28T00:00:00.000Z",56677832,12,"Jarace Walker",0,0,0,0,0,0
"17456",5934,0,0,0,0,0,0,0,0,0,0,0,0,0,0,0,0,1038014,"2023-12-28T00:00:00.000Z",69,12,"Bruce Brown",0,0,0,0,0,0
"17457",5935,1,1,2,8,3,18,7,0,0,31,0,2,17,2,1,0,1038015,"2023-12-28T00:00:00.000Z",38017679,7,"Jaden Hardy",2,19,20,18,3,26.9
"17458",5936,6,0,2,1,1,11,5,0,0,24,0,4,11,2,0,4,1038015,"2023-12-28T00:00:00.000Z",151,7,"Dante Exum",0,13,19,17,8,18.4
"17459",5937,3,0,3,11,5,19,11,7,5,32,0,2,32,3,2,1,1038015,"2023-12-28T00:00:00.000Z",191,7,"Tim Hardaway Jr.",2,35,38,35,6,45.1
"17460",5938,3,0,2,4,2,8,3,4,3,30,0,2,11,2,0,3,1038015,"2023-12-28T00:00:00.000Z",114,7,"Seth Curry",0,13,16,14,5,14.9
"17461",5939,5,0,0,1,0,3,1,0,0,15,0,0,2,0,0,1,1038015,"2023-12-28T00:00:00.000Z",3547258,7,"Josh Green",0,2,7,7,5,8.5
"17462",5940,0,0,0,0,0,0,0,0,0,0,0,0,0,0,0,0,1038015,"2023-12-28T00:00:00.000Z",217,7,"Richaun Holmes",0,0,0,0,0,0
"17463",5941,0,0,0,0,0,0,0,0,0,0,0,0,0,0,0,0,1038015,"2023-12-28T00:00:00.000Z",17554004,7,"AJ Lawson",0,0,0,0,0,0
"17464",5942,0,0,0,0,0,0,0,0,0,0,0,0,0,0,0,0,1038014,"2023-12-28T00:00:00.000Z",27,5,"Lonzo Ball",0,0,0,0,0,0
"17465",5943,0,0,0,0,0,0,0,0,0,0,0,0,0,0,0,0,1038014,"2023-12-28T00:00:00.000Z",56677874,5,"Onuralp Bitim",0,0,0,0,0,0
"17466",5945,2,0,2,1,1,5,4,0,0,16,0,1,9,2,0,3,1038016,"2023-12-28T00:00:00.000Z",3547293,19,"Naji Marshall",0,11,13,11,4,11.4
"17467",5946,0,0,0,0,0,0,0,0,0,0,0,0,0,0,0,0,1038014,"2023-12-28T00:00:00.000Z",268,5,"Zach LaVine",0,0,0,0,0,0
"17468",5947,0,1,6,2,1,6,4,0,0,25,1,0,9,7,5,2,1038016,"2023-12-28T00:00:00.000Z",340,19,"Larry Nance Jr.",6,16,16,9,7,33.4
"17469",5948,2,0,1,7,2,8,2,0,0,23,0,2,6,1,0,1,1038016,"2023-12-28T00:00:00.000Z",18677986,19,"Trey Murphy III",0,7,9,8,3,9.2
"17470",5949,2,1,2,1,0,1,0,0,0,14,0,2,0,2,2,1,1038016,"2023-12-28T00:00:00.000Z",38017677,19,"Dyson Daniels",3,2,4,2,4,13.4
"17471",5950,0,0,0,0,0,0,0,0,0,0,0,0,0,0,0,0,1038014,"2023-12-28T00:00:00.000Z",460,5,"Nikola Vucevic",0,0,0,0,0,0
"17472",5951,0,0,1,3,1,3,1,0,0,17,0,3,3,1,0,0,1037935,"2023-12-16T00:00:00.000Z",666511,13,"Amir Coffey",0,4,4,3,1,4.2
"17473",5952,0,0,0,0,0,0,0,0,0,0,0,0,0,0,0,0,1037929,"2023-12-16T00:00:00.000Z",38017736,16,"Cole Swider",0,0,0,0,0,0
"17474",5953,5,3,2,2,1,13,9,9,8,42,1,1,27,3,2,3,1037929,"2023-12-16T00:00:00.000Z",125,5,"DeMar DeRozan",5,30,35,32,8,50.1
"17475",5954,4,0,5,5,2,9,4,0,0,20,0,0,10,5,1,2,1037933,"2023-12-16T00:00:00.000Z",329,7,"Markieff Morris",1,15,19,14,9,23
"17476",5955,0,0,0,0,0,0,0,0,0,1,0,0,0,0,0,0,1037933,"2023-12-16T00:00:00.000Z",17554004,7,"AJ Lawson",0,0,0,0,0,0
"17477",5956,0,0,0,0,0,0,0,0,0,0,0,0,0,0,0,0,1037933,"2023-12-16T00:00:00.000Z",3547258,7,"Josh Green",0,0,0,0,0,0
"17478",5957,0,0,0,0,0,0,0,0,0,0,0,0,0,0,0,0,1037933,"2023-12-16T00:00:00.000Z",217,7,"Richaun Holmes",0,0,0,0,0,0
"17479",5958,0,0,0,0,0,0,0,0,0,0,0,0,0,0,0,0,1037933,"2023-12-16T00:00:00.000Z",228,7,"Kyrie Irving",0,0,0,0,0,0
"17480",5959,0,0,0,0,0,0,0,0,0,0,0,0,0,0,0,0,1037933,"2023-12-16T00:00:00.000Z",257,7,"Maxi Kleber",0,0,0,0,0,0
"17481",5960,0,1,2,4,2,14,7,1,1,26,3,1,17,5,0,0,1037930,"2023-12-16T00:00:00.000Z",3547250,12,"Aaron Nesmith",1,22,22,17,5,26
"17482",5961,3,0,2,2,1,3,2,0,0,24,0,2,5,2,2,1,1037930,"2023-12-16T00:00:00.000Z",56677832,12,"Jarace Walker",2,7,10,8,5,16.9
"17483",5962,3,0,1,1,0,4,3,1,1,10,0,0,7,1,0,1,1037930,"2023-12-16T00:00:00.000Z",3547207,12,"Jordan Nwora",0,8,11,10,4,11.7
"17484",5963,1,0,2,0,0,6,3,2,2,7,2,0,8,4,0,0,1037930,"2023-12-16T00:00:00.000Z",56677778,12,"Oscar Tshiebwe",0,12,13,9,5,14.3
"17485",5964,0,0,2,0,0,0,0,0,0,3,0,1,0,2,0,0,1037930,"2023-12-16T00:00:00.000Z",242,12,"James Johnson",0,2,2,0,2,2.4
"17486",5965,0,0,0,0,0,0,0,0,0,0,0,0,0,0,0,0,1037930,"2023-12-16T00:00:00.000Z",38017701,12,"Kendall Brown",0,0,0,0,0,0
"17487",5966,0,0,0,0,0,0,0,0,0,0,0,0,0,0,0,0,1037930,"2023-12-16T00:00:00.000Z",3547245,12,"Tyrese Haliburton",0,0,0,0,0,0
"17488",5967,4,0,3,1,0,7,4,4,2,15,3,1,10,6,1,0,1037935,"2023-12-16T00:00:00.000Z",472,13,"Russell Westbrook",1,16,20,14,10,26.2
"17489",5968,0,0,0,0,0,0,0,0,0,0,0,0,0,0,0,0,1037935,"2023-12-16T00:00:00.000Z",450,13,"PJ Tucker",0,0,0,0,0,0
"17490",5969,0,0,0,0,0,0,0,0,0,0,0,0,0,0,0,0,1037935,"2023-12-16T00:00:00.000Z",38017725,13,"Moussa Diabate",0,0,0,0,0,0
"17491",5970,0,0,0,0,0,0,0,0,0,0,0,0,0,0,0,0,1037935,"2023-12-16T00:00:00.000Z",17896031,13,"Nah'Shon Hyland",0,0,0,0,0,0
"17492",5971,1,0,2,5,2,8,3,5,4,22,1,0,12,3,1,0,1037934,"2023-12-16T00:00:00.000Z",56677824,29,"Taylor Hendricks",1,15,16,13,4,20.1
"17493",5972,0,0,4,1,0,1,0,0,0,4,0,0,0,4,0,0,1037934,"2023-12-16T00:00:00.000Z",19465584,29,"Micah Potter",0,4,4,0,4,4.8
"17494",5973,1,0,0,2,0,2,0,0,0,4,0,0,0,0,0,0,1037934,"2023-12-16T00:00:00.000Z",38017630,29,"Johnny Juzang",0,0,1,1,1,1.5
"17495",5974,0,0,0,0,0,0,0,0,0,0,0,0,0,0,0,0,1037934,"2023-12-16T00:00:00.000Z",17896023,29,"Josh Christopher",0,0,0,0,0,0
"17496",5975,0,0,0,0,0,0,0,0,0,0,0,0,0,0,0,0,1037934,"2023-12-16T00:00:00.000Z",100,29,"Jordan Clarkson",0,0,0,0,0,0
"17497",5976,0,0,0,0,0,0,0,0,0,0,0,0,0,0,0,0,7050286,"2023-12-08T00:00:00.000Z",277,6,"Caris LeVert",0,0,0,0,0,0
"17498",5977,3,0,5,2,0,5,1,5,1,22,1,1,3,6,0,1,7050290,"2023-12-08T00:00:00.000Z",177,8,"Aaron Gordon",0,9,12,6,9,13.7
"17499",5978,5,2,9,2,1,26,9,7,4,34,7,5,23,16,0,3,7050290,"2023-12-08T00:00:00.000Z",246,8,"Nikola Jokic",2,39,44,28,21,52.7
"17500",5979,0,1,0,3,2,6,5,2,2,25,0,1,14,0,0,0,7050290,"2023-12-08T00:00:00.000Z",81,8,"Kentavious Caldwell-Pope",1,14,14,14,0,17
"17501",5980,3,0,5,8,4,17,6,5,5,32,0,2,21,5,0,1,7050290,"2023-12-08T00:00:00.000Z",335,8,"Jamal Murray",0,26,29,24,8,30.5
"17502",5981,0,0,0,0,0,0,0,0,0,0,0,0,0,0,0,0,7050289,"2023-12-08T00:00:00.000Z",56677817,27,"Sidy Cissoko",0,0,0,0,0,0
"17503",5982,0,0,0,0,0,0,0,0,0,0,0,0,0,0,0,0,7050289,"2023-12-08T00:00:00.000Z",56677870,27,"Sir'Jabari Rice",0,0,0,0,0,0
"17504",5983,10,0,5,2,0,24,7,10,6,39,1,2,20,6,3,2,7050289,"2023-12-08T00:00:00.000Z",125,5,"DeMar DeRozan",3,26,36,30,16,49.2
"17505",5984,3,1,5,3,2,11,8,4,2,34,1,3,20,6,1,0,7050289,"2023-12-08T00:00:00.000Z",3547248,5,"Patrick Williams",2,26,29,23,9,37.7
"17506",5985,2,1,6,2,0,22,9,3,3,36,10,2,21,16,0,0,7050289,"2023-12-08T00:00:00.000Z",460,5,"Nikola Vucevic",1,37,39,23,18,46.2
"17507",5986,2,0,2,2,0,5,2,0,0,18,1,2,4,3,1,2,7050289,"2023-12-08T00:00:00.000Z",89,5,"Alex Caruso",1,7,9,6,5,11.6
"17508",5987,1,0,0,1,0,1,0,0,0,4,0,0,0,0,0,0,7050287,"2023-12-08T00:00:00.000Z",38017700,18,"Wendell Moore Jr.",0,0,1,1,1,1.5
"17509",5988,0,0,0,0,0,0,0,0,0,0,0,0,0,0,0,0,7050287,"2023-12-08T00:00:00.000Z",56677851,18,"Jaylen Clark",0,0,0,0,0,0
"17510",5989,1,0,1,2,0,4,1,0,0,14,0,3,2,1,2,1,7050290,"2023-12-08T00:00:00.000Z",38017709,8,"Christian Braun",2,3,4,3,2,9.7
"17511",5990,6,0,4,7,5,15,9,1,1,39,0,0,24,4,1,3,7050289,"2023-12-08T00:00:00.000Z",666956,5,"Coby White",1,28,34,30,10,37.8
"17512",5991,3,0,3,2,0,5,2,0,0,26,0,1,4,3,1,0,7050289,"2023-12-08T00:00:00.000Z",17895983,5,"Ayo Dosunmu",1,7,10,7,6,15.1
"17513",5992,0,0,0,0,0,0,0,0,0,4,0,1,0,0,0,0,7050290,"2023-12-08T00:00:00.000Z",56677776,8,"Julian Strawther",0,0,0,0,0,0
"17514",5993,6,0,2,4,0,8,2,2,2,25,1,2,6,3,0,0,7050290,"2023-12-08T00:00:00.000Z",236,8,"Reggie Jackson",0,9,15,12,9,18.6
"17515",5994,2,0,3,1,0,9,4,5,5,26,1,3,13,4,0,1,7050290,"2023-12-08T00:00:00.000Z",38017721,8,"Peyton Watson",0,17,19,15,6,19.8
"17516",5995,0,0,0,0,0,0,0,0,0,0,0,0,0,0,0,0,7050287,"2023-12-08T00:00:00.000Z",3547259,18,"Jaden McDaniels",0,0,0,0,0,0
"17517",5996,0,0,0,0,0,0,0,0,0,0,0,0,0,0,0,0,7050287,"2023-12-08T00:00:00.000Z",56677782,18,"Leonard Miller",0,0,0,0,0,0
"17518",5997,0,0,0,0,0,0,0,0,0,0,0,0,0,0,0,0,7050287,"2023-12-08T00:00:00.000Z",38017715,18,"Josh Minott",0,0,0,0,0,0
"17519",5998,0,0,0,0,0,0,0,0,0,0,0,0,0,0,0,0,7050287,"2023-12-08T00:00:00.000Z",17895968,18,"Daishen Nix",0,0,0,0,0,0
"17520",5999,2,0,3,0,0,2,1,0,0,12,1,2,2,4,1,1,7050290,"2023-12-08T00:00:00.000Z",250,8,"DeAndre Jordan",1,6,8,4,6,11.8
"17521",6000,0,0,0,0,0,1,1,0,0,6,0,1,2,0,1,0,7050290,"2023-12-08T00:00:00.000Z",215,8,"Justin Holiday",1,2,2,2,0,5
"17522",6001,2,0,3,3,0,5,0,4,3,17,1,3,3,4,1,2,1037831,"2023-11-26T00:00:00.000Z",356,24,"Josh Okogie",1,7,9,5,6,11.8
"17523",6002,2,1,5,5,0,11,3,3,3,27,2,3,9,7,2,1,1037831,"2023-11-26T00:00:00.000Z",32,24,"Keita Bates-Diop",3,16,18,11,9,28.4
"17524",6003,4,4,6,2,0,9,4,0,0,33,4,2,8,10,1,1,1037831,"2023-11-26T00:00:00.000Z",349,24,"Jusuf Nurkic",5,18,22,12,14,40
"17525",6004,2,1,2,9,6,13,9,2,1,33,0,3,25,2,0,2,1037831,"2023-11-26T00:00:00.000Z",178,24,"Eric Gordon",1,27,29,27,4,31.4
"17526",6005,11,2,3,4,1,25,10,8,7,38,2,3,28,5,0,2,1037831,"2023-11-26T00:00:00.000Z",57,24,"Devin Booker",2,33,44,39,16,54.5
"17527",6006,0,2,2,6,3,9,4,0,0,20,0,1,11,2,0,1,1037831,"2023-11-26T00:00:00.000Z",666729,24,"Nassir Little",2,13,13,11,2,18.4
"17528",6007,5,1,4,3,2,10,6,0,0,29,3,2,14,7,1,0,1037831,"2023-11-26T00:00:00.000Z",18678058,24,"Jordan Goodwin",2,21,26,19,12,35.9
"17529",6008,0,0,2,2,2,3,3,0,0,13,2,3,8,4,0,0,1037831,"2023-11-26T00:00:00.000Z",314,24,"Chimezie Metu",0,12,12,8,4,12.8
"17530",6009,1,0,2,0,0,2,1,2,1,15,4,4,3,6,0,2,1037831,"2023-11-26T00:00:00.000Z",147,24,"Drew Eubanks",0,9,10,4,7,9.7
"17531",6010,0,0,0,4,2,4,2,2,1,15,0,1,7,0,0,0,1037831,"2023-11-26T00:00:00.000Z",470,24,"Yuta Watanabe",0,7,7,7,0,7
"17532",6011,0,0,0,0,0,0,0,0,0,0,0,0,0,0,0,0,1037831,"2023-11-26T00:00:00.000Z",3547095,24,"Udoka Azubuike",0,0,0,0,0,0
"17533",6012,0,0,0,0,0,0,0,0,0,0,0,0,0,0,0,0,1037831,"2023-11-26T00:00:00.000Z",666451,24,"Bol Bol",0,0,0,0,0,0
"17534",6013,0,0,0,0,0,0,0,0,0,0,0,0,0,0,0,0,1037831,"2023-11-26T00:00:00.000Z",140,24,"Kevin Durant",0,0,0,0,0,0
"17535",6014,0,0,0,0,0,0,0,0,0,0,0,0,0,0,0,0,1037831,"2023-11-26T00:00:00.000Z",3547298,24,"Saben Lee",0,0,0,0,0,0
"17536",6015,0,0,0,0,0,0,0,0,0,0,0,0,0,0,0,0,1037831,"2023-11-26T00:00:00.000Z",8,24,"Grayson Allen",0,0,0,0,0,0
"17537",6016,0,0,0,0,0,0,0,0,0,0,0,0,0,0,0,0,1037831,"2023-11-26T00:00:00.000Z",37,24,"Bradley Beal",0,0,0,0,0,0
"17538",6017,0,0,0,0,0,0,0,0,0,0,0,0,0,0,0,0,1037831,"2023-11-26T00:00:00.000Z",272,24,"Damion Lee",0,0,0,0,0,0
"17539",6018,4,0,0,2,0,12,5,2,2,20,2,2,12,2,1,1,1037833,"2023-11-26T00:00:00.000Z",401,15,"Derrick Rose",1,14,18,16,6,22.4
"17540",6019,1,0,2,2,0,2,0,0,0,10,1,1,0,3,1,0,1037833,"2023-11-26T00:00:00.000Z",38017731,15,"Vince Williams Jr.",1,3,4,1,4,8.1
"17541",6020,1,0,2,3,2,8,4,2,1,18,0,5,11,2,0,2,1037833,"2023-11-26T00:00:00.000Z",17896027,15,"Ziaire Williams",0,13,14,12,3,12.9
"17542",6021,0,0,0,0,0,0,0,0,0,0,0,0,0,0,0,0,1037833,"2023-11-26T00:00:00.000Z",3,15,"Steven Adams",0,0,0,0,0,0
"17543",6022,1,0,5,3,2,11,7,5,4,33,0,5,20,5,1,2,1037832,"2023-11-26T00:00:00.000Z",56677823,4,"Brandon Miller",1,25,26,21,6,28.5
"17544",6023,1,0,1,0,0,0,0,0,0,6,1,2,0,2,1,1,1037832,"2023-11-26T00:00:00.000Z",38017708,4,"Bryce McGowens",1,2,3,1,3,5.9
"17545",6024,3,0,0,0,0,0,0,0,0,4,0,0,0,0,0,0,1037832,"2023-11-26T00:00:00.000Z",3547253,4,"Theo Maledon",0,0,3,3,3,4.5
"17546",6025,0,0,0,0,0,0,0,0,0,0,0,0,0,0,0,0,1037832,"2023-11-26T00:00:00.000Z",56677866,4,"Leaky Black",0,0,0,0,0,0
"17547",6026,0,0,1,1,0,1,0,0,0,2,0,0,0,1,1,1,1037753,"2023-11-15T00:00:00.000Z",38017691,17,"TyTy Washington Jr.",1,1,1,0,1,3.2
"17548",6027,0,0,0,1,0,1,0,0,0,2,0,1,0,0,0,1,1037753,"2023-11-15T00:00:00.000Z",666960,17,"Lindell Wigginton",0,0,0,0,0,-1
"17549",6028,0,0,0,0,0,0,0,0,0,2,0,0,0,0,0,0,1037753,"2023-11-15T00:00:00.000Z",284,17,"Robin Lopez",0,0,0,0,0,0
"17550",6029,0,0,0,0,0,0,0,0,0,0,0,0,0,0,0,0,1037753,"2023-11-15T00:00:00.000Z",15,17,"Giannis Antetokounmpo",0,0,0,0,0,0
"17551",6030,0,0,0,0,0,0,0,0,0,0,0,0,0,0,0,0,1037753,"2023-11-15T00:00:00.000Z",666453,17,"Marques Bolden",0,0,0,0,0,0
"17552",6031,0,0,0,0,0,0,0,0,0,0,0,0,0,0,0,0,1037753,"2023-11-15T00:00:00.000Z",112,17,"Jae Crowder",0,0,0,0,0,0
"17553",6032,0,0,0,0,0,0,0,0,0,0,0,0,0,0,0,0,1037753,"2023-11-15T00:00:00.000Z",56677854,17,"Chris Livingston",0,0,0,0,0,0
"17554",6033,0,0,0,2,0,3,0,0,0,8,0,0,0,0,0,1,1037752,"2023-11-15T00:00:00.000Z",328,23,"Marcus Morris",0,0,0,0,0,-1
"17555",6034,0,0,2,1,1,5,4,0,0,20,0,2,9,2,2,2,1037752,"2023-11-15T00:00:00.000Z",17896025,23,"Jaden Springer",2,11,11,9,2,15.4
"17556",6035,2,1,3,1,1,5,4,2,1,14,3,1,10,6,0,1,1037752,"2023-11-15T00:00:00.000Z",3547270,23,"Paul Reed",1,16,18,12,8,22.2
"17557",6036,0,0,0,0,0,0,0,0,0,0,0,0,0,0,0,0,1037752,"2023-11-15T00:00:00.000Z",3547294,23,"Kenyon Martin Jr.",0,0,0,0,0,0
"17558",6037,0,0,0,0,0,0,0,0,0,0,0,0,0,0,0,0,1037752,"2023-11-15T00:00:00.000Z",33,23,"Nicolas Batum",0,0,0,0,0,0
"17559",6038,0,0,0,0,0,0,0,0,0,0,0,0,0,0,0,0,1037752,"2023-11-15T00:00:00.000Z",56913527,23,"Ricky Council IV",0,0,0,0,0,0
"17560",6039,0,0,0,0,0,0,0,0,0,0,0,0,0,0,0,0,1037752,"2023-11-15T00:00:00.000Z",360,23,"Kelly Oubre Jr.",0,0,0,0,0,0
"17561",6040,0,0,0,0,0,0,0,0,0,0,0,0,0,0,0,0,1037752,"2023-11-15T00:00:00.000Z",17554001,23,"Javonte Smart",0,0,0,0,0,0
"17562",6041,0,0,0,0,0,0,0,0,0,0,0,0,0,0,0,0,1037751,"2023-11-15T00:00:00.000Z",56677806,1,"Mouhamed Gueye",0,0,0,0,0,0
"17563",6042,0,0,0,0,0,0,0,0,0,0,0,0,0,0,0,0,1037751,"2023-11-15T00:00:00.000Z",56677855,1,"Seth Lundy",0,0,0,0,0,0
"17564",6043,0,0,0,0,0,0,0,0,0,0,0,0,0,0,0,0,1037751,"2023-11-15T00:00:00.000Z",56677875,1,"Miles Norris",0,0,0,0,0,0
"17565",6044,5,1,6,5,1,10,4,0,0,33,2,4,9,8,0,2,1037751,"2023-11-15T00:00:00.000Z",202,20,"Josh Hart",1,17,22,14,13,27.1
"17566",6045,8,0,8,5,3,24,12,2,2,39,2,4,29,10,1,1,1037751,"2023-11-15T00:00:00.000Z",387,20,"Julius Randle",1,39,47,37,18,55
"17567",6046,0,1,9,0,0,3,3,0,0,31,6,0,6,15,3,1,1037751,"2023-11-15T00:00:00.000Z",399,20,"Mitchell Robinson",4,21,21,6,15,35
"17568",6047,1,0,1,7,3,10,4,0,0,28,0,3,11,1,1,3,1037751,"2023-11-15T00:00:00.000Z",17895858,20,"Quentin Grimes",1,12,13,12,2,13.7
"17569",6048,8,0,0,10,6,19,8,2,2,41,0,2,24,0,0,3,1037751,"2023-11-15T00:00:00.000Z",73,20,"Jalen Brunson",0,24,32,32,8,33
"17570",6049,0,0,0,0,0,0,0,0,0,0,0,0,0,0,0,0,1037751,"2023-11-15T00:00:00.000Z",19,20,"Ryan Arcidiacono",0,0,0,0,0,0
"17571",6050,0,0,0,0,0,2,1,1,0,4,0,0,2,0,1,1,1037750,"2023-11-15T00:00:00.000Z",38017679,7,"Jaden Hardy",1,2,2,2,0,4
"17572",6051,0,0,0,0,0,0,0,0,0,0,0,0,0,0,0,0,1037681,"2023-11-05T00:00:00.000Z",3547247,6,"Isaac Okoro",0,0,0,0,0,0
"17573",6052,0,0,0,0,0,0,0,0,0,0,0,0,0,0,0,0,1037681,"2023-11-05T00:00:00.000Z",56677872,6,"Craig Porter",0,0,0,0,0,0
"17574",6053,0,2,2,4,1,14,5,4,4,20,1,2,15,3,0,1,1037681,"2023-11-05T00:00:00.000Z",17553979,10,"Jonathan Kuminga",2,18,18,15,3,23.6
"17575",6054,0,0,2,2,0,3,1,2,1,14,1,1,3,3,1,0,1037681,"2023-11-05T00:00:00.000Z",17553992,10,"Moses Moody",1,6,6,3,3,9.6
"17576",6055,1,1,3,0,0,3,2,6,1,12,1,4,5,4,1,0,1037681,"2023-11-05T00:00:00.000Z",56677799,10,"Trayce Jackson-Davis",2,9,10,6,5,17.3
"17577",6056,2,0,1,1,0,2,0,0,0,8,1,0,0,2,1,2,1037681,"2023-11-05T00:00:00.000Z",56677858,10,"Brandin Podziemski",1,2,4,2,4,6.4
"17578",6057,0,0,0,0,0,0,0,0,0,3,0,0,0,0,1,0,1037681,"2023-11-05T00:00:00.000Z",251,10,"Cory Joseph",1,0,0,0,0,3
"17579",6058,0,0,0,0,0,0,0,0,0,0,0,0,0,0,0,0,1037681,"2023-11-05T00:00:00.000Z",17896070,10,"Usman Garuba",0,0,0,0,0,0
"17580",6059,0,0,0,0,0,0,0,0,0,0,0,0,0,0,0,0,1037681,"2023-11-05T00:00:00.000Z",45658838,10,"Lester Quinones",0,0,0,0,0,0
"17581",6060,0,0,0,0,0,0,0,0,0,0,0,0,0,0,0,0,1037681,"2023-11-05T00:00:00.000Z",398,10,"Jerome Robinson",0,0,0,0,0,0
"17582",6061,0,0,1,0,0,3,2,1,1,11,2,4,5,3,0,1,1037683,"2023-11-05T00:00:00.000Z",476,25,"Robert Williams III",0,8,8,5,3,7.6
"17583",6062,1,1,2,5,0,9,2,1,1,16,3,2,5,5,3,0,1037683,"2023-11-05T00:00:00.000Z",38017711,25,"Jabari Walker",4,10,11,6,6,24.5
"17584",6063,0,0,0,0,0,0,0,0,0,0,0,0,0,0,0,0,1037683,"2023-11-05T00:00:00.000Z",56677791,25,"Kris Murray",0,0,0,0,0,0
"17585",6064,0,0,0,0,0,0,0,0,0,0,0,0,0,0,0,0,1037683,"2023-11-05T00:00:00.000Z",56677829,25,"Rayan Rupert",0,0,0,0,0,0
"17586",6065,0,0,0,0,0,0,0,0,0,0,0,0,0,0,0,0,1037683,"2023-11-05T00:00:00.000Z",56677747,25,"Scoot Henderson",0,0,0,0,0,0
"17587",6066,0,0,0,0,0,0,0,0,0,0,0,0,0,0,0,0,1037683,"2023-11-05T00:00:00.000Z",56783340,25,"Duop Reath",0,0,0,0,0,0
"17588",6067,0,0,0,0,0,0,0,0,0,0,0,0,0,0,0,0,1037683,"2023-11-05T00:00:00.000Z",419,25,"Anfernee Simons",0,0,0,0,0,0
"17589",6068,0,0,0,0,0,0,0,0,0,0,0,0,0,0,0,0,1037683,"2023-11-05T00:00:00.000Z",17896120,25,"Ish Wainright",0,0,0,0,0,0
"17590",6069,1,1,6,2,1,4,2,2,1,28,1,2,6,7,0,2,1037683,"2023-11-05T00:00:00.000Z",17896027,15,"Ziaire Williams",1,13,14,7,8,16.9
"17591",6070,2,1,4,4,1,18,11,6,4,37,3,1,27,7,1,2,1037683,"2023-11-05T00:00:00.000Z",231,15,"Jaren Jackson Jr.",2,34,36,29,9,42.4
"17592",6071,5,0,8,9,3,27,13,1,1,34,0,5,30,8,1,3,1037683,"2023-11-05T00:00:00.000Z",3547287,15,"Desmond Bane",1,38,43,35,13,47.1
"17593",6072,5,0,2,5,2,9,4,0,0,29,0,3,10,2,2,3,1037683,"2023-11-05T00:00:00.000Z",420,15,"Marcus Smart",2,12,17,15,7,22.9
"17594",6073,3,0,4,3,1,8,3,0,0,20,1,0,7,5,0,2,1037683,"2023-11-05T00:00:00.000Z",17896067,15,"Santi Aldama",0,12,15,10,8,15.5
"17595",6074,3,1,2,2,1,3,2,1,0,10,0,0,5,2,0,0,1037683,"2023-11-05T00:00:00.000Z",38017732,15,"Kenneth Lofton Jr.",1,7,10,8,5,14.9
"17596",6075,2,0,5,6,4,9,5,1,1,32,0,0,15,5,1,1,1037683,"2023-11-05T00:00:00.000Z",254,15,"Luke Kennard",1,20,22,17,7,26
"17597",6076,9,1,9,0,0,6,2,0,0,23,1,2,4,10,0,2,1037599,"2023-10-25T00:00:00.000Z",417,3,"Ben Simmons",1,14,23,13,19,30.5
"17598",6077,2,0,3,5,2,21,13,11,8,25,0,0,36,3,1,1,1037599,"2023-10-25T00:00:00.000Z",17896048,3,"Cam Thomas",1,39,41,38,5,44.6
"17599",6078,0,2,1,0,0,3,2,0,0,12,1,2,4,2,0,3,1037599,"2023-10-25T00:00:00.000Z",17896038,3,"Day'Ron Sharpe",2,6,6,4,2,9.4
"17600",6079,9,0,1,9,1,19,4,15,14,36,0,3,23,1,1,5,1037595,"2023-10-25T00:00:00.000Z",490,1,"Trae Young",1,24,33,32,10,35.7
"17601",6080,0,0,0,0,0,0,0,0,0,0,0,0,0,0,0,0,1037595,"2023-10-25T00:00:00.000Z",56677855,1,"Seth Lundy",0,0,0,0,0,0
"17602",6081,0,0,0,0,0,0,0,0,0,0,0,0,0,0,0,0,1037595,"2023-10-25T00:00:00.000Z",301,1,"Wesley Matthews",0,0,0,0,0,0
"17603",6082,0,0,0,0,0,0,0,0,0,0,0,0,0,0,0,0,1037595,"2023-10-25T00:00:00.000Z",56677875,1,"Miles Norris",0,0,0,0,0,0
"17604",6083,6,0,5,1,1,8,3,1,1,25,1,1,8,6,3,0,1037596,"2023-10-25T00:00:00.000Z",487,30,"Delon Wright",3,14,20,14,12,33.2
"17605",6084,1,0,3,5,1,11,4,2,2,25,2,1,11,5,0,1,1037596,"2023-10-25T00:00:00.000Z",17896045,30,"Corey Kispert",0,16,17,12,6,17.5
"17606",6085,0,0,1,2,2,7,4,6,6,17,2,1,16,3,0,0,1037596,"2023-10-25T00:00:00.000Z",167,30,"Danilo Gallinari",0,19,19,16,3,19.6
"17607",6086,3,3,4,1,1,3,1,0,0,23,0,1,3,4,0,3,1037596,"2023-10-25T00:00:00.000Z",56677844,30,"Bilal Coulibaly",3,7,10,6,7,18.3
"17608",6087,0,0,3,0,0,0,0,0,0,8,0,0,0,3,0,0,1037596,"2023-10-25T00:00:00.000Z",337,30,"Mike Muscala",0,3,3,0,3,3.6
"17609",6088,1,0,1,0,0,3,2,0,0,8,1,0,4,2,0,1,1037596,"2023-10-25T00:00:00.000Z",17896106,30,"Eugene Omoruyi",0,6,7,5,3,6.9
"17610",6089,1,0,3,0,0,3,0,2,1,6,0,0,1,3,0,1,1037596,"2023-10-25T00:00:00.000Z",38017712,30,"Ryan Rollins",0,4,5,2,4,5.1
"17611",6090,2,0,0,1,1,3,1,0,0,10,0,4,3,0,1,2,1037601,"2023-10-25T00:00:00.000Z",3547275,28,"Malachi Flynn",1,3,5,5,2,7
"17612",6091,1,0,0,0,0,1,0,0,0,2,0,1,0,0,0,0,1037601,"2023-10-25T00:00:00.000Z",56677828,28,"Gradey Dick",0,0,1,1,1,1.5
"17613",6092,0,0,0,1,1,2,1,0,0,4,0,0,3,0,0,0,1037596,"2023-10-25T00:00:00.000Z",18677954,30,"Jared Butler",0,3,3,3,0,3
"17614",6093,0,0,0,0,0,0,0,0,0,0,0,0,0,0,0,0,1037596,"2023-10-25T00:00:00.000Z",38124126,30,"John Butler Jr.",0,0,0,0,0,0
"17615",6094,0,0,0,0,0,0,0,0,0,0,0,0,0,0,0,0,1037596,"2023-10-25T00:00:00.000Z",38017687,30,"Johnny Davis",0,0,0,0,0,0
"17616",6095,0,0,0,0,0,0,0,0,0,0,0,0,0,0,0,0,1037596,"2023-10-25T00:00:00.000Z",3547302,30,"Anthony Gill",0,0,0,0,0,0
"17617",6096,0,0,0,0,0,0,0,0,0,0,0,0,0,0,0,0,1037596,"2023-10-25T00:00:00.000Z",414,30,"Landry Shamet",0,0,0,0,0,0
"17618",6097,0,0,0,0,0,0,0,0,0,0,0,0,0,0,0,0,1037601,"2023-10-25T00:00:00.000Z",58,28,"Chris Boucher",0,0,0,0,0,0
"17619",6098,2,1,3,3,1,20,9,3,1,33,2,1,20,5,1,0,1037602,"2023-10-25T00:00:00.000Z",125,5,"DeMar DeRozan",2,25,27,22,7,35
"17620",6099,4,0,1,4,0,10,4,0,0,30,2,3,8,3,2,0,1037602,"2023-10-25T00:00:00.000Z",3547248,5,"Patrick Williams",2,11,15,12,7,23.6
"17621",6100,4,2,8,2,0,8,5,1,1,32,1,2,11,9,3,4,1037602,"2023-10-25T00:00:00.000Z",460,5,"Nikola Vucevic",5,20,24,15,13,38.8
"17622",6101,1,0,1,1,1,3,2,2,2,7,1,0,7,2,0,2,1038092,"2024-01-07T00:00:00.000Z",491,19,"Cody Zeller",0,9,10,8,3,8.9
"17623",6102,0,0,0,0,0,0,0,0,0,0,0,0,0,0,0,0,1038091,"2024-01-07T00:00:00.000Z",196,22,"Gary Harris",0,0,0,0,0,0
"17624",6103,0,0,0,0,0,0,0,0,0,0,0,0,0,0,0,0,1038091,"2024-01-07T00:00:00.000Z",38017607,22,"Kevon Harris",0,0,0,0,0,0
"17625",6104,0,0,0,0,0,0,0,0,0,0,0,0,0,0,0,0,1038091,"2024-01-07T00:00:00.000Z",56677839,22,"Jett Howard",0,0,0,0,0,0
"17626",6105,0,0,0,0,0,0,0,0,0,0,0,0,0,0,0,0,1038091,"2024-01-07T00:00:00.000Z",229,22,"Jonathan Isaac",0,0,0,0,0,0
"17627",6106,0,0,0,0,0,0,0,0,0,0,0,0,0,0,0,0,1038091,"2024-01-07T00:00:00.000Z",17896026,22,"Franz Wagner",0,0,0,0,0,0
"17628",6107,2,0,6,4,2,10,5,5,4,38,1,1,16,7,1,0,1038091,"2024-01-07T00:00:00.000Z",3547256,1,"Saddiq Bey",1,23,25,18,9,30.4
"17629",6108,4,1,10,4,0,12,6,0,0,40,1,6,12,11,0,3,1038091,"2024-01-07T00:00:00.000Z",17896040,1,"Jalen Johnson",1,23,27,16,15,31.2
"17630",6109,0,2,8,0,0,6,2,2,0,36,4,3,4,12,3,1,1038091,"2024-01-07T00:00:00.000Z",83,1,"Clint Capela",5,16,16,4,12,32.4
"17631",6110,0,0,0,0,0,0,0,0,0,0,0,0,0,0,0,0,1038091,"2024-01-07T00:00:00.000Z",56677838,1,"Kobe Bufkin",0,0,0,0,0,0
"17632",6111,0,0,0,0,0,0,0,0,0,0,0,0,0,0,0,0,1038091,"2024-01-07T00:00:00.000Z",56677806,1,"Mouhamed Gueye",0,0,0,0,0,0
"17633",6112,0,0,0,0,0,0,0,0,0,0,0,0,0,0,0,0,1038091,"2024-01-07T00:00:00.000Z",666656,1,"De'Andre Hunter",0,0,0,0,0,0
"17634",6113,0,0,0,0,0,0,0,0,0,0,0,0,0,0,0,0,1038091,"2024-01-07T00:00:00.000Z",4197387,1,"Vit Krejci",0,0,0,0,0,0
"17635",6114,0,0,0,2,0,2,0,0,0,10,0,1,0,0,1,0,1038092,"2024-01-07T00:00:00.000Z",17553994,26,"Davion Mitchell",1,0,0,0,0,3
"17636",6115,0,0,1,5,1,9,5,0,0,21,1,0,11,2,0,0,1038092,"2024-01-07T00:00:00.000Z",4197162,26,"Aleksandar Vezenkov",0,13,13,11,2,13.4
"17637",6116,0,0,1,2,2,4,3,2,2,8,1,0,10,2,0,0,1038092,"2024-01-07T00:00:00.000Z",17896044,26,"Kessler Edwards",0,12,12,10,2,12.4
"17638",6117,1,0,1,0,0,1,0,0,0,6,0,0,0,1,0,1,1038092,"2024-01-07T00:00:00.000Z",306,26,"JaVale McGee",0,1,2,1,2,1.7
"17639",6118,1,0,0,3,3,6,5,0,0,12,2,1,13,2,1,0,1038092,"2024-01-07T00:00:00.000Z",38017714,26,"Keon Ellis",1,15,16,14,3,19.9
"17640",6119,4,0,1,2,0,5,2,0,0,10,0,1,4,1,1,0,1038092,"2024-01-07T00:00:00.000Z",56677845,26,"Colby Jones",1,5,9,8,5,14.2
"17641",6120,3,0,0,0,0,2,0,0,0,10,1,1,0,1,1,0,1038092,"2024-01-07T00:00:00.000Z",273,26,"Alex Len",1,1,4,3,4,8.7
"17642",6121,0,0,0,0,0,0,0,0,0,0,0,0,0,0,0,0,1038092,"2024-01-07T00:00:00.000Z",17895990,26,"Jordan Ford",0,0,0,0,0,0
"17643",6122,2,0,6,2,0,20,9,10,6,40,0,2,24,6,0,3,1038091,"2024-01-07T00:00:00.000Z",334,1,"Dejounte Murray",0,30,32,26,8,31.2
"17644",6123,9,1,4,9,2,23,11,10,7,42,0,2,31,4,1,5,1038091,"2024-01-07T00:00:00.000Z",490,1,"Trae Young",2,35,44,40,13,50.3
"17645",6124,1,0,2,9,4,17,7,0,0,26,1,5,18,3,4,0,1038091,"2024-01-07T00:00:00.000Z",53,1,"Bogdan Bogdanovic",4,21,22,19,4,35.1
"17646",6125,3,5,5,2,1,3,2,2,0,32,1,3,5,6,0,0,1038091,"2024-01-07T00:00:00.000Z",3547244,1,"Onyeka Okongwu",5,11,14,8,9,31.7
"17647",6126,0,0,0,0,0,0,0,0,0,0,0,0,0,0,0,0,1038018,"2023-12-28T00:00:00.000Z",666747,16,"Caleb Martin",0,0,0,0,0,0
"17648",6127,4,0,2,3,2,8,6,2,2,24,0,4,16,2,1,1,1038020,"2023-12-28T00:00:00.000Z",17553995,14,"Austin Reaves",1,18,22,20,6,26.4
"17649",6128,4,1,5,3,3,4,3,0,0,23,0,2,9,5,0,2,1038020,"2023-12-28T00:00:00.000Z",486,14,"Christian Wood",1,14,18,13,9,22
"17650",6129,1,0,0,1,0,5,1,0,0,7,0,1,2,0,1,1,1038020,"2023-12-28T00:00:00.000Z",56677835,14,"Jalen Hood-Schifino",1,2,3,3,1,5.5
"17651",6130,0,0,1,0,0,7,5,0,0,7,1,0,10,2,0,0,1038020,"2023-12-28T00:00:00.000Z",666626,14,"Jaxson Hayes",0,12,12,10,2,12.4
"17652",6131,0,0,0,0,0,0,0,0,0,0,0,0,0,0,0,0,1038020,"2023-12-28T00:00:00.000Z",56677738,14,"Colin Castleton",0,0,0,0,0,0
"17653",6132,0,0,0,0,0,0,0,0,0,0,0,0,0,0,0,0,1038020,"2023-12-28T00:00:00.000Z",56677867,14,"Alex Fudge",0,0,0,0,0,0
"17654",6133,0,0,0,0,0,0,0,0,0,0,0,0,0,0,0,0,1038020,"2023-12-28T00:00:00.000Z",56677868,14,"D'Moi Hodge",0,0,0,0,0,0
"17655",6134,0,0,0,0,0,0,0,0,0,0,0,0,0,0,0,0,1038020,"2023-12-28T00:00:00.000Z",56677836,14,"Maxwell Lewis",0,0,0,0,0,0
"17656",6135,0,0,0,0,0,0,0,0,0,0,0,0,0,0,0,0,1038020,"2023-12-28T00:00:00.000Z",666860,14,"Cameron Reddish",0,0,0,0,0,0
"17657",6136,0,0,0,0,0,0,0,0,0,0,0,0,0,0,0,0,1038020,"2023-12-28T00:00:00.000Z",1603383,14,"Gabe Vincent",0,0,0,0,0,0
"17658",6137,1,0,2,4,3,6,3,2,1,22,0,3,10,2,0,1,1038020,"2023-12-28T00:00:00.000Z",38017708,4,"Bryce McGowens",0,12,13,11,3,12.9
"17659",6138,5,1,4,10,4,20,7,2,2,33,1,3,20,5,0,3,1038020,"2023-12-28T00:00:00.000Z",62,4,"Miles Bridges",1,25,30,25,10,33.5
"17660",6139,1,2,7,0,0,5,5,3,1,26,3,3,11,10,1,0,1038020,"2023-12-28T00:00:00.000Z",3547282,4,"Nick Richards",3,21,22,12,11,33.5
"17661",6140,2,1,0,5,3,9,5,4,4,29,1,0,17,1,1,3,1038020,"2023-12-28T00:00:00.000Z",56677823,4,"Brandon Miller",2,18,20,19,3,24.2
"17662",6141,8,0,6,3,1,14,5,9,7,32,0,0,18,6,1,4,1038020,"2023-12-28T00:00:00.000Z",403,4,"Terry Rozier",1,24,32,26,14,36.2
"17663",6142,4,1,3,4,1,7,2,2,1,22,0,0,6,3,1,2,1038017,"2023-12-28T00:00:00.000Z",3547285,15,"Xavier Tillman",2,9,13,10,7,19.6
"17664",6143,0,0,0,0,0,0,0,0,0,0,0,0,0,0,0,0,1038017,"2023-12-28T00:00:00.000Z",3,15,"Steven Adams",0,0,0,0,0,0
"17665",6144,0,0,0,0,0,0,0,0,0,0,0,0,0,0,0,0,1038017,"2023-12-28T00:00:00.000Z",666505,15,"Brandon Clarke",0,0,0,0,0,0
"17666",6145,0,0,0,0,0,0,0,0,0,0,0,0,0,0,0,0,1038017,"2023-12-28T00:00:00.000Z",56677830,15,"GG Jackson",0,0,0,0,0,0
"17667",6146,0,0,0,0,0,0,0,0,0,0,0,0,0,0,0,0,1038017,"2023-12-28T00:00:00.000Z",254,15,"Luke Kennard",0,0,0,0,0,0
"17668",6147,0,0,0,0,0,0,0,0,0,0,0,0,0,0,0,0,1038017,"2023-12-28T00:00:00.000Z",38017728,15,"Jake LaRavia",0,0,0,0,0,0
"17669",6148,0,0,0,0,0,0,0,0,0,0,0,0,0,0,0,0,1038017,"2023-12-28T00:00:00.000Z",401,15,"Derrick Rose",0,0,0,0,0,0
"17670",6149,2,0,2,3,0,7,2,4,1,20,2,1,5,4,1,2,1038020,"2023-12-28T00:00:00.000Z",666748,4,"Cody Martin",1,9,11,7,6,13.8
"17671",6150,0,0,5,4,0,11,4,2,1,25,1,1,9,6,0,3,1038020,"2023-12-28T00:00:00.000Z",666950,4,"P.J. Washington",0,15,15,9,6,13.2
"17672",6151,2,1,2,5,1,10,6,0,0,23,1,1,13,3,1,2,1037949,"2023-12-18T00:00:00.000Z",38017620,29,"Ochai Agbaji",2,16,18,15,5,23.6
"17673",6152,1,0,1,6,2,6,2,0,0,23,0,2,6,1,1,1,1037949,"2023-12-18T00:00:00.000Z",351,3,"Royce O'Neale",1,7,8,7,2,10.7
"17674",6153,0,0,0,0,0,0,0,0,0,3,0,0,0,0,0,0,1037949,"2023-12-18T00:00:00.000Z",174,3,"Harry Giles III",0,0,0,0,0,0
"17675",6154,2,0,1,1,1,5,5,0,0,23,0,3,11,1,0,1,1037948,"2023-12-18T00:00:00.000Z",151,7,"Dante Exum",0,12,14,13,3,14.2
"17676",6155,8,0,8,12,6,24,13,10,6,36,3,1,38,11,0,3,1037948,"2023-12-18T00:00:00.000Z",132,7,"Luka Doncic",0,49,57,46,19,60.2
"17677",6156,1,0,2,9,2,12,3,0,0,22,0,2,8,2,0,2,1037948,"2023-12-18T00:00:00.000Z",191,7,"Tim Hardaway Jr.",0,10,11,9,3,9.9
"17678",6157,3,0,3,2,0,5,1,0,0,20,1,1,2,4,0,0,1037948,"2023-12-18T00:00:00.000Z",56677859,7,"Olivier-Maxence Prosper",0,6,9,5,7,11.3
"17679",6158,0,0,3,2,0,3,1,0,0,13,0,1,2,3,0,0,1037948,"2023-12-18T00:00:00.000Z",329,7,"Markieff Morris",0,5,5,2,3,5.6
"17680",6159,0,0,0,0,0,0,0,0,0,7,0,2,0,0,0,0,1037948,"2023-12-18T00:00:00.000Z",114,7,"Seth Curry",0,0,0,0,0,0
"17681",6160,3,1,1,3,2,9,3,2,1,19,0,1,9,1,0,1,1037948,"2023-12-18T00:00:00.000Z",38017679,7,"Jaden Hardy",1,10,13,12,4,16.7
"17682",6161,0,0,1,2,1,4,2,2,1,15,1,2,6,2,0,1,1037948,"2023-12-18T00:00:00.000Z",17554004,7,"AJ Lawson",0,8,8,6,2,7.4
"17683",6162,0,0,1,0,0,3,2,5,1,9,1,1,5,2,0,1,1037948,"2023-12-18T00:00:00.000Z",17896028,7,"Greg Brown III",0,7,7,5,2,6.4
"17684",6163,0,0,3,0,0,4,1,0,0,7,1,0,2,4,0,0,1037948,"2023-12-18T00:00:00.000Z",217,7,"Richaun Holmes",0,6,6,2,4,6.8
"17685",6164,0,0,0,0,0,0,0,0,0,0,0,0,0,0,0,0,1037948,"2023-12-18T00:00:00.000Z",56677873,7,"Dexter Dennis",0,0,0,0,0,0
"17686",6165,0,0,0,0,0,0,0,0,0,0,0,0,0,0,0,0,1037948,"2023-12-18T00:00:00.000Z",3547258,7,"Josh Green",0,0,0,0,0,0
"17687",6166,0,0,0,0,0,0,0,0,0,0,0,0,0,0,0,0,1037948,"2023-12-18T00:00:00.000Z",228,7,"Kyrie Irving",0,0,0,0,0,0
"17688",6167,0,0,0,0,0,0,0,0,0,0,0,0,0,0,0,0,1037948,"2023-12-18T00:00:00.000Z",257,7,"Maxi Kleber",0,0,0,0,0,0
"17689",6168,0,0,0,0,0,0,0,0,0,0,0,0,0,0,0,0,1037948,"2023-12-18T00:00:00.000Z",56677840,7,"Dereck Lively II",0,0,0,0,0,0
"17690",6169,0,0,0,4,2,11,8,1,1,33,0,1,19,0,1,1,1037950,"2023-12-18T00:00:00.000Z",30,26,"Harrison Barnes",1,19,19,19,0,21
"17691",6170,4,0,4,7,4,17,9,3,3,32,1,4,25,5,1,0,1037950,"2023-12-18T00:00:00.000Z",38017688,26,"Keegan Murray",1,30,34,29,9,40
"17692",6171,12,1,10,1,1,16,11,6,5,32,3,1,28,13,0,2,1037950,"2023-12-18T00:00:00.000Z",406,26,"Domantas Sabonis",1,41,53,40,25,62.6
"17693",6172,2,1,4,4,1,8,4,2,2,23,0,4,11,4,0,0,1037950,"2023-12-18T00:00:00.000Z",221,26,"Kevin Huerter",1,15,17,13,6,21.8
"17694",6173,6,1,5,7,2,19,10,12,8,33,0,2,30,5,3,1,1037950,"2023-12-18T00:00:00.000Z",161,26,"De'Aaron Fox",4,35,41,36,11,56
"17695",6174,6,1,1,6,3,7,3,2,1,21,0,3,10,1,0,1,1037950,"2023-12-18T00:00:00.000Z",324,26,"Malik Monk",1,11,17,16,7,22.2
"17696",6175,2,1,1,5,1,5,1,0,0,15,0,4,3,1,1,0,1037950,"2023-12-18T00:00:00.000Z",38017714,26,"Keon Ellis",2,4,6,5,3,13.2
"17697",6176,0,0,0,0,0,0,0,0,0,0,0,0,0,0,0,0,7050288,"2023-12-08T00:00:00.000Z",17896036,21,"Tre Mann",0,0,0,0,0,0
"17698",6177,2,2,4,2,0,7,3,2,1,18,4,5,7,8,0,0,7050284,"2023-12-08T00:00:00.000Z",3547244,1,"Onyeka Okongwu",2,15,17,9,10,25.6
"17699",6178,2,1,1,3,1,4,1,0,0,17,0,2,3,1,1,1,7050284,"2023-12-08T00:00:00.000Z",319,1,"Patty Mills",2,4,6,5,3,12.2
"17700",6179,0,0,0,0,0,0,0,0,0,0,0,0,0,0,0,0,7050284,"2023-12-08T00:00:00.000Z",56677838,1,"Kobe Bufkin",0,0,0,0,0,0
"17701",6180,0,0,0,0,0,0,0,0,0,0,0,0,0,0,0,0,7050284,"2023-12-08T00:00:00.000Z",56677806,1,"Mouhamed Gueye",0,0,0,0,0,0
"17702",6181,0,0,0,0,0,0,0,0,0,0,0,0,0,0,0,0,7050284,"2023-12-08T00:00:00.000Z",17896040,1,"Jalen Johnson",0,0,0,0,0,0
"17703",6182,0,0,0,0,0,0,0,0,0,0,0,0,0,0,0,0,7050284,"2023-12-08T00:00:00.000Z",56677855,1,"Seth Lundy",0,0,0,0,0,0
"17704",6183,0,0,0,0,0,0,0,0,0,0,0,0,0,0,0,0,7050284,"2023-12-08T00:00:00.000Z",56677875,1,"Miles Norris",0,0,0,0,0,0
"17705",6184,0,0,0,0,0,0,0,0,0,0,0,0,0,0,0,0,7050284,"2023-12-08T00:00:00.000Z",490,1,"Trae Young",0,0,0,0,0,0
"17706",6185,0,0,0,0,0,0,0,0,0,0,0,0,0,0,0,0,7050285,"2023-12-08T00:00:00.000Z",9051997,3,"Armoni Brooks",0,0,0,0,0,0
"17707",6186,0,0,0,0,0,0,0,0,0,0,0,0,0,0,0,0,7050285,"2023-12-08T00:00:00.000Z",56677843,3,"Noah Clowney",0,0,0,0,0,0
"17708",6187,0,0,0,0,0,0,0,0,0,1,0,0,0,0,0,0,7981426,"2023-12-08T00:00:00.000Z",666468,2,"Oshae Brissett",0,0,0,0,0,0
"17709",6188,0,0,0,0,0,0,0,0,0,1,0,0,0,0,0,0,7981426,"2023-12-08T00:00:00.000Z",17896094,2,"Dalano Banton",0,0,0,0,0,0
"17710",6189,3,0,6,6,2,8,3,4,3,22,5,2,11,11,1,3,7050288,"2023-12-08T00:00:00.000Z",407,10,"Dario Saric",1,22,25,14,14,28.7
"17711",6190,0,0,0,0,0,0,0,0,0,0,0,0,0,0,0,0,7050288,"2023-12-08T00:00:00.000Z",17896070,10,"Usman Garuba",0,0,0,0,0,0
"17712",6191,0,0,0,0,0,0,0,0,0,0,0,0,0,0,0,0,7050288,"2023-12-08T00:00:00.000Z",45658838,10,"Lester Quinones",0,0,0,0,0,0
"17713",6192,0,0,0,0,0,0,0,0,0,0,0,0,0,0,0,0,7050288,"2023-12-08T00:00:00.000Z",398,10,"Jerome Robinson",0,0,0,0,0,0
"17714",6193,0,0,0,0,0,0,0,0,0,0,0,0,0,0,0,0,7050288,"2023-12-08T00:00:00.000Z",57875092,10,"Gui Santos",0,0,0,0,0,0
"17715",6194,0,0,4,0,0,1,1,0,0,13,0,0,2,4,1,1,7050283,"2023-12-08T00:00:00.000Z",666818,22,"Chuma Okeke",1,6,6,2,4,8.8
"17716",6195,0,0,0,0,0,0,0,0,0,0,0,0,0,0,0,0,7050285,"2023-12-08T00:00:00.000Z",17896041,3,"Keon Johnson",0,0,0,0,0,0
"17717",6196,0,0,0,0,0,0,0,0,0,0,0,0,0,0,0,0,7050285,"2023-12-08T00:00:00.000Z",417,3,"Ben Simmons",0,0,0,0,0,0
"17718",6197,0,0,0,0,0,0,0,0,0,0,0,0,0,0,0,0,7050285,"2023-12-08T00:00:00.000Z",56677841,3,"Dariq Whitehead",0,0,0,0,0,0
"17719",6198,0,0,0,0,0,0,0,0,0,0,0,0,0,0,0,0,7050285,"2023-12-08T00:00:00.000Z",56677722,3,"Jalen Wilson",0,0,0,0,0,0
"17720",6199,4,2,7,4,1,9,6,3,2,27,0,1,15,7,1,0,7050285,"2023-12-08T00:00:00.000Z",3547242,30,"Deni Avdija",3,22,26,19,11,38.4
"17721",6200,2,0,4,0,0,4,2,0,0,16,1,1,4,5,0,2,7050283,"2023-12-08T00:00:00.000Z",462,22,"Moritz Wagner",0,9,11,6,7,11
"17722",6201,8,0,7,5,2,18,9,6,3,37,0,2,23,7,2,2,1037832,"2023-11-26T00:00:00.000Z",38017683,22,"Paolo Banchero",2,30,38,31,15,47.4
"17723",6202,3,0,5,0,0,7,5,1,1,20,2,4,11,7,1,2,1037832,"2023-11-26T00:00:00.000Z",666442,22,"Goga Bitadze",1,18,21,14,10,24.9
"17724",6203,1,2,5,5,2,9,5,0,0,32,0,2,12,5,1,1,1037832,"2023-11-26T00:00:00.000Z",17896073,22,"Jalen Suggs",3,17,18,13,6,27.5
"17725",6204,3,0,0,1,0,4,1,0,0,15,0,3,2,0,0,0,1037832,"2023-11-26T00:00:00.000Z",56677827,22,"Anthony Black",0,2,5,5,3,6.5
"17726",6205,1,0,2,1,0,3,0,0,0,15,0,2,0,2,1,2,1037832,"2023-11-26T00:00:00.000Z",226,22,"Joe Ingles",1,2,3,1,3,4.9
"17727",6206,6,0,0,5,1,6,2,0,0,24,0,2,5,0,1,0,1037832,"2023-11-26T00:00:00.000Z",196,22,"Gary Harris",1,5,11,11,6,17
"17728",6207,2,0,5,2,1,7,4,2,2,18,2,3,11,7,0,2,1037832,"2023-11-26T00:00:00.000Z",462,22,"Moritz Wagner",0,18,20,13,9,20.4
"17729",6208,7,1,6,3,1,16,9,12,11,32,1,3,30,7,2,2,1037832,"2023-11-26T00:00:00.000Z",3547251,22,"Cole Anthony",3,37,44,37,14,55.9
"17730",6209,0,0,1,2,1,2,1,3,3,12,1,2,6,2,0,0,1037832,"2023-11-26T00:00:00.000Z",38017724,22,"Caleb Houstan",0,8,8,6,2,8.4
"17731",6210,0,0,0,0,0,0,0,0,0,0,0,0,0,0,0,0,1037832,"2023-11-26T00:00:00.000Z",229,22,"Jonathan Isaac",0,0,0,0,0,0
"17732",6211,0,0,0,0,0,0,0,0,0,0,0,0,0,0,0,0,1037832,"2023-11-26T00:00:00.000Z",666818,22,"Chuma Okeke",0,0,0,0,0,0
"17733",6212,0,0,0,0,0,0,0,0,0,0,0,0,0,0,0,0,1037832,"2023-11-26T00:00:00.000Z",666885,22,"Admiral Schofield",0,0,0,0,0,0
"17734",6213,0,0,0,0,0,0,0,0,0,0,0,0,0,0,0,0,1037832,"2023-11-26T00:00:00.000Z",85,22,"Wendell Carter Jr.",0,0,0,0,0,0
"17735",6214,0,0,0,0,0,0,0,0,0,0,0,0,0,0,0,0,1037832,"2023-11-26T00:00:00.000Z",165,22,"Markelle Fultz",0,0,0,0,0,0
"17736",6215,0,0,0,0,0,0,0,0,0,0,0,0,0,0,0,0,1037832,"2023-11-26T00:00:00.000Z",38017607,22,"Kevon Harris",0,0,0,0,0,0
"17737",6216,0,0,0,0,0,0,0,0,0,0,0,0,0,0,0,0,1037832,"2023-11-26T00:00:00.000Z",56677839,22,"Jett Howard",0,0,0,0,0,0
"17738",6217,0,0,0,0,0,0,0,0,0,0,0,0,0,0,0,0,1037832,"2023-11-26T00:00:00.000Z",17553983,22,"Trevelin Queen",0,0,0,0,0,0
"17739",6218,2,1,5,4,2,11,4,2,0,33,0,1,10,5,0,3,1037832,"2023-11-26T00:00:00.000Z",204,4,"Gordon Hayward",1,15,17,12,7,19
"17740",6219,2,1,7,4,1,17,9,6,4,37,3,2,23,10,1,3,1037832,"2023-11-26T00:00:00.000Z",62,4,"Miles Bridges",2,33,35,25,12,41
"17741",6220,1,1,5,0,0,6,5,2,2,22,1,4,12,6,1,1,1037832,"2023-11-26T00:00:00.000Z",38017698,4,"Mark Williams",2,18,19,13,7,25.7
"17742",6221,9,1,1,4,2,15,9,4,2,37,0,4,22,1,1,5,1037832,"2023-11-26T00:00:00.000Z",403,4,"Terry Rozier",2,23,32,31,10,37.7
"17743",6222,2,0,1,3,1,6,3,0,0,14,0,0,7,1,0,1,1037832,"2023-11-26T00:00:00.000Z",3547239,4,"LaMelo Ball",0,8,10,9,3,10.2
"17744",6223,0,0,4,2,1,9,4,4,3,22,2,4,12,6,1,1,1037833,"2023-11-26T00:00:00.000Z",667378,18,"Naz Reid",1,18,18,12,6,21.2
"17745",6224,0,0,0,1,1,2,1,0,0,2,0,0,3,0,0,0,1037833,"2023-11-26T00:00:00.000Z",17895968,18,"Daishen Nix",0,3,3,3,0,3
"17746",6225,0,0,0,0,0,0,0,0,0,0,0,0,0,0,0,0,1037833,"2023-11-26T00:00:00.000Z",56677851,18,"Jaylen Clark",0,0,0,0,0,0
"17747",6226,0,0,0,0,0,0,0,0,0,0,0,0,0,0,0,0,1037792,"2023-11-20T00:00:00.000Z",56677849,13,"Kobe Brown",0,0,0,0,0,0
"17748",6227,0,0,0,0,0,0,0,0,0,0,0,0,0,0,0,0,1037792,"2023-11-20T00:00:00.000Z",56677856,13,"Jordan Miller",0,0,0,0,0,0
"17749",6228,0,0,0,0,0,0,0,0,0,0,0,0,0,0,0,0,1037792,"2023-11-20T00:00:00.000Z",24417679,13,"Xavier Moon",0,0,0,0,0,0
"17750",6229,0,0,0,0,0,0,0,0,0,0,0,0,0,0,0,0,1037792,"2023-11-20T00:00:00.000Z",371,13,"Mason Plumlee",0,0,0,0,0,0
"17751",6230,0,0,0,0,0,0,0,0,0,0,0,0,0,0,0,0,1037792,"2023-11-20T00:00:00.000Z",17896051,13,"Joshua Primo",0,0,0,0,0,0
"17752",6231,0,0,1,0,0,2,2,0,0,5,0,0,4,1,0,1,1037790,"2023-11-20T00:00:00.000Z",3547259,18,"Jaden McDaniels",0,5,5,4,1,4.2
"17753",6232,4,2,5,3,2,10,6,7,6,36,0,6,20,5,3,3,1037790,"2023-11-20T00:00:00.000Z",447,18,"Karl-Anthony Towns",5,25,29,24,9,44
"17754",6233,1,2,4,0,0,7,7,7,2,26,3,2,16,7,0,1,1037790,"2023-11-20T00:00:00.000Z",176,18,"Rudy Gobert",2,23,24,17,8,30.9
"17755",6234,5,0,8,6,1,21,9,4,4,39,2,1,23,10,2,3,1037790,"2023-11-20T00:00:00.000Z",3547238,18,"Anthony Edwards",2,33,38,28,15,45.5
"17756",6235,5,1,1,8,3,9,3,2,2,28,0,3,11,1,0,0,1037790,"2023-11-20T00:00:00.000Z",104,18,"Mike Conley",1,12,17,16,6,22.7
"17757",6236,3,0,2,6,3,8,4,0,0,33,1,2,11,3,0,0,1037790,"2023-11-20T00:00:00.000Z",666400,18,"Nickeil Alexander-Walker",0,14,17,14,6,19.1
"17758",6237,5,2,2,0,0,4,3,5,3,23,0,2,9,2,1,1,1037790,"2023-11-20T00:00:00.000Z",12,18,"Kyle Anderson",3,11,16,14,7,26.9
"17759",6238,1,0,3,6,1,8,3,3,3,18,0,6,10,3,1,3,1037790,"2023-11-20T00:00:00.000Z",667378,18,"Naz Reid",1,13,14,11,4,15.1
"17760",6239,5,1,4,4,2,10,6,1,1,34,0,1,15,4,0,0,1037789,"2023-11-20T00:00:00.000Z",125,5,"DeMar DeRozan",1,19,24,20,9,30.3
"17761",6240,3,1,2,4,2,10,4,4,3,27,2,1,13,4,1,2,1037789,"2023-11-20T00:00:00.000Z",89,5,"Alex Caruso",2,17,20,16,7,26.3
"17762",6241,2,0,5,4,0,16,7,4,4,32,2,4,18,7,0,2,1037789,"2023-11-20T00:00:00.000Z",460,5,"Nikola Vucevic",0,25,27,20,9,27.4
"17763",6242,5,0,3,6,2,9,5,1,1,35,0,1,13,3,0,1,1037789,"2023-11-20T00:00:00.000Z",268,5,"Zach LaVine",0,16,21,18,8,23.1
"17764",6243,3,1,5,8,4,11,7,2,2,34,1,2,20,6,1,2,1037789,"2023-11-20T00:00:00.000Z",666956,5,"Coby White",2,26,29,23,9,35.7
"17765",6244,0,0,1,3,0,5,1,0,0,16,0,1,2,1,0,0,1037789,"2023-11-20T00:00:00.000Z",110,5,"Torrey Craig",0,3,3,2,1,3.2
"17766",6245,1,1,0,4,0,5,0,0,0,14,0,2,0,0,0,1,1037789,"2023-11-20T00:00:00.000Z",87,5,"Jevon Carter",1,0,1,1,1,3.5
"17767",6246,1,0,1,2,0,6,2,0,0,24,0,0,4,1,2,0,1037790,"2023-11-20T00:00:00.000Z",202,20,"Josh Hart",2,5,6,5,2,12.7
"17768",6247,0,0,1,7,1,14,4,6,6,17,0,3,15,1,0,0,1037790,"2023-11-20T00:00:00.000Z",3547269,20,"Immanuel Quickley",0,16,16,15,1,16.2
"17769",6248,5,0,1,6,1,8,2,2,2,26,2,3,7,3,1,0,1037790,"2023-11-20T00:00:00.000Z",131,20,"Donte DiVincenzo",1,10,15,12,8,21.1
"17770",6249,0,1,2,0,0,3,1,0,0,14,3,3,2,5,0,1,1037790,"2023-11-20T00:00:00.000Z",201,20,"Isaiah Hartenstein",1,7,7,2,5,10
"17771",6250,0,0,1,1,0,3,0,2,0,3,0,0,0,1,0,0,1037790,"2023-11-20T00:00:00.000Z",666675,20,"DaQuan Jeffries",0,1,1,0,1,1.2
"17772",6251,0,0,0,0,0,0,0,0,0,0,0,0,0,0,0,0,3277399,"2023-11-10T00:00:00.000Z",56677843,3,"Noah Clowney",0,0,0,0,0,0
"17773",6252,0,0,0,0,0,0,0,0,0,3,0,0,0,0,0,0,3277405,"2023-11-10T00:00:00.000Z",17896044,26,"Kessler Edwards",0,0,0,0,0,0
"17774",6253,0,0,1,2,0,2,0,0,0,5,0,2,0,1,1,1,3277405,"2023-11-10T00:00:00.000Z",17896030,26,"Chris Duarte",1,1,1,0,1,3.2
"17775",6254,0,0,0,0,0,0,0,0,0,0,0,0,0,0,0,0,3277405,"2023-11-10T00:00:00.000Z",17895990,26,"Jordan Ford",0,0,0,0,0,0
"17776",6255,0,0,0,0,0,0,0,0,0,0,0,0,0,0,0,0,3277405,"2023-11-10T00:00:00.000Z",56677845,26,"Colby Jones",0,0,0,0,0,0
"17777",6256,0,0,3,6,1,11,4,2,2,30,2,0,11,5,2,0,3277404,"2023-11-10T00:00:00.000Z",32,24,"Keita Bates-Diop",2,16,16,11,5,23
"17778",6257,5,0,8,6,4,27,13,10,8,38,1,4,38,9,0,4,3277404,"2023-11-10T00:00:00.000Z",140,24,"Kevin Durant",0,47,52,43,14,52.3
"17779",6258,7,0,6,3,2,8,4,7,4,33,3,3,14,9,1,2,3277404,"2023-11-10T00:00:00.000Z",349,24,"Jusuf Nurkic",1,23,30,21,16,36.3
"17780",6259,4,0,7,4,1,8,4,0,0,32,2,6,9,9,1,2,3277404,"2023-11-10T00:00:00.000Z",8,24,"Grayson Allen",1,18,22,13,13,26.8
"17781",6260,2,0,2,4,2,17,9,6,4,31,2,4,24,4,2,2,3277404,"2023-11-10T00:00:00.000Z",37,24,"Bradley Beal",2,28,30,26,6,35.8
"17782",6261,1,1,3,0,0,3,1,0,0,14,2,2,2,5,0,2,3277404,"2023-11-10T00:00:00.000Z",147,24,"Drew Eubanks",1,7,8,3,6,10.5
"17783",6262,0,0,0,0,0,0,0,0,0,0,0,0,0,0,0,0,3277404,"2023-11-10T00:00:00.000Z",3547095,24,"Udoka Azubuike",0,0,0,0,0,0
"17784",6263,0,0,0,0,0,0,0,0,0,0,0,0,0,0,0,0,3277404,"2023-11-10T00:00:00.000Z",666451,24,"Bol Bol",0,0,0,0,0,0
"17785",6264,0,0,0,0,0,0,0,0,0,0,0,0,0,0,0,0,3277400,"2023-11-10T00:00:00.000Z",56677831,11,"Cam Whitmore",0,0,0,0,0,0
"17786",6265,5,1,6,11,3,24,11,9,6,38,0,2,31,6,0,4,3277400,"2023-11-10T00:00:00.000Z",227,19,"Brandon Ingram",1,37,42,36,11,44.7
"17787",6266,1,1,6,0,0,16,8,11,8,34,2,5,24,8,0,5,3277400,"2023-11-10T00:00:00.000Z",666969,19,"Zion Williamson",1,32,33,25,9,33.1
"17788",6267,2,4,6,1,1,12,7,1,0,29,3,6,15,9,0,2,3277400,"2023-11-10T00:00:00.000Z",455,19,"Jonas Valanciunas",4,24,26,17,11,38.8
"17789",6268,2,0,8,3,0,6,2,6,6,41,2,2,10,10,1,2,3277400,"2023-11-10T00:00:00.000Z",38017677,19,"Dyson Daniels",1,20,22,12,12,26
"17790",6269,1,0,7,8,3,11,4,4,3,41,0,6,14,7,2,3,3277400,"2023-11-10T00:00:00.000Z",56677837,19,"Jordan Hawkins",2,21,22,15,8,26.9
"17791",6270,1,0,2,4,0,8,1,2,2,26,2,1,4,4,0,1,3277405,"2023-11-10T00:00:00.000Z",30,26,"Harrison Barnes",0,8,9,5,5,9.3
"17792",6271,1,1,7,10,3,17,8,5,5,40,4,1,24,11,3,3,3277405,"2023-11-10T00:00:00.000Z",38017688,26,"Keegan Murray",4,35,36,25,12,47.7
"17793",6272,13,2,7,0,0,15,7,6,3,38,6,5,17,13,1,5,3277405,"2023-11-10T00:00:00.000Z",406,26,"Domantas Sabonis",3,30,43,30,26,56.1
"17794",6273,2,1,9,10,4,19,11,2,2,34,0,4,28,9,3,2,3277405,"2023-11-10T00:00:00.000Z",221,26,"Kevin Huerter",4,37,39,30,11,51.8
"17795",6274,2,3,3,7,1,8,2,4,3,31,1,3,8,4,0,1,3277405,"2023-11-10T00:00:00.000Z",38017714,26,"Keon Ellis",3,12,14,10,6,23.8
"17796",6275,3,0,5,3,2,6,3,6,6,29,0,0,14,5,2,2,3277403,"2023-11-10T00:00:00.000Z",192,13,"James Harden",2,19,22,17,8,28.5
"17797",6276,0,0,1,8,1,10,2,0,0,21,0,1,5,1,0,0,1037648,"2023-11-01T00:00:00.000Z",56677828,28,"Gradey Dick",0,6,6,5,1,6.2
"17798",6277,0,0,0,0,0,0,0,0,0,0,0,0,0,0,0,0,1037646,"2023-10-31T00:00:00.000Z",17896022,13,"Brandon Boston Jr.",0,0,0,0,0,0
"17799",6278,0,0,0,0,0,0,0,0,0,0,0,0,0,0,0,0,1037646,"2023-10-31T00:00:00.000Z",108,13,"Robert Covington",0,0,0,0,0,0
"17800",6279,0,0,0,0,0,0,0,0,0,0,0,0,0,0,0,0,1037646,"2023-10-31T00:00:00.000Z",666743,13,"Terance Mann",0,0,0,0,0,0
"17801",6280,0,0,0,0,0,0,0,0,0,0,0,0,0,0,0,0,1037646,"2023-10-31T00:00:00.000Z",3547294,13,"Kenyon Martin Jr.",0,0,0,0,0,0
"17802",6281,0,0,0,0,0,0,0,0,0,0,0,0,0,0,0,0,1037646,"2023-10-31T00:00:00.000Z",328,13,"Marcus Morris",0,0,0,0,0,0
"17803",6282,0,0,0,0,0,0,0,0,0,0,0,0,0,0,0,0,1037646,"2023-10-31T00:00:00.000Z",17896051,13,"Joshua Primo",0,0,0,0,0,0
"17804",6283,3,1,7,7,2,13,6,0,0,32,1,4,14,8,0,3,1037646,"2023-10-31T00:00:00.000Z",17896026,22,"Franz Wagner",1,22,25,17,11,28.1
"17805",6284,4,0,4,3,1,13,5,8,4,32,0,3,15,4,4,3,1037646,"2023-10-31T00:00:00.000Z",38017683,22,"Paolo Banchero",4,19,23,19,8,34.8
"17806",6285,3,0,7,2,0,8,2,6,3,30,1,2,7,8,1,2,1037646,"2023-10-31T00:00:00.000Z",85,22,"Wendell Carter Jr.",1,15,18,10,11,22.1
"17807",6286,0,0,0,0,0,0,0,0,0,0,0,0,0,0,0,0,1037648,"2023-11-01T00:00:00.000Z",666960,17,"Lindell Wigginton",0,0,0,0,0,0
"17808",6287,0,0,1,6,3,7,3,0,0,30,1,4,9,2,1,1,1037653,"2023-11-01T00:00:00.000Z",666541,21,"Luguentz Dort",1,11,11,9,2,13.4
"17809",6288,3,0,7,3,0,13,5,9,8,38,1,3,18,8,0,1,1037653,"2023-11-01T00:00:00.000Z",38017703,21,"Jalen Williams",0,26,29,21,11,31.1
"17810",6289,3,2,8,5,1,14,8,2,2,37,3,4,19,11,1,5,1037653,"2023-11-01T00:00:00.000Z",38017685,21,"Chet Holmgren",3,30,33,22,14,40.7
"17811",6290,4,1,9,4,1,16,6,2,2,31,0,1,15,9,1,2,1037653,"2023-11-01T00:00:00.000Z",17896065,21,"Josh Giddey",2,24,28,19,13,35.8
"17812",6291,8,0,5,5,0,20,8,5,4,38,0,2,20,5,3,2,1037653,"2023-11-01T00:00:00.000Z",175,21,"Shai Gilgeous-Alexander",3,25,33,28,13,45
"17813",6292,2,0,4,1,0,5,4,2,2,14,0,5,10,4,0,2,1037653,"2023-11-01T00:00:00.000Z",17896078,21,"Aaron Wiggins",0,14,16,12,6,15.8
"17814",6293,0,0,0,0,0,0,0,0,0,0,0,0,0,0,0,0,1037653,"2023-11-01T00:00:00.000Z",38017663,19,"E.J. Liddell",0,0,0,0,0,0
"17815",6294,1,0,6,1,0,15,7,2,2,25,1,3,16,7,0,2,1037650,"2023-11-01T00:00:00.000Z",70,2,"Jaylen Brown",0,23,24,17,8,23.9
"17816",6295,4,0,10,5,3,15,9,10,9,27,2,1,30,12,0,2,1037650,"2023-11-01T00:00:00.000Z",434,2,"Jayson Tatum",0,42,46,34,16,48.4
"17817",6296,2,0,5,3,1,7,3,6,6,27,1,3,13,6,0,2,1037650,"2023-11-01T00:00:00.000Z",378,2,"Kristaps Porzingis",0,19,21,15,8,21.2
"17818",6297,4,1,7,4,3,9,6,0,0,25,0,0,15,7,0,1,1037650,"2023-11-01T00:00:00.000Z",214,2,"Jrue Holiday",1,22,26,19,11,31.4
"17819",6298,4,0,2,7,4,10,7,0,0,27,1,3,18,3,0,2,1037650,"2023-11-01T00:00:00.000Z",473,2,"Derrick White",0,21,25,22,7,25.6
"17820",6299,0,0,3,6,5,7,5,2,2,20,0,3,17,3,1,1,1037650,"2023-11-01T00:00:00.000Z",17896060,2,"Sam Hauser",1,20,20,17,3,22.6
"17821",6300,0,1,2,1,1,3,1,2,2,11,2,0,5,4,1,1,1037650,"2023-11-01T00:00:00.000Z",219,2,"Al Horford",2,9,9,5,4,14.8
"17822",6301,0,0,0,0,0,0,0,0,0,0,0,0,0,0,0,0,1037600,"2023-10-25T00:00:00.000Z",44477024,9,"Stanley Umude",0,0,0,0,0,0
"17823",6302,0,0,0,0,0,0,0,0,0,0,0,0,0,0,0,0,1037600,"2023-10-25T00:00:00.000Z",3547240,9,"James Wiseman",0,0,0,0,0,0
"17824",6303,0,0,0,0,0,0,0,0,0,0,0,0,0,0,0,0,1037600,"2023-10-25T00:00:00.000Z",54,9,"Bojan Bogdanovic",0,0,0,0,0,0
"17825",6304,0,0,0,0,0,0,0,0,0,0,0,0,0,0,0,0,1037600,"2023-10-25T00:00:00.000Z",17896071,9,"Isaiah Livers",0,0,0,0,0,0
"17826",6305,0,0,0,0,0,0,0,0,0,0,0,0,0,0,0,0,1037600,"2023-10-25T00:00:00.000Z",330,9,"Monte Morris",0,0,0,0,0,0
"17827",6306,0,0,0,0,0,0,0,0,0,0,0,0,0,0,0,0,1037599,"2023-10-25T00:00:00.000Z",56677841,3,"Dariq Whitehead",0,0,0,0,0,0
"17828",6307,0,0,0,0,0,0,0,0,0,0,0,0,0,0,0,0,1037599,"2023-10-25T00:00:00.000Z",56677722,3,"Jalen Wilson",0,0,0,0,0,0
"17829",6308,2,1,12,13,7,17,9,2,2,39,0,4,27,12,1,0,1037599,"2023-10-25T00:00:00.000Z",666908,6,"Max Strus",2,39,41,29,14,50.4
"17830",6309,4,1,3,4,2,10,6,5,4,32,3,5,18,6,2,2,1037599,"2023-10-25T00:00:00.000Z",3547247,6,"Isaac Okoro",3,24,28,22,10,38.2
"17831",6310,1,2,5,0,0,11,5,0,0,34,1,3,10,6,0,0,1037599,"2023-10-25T00:00:00.000Z",17896076,6,"Evan Mobley",2,16,17,11,7,24.7
"17832",6311,1,0,3,2,0,8,3,4,4,24,1,0,10,4,0,1,1037601,"2023-10-25T00:00:00.000Z",667378,18,"Naz Reid",0,14,15,11,5,15.3
"17833",6312,0,0,0,0,0,0,0,0,0,0,0,0,0,0,0,0,1037601,"2023-10-25T00:00:00.000Z",17895968,18,"Daishen Nix",0,0,0,0,0,0
"17834",6313,0,0,0,0,0,0,0,0,0,0,0,0,0,0,0,0,1037601,"2023-10-25T00:00:00.000Z",56677851,18,"Jaylen Clark",0,0,0,0,0,0
"17835",6314,0,0,0,0,0,0,0,0,0,0,0,0,0,0,0,0,1037601,"2023-10-25T00:00:00.000Z",3547259,18,"Jaden McDaniels",0,0,0,0,0,0
"17836",6315,6,1,3,10,4,21,11,1,1,36,2,1,27,5,4,0,1037599,"2023-10-25T00:00:00.000Z",322,6,"Donovan Mitchell",5,32,38,33,11,57
"17837",6316,5,0,1,5,1,12,6,2,2,32,1,2,15,2,2,6,1037599,"2023-10-25T00:00:00.000Z",666581,6,"Darius Garland",2,17,22,20,7,24.9
"17838",6317,5,1,3,8,3,17,4,0,0,31,0,1,11,3,1,0,1037599,"2023-10-25T00:00:00.000Z",277,6,"Caris LeVert",2,14,19,16,8,28.1
"17839",6318,0,0,0,0,0,1,1,0,0,5,0,1,2,0,0,0,1037599,"2023-10-25T00:00:00.000Z",666676,6,"Ty Jerome",0,2,2,2,0,2
"17840",6319,0,0,2,3,0,3,0,0,0,20,2,3,0,4,0,0,1037599,"2023-10-25T00:00:00.000Z",344,6,"Georges Niang",0,4,4,0,4,4.8
"17841",6320,2,0,0,0,0,2,2,0,0,11,0,3,4,0,0,2,1037599,"2023-10-25T00:00:00.000Z",248,6,"Damian Jones",0,4,6,6,2,5
"17842",6321,0,0,0,0,0,0,0,0,0,0,0,0,0,0,0,0,1037599,"2023-10-25T00:00:00.000Z",56677847,6,"Emoni Bates",0,0,0,0,0,0
"17843",6322,0,0,0,0,0,0,0,0,0,0,0,0,0,0,0,0,1037603,"2023-10-25T00:00:00.000Z",666505,15,"Brandon Clarke",0,0,0,0,0,0
"17844",6323,6,0,7,3,0,18,7,6,5,36,0,3,19,7,2,5,1037603,"2023-10-25T00:00:00.000Z",227,19,"Brandon Ingram",2,26,32,25,13,37.4
"17845",6324,3,0,3,0,0,17,9,7,5,32,4,1,23,7,0,3,1037603,"2023-10-25T00:00:00.000Z",666969,19,"Zion Williamson",0,30,33,26,10,32.9
"17846",6325,1,1,12,4,2,7,4,2,2,29,0,1,12,12,0,3,1037603,"2023-10-25T00:00:00.000Z",455,19,"Jonas Valanciunas",1,24,25,13,13,27.9
"17847",6326,0,0,1,0,0,0,0,2,2,3,0,0,2,1,0,0,1038094,"2024-01-07T00:00:00.000Z",17896007,8,"Braxton Key",0,3,3,2,1,3.2
"17848",6327,0,0,0,0,0,0,0,0,0,3,0,1,0,0,0,1,1038094,"2024-01-07T00:00:00.000Z",38017727,8,"Collin Gillespie",0,0,0,0,0,-1
"17849",6328,0,0,0,1,0,1,0,0,0,3,0,0,0,0,0,0,1038094,"2024-01-07T00:00:00.000Z",3547268,8,"Zeke Nnaji",0,0,0,0,0,0
"17850",6329,0,0,0,1,0,1,0,0,0,2,0,1,0,0,0,0,1038094,"2024-01-07T00:00:00.000Z",17896103,8,"Jay Huff",0,0,0,0,0,0
"17851",6330,5,2,2,6,2,9,2,4,3,36,1,1,9,3,0,2,1038098,"2024-01-08T00:00:00.000Z",268,5,"Zach LaVine",2,12,17,14,8,24.1
"17852",6331,2,1,0,0,0,3,2,2,2,18,1,3,6,1,0,1,1038098,"2024-01-08T00:00:00.000Z",17895983,5,"Ayo Dosunmu",1,7,9,8,3,12.2
"17853",6332,1,0,1,1,0,1,0,2,2,12,1,1,2,2,0,1,1038098,"2024-01-08T00:00:00.000Z",38017719,5,"Dalen Terry",0,4,5,3,3,4.9
"17854",6333,0,0,0,1,0,2,1,0,0,4,0,0,2,0,0,0,1038098,"2024-01-08T00:00:00.000Z",87,5,"Jevon Carter",0,2,2,2,0,2
"17855",6334,0,0,0,0,0,0,0,0,0,0,0,0,0,0,0,0,1038098,"2024-01-08T00:00:00.000Z",56677857,5,"Julian Phillips",0,0,0,0,0,0
"17856",6335,0,0,0,0,0,0,0,0,0,0,0,0,0,0,0,0,1038098,"2024-01-08T00:00:00.000Z",17896116,5,"Terry Taylor",0,0,0,0,0,0
"17857",6336,2,1,2,5,3,10,6,3,2,26,2,2,17,4,0,0,1038099,"2024-01-08T00:00:00.000Z",3547250,12,"Aaron Nesmith",1,21,23,19,6,27.8
"17858",6337,1,3,7,4,1,8,3,4,4,27,2,1,11,9,0,2,1038099,"2024-01-08T00:00:00.000Z",3547264,12,"Jalen Smith",3,20,21,12,10,30.3
"17859",6338,1,0,6,3,1,13,7,2,1,35,2,2,16,8,0,2,1038099,"2024-01-08T00:00:00.000Z",452,12,"Myles Turner",0,24,25,17,9,25.1
"17860",6339,2,0,2,1,1,6,1,4,4,21,0,1,7,2,1,0,1038099,"2024-01-08T00:00:00.000Z",69,12,"Bruce Brown",1,9,11,9,4,15.4
"17861",6340,6,0,2,3,1,5,3,0,0,13,0,1,7,2,0,2,1038099,"2024-01-08T00:00:00.000Z",3547245,12,"Tyrese Haliburton",0,9,15,13,8,16.4
"17862",6341,3,0,4,9,5,15,8,7,5,29,0,4,26,4,2,2,1038099,"2024-01-08T00:00:00.000Z",38017686,12,"Bennedict Mathurin",2,30,33,29,7,39.3
"17863",6342,3,2,3,7,3,11,6,0,0,25,1,3,15,4,1,1,1038099,"2024-01-08T00:00:00.000Z",210,12,"Buddy Hield",3,19,22,18,7,32.3
"17864",6343,7,0,3,2,0,12,6,0,0,25,1,1,12,4,2,2,1038099,"2024-01-08T00:00:00.000Z",304,12,"T.J. McConnell",2,16,23,19,11,31.3
"17865",6344,0,2,1,0,0,0,0,0,0,7,1,1,0,2,0,0,1038099,"2024-01-08T00:00:00.000Z",17896035,12,"Isaiah Jackson",2,2,2,0,2,8.4
"17866",6345,3,0,0,2,1,6,4,0,0,12,0,5,9,0,0,2,1038099,"2024-01-08T00:00:00.000Z",38017507,12,"Andrew Nembhard",0,9,12,12,3,11.5
"17867",6346,0,0,0,0,0,0,0,0,0,0,0,0,0,0,0,0,1038099,"2024-01-08T00:00:00.000Z",242,12,"James Johnson",0,0,0,0,0,0
"17868",6347,4,0,4,3,2,8,5,6,5,33,0,4,17,4,1,4,1038100,"2024-01-08T00:00:00.000Z",3547242,30,"Deni Avdija",1,21,25,21,8,26.8
"17869",6348,5,0,11,5,0,24,10,2,2,37,4,1,22,15,0,2,1038100,"2024-01-08T00:00:00.000Z",265,30,"Kyle Kuzma",0,37,42,27,20,45.5
"17870",6349,1,1,5,0,0,7,3,3,3,26,4,2,9,9,0,0,1038100,"2024-01-08T00:00:00.000Z",666577,30,"Daniel Gafford",1,18,19,10,10,24.3
"17871",6350,5,0,0,8,4,17,8,5,4,29,0,5,24,0,0,1,1038100,"2024-01-08T00:00:00.000Z",666848,30,"Jordan Poole",0,24,29,29,5,30.5
"17872",6351,4,0,1,0,0,2,0,0,0,10,0,2,0,1,1,3,1038032,"2023-12-30T00:00:00.000Z",3547241,9,"Killian Hayes",1,1,5,4,5,7.2
"17873",6352,0,2,8,0,0,5,5,0,0,23,0,1,10,8,0,0,1038031,"2023-12-30T00:00:00.000Z",38017705,29,"Walker Kessler",2,18,18,10,8,25.6
"17874",6353,2,0,6,8,5,10,6,5,4,28,0,3,21,6,0,2,1038031,"2023-12-30T00:00:00.000Z",56677834,29,"Keyonte George",0,27,29,23,8,29.2
"17875",6354,3,0,2,5,1,10,3,2,2,25,0,0,9,2,0,0,1038031,"2023-12-30T00:00:00.000Z",100,29,"Jordan Clarkson",0,11,14,12,5,15.9
"17876",6355,10,1,3,1,0,12,8,3,3,27,3,5,19,6,1,3,1038031,"2023-12-30T00:00:00.000Z",358,29,"Kelly Olynyk",2,25,35,29,16,44.2
"17877",6356,0,1,0,3,0,4,0,2,0,15,0,1,0,0,0,0,1038031,"2023-12-30T00:00:00.000Z",38017620,29,"Ochai Agbaji",1,0,0,0,0,3
"17878",6357,0,0,0,0,0,0,0,0,0,0,0,0,0,0,0,0,1038031,"2023-12-30T00:00:00.000Z",666650,29,"Talen Horton-Tucker",0,0,0,0,0,0
"17879",6358,0,0,0,0,0,0,0,0,0,0,0,0,0,0,0,0,1038031,"2023-12-30T00:00:00.000Z",666881,29,"Luka Samanic",0,0,0,0,0,0
"17880",6359,0,0,0,0,0,0,0,0,0,0,0,0,0,0,0,0,1038031,"2023-12-30T00:00:00.000Z",11891374,29,"Omer Yurtseven",0,0,0,0,0,0
"17881",6360,0,0,0,0,0,0,0,0,0,0,0,0,0,0,0,0,1038031,"2023-12-30T00:00:00.000Z",17896023,29,"Josh Christopher",0,0,0,0,0,0
"17882",6361,0,0,0,0,0,0,0,0,0,0,0,0,0,0,0,0,1038031,"2023-12-30T00:00:00.000Z",56677824,29,"Taylor Hendricks",0,0,0,0,0,0
"17883",6362,0,0,0,0,0,0,0,0,0,0,0,0,0,0,0,0,1038031,"2023-12-30T00:00:00.000Z",38017630,29,"Johnny Juzang",0,0,0,0,0,0
"17884",6363,0,0,0,0,0,0,0,0,0,0,0,0,0,0,0,0,1038031,"2023-12-30T00:00:00.000Z",19465584,29,"Micah Potter",0,0,0,0,0,0
"17885",6364,0,0,1,2,0,4,2,2,2,12,0,1,6,1,0,0,1038032,"2023-12-30T00:00:00.000Z",56677826,9,"Ausar Thompson",0,7,7,6,1,7.2
"17886",6365,1,0,1,2,1,2,1,0,0,17,0,3,3,1,0,1,1038032,"2023-12-30T00:00:00.000Z",17896071,9,"Isaiah Livers",0,4,5,4,2,4.7
"17887",6366,0,3,4,0,0,4,4,0,0,13,0,1,8,4,0,0,1038032,"2023-12-30T00:00:00.000Z",3547240,9,"James Wiseman",3,12,12,8,4,21.8
"17888",6367,0,0,0,0,0,0,0,0,0,0,0,0,0,0,0,0,1038032,"2023-12-30T00:00:00.000Z",56677792,9,"Marcus Sasser",0,0,0,0,0,0
"17889",6368,0,0,0,0,0,0,0,0,0,0,0,0,0,0,0,0,1038032,"2023-12-30T00:00:00.000Z",56677729,9,"Malcolm Cazalon",0,0,0,0,0,0
"17890",6369,0,0,0,0,0,0,0,0,0,0,0,0,0,0,0,0,1038032,"2023-12-30T00:00:00.000Z",330,9,"Monte Morris",0,0,0,0,0,0
"17891",6370,0,0,0,0,0,0,0,0,0,0,0,0,0,0,0,0,1038032,"2023-12-30T00:00:00.000Z",42097199,9,"Jared Rhoden",0,0,0,0,0,0
"17892",6371,0,0,0,0,0,0,0,0,0,0,0,0,0,0,0,0,1038032,"2023-12-30T00:00:00.000Z",3547267,9,"Isaiah Stewart",0,0,0,0,0,0
"17893",6372,0,0,0,0,0,0,0,0,0,0,0,0,0,0,0,0,1038032,"2023-12-30T00:00:00.000Z",44477024,9,"Stanley Umude",0,0,0,0,0,0
"17894",6373,2,1,7,5,1,20,8,5,5,36,2,4,22,9,2,1,1038032,"2023-12-30T00:00:00.000Z",17896055,28,"Scottie Barnes",3,31,33,24,11,43.8
"17895",6374,4,0,4,2,2,24,14,8,5,40,1,5,35,5,0,2,1038032,"2023-12-30T00:00:00.000Z",416,28,"Pascal Siakam",0,40,44,39,9,45
"17896",6375,5,3,12,0,0,4,2,0,0,35,2,4,4,14,1,0,1038032,"2023-12-30T00:00:00.000Z",373,28,"Jakob Poeltl",4,18,23,9,19,40.3
"17897",6376,0,0,0,0,0,0,0,0,0,0,0,0,0,0,0,0,1037966,"2023-12-21T00:00:00.000Z",3547241,9,"Killian Hayes",0,0,0,0,0,0
"17898",6377,0,0,0,0,0,0,0,0,0,0,0,0,0,0,0,0,1037962,"2023-12-20T00:00:00.000Z",27,5,"Lonzo Ball",0,0,0,0,0,0
"17899",6378,0,0,0,0,0,0,0,0,0,0,0,0,0,0,0,0,1037962,"2023-12-20T00:00:00.000Z",56677874,5,"Onuralp Bitim",0,0,0,0,0,0
"17900",6380,3,0,1,3,1,4,1,0,0,14,0,2,3,1,0,0,1037962,"2023-12-20T00:00:00.000Z",1603383,14,"Gabe Vincent",0,4,7,6,4,8.7
"17901",6381,1,0,2,2,1,9,2,0,0,16,3,0,5,5,0,0,1037962,"2023-12-20T00:00:00.000Z",666609,14,"Rui Hachimura",0,10,11,6,6,12.5
"17902",6382,4,1,2,8,4,12,4,0,0,34,0,1,12,2,1,0,1037958,"2023-12-20T00:00:00.000Z",391,16,"Josh Richardson",2,14,18,16,6,26.4
"17903",6383,1,0,2,0,0,7,5,2,2,17,3,1,12,5,0,2,1037958,"2023-12-20T00:00:00.000Z",74,16,"Thomas Bryant",0,17,18,13,6,17.5
"17904",6384,0,0,0,0,0,0,0,0,0,1,0,0,0,0,0,0,1037962,"2023-12-20T00:00:00.000Z",38017697,14,"Max Christie",0,0,0,0,0,0
"17905",6385,0,0,1,0,0,1,1,0,0,1,0,0,2,1,0,0,1037962,"2023-12-20T00:00:00.000Z",666626,14,"Jaxson Hayes",0,3,3,2,1,3.2
"17906",6386,0,0,0,0,0,0,0,0,0,1,0,0,0,0,0,0,1037962,"2023-12-20T00:00:00.000Z",56677836,14,"Maxwell Lewis",0,0,0,0,0,0
"17907",6387,0,0,1,4,2,4,2,0,0,17,0,1,6,1,0,1,1037963,"2023-12-20T00:00:00.000Z",666754,1,"Garrison Mathews",0,7,7,6,1,6.2
"17908",6388,2,0,2,1,0,9,6,0,0,30,3,1,12,5,0,1,1037961,"2023-12-20T00:00:00.000Z",177,8,"Aaron Gordon",0,17,19,14,7,20
"17909",6389,6,2,10,5,3,23,13,3,2,38,5,2,31,15,0,2,1037961,"2023-12-20T00:00:00.000Z",246,8,"Nikola Jokic",2,46,52,37,21,62
"17910",6390,3,1,2,3,2,5,4,0,0,32,0,2,10,2,3,0,1037961,"2023-12-20T00:00:00.000Z",81,8,"Kentavious Caldwell-Pope",4,12,15,13,5,28.9
"17911",6391,6,0,3,1,1,5,4,3,3,23,0,3,12,3,0,1,1037958,"2023-12-20T00:00:00.000Z",397,16,"Duncan Robinson",0,15,21,18,9,23.6
"17912",6392,2,0,2,9,4,12,5,2,1,30,4,3,15,6,2,1,1037958,"2023-12-20T00:00:00.000Z",3092,16,"Haywood Highsmith",2,21,23,17,8,30.2
"17913",6393,0,0,0,0,0,0,0,0,0,1,0,0,0,0,0,0,1037958,"2023-12-20T00:00:00.000Z",39398582,16,"Orlando Robinson",0,0,0,0,0,0
"17914",6394,0,0,0,0,0,0,0,0,0,0,0,0,0,0,0,0,1037958,"2023-12-20T00:00:00.000Z",38017734,16,"Jamal Cain",0,0,0,0,0,0
"17915",6395,0,0,0,0,0,0,0,0,0,0,0,0,0,0,0,0,1037958,"2023-12-20T00:00:00.000Z",38017696,16,"Nikola Jovic",0,0,0,0,0,0
"17916",6396,0,0,0,0,0,0,0,0,0,0,0,0,0,0,0,0,1037963,"2023-12-20T00:00:00.000Z",666564,1,"Bruno Fernando",0,0,0,0,0,0
"17917",6397,0,0,0,0,0,0,0,0,0,0,0,0,0,0,0,0,1037963,"2023-12-20T00:00:00.000Z",3547297,1,"Trent Forrest",0,0,0,0,0,0
"17918",6398,0,0,0,0,0,0,0,0,0,0,0,0,0,0,0,0,1037963,"2023-12-20T00:00:00.000Z",319,1,"Patty Mills",0,0,0,0,0,0
"17919",6399,0,0,0,0,0,0,0,0,0,0,0,0,0,0,0,0,1037963,"2023-12-20T00:00:00.000Z",56677838,1,"Kobe Bufkin",0,0,0,0,0,0
"17920",6400,0,0,0,0,0,0,0,0,0,0,0,0,0,0,0,0,1037963,"2023-12-20T00:00:00.000Z",38017689,1,"AJ Griffin",0,0,0,0,0,0
"17921",6401,9,0,1,5,1,26,11,6,5,37,1,4,28,2,0,3,1037925,"2023-12-15T00:00:00.000Z",57,24,"Devin Booker",0,30,39,37,11,40.9
"17922",6402,0,0,0,0,0,0,0,0,0,0,0,0,0,0,0,0,1037922,"2023-12-15T00:00:00.000Z",56677869,28,"Markquis Nowell",0,0,0,0,0,0
"17923",6403,0,0,0,0,0,0,0,0,0,0,0,0,0,0,0,0,1037924,"2023-12-15T00:00:00.000Z",296,11,"Boban Marjanovic",0,0,0,0,0,0
"17924",6404,0,0,0,0,0,0,0,0,0,0,0,0,0,0,0,0,1037924,"2023-12-15T00:00:00.000Z",47738533,11,"Jeenathan Williams",0,0,0,0,0,0
"17925",6405,0,0,0,0,0,0,0,0,0,0,0,0,0,0,0,0,1037921,"2023-12-15T00:00:00.000Z",56677864,2,"Jordan Walsh",0,0,0,0,0,0
"17926",6406,0,0,0,0,0,0,0,0,0,0,0,0,0,0,0,0,1037924,"2023-12-15T00:00:00.000Z",3547281,11,"Nate Hinton",0,0,0,0,0,0
"17927",6407,0,0,0,0,0,0,0,0,0,0,0,0,0,0,0,0,1037924,"2023-12-15T00:00:00.000Z",357,11,"Victor Oladipo",0,0,0,0,0,0
"17928",6408,0,0,0,0,0,0,0,0,0,0,0,0,0,0,0,0,1037924,"2023-12-15T00:00:00.000Z",56677809,11,"Jermaine Samuels Jr.",0,0,0,0,0,0
"17929",6409,0,0,0,0,0,0,0,0,0,0,0,0,0,0,0,0,1037924,"2023-12-15T00:00:00.000Z",3547301,11,"Jae'Sean Tate",0,0,0,0,0,0
"17930",6410,0,0,0,0,0,0,0,0,0,0,0,0,0,0,0,0,1037924,"2023-12-15T00:00:00.000Z",56677825,11,"Amen Thompson",0,0,0,0,0,0
"17931",6411,0,0,0,2,0,3,1,0,0,16,0,3,2,0,2,0,1037921,"2023-12-15T00:00:00.000Z",196,22,"Gary Harris",2,2,2,2,0,8
"17932",6412,4,0,0,3,2,8,5,6,5,20,0,3,17,0,1,1,1037921,"2023-12-15T00:00:00.000Z",3547251,22,"Cole Anthony",1,17,21,21,4,25
"17933",6413,2,0,0,1,0,3,1,0,0,13,1,3,2,1,0,3,1037921,"2023-12-15T00:00:00.000Z",462,22,"Moritz Wagner",0,3,5,4,3,3.2
"17934",6414,0,0,3,2,1,5,3,0,0,16,1,1,7,4,0,0,1037921,"2023-12-15T00:00:00.000Z",229,22,"Jonathan Isaac",0,11,11,7,4,11.8
"17935",6415,1,0,1,4,1,5,2,0,0,11,1,0,5,2,0,0,1037921,"2023-12-15T00:00:00.000Z",38017724,22,"Caleb Houstan",0,7,8,6,3,8.9
"17936",6416,0,0,0,0,0,1,0,0,0,4,0,0,0,0,0,0,1037921,"2023-12-15T00:00:00.000Z",666818,22,"Chuma Okeke",0,0,0,0,0,0
"17937",6417,0,0,1,1,0,1,0,0,0,3,0,0,0,1,0,0,1037921,"2023-12-15T00:00:00.000Z",56677839,22,"Jett Howard",0,1,1,0,1,1.2
"17938",6418,0,0,2,0,0,1,0,0,0,3,0,1,0,2,0,1,1037921,"2023-12-15T00:00:00.000Z",666885,22,"Admiral Schofield",0,2,2,0,2,1.4
"17939",6419,0,2,2,0,0,4,3,2,2,15,1,1,8,3,1,1,1037925,"2023-12-15T00:00:00.000Z",147,24,"Drew Eubanks",3,11,11,8,3,19.6
"17940",6420,0,0,0,0,0,0,0,0,0,7,0,0,0,0,0,0,1037925,"2023-12-15T00:00:00.000Z",470,24,"Yuta Watanabe",0,0,0,0,0,0
"17941",6421,0,0,3,1,0,5,2,0,0,14,0,0,4,3,0,0,1037925,"2023-12-15T00:00:00.000Z",32,24,"Keita Bates-Diop",0,7,7,4,3,7.6
"17942",6422,1,0,1,2,0,3,1,2,1,10,0,0,3,1,0,1,1037925,"2023-12-15T00:00:00.000Z",314,24,"Chimezie Metu",0,4,5,4,2,4.7
"17943",6423,0,0,0,0,0,1,1,0,0,2,0,0,2,0,0,0,1037925,"2023-12-15T00:00:00.000Z",666451,24,"Bol Bol",0,2,2,2,0,2
"17944",6424,0,0,0,0,0,0,0,0,0,0,0,0,0,0,0,0,1037925,"2023-12-15T00:00:00.000Z",3547095,24,"Udoka Azubuike",0,0,0,0,0,0
"17945",6425,0,0,0,0,0,0,0,0,0,0,0,0,0,0,0,0,1037925,"2023-12-15T00:00:00.000Z",178,24,"Eric Gordon",0,0,0,0,0,0
"17946",6426,2,0,6,8,2,15,7,0,0,40,2,3,16,8,3,1,7049319,"2023-12-06T00:00:00.000Z",62,4,"Miles Bridges",3,24,26,18,10,36.6
"17947",6427,2,0,7,2,0,5,1,0,0,24,2,4,2,9,1,1,7049317,"2023-12-06T00:00:00.000Z",3547244,1,"Onyeka Okongwu",1,11,13,4,11,17.8
"17948",6428,0,0,0,0,0,0,0,0,0,0,0,0,0,0,0,0,7049317,"2023-12-06T00:00:00.000Z",319,1,"Patty Mills",0,0,0,0,0,0
"17949",6429,0,0,0,0,0,0,0,0,0,0,0,0,0,0,0,0,7049317,"2023-12-06T00:00:00.000Z",56677838,1,"Kobe Bufkin",0,0,0,0,0,0
"17950",6430,0,0,0,0,0,0,0,0,0,0,0,0,0,0,0,0,7049317,"2023-12-06T00:00:00.000Z",56677806,1,"Mouhamed Gueye",0,0,0,0,0,0
"17951",6431,0,0,0,0,0,0,0,0,0,0,0,0,0,0,0,0,7049317,"2023-12-06T00:00:00.000Z",17896040,1,"Jalen Johnson",0,0,0,0,0,0
"17952",6432,0,0,0,0,0,0,0,0,0,0,0,0,0,0,0,0,7049317,"2023-12-06T00:00:00.000Z",56677855,1,"Seth Lundy",0,0,0,0,0,0
"17953",6433,0,0,0,0,0,0,0,0,0,0,0,0,0,0,0,0,7049317,"2023-12-06T00:00:00.000Z",56677875,1,"Miles Norris",0,0,0,0,0,0
"17954",6434,0,0,0,0,0,0,0,0,0,0,0,0,0,0,0,0,7049319,"2023-12-06T00:00:00.000Z",666748,4,"Cody Martin",0,0,0,0,0,0
"17955",6435,0,0,0,0,0,0,0,0,0,0,0,0,0,0,0,0,7049319,"2023-12-06T00:00:00.000Z",347,4,"Frank Ntilikina",0,0,0,0,0,0
"17956",6436,0,0,0,0,0,0,0,0,0,0,0,0,0,0,0,0,7049319,"2023-12-06T00:00:00.000Z",38017698,4,"Mark Williams",0,0,0,0,0,0
"17957",6437,4,2,6,4,2,6,2,4,3,22,2,2,9,8,0,1,7049320,"2023-12-06T00:00:00.000Z",38017695,11,"Tari Eason",2,17,21,13,12,29.6
"17958",6438,0,0,0,1,0,2,1,1,1,6,0,0,3,0,0,0,7049320,"2023-12-06T00:00:00.000Z",75,11,"Reggie Bullock",0,3,3,3,0,3
"17959",6439,0,0,0,0,0,0,0,0,0,0,0,0,0,0,0,0,7049315,"2023-12-06T00:00:00.000Z",56677805,28,"Javon Freeman-Liberty",0,0,0,0,0,0
"17960",6440,0,0,0,0,0,0,0,0,0,0,0,0,0,0,0,0,7049315,"2023-12-06T00:00:00.000Z",38017717,28,"Ron Harper Jr.",0,0,0,0,0,0
"17961",6441,0,0,0,0,0,0,0,0,0,0,0,0,0,0,0,0,7049315,"2023-12-06T00:00:00.000Z",38017710,28,"Christian Koloko",0,0,0,0,0,0
"17962",6442,0,0,0,0,0,0,0,0,0,0,0,0,0,0,0,0,7049315,"2023-12-06T00:00:00.000Z",56677869,28,"Markquis Nowell",0,0,0,0,0,0
"17963",6443,8,0,2,1,1,16,7,5,4,35,0,2,19,2,1,0,7049315,"2023-12-06T00:00:00.000Z",79,16,"Jimmy Butler",1,21,29,27,10,36.4
"17964",6444,3,1,10,7,4,16,9,4,2,31,2,1,24,12,0,0,7049315,"2023-12-06T00:00:00.000Z",666747,16,"Caleb Martin",1,36,39,27,15,45.9
"17965",6445,4,1,9,3,2,9,5,3,3,33,3,3,15,12,3,1,7049315,"2023-12-06T00:00:00.000Z",39398582,16,"Orlando Robinson",4,27,31,19,16,46.4
"17966",6446,7,0,5,10,3,19,9,0,0,32,1,1,21,6,1,0,7049315,"2023-12-06T00:00:00.000Z",397,16,"Duncan Robinson",1,27,34,28,13,41.7
"17967",6447,3,2,4,4,1,4,1,0,0,28,0,2,3,4,0,2,7049315,"2023-12-06T00:00:00.000Z",286,16,"Kyle Lowry",2,7,10,6,7,16.3
"17968",6448,2,4,1,0,0,6,2,4,3,22,0,2,7,1,0,0,7049318,"2023-12-06T00:00:00.000Z",12,18,"Kyle Anderson",4,8,10,9,3,23.2
"17969",6449,2,0,2,7,2,17,9,3,3,40,2,2,23,4,1,3,7049320,"2023-12-06T00:00:00.000Z",66,11,"Dillon Brooks",1,27,29,25,6,30.8
"17970",6450,1,0,14,1,1,4,2,1,1,32,4,1,6,18,0,3,7049320,"2023-12-06T00:00:00.000Z",38017684,11,"Jabari Smith Jr.",0,24,25,7,19,26.1
"17971",6451,4,0,4,3,2,15,8,0,0,31,1,1,18,5,1,2,1037824,"2023-11-25T00:00:00.000Z",56677785,16,"Jaime Jaquez Jr.",1,23,27,22,9,31
"17972",6452,0,0,0,0,0,0,0,0,0,0,0,0,0,0,0,0,1037832,"2023-11-26T00:00:00.000Z",56677846,4,"Nick Smith Jr.",0,0,0,0,0,0
"17973",6453,0,0,0,0,0,0,0,0,0,0,0,0,0,0,0,0,1037832,"2023-11-26T00:00:00.000Z",56677848,4,"Amari Bailey",0,0,0,0,0,0
"17974",6454,0,0,0,0,0,0,0,0,0,0,0,0,0,0,0,0,1037832,"2023-11-26T00:00:00.000Z",17896037,4,"James Bouknight",0,0,0,0,0,0
"17975",6455,2,0,1,5,2,9,5,0,0,17,0,1,12,1,0,1,1037825,"2023-11-25T00:00:00.000Z",414,30,"Landry Shamet",0,13,15,14,3,15.2
"17976",6456,0,0,0,0,0,0,0,0,0,0,0,0,0,0,0,0,1037825,"2023-11-25T00:00:00.000Z",666848,30,"Jordan Poole",0,0,0,0,0,0
"17977",6457,0,0,0,0,0,0,0,0,0,0,0,0,0,0,0,0,1037825,"2023-11-25T00:00:00.000Z",38017704,30,"Patrick Baldwin Jr.",0,0,0,0,0,0
"17978",6458,0,0,0,0,0,0,0,0,0,0,0,0,0,0,0,0,1037825,"2023-11-25T00:00:00.000Z",38124126,30,"John Butler Jr.",0,0,0,0,0,0
"17979",6459,0,0,0,0,0,0,0,0,0,0,0,0,0,0,0,0,1037825,"2023-11-25T00:00:00.000Z",167,30,"Danilo Gallinari",0,0,0,0,0,0
"17980",6460,0,0,0,0,0,0,0,0,0,0,0,0,0,0,0,0,1037825,"2023-11-25T00:00:00.000Z",38017712,30,"Ryan Rollins",0,0,0,0,0,0
"17981",6461,0,0,0,0,0,0,0,0,0,0,0,0,0,0,0,0,1037825,"2023-11-25T00:00:00.000Z",487,30,"Delon Wright",0,0,0,0,0,0
"17982",6462,0,0,3,5,3,11,7,3,3,31,1,4,20,4,2,2,1037825,"2023-11-25T00:00:00.000Z",666656,1,"De'Andre Hunter",2,24,24,20,4,28.8
"17983",6463,1,1,0,2,1,4,3,2,1,9,1,0,8,1,2,0,1037825,"2023-11-25T00:00:00.000Z",17896040,1,"Jalen Johnson",3,9,10,9,2,19.7
"17984",6464,1,0,4,0,0,14,6,2,0,18,7,2,12,11,0,0,1037825,"2023-11-25T00:00:00.000Z",83,1,"Clint Capela",0,23,24,13,12,26.7
"17985",6465,10,0,5,6,1,14,4,2,2,27,0,0,11,5,4,0,1037825,"2023-11-25T00:00:00.000Z",334,1,"Dejounte Murray",4,16,26,21,15,44
"17986",6466,0,0,0,0,0,0,0,0,0,0,0,0,0,0,0,0,1037833,"2023-11-26T00:00:00.000Z",666505,15,"Brandon Clarke",0,0,0,0,0,0
"17987",6467,0,0,0,0,0,0,0,0,0,0,0,0,0,0,0,0,1037833,"2023-11-26T00:00:00.000Z",56677830,15,"GG Jackson",0,0,0,0,0,0
"17988",6468,0,0,0,0,0,0,0,0,0,0,0,0,0,0,0,0,1037833,"2023-11-26T00:00:00.000Z",254,15,"Luke Kennard",0,0,0,0,0,0
"17989",6469,0,0,0,0,0,0,0,0,0,0,0,0,0,0,0,0,1037833,"2023-11-26T00:00:00.000Z",38017728,15,"Jake LaRavia",0,0,0,0,0,0
"17990",6470,0,0,0,0,0,0,0,0,0,0,0,0,0,0,0,0,1037833,"2023-11-26T00:00:00.000Z",666786,15,"Ja Morant",0,0,0,0,0,0
"17991",6471,0,0,0,0,0,0,0,0,0,0,0,0,0,0,0,0,1037833,"2023-11-26T00:00:00.000Z",420,15,"Marcus Smart",0,0,0,0,0,0
"17992",6472,0,0,0,0,0,0,0,0,0,0,0,0,0,0,0,0,1037833,"2023-11-26T00:00:00.000Z",3547285,15,"Xavier Tillman",0,0,0,0,0,0
"17993",6473,3,1,5,1,0,7,3,0,0,23,1,3,6,6,0,0,1037833,"2023-11-26T00:00:00.000Z",12,18,"Kyle Anderson",1,12,15,9,9,20.7
"17994",6474,3,0,2,3,1,6,2,2,1,19,0,2,6,2,1,1,1037833,"2023-11-26T00:00:00.000Z",320,18,"Shake Milton",1,8,11,9,5,14.9
"17995",6475,1,0,2,4,2,4,2,0,0,18,2,1,6,4,0,1,1037833,"2023-11-26T00:00:00.000Z",68,18,"Troy Brown Jr.",0,10,11,7,5,11.3
"17996",6476,3,0,2,1,1,8,7,2,2,30,1,2,17,3,1,4,1037787,"2023-11-20T00:00:00.000Z",38017682,9,"Jaden Ivey",1,20,23,20,6,24.1
"17997",6477,2,0,3,4,0,5,1,2,1,17,0,1,3,3,1,1,1037787,"2023-11-20T00:00:00.000Z",77,9,"Alec Burks",1,6,8,5,5,11.6
"17998",6478,0,0,0,0,0,0,0,0,0,0,0,0,0,0,0,0,1037787,"2023-11-20T00:00:00.000Z",38017694,9,"Jalen Duren",0,0,0,0,0,0
"17999",6479,2,1,3,1,0,5,3,2,1,32,1,3,7,4,0,0,1037788,"2023-11-20T00:00:00.000Z",3547242,30,"Deni Avdija",1,11,13,9,6,17.8
"18000",6480,13,1,3,5,2,15,10,0,0,31,0,2,22,3,2,2,1037788,"2023-11-20T00:00:00.000Z",265,30,"Kyle Kuzma",3,25,38,35,16,52.1
"18001",6481,0,0,0,0,0,0,0,0,0,5,0,1,0,0,0,0,1037786,"2023-11-20T00:00:00.000Z",18678001,4,"JT Thor",0,0,0,0,0,0
"18002",6482,0,0,0,0,0,0,0,0,0,0,0,0,0,0,0,0,1037786,"2023-11-20T00:00:00.000Z",56677846,4,"Nick Smith Jr.",0,0,0,0,0,0
"18003",6483,0,0,0,0,0,0,0,0,0,0,0,0,0,0,0,0,1037786,"2023-11-20T00:00:00.000Z",56677848,4,"Amari Bailey",0,0,0,0,0,0
"18004",6484,0,0,0,0,0,0,0,0,0,0,0,0,0,0,0,0,1037786,"2023-11-20T00:00:00.000Z",56677866,4,"Leaky Black",0,0,0,0,0,0
"18005",6485,0,0,0,0,0,0,0,0,0,0,0,0,0,0,0,0,1037786,"2023-11-20T00:00:00.000Z",666748,4,"Cody Martin",0,0,0,0,0,0
"18006",6486,0,0,0,0,0,0,0,0,0,0,0,0,0,0,0,0,1037786,"2023-11-20T00:00:00.000Z",347,4,"Frank Ntilikina",0,0,0,0,0,0
"18007",6487,0,0,0,0,0,0,0,0,0,0,0,0,0,0,0,0,1037786,"2023-11-20T00:00:00.000Z",3547282,4,"Nick Richards",0,0,0,0,0,0
"18008",6488,0,0,0,0,0,0,0,0,0,0,0,0,0,0,0,0,1037786,"2023-11-20T00:00:00.000Z",403,4,"Terry Rozier",0,0,0,0,0,0
"18009",6489,1,0,1,9,1,9,1,0,0,38,0,3,3,1,0,1,1037786,"2023-11-20T00:00:00.000Z",17896060,2,"Sam Hauser",0,4,5,4,2,4.7
"18010",6490,6,2,13,15,7,28,15,10,8,44,0,1,45,13,0,3,1037786,"2023-11-20T00:00:00.000Z",434,2,"Jayson Tatum",2,58,64,51,19,72.6
"18011",6491,0,3,5,8,1,14,5,10,6,34,3,2,17,8,2,0,1037786,"2023-11-20T00:00:00.000Z",378,2,"Kristaps Porzingis",5,25,25,17,8,41.6
"18012",6492,3,0,3,5,0,17,5,4,3,34,1,5,13,4,0,2,1037786,"2023-11-20T00:00:00.000Z",70,2,"Jaylen Brown",0,17,20,16,7,20.3
"18013",6493,5,2,3,3,1,11,5,2,0,37,3,1,11,6,1,7,1037786,"2023-11-20T00:00:00.000Z",214,2,"Jrue Holiday",3,17,22,16,11,27.7
"18014",6494,3,0,4,8,5,14,8,0,0,33,2,1,21,6,2,0,1037786,"2023-11-20T00:00:00.000Z",3547276,2,"Payton Pritchard",2,27,30,24,9,38.7
"18015",6495,1,0,5,0,0,0,0,2,1,17,2,2,1,7,0,0,1037786,"2023-11-20T00:00:00.000Z",666468,2,"Oshae Brissett",0,8,9,2,8,10.9
"18016",6496,0,1,3,0,0,2,2,0,0,19,0,0,4,3,0,0,1037786,"2023-11-20T00:00:00.000Z",261,2,"Luke Kornet",1,7,7,4,3,10.6
"18017",6497,0,0,0,2,1,2,1,0,0,9,0,0,3,0,1,0,1037786,"2023-11-20T00:00:00.000Z",338,2,"Svi Mykhailiuk",1,3,3,3,0,6
"18018",6498,0,0,0,0,0,0,0,0,0,0,0,0,0,0,0,0,1037786,"2023-11-20T00:00:00.000Z",17896094,2,"Dalano Banton",0,0,0,0,0,0
"18019",6499,0,0,0,0,0,0,0,0,0,0,0,0,0,0,0,0,1037786,"2023-11-20T00:00:00.000Z",38017707,2,"JD Davison",0,0,0,0,0,0
"18020",6500,0,0,0,0,0,0,0,0,0,0,0,0,0,0,0,0,1037786,"2023-11-20T00:00:00.000Z",17553967,2,"Neemias Queta",0,0,0,0,0,0
"18021",6501,0,0,0,0,0,3,1,0,0,3,2,0,2,2,0,0,1037725,"2023-11-12T00:00:00.000Z",56677848,4,"Amari Bailey",0,4,4,2,2,4.4
"18022",6502,0,0,3,0,0,9,7,2,2,22,1,4,16,4,0,2,1037725,"2023-11-12T00:00:00.000Z",3547282,4,"Nick Richards",0,20,20,16,4,18.8
"18023",6503,0,0,0,2,0,4,1,0,0,19,0,0,2,0,0,0,1037725,"2023-11-12T00:00:00.000Z",38017708,4,"Bryce McGowens",0,2,2,2,0,2
"18024",6504,2,0,4,0,0,4,2,0,0,17,1,1,4,5,2,0,1037725,"2023-11-12T00:00:00.000Z",422,4,"Ish Smith",2,9,11,6,7,19
"18025",6505,2,0,0,4,1,6,1,0,0,8,0,0,3,0,0,0,1037725,"2023-11-12T00:00:00.000Z",56677846,4,"Nick Smith Jr.",0,3,5,5,2,6
"18026",6506,0,0,0,0,0,0,0,0,0,0,0,0,0,0,0,0,1037725,"2023-11-12T00:00:00.000Z",17896037,4,"James Bouknight",0,0,0,0,0,0
"18027",6507,0,0,0,0,0,0,0,0,0,0,0,0,0,0,0,0,1037725,"2023-11-12T00:00:00.000Z",62,4,"Miles Bridges",0,0,0,0,0,0
"18028",6508,0,0,0,0,0,0,0,0,0,0,0,0,0,0,0,0,1037725,"2023-11-12T00:00:00.000Z",666748,4,"Cody Martin",0,0,0,0,0,0
"18029",6509,0,0,0,0,0,0,0,0,0,0,0,0,0,0,0,0,1037725,"2023-11-12T00:00:00.000Z",347,4,"Frank Ntilikina",0,0,0,0,0,0
"18030",6510,1,0,5,11,2,16,5,2,2,35,1,0,14,6,0,3,1037726,"2023-11-12T00:00:00.000Z",666679,3,"Cameron Johnson",0,20,21,15,7,19.7
"18031",6511,0,0,1,6,2,7,2,0,0,20,2,5,6,3,0,2,1037726,"2023-11-12T00:00:00.000Z",158,3,"Dorian Finney-Smith",0,9,9,6,3,7.6
"18032",6512,2,4,9,0,0,7,5,0,0,28,4,2,10,13,0,0,1037726,"2023-11-12T00:00:00.000Z",666508,3,"Nicolas Claxton",4,23,25,12,15,40.6
"18033",6513,2,0,9,14,2,29,11,5,3,34,4,0,27,13,1,4,1037726,"2023-11-12T00:00:00.000Z",61,3,"Mikal Bridges",1,40,42,29,15,44.6
"18034",6514,3,1,4,5,0,10,3,7,6,31,0,2,12,4,2,0,1037726,"2023-11-12T00:00:00.000Z",130,3,"Spencer Dinwiddie",3,16,19,15,7,30.3
"18035",6515,1,1,5,1,0,6,3,2,2,19,7,1,8,12,1,1,1037726,"2023-11-12T00:00:00.000Z",17896038,3,"Day'Ron Sharpe",2,20,21,9,13,28.9
"18036",6516,4,0,5,7,3,8,3,2,1,31,1,4,10,6,2,2,1037726,"2023-11-12T00:00:00.000Z",351,3,"Royce O'Neale",2,16,20,14,10,27.2
"18037",6517,6,0,3,2,2,4,2,2,2,19,1,1,8,4,0,4,1037726,"2023-11-12T00:00:00.000Z",421,3,"Dennis Smith Jr.",0,12,18,14,10,17.8
"18038",6518,2,0,2,3,1,8,2,0,0,14,0,1,5,2,0,1,1037726,"2023-11-12T00:00:00.000Z",464,3,"Lonnie Walker IV",0,7,9,7,4,9.4
"18039",6519,1,0,3,0,0,3,1,0,0,9,0,2,2,3,0,1,1037726,"2023-11-12T00:00:00.000Z",17896058,3,"Trendon Watford",0,5,6,3,4,6.1
"18040",6520,0,0,0,0,0,0,0,0,0,0,0,0,0,0,0,0,1037726,"2023-11-12T00:00:00.000Z",9051997,3,"Armoni Brooks",0,0,0,0,0,0
"18041",6521,0,0,0,0,0,0,0,0,0,0,0,0,0,0,0,0,1037725,"2023-11-12T00:00:00.000Z",403,4,"Terry Rozier",0,0,0,0,0,0
"18042",6522,0,0,0,0,0,0,0,0,0,0,0,0,0,0,0,0,1037726,"2023-11-12T00:00:00.000Z",174,3,"Harry Giles III",0,0,0,0,0,0
"18043",6523,0,0,0,0,0,0,0,0,0,0,0,0,0,0,0,0,1037726,"2023-11-12T00:00:00.000Z",56677843,3,"Noah Clowney",0,0,0,0,0,0
"18044",6524,0,0,0,0,0,0,0,0,0,0,0,0,0,0,0,0,1037726,"2023-11-12T00:00:00.000Z",17896041,3,"Keon Johnson",0,0,0,0,0,0
"18045",6525,0,0,0,0,0,0,0,0,0,0,0,0,0,0,0,0,1037726,"2023-11-12T00:00:00.000Z",417,3,"Ben Simmons",0,0,0,0,0,0
"18046",6526,0,0,0,0,0,0,0,0,0,0,0,0,0,0,0,0,1037687,"2023-11-06T00:00:00.000Z",56913527,23,"Ricky Council IV",0,0,0,0,0,0
"18047",6527,0,0,0,0,0,0,0,0,0,0,0,0,0,0,0,0,1037687,"2023-11-06T00:00:00.000Z",17554001,23,"Javonte Smart",0,0,0,0,0,0
"18048",6528,0,0,0,0,0,0,0,0,0,0,0,0,0,0,0,0,1037687,"2023-11-06T00:00:00.000Z",56677788,23,"Terquavion Smith",0,0,0,0,0,0
"18049",6529,6,0,4,4,2,8,5,4,4,28,1,1,16,5,1,1,1037687,"2023-11-06T00:00:00.000Z",3547242,30,"Deni Avdija",1,21,27,22,11,33
"18050",6530,4,1,4,5,4,20,12,1,0,30,2,2,28,6,0,2,1037687,"2023-11-06T00:00:00.000Z",265,30,"Kyle Kuzma",1,34,38,32,10,42.2
"18051",6531,3,5,4,0,0,7,6,0,0,30,3,5,12,7,0,4,1037687,"2023-11-06T00:00:00.000Z",666577,30,"Daniel Gafford",5,19,22,15,10,35.9
"18052",6532,6,1,1,9,4,15,8,3,3,31,0,4,23,1,0,2,1037687,"2023-11-06T00:00:00.000Z",666848,30,"Jordan Poole",1,24,30,29,7,34.2
"18053",6533,1,0,1,0,0,8,2,0,0,14,2,0,4,3,0,0,1037687,"2023-11-06T00:00:00.000Z",38017687,30,"Johnny Davis",0,7,8,5,4,9.1
"18054",6534,2,0,2,2,0,8,4,2,2,22,1,2,10,3,1,1,1037685,"2023-11-06T00:00:00.000Z",38017686,12,"Bennedict Mathurin",1,13,15,12,5,18.6
"18055",6535,2,0,3,4,1,10,6,3,3,38,4,2,16,7,4,1,1037684,"2023-11-06T00:00:00.000Z",56677826,9,"Ausar Thompson",4,23,25,18,9,38.4
"18056",6536,4,1,9,5,3,9,5,4,4,39,2,3,17,11,0,3,1037684,"2023-11-06T00:00:00.000Z",3547267,9,"Isaiah Stewart",1,28,32,21,15,36.2
"18057",6537,1,0,2,0,0,8,4,2,2,24,0,1,10,2,0,1,1037684,"2023-11-06T00:00:00.000Z",24,9,"Marvin Bagley III",0,12,13,11,3,12.9
"18058",6538,5,0,4,6,1,18,7,7,6,40,0,2,21,4,2,5,1037684,"2023-11-06T00:00:00.000Z",17896075,9,"Cade Cunningham",2,25,30,26,9,34.3
"18059",6539,7,1,4,4,3,12,8,2,2,34,0,3,21,4,1,0,1037684,"2023-11-06T00:00:00.000Z",3547241,9,"Killian Hayes",2,25,32,28,11,42.3
"18060",6540,0,0,0,0,0,0,0,0,0,0,0,0,0,0,0,0,1037684,"2023-11-06T00:00:00.000Z",56677729,9,"Malcolm Cazalon",0,0,0,0,0,0
"18061",6541,0,0,0,0,0,0,0,0,0,0,0,0,0,0,0,0,1037684,"2023-11-06T00:00:00.000Z",38017694,9,"Jalen Duren",0,0,0,0,0,0
"18062",6542,0,0,0,0,0,0,0,0,0,0,0,0,0,0,0,0,1037684,"2023-11-06T00:00:00.000Z",197,9,"Joe Harris",0,0,0,0,0,0
"18063",6543,1,0,2,3,1,11,6,6,6,27,0,3,19,2,2,1,1037685,"2023-11-06T00:00:00.000Z",3547243,12,"Obi Toppin",2,21,22,20,3,27.9
"18064",6544,2,1,7,1,1,7,5,4,4,21,4,3,15,11,0,0,1037685,"2023-11-06T00:00:00.000Z",452,12,"Myles Turner",1,26,28,17,13,34.2
"18065",6545,4,0,5,3,1,7,3,0,0,24,0,1,7,5,0,0,1037685,"2023-11-06T00:00:00.000Z",69,12,"Bruce Brown",0,12,16,11,9,19
"18066",6546,8,1,2,7,3,19,9,2,2,27,0,1,23,2,1,2,1037685,"2023-11-06T00:00:00.000Z",3547245,12,"Tyrese Haliburton",2,25,33,31,10,41.4
"18067",6547,2,0,2,6,5,8,7,0,0,21,0,1,19,2,1,4,1037685,"2023-11-06T00:00:00.000Z",210,12,"Buddy Hield",1,21,23,21,4,23.4
"18068",6548,2,0,1,4,3,8,5,2,2,16,1,0,15,2,2,0,1037685,"2023-11-06T00:00:00.000Z",3547250,12,"Aaron Nesmith",2,17,19,17,4,26.4
"18069",6549,2,0,6,1,1,4,4,0,0,12,1,3,9,7,0,1,1037685,"2023-11-06T00:00:00.000Z",3547264,12,"Jalen Smith",0,16,18,11,9,19.4
"18070",6550,8,0,2,5,3,7,3,0,0,16,0,3,9,2,0,2,1037685,"2023-11-06T00:00:00.000Z",38017507,12,"Andrew Nembhard",0,11,19,17,10,21.4
"18071",6551,3,1,3,5,2,5,2,0,0,37,0,2,6,3,0,0,1037623,"2023-10-28T00:00:00.000Z",666940,6,"Dean Wade",1,9,12,9,6,17.1
"18072",6552,3,3,9,1,1,22,12,10,8,33,5,4,33,14,0,2,1037623,"2023-10-28T00:00:00.000Z",17896076,6,"Evan Mobley",3,47,50,36,17,61.3
"18073",6553,6,0,10,9,4,20,7,3,3,42,1,2,21,11,0,1,1037623,"2023-10-28T00:00:00.000Z",666908,6,"Max Strus",0,32,38,27,17,42.2
"18074",6554,8,0,3,10,4,28,12,9,3,44,2,2,31,5,1,2,1037623,"2023-10-28T00:00:00.000Z",277,6,"Caris LeVert",1,36,44,39,13,50
"18075",6555,0,0,1,0,0,0,0,0,0,6,2,0,0,3,0,0,1037623,"2023-10-28T00:00:00.000Z",248,6,"Damian Jones",0,3,3,0,3,3.6
"18076",6556,0,0,0,0,0,0,0,0,0,0,0,0,0,0,0,0,1037621,"2023-10-28T00:00:00.000Z",38017731,15,"Vince Williams Jr.",0,0,0,0,0,0
"18077",6557,0,0,0,0,0,0,0,0,0,0,0,0,0,0,0,0,1037621,"2023-10-28T00:00:00.000Z",3,15,"Steven Adams",0,0,0,0,0,0
"18078",6558,0,0,0,0,0,0,0,0,0,0,0,0,0,0,0,0,1037621,"2023-10-28T00:00:00.000Z",17896067,15,"Santi Aldama",0,0,0,0,0,0
"18079",6559,0,0,0,0,0,0,0,0,0,0,0,0,0,0,0,0,1037621,"2023-10-28T00:00:00.000Z",666505,15,"Brandon Clarke",0,0,0,0,0,0
"18080",6560,0,0,0,1,0,1,0,0,0,6,0,0,0,0,0,0,1037623,"2023-10-28T00:00:00.000Z",56677847,6,"Emoni Bates",0,0,0,0,0,0
"18081",6561,0,0,0,0,0,0,0,0,0,3,0,0,0,0,0,0,1037624,"2023-10-28T00:00:00.000Z",666762,28,"Jalen McDaniels",0,0,0,0,0,0
"18082",6562,1,0,2,10,2,12,3,0,0,29,1,1,8,3,1,1,1037625,"2023-10-28T00:00:00.000Z",397,16,"Duncan Robinson",1,11,12,9,4,15.1
"18083",6563,4,0,1,1,1,4,2,0,0,22,0,1,5,1,1,1,1037625,"2023-10-28T00:00:00.000Z",19465585,16,"Dru Smith",1,6,10,9,5,14.2
"18084",6564,0,1,1,0,0,2,0,0,0,4,0,0,0,1,0,0,1037625,"2023-10-28T00:00:00.000Z",39398582,16,"Orlando Robinson",1,1,1,0,1,4.2
"18085",6565,8,0,1,0,0,5,3,2,2,19,1,1,8,2,0,0,1037623,"2023-10-28T00:00:00.000Z",304,12,"T.J. McConnell",0,10,18,16,10,22.4
"18086",6566,0,0,0,0,0,0,0,0,0,0,0,0,0,0,0,0,1037623,"2023-10-28T00:00:00.000Z",17896035,12,"Isaiah Jackson",0,0,0,0,0,0
"18087",6567,0,0,0,0,0,0,0,0,0,0,0,0,0,0,0,0,1037624,"2023-10-28T00:00:00.000Z",376,28,"Otto Porter Jr.",0,0,0,0,0,0
"18088",6568,0,0,0,0,0,0,0,0,0,0,0,0,0,0,0,0,1037624,"2023-10-28T00:00:00.000Z",436,28,"Garrett Temple",0,0,0,0,0,0
"18089",6569,0,0,0,0,0,0,0,0,0,0,0,0,0,0,0,0,1037624,"2023-10-28T00:00:00.000Z",489,28,"Thaddeus Young",0,0,0,0,0,0
"18090",6570,0,0,0,0,0,0,0,0,0,0,0,0,0,0,0,0,1037624,"2023-10-28T00:00:00.000Z",18,28,"OG Anunoby",0,0,0,0,0,0
"18091",6571,0,0,0,0,0,0,0,0,0,0,0,0,0,0,0,0,1037624,"2023-10-28T00:00:00.000Z",38017717,28,"Ron Harper Jr.",0,0,0,0,0,0
"18092",6572,0,0,0,0,0,0,0,0,0,0,0,0,0,0,0,0,1037624,"2023-10-28T00:00:00.000Z",38017710,28,"Christian Koloko",0,0,0,0,0,0
"18093",6573,0,0,0,0,0,0,0,0,0,0,0,0,0,0,0,0,1037624,"2023-10-28T00:00:00.000Z",56677869,28,"Markquis Nowell",0,0,0,0,0,0
"18094",6574,2,2,1,4,1,10,4,7,6,36,1,1,15,2,2,2,1037624,"2023-10-28T00:00:00.000Z",200,23,"Tobias Harris",4,17,19,17,4,30.4
"18095",6575,0,0,0,0,0,0,0,0,0,0,0,0,0,0,0,0,1037624,"2023-10-28T00:00:00.000Z",17896025,23,"Jaden Springer",0,0,0,0,0,0
"18096",6576,1,0,4,9,4,11,5,3,3,21,0,1,17,4,3,2,1038106,"2024-01-09T00:00:00.000Z",17895858,20,"Quentin Grimes",3,21,22,18,5,30.3
"18097",6577,0,0,1,0,0,0,0,0,0,7,0,0,0,1,1,1,1038106,"2024-01-09T00:00:00.000Z",17896063,20,"Jericho Sims",1,1,1,0,1,3.2
"18098",6578,0,0,0,1,0,1,0,0,0,6,0,2,0,0,0,0,1038106,"2024-01-09T00:00:00.000Z",19,20,"Ryan Arcidiacono",0,0,0,0,0,0
"18099",6579,1,1,4,0,0,3,2,0,0,24,1,2,4,5,0,1,1038104,"2024-01-09T00:00:00.000Z",3547240,9,"James Wiseman",1,9,10,5,6,13.5
"18100",6580,0,0,0,1,0,1,0,2,2,4,0,0,2,0,0,0,1038106,"2024-01-09T00:00:00.000Z",3547275,20,"Malachi Flynn",0,2,2,2,0,2
"18101",6581,0,0,0,0,0,0,0,0,0,0,0,0,0,0,0,0,1038106,"2024-01-09T00:00:00.000Z",160,20,"Evan Fournier",0,0,0,0,0,0
"18102",6582,0,0,0,0,0,0,0,0,0,0,0,0,0,0,0,0,1038106,"2024-01-09T00:00:00.000Z",666474,20,"Charles Brown",0,0,0,0,0,0
"18103",6583,0,0,0,0,0,0,0,0,0,0,0,0,0,0,0,0,1038106,"2024-01-09T00:00:00.000Z",399,20,"Mitchell Robinson",0,0,0,0,0,0
"18104",6584,0,0,0,0,0,0,0,0,0,0,0,0,0,0,0,0,1038106,"2024-01-09T00:00:00.000Z",56677795,20,"Jacob Toppin",0,0,0,0,0,0
"18105",6585,0,0,0,0,0,0,0,0,0,0,0,0,0,0,0,0,1038106,"2024-01-09T00:00:00.000Z",17896089,20,"Duane Washington Jr.",0,0,0,0,0,0
"18106",6586,2,2,3,3,1,4,2,0,0,25,3,3,5,6,1,2,1038106,"2024-01-09T00:00:00.000Z",56677850,25,"Toumani Camara",3,11,13,7,8,22.2
"18107",6587,1,0,3,7,3,11,5,5,3,20,0,0,16,3,1,2,1038104,"2024-01-09T00:00:00.000Z",77,9,"Alec Burks",1,19,20,17,4,22.1
"18108",6588,1,0,1,4,1,8,3,1,1,20,1,1,8,2,1,2,1038104,"2024-01-09T00:00:00.000Z",259,9,"Kevin Knox",1,10,11,9,3,12.9
"18109",6589,4,1,2,2,0,4,0,2,2,18,0,0,2,2,1,0,1038104,"2024-01-09T00:00:00.000Z",56677792,9,"Marcus Sasser",2,4,8,6,6,16.4
"18110",6590,0,0,1,5,3,5,3,0,0,9,0,2,9,1,0,0,1038104,"2024-01-09T00:00:00.000Z",197,9,"Joe Harris",0,10,10,9,1,10.2
"18111",6591,0,0,0,0,0,0,0,0,0,0,0,0,0,0,0,0,1038104,"2024-01-09T00:00:00.000Z",3547267,9,"Isaiah Stewart",0,0,0,0,0,0
"18112",6592,0,0,0,0,0,0,0,0,0,0,0,0,0,0,0,0,1038104,"2024-01-09T00:00:00.000Z",56677729,9,"Malcolm Cazalon",0,0,0,0,0,0
"18113",6593,0,0,0,0,0,0,0,0,0,0,0,0,0,0,0,0,1038104,"2024-01-09T00:00:00.000Z",17896075,9,"Cade Cunningham",0,0,0,0,0,0
"18114",6594,0,0,0,0,0,0,0,0,0,0,0,0,0,0,0,0,1038104,"2024-01-09T00:00:00.000Z",330,9,"Monte Morris",0,0,0,0,0,0
"18115",6595,0,0,0,0,0,0,0,0,0,0,0,0,0,0,0,0,1038104,"2024-01-09T00:00:00.000Z",42097199,9,"Jared Rhoden",0,0,0,0,0,0
"18116",6596,0,0,0,0,0,0,0,0,0,0,0,0,0,0,0,0,1038104,"2024-01-09T00:00:00.000Z",44477024,9,"Stanley Umude",0,0,0,0,0,0
"18117",6597,0,1,2,1,0,3,0,0,0,23,1,1,0,3,0,0,1038107,"2024-01-09T00:00:00.000Z",3547258,7,"Josh Green",1,3,3,0,3,6.6
"18118",6598,2,1,4,1,0,9,5,1,1,36,0,1,11,4,0,0,1038107,"2024-01-09T00:00:00.000Z",247,7,"Derrick Jones Jr.",1,15,17,13,6,21.8
"18119",6599,3,1,3,0,0,3,2,0,0,22,1,3,4,4,2,2,1038107,"2024-01-09T00:00:00.000Z",379,7,"Dwight Powell",3,8,11,7,7,20.3
"18120",6600,0,1,1,1,0,1,0,0,0,12,0,0,0,1,1,0,1038106,"2024-01-09T00:00:00.000Z",666923,25,"Matisse Thybulle",2,1,1,0,1,7.2
"18121",6601,0,0,0,1,1,1,1,0,0,3,0,0,3,0,0,0,1038050,"2024-01-01T00:00:00.000Z",38017736,16,"Cole Swider",0,3,3,3,0,3
"18122",6602,0,0,0,0,0,0,0,0,0,0,0,0,0,0,0,0,1038048,"2024-01-01T00:00:00.000Z",47957121,25,"Justin Minaya",0,0,0,0,0,0
"18123",6603,0,0,0,0,0,0,0,0,0,0,0,0,0,0,0,0,1038048,"2024-01-01T00:00:00.000Z",56783340,25,"Duop Reath",0,0,0,0,0,0
"18124",6604,0,0,0,0,0,0,0,0,0,0,0,0,0,0,0,0,1038048,"2024-01-01T00:00:00.000Z",56677829,25,"Rayan Rupert",0,0,0,0,0,0
"18125",6605,0,0,0,0,0,0,0,0,0,0,0,0,0,0,0,0,1038048,"2024-01-01T00:00:00.000Z",419,25,"Anfernee Simons",0,0,0,0,0,0
"18126",6606,0,0,0,0,0,0,0,0,0,0,0,0,0,0,0,0,1038048,"2024-01-01T00:00:00.000Z",476,25,"Robert Williams III",0,0,0,0,0,0
"18127",6607,1,3,3,7,1,14,4,0,0,37,5,2,9,8,1,0,1038054,"2024-01-02T00:00:00.000Z",666541,21,"Luguentz Dort",4,17,18,10,9,32.1
"18128",6608,1,2,1,2,2,9,6,2,2,31,0,3,16,1,3,5,1038054,"2024-01-02T00:00:00.000Z",38017703,21,"Jalen Williams",5,17,18,17,2,28.7
"18129",6609,7,4,3,5,3,9,5,2,1,33,0,1,14,3,0,1,1038054,"2024-01-02T00:00:00.000Z",38017685,21,"Chet Holmgren",4,17,24,21,10,39.1
"18130",6610,6,0,7,7,4,14,8,3,3,27,1,0,23,8,0,3,1038054,"2024-01-02T00:00:00.000Z",17896065,21,"Josh Giddey",0,31,37,29,14,38.6
"18131",6611,7,0,6,5,3,22,14,8,5,37,0,5,36,6,1,0,1038054,"2024-01-02T00:00:00.000Z",175,21,"Shai Gilgeous-Alexander",1,42,49,43,13,56.7
"18132",6612,0,0,3,3,2,5,4,0,0,13,0,1,10,3,0,1,1038054,"2024-01-02T00:00:00.000Z",3547272,21,"Isaiah Joe",0,13,13,10,3,12.6
"18133",6613,0,0,0,0,0,0,0,0,0,0,0,0,0,0,0,0,1038054,"2024-01-02T00:00:00.000Z",44,21,"Davis Bertans",0,0,0,0,0,0
"18134",6614,0,0,0,0,0,0,0,0,0,0,0,0,0,0,0,0,1038054,"2024-01-02T00:00:00.000Z",17896036,21,"Tre Mann",0,0,0,0,0,0
"18135",6615,0,0,0,0,0,0,0,0,0,0,0,0,0,0,0,0,1038054,"2024-01-02T00:00:00.000Z",38017716,21,"Ousmane Dieng",0,0,0,0,0,0
"18136",6616,0,0,0,0,0,0,0,0,0,0,0,0,0,0,0,0,1038054,"2024-01-02T00:00:00.000Z",56677853,21,"Keyontae Johnson",0,0,0,0,0,0
"18137",6617,0,0,0,0,0,0,0,0,0,0,0,0,0,0,0,0,1038054,"2024-01-02T00:00:00.000Z",24572055,21,"Olivier Sarr",0,0,0,0,0,0
"18138",6618,0,0,0,0,0,0,0,0,0,0,0,0,0,0,0,0,1038054,"2024-01-02T00:00:00.000Z",27924547,21,"Lindy Waters III",0,0,0,0,0,0
"18139",6619,3,0,4,8,0,18,4,8,7,38,2,5,15,6,0,3,1038054,"2024-01-02T00:00:00.000Z",70,2,"Jaylen Brown",0,21,24,18,9,23.7
"18140",6620,8,0,8,5,2,21,10,10,8,38,5,3,30,13,1,4,1038054,"2024-01-02T00:00:00.000Z",434,2,"Jayson Tatum",1,43,51,38,21,56.6
"18141",6621,2,3,4,3,2,18,12,9,8,35,6,1,34,10,0,1,1038054,"2024-01-02T00:00:00.000Z",378,2,"Kristaps Porzingis",3,44,46,36,12,57
"18142",6622,6,1,5,9,5,12,7,0,0,28,0,4,19,5,1,3,1038054,"2024-01-02T00:00:00.000Z",473,2,"Derrick White",2,24,30,25,11,37
"18143",6623,0,0,0,0,0,0,0,0,0,0,0,0,0,0,0,0,1038051,"2024-01-02T00:00:00.000Z",260,23,"Furkan Korkmaz",0,0,0,0,0,0
"18144",6624,0,0,0,0,0,0,0,0,0,0,0,0,0,0,0,0,1038051,"2024-01-02T00:00:00.000Z",313,23,"De'Anthony Melton",0,0,0,0,0,0
"18145",6625,0,0,0,0,0,0,0,0,0,0,0,0,0,0,0,0,1038051,"2024-01-02T00:00:00.000Z",56677788,23,"Terquavion Smith",0,0,0,0,0,0
"18146",6626,0,0,0,2,0,2,0,4,3,4,0,0,3,0,0,0,1037991,"2023-12-23T00:00:00.000Z",398,10,"Jerome Robinson",0,3,3,3,0,3
"18147",6627,1,0,2,5,3,7,4,0,0,24,2,2,11,4,0,0,1037990,"2023-12-23T00:00:00.000Z",247,7,"Derrick Jones Jr.",0,15,16,12,5,17.3
"18148",6628,3,0,2,6,4,8,5,0,0,25,0,3,14,2,0,1,1037990,"2023-12-23T00:00:00.000Z",666965,7,"Grant Williams",0,16,19,17,5,19.9
"18149",6629,4,1,5,2,2,10,8,2,2,32,2,1,20,7,0,3,1037990,"2023-12-23T00:00:00.000Z",151,7,"Dante Exum",1,27,31,24,11,34.4
"18150",6630,10,1,10,10,5,27,13,11,8,32,2,1,39,12,1,2,1037990,"2023-12-23T00:00:00.000Z",132,7,"Luka Doncic",2,51,61,49,22,72.4
"18151",6631,1,0,6,4,1,7,1,4,3,22,0,1,6,6,3,0,1037990,"2023-12-23T00:00:00.000Z",38017679,7,"Jaden Hardy",3,12,13,7,7,23.7
"18152",6632,3,0,4,4,3,10,7,0,0,31,3,2,17,7,2,1,1037990,"2023-12-23T00:00:00.000Z",17554004,7,"AJ Lawson",2,24,27,20,10,34.9
"18153",6633,1,1,2,0,0,5,5,4,4,22,2,4,14,4,1,0,1037990,"2023-12-23T00:00:00.000Z",379,7,"Dwight Powell",2,18,19,15,5,26.3
"18154",6634,0,0,2,1,0,3,0,0,0,12,0,1,0,2,0,0,1037990,"2023-12-23T00:00:00.000Z",56677859,7,"Olivier-Maxence Prosper",0,2,2,0,2,2.4
"18155",6635,5,1,4,5,4,9,8,0,0,33,1,5,20,5,1,0,1037986,"2023-12-23T00:00:00.000Z",3547267,9,"Isaiah Stewart",2,25,30,25,10,39.5
"18156",6636,7,2,6,6,3,11,6,10,8,35,0,4,23,6,0,3,1037986,"2023-12-23T00:00:00.000Z",38017682,9,"Jaden Ivey",2,29,36,30,13,43.7
"18157",6637,6,0,3,5,1,20,9,4,3,33,0,4,22,3,0,2,1037986,"2023-12-23T00:00:00.000Z",17896075,9,"Cade Cunningham",0,25,31,28,9,32.6
"18158",6638,0,0,0,0,0,0,0,0,0,0,0,0,0,0,0,0,1037990,"2023-12-23T00:00:00.000Z",329,7,"Markieff Morris",0,0,0,0,0,0
"18159",6639,0,0,0,0,0,0,0,0,0,0,0,0,0,0,0,0,1037990,"2023-12-23T00:00:00.000Z",3547258,7,"Josh Green",0,0,0,0,0,0
"18160",6640,0,0,0,0,0,0,0,0,0,0,0,0,0,0,0,0,1037990,"2023-12-23T00:00:00.000Z",228,7,"Kyrie Irving",0,0,0,0,0,0
"18161",6641,0,0,0,0,0,0,0,0,0,0,0,0,0,0,0,0,1037990,"2023-12-23T00:00:00.000Z",257,7,"Maxi Kleber",0,0,0,0,0,0
"18162",6642,0,0,0,0,0,0,0,0,0,0,0,0,0,0,0,0,1037990,"2023-12-23T00:00:00.000Z",56677840,7,"Dereck Lively II",0,0,0,0,0,0
"18163",6643,1,0,5,4,2,6,4,2,2,22,0,0,12,5,1,0,1037990,"2023-12-23T00:00:00.000Z",38017649,27,"Julian Champagnie",1,17,18,13,6,22.5
"18164",6644,0,0,0,0,0,0,0,0,0,0,0,0,0,0,0,0,1037985,"2023-12-23T00:00:00.000Z",254,15,"Luke Kennard",0,0,0,0,0,0
"18165",6645,0,0,0,0,0,0,0,0,0,0,0,0,0,0,0,0,1037985,"2023-12-23T00:00:00.000Z",401,15,"Derrick Rose",0,0,0,0,0,0
"18166",6646,4,0,7,6,4,16,9,2,1,30,2,2,23,9,0,3,1037990,"2023-12-23T00:00:00.000Z",38017699,27,"Jeremy Sochan",0,32,36,27,13,36.8
"18167",6647,0,0,3,2,0,3,0,2,2,14,0,2,2,3,2,0,1037990,"2023-12-23T00:00:00.000Z",56677817,27,"Sidy Cissoko",2,5,5,2,3,11.6
"18168",6648,0,1,3,2,0,4,2,2,1,18,2,2,5,5,0,1,1037991,"2023-12-23T00:00:00.000Z",38017711,25,"Jabari Walker",1,10,10,5,5,13
"18169",6649,0,0,0,0,0,0,0,0,0,0,0,0,0,0,0,0,1037991,"2023-12-23T00:00:00.000Z",39613724,25,"Ibou Badji",0,0,0,0,0,0
"18170",6650,0,0,0,0,0,0,0,0,0,0,0,0,0,0,0,0,1037991,"2023-12-23T00:00:00.000Z",47957121,25,"Justin Minaya",0,0,0,0,0,0
"18171",6651,0,0,0,0,0,0,0,0,0,0,0,0,0,0,0,0,1037952,"2023-12-19T00:00:00.000Z",420,15,"Marcus Smart",0,0,0,0,0,0
"18172",6652,0,0,0,0,0,0,0,0,0,0,0,0,0,0,0,0,1037952,"2023-12-19T00:00:00.000Z",666505,15,"Brandon Clarke",0,0,0,0,0,0
"18173",6653,0,0,0,0,0,0,0,0,0,0,0,0,0,0,0,0,1037952,"2023-12-19T00:00:00.000Z",56677830,15,"GG Jackson",0,0,0,0,0,0
"18174",6654,0,0,0,0,0,0,0,0,0,0,0,0,0,0,0,0,1037952,"2023-12-19T00:00:00.000Z",254,15,"Luke Kennard",0,0,0,0,0,0
"18175",6655,0,0,0,0,0,0,0,0,0,0,0,0,0,0,0,0,1037952,"2023-12-19T00:00:00.000Z",38017728,15,"Jake LaRavia",0,0,0,0,0,0
"18176",6656,0,0,0,0,0,0,0,0,0,0,0,0,0,0,0,0,1037952,"2023-12-19T00:00:00.000Z",38017732,15,"Kenneth Lofton Jr.",0,0,0,0,0,0
"18177",6657,3,3,2,8,4,13,8,5,5,26,2,2,25,4,1,2,1037957,"2023-12-20T00:00:00.000Z",210,12,"Buddy Hield",4,29,32,28,7,44.3
"18178",6658,0,0,4,3,0,5,2,2,2,23,0,1,6,4,0,1,1037957,"2023-12-20T00:00:00.000Z",3547243,12,"Obi Toppin",0,10,10,6,4,9.8
"18179",6659,0,2,5,4,1,9,5,7,7,25,1,2,18,6,0,1,1037957,"2023-12-20T00:00:00.000Z",452,12,"Myles Turner",2,24,24,18,6,30.2
"18180",6660,6,0,5,1,0,6,3,0,0,28,0,3,6,5,0,0,1037957,"2023-12-20T00:00:00.000Z",69,12,"Bruce Brown",0,11,17,12,11,21
"18181",6661,13,1,2,9,3,14,6,4,4,28,1,0,19,3,1,4,1037957,"2023-12-20T00:00:00.000Z",3547245,12,"Tyrese Haliburton",2,22,35,32,16,44.1
"18182",6662,1,0,2,6,4,7,5,0,0,29,0,2,14,2,1,2,1037957,"2023-12-20T00:00:00.000Z",38017686,12,"Bennedict Mathurin",1,16,17,15,3,18.9
"18183",6663,1,0,2,4,4,6,6,3,3,23,0,1,19,2,1,1,1037957,"2023-12-20T00:00:00.000Z",3547250,12,"Aaron Nesmith",1,21,22,20,3,24.9
"18184",6664,0,0,2,2,2,4,4,0,0,8,2,2,10,4,0,0,1037957,"2023-12-20T00:00:00.000Z",3547264,12,"Jalen Smith",0,14,14,10,4,14.8
"18185",6665,9,0,4,0,0,3,3,4,3,20,1,1,9,5,1,1,1037957,"2023-12-20T00:00:00.000Z",304,12,"T.J. McConnell",1,14,23,18,14,30.5
"18186",6666,1,2,2,1,0,7,4,3,2,15,1,3,10,3,1,1,1037957,"2023-12-20T00:00:00.000Z",17896035,12,"Isaiah Jackson",3,13,14,11,4,23.1
"18187",6667,1,0,0,1,0,5,2,2,2,9,0,3,6,0,0,0,1037957,"2023-12-20T00:00:00.000Z",3547207,12,"Jordan Nwora",0,6,7,7,1,7.5
"18188",6668,2,0,0,0,0,1,1,0,0,6,0,0,2,0,0,0,1037957,"2023-12-20T00:00:00.000Z",242,12,"James Johnson",0,2,4,4,2,5
"18189",6669,0,0,0,0,0,0,0,0,0,0,0,0,0,0,0,0,1037957,"2023-12-20T00:00:00.000Z",38017507,12,"Andrew Nembhard",0,0,0,0,0,0
"18190",6670,0,0,0,0,0,0,0,0,0,0,0,0,0,0,0,0,1037957,"2023-12-20T00:00:00.000Z",38017701,12,"Kendall Brown",0,0,0,0,0,0
"18191",6671,0,0,0,0,0,0,0,0,0,0,0,0,0,0,0,0,1037954,"2023-12-19T00:00:00.000Z",45658838,10,"Lester Quinones",0,0,0,0,0,0
"18192",6672,0,0,0,0,0,0,0,0,0,0,0,0,0,0,0,0,1037954,"2023-12-19T00:00:00.000Z",398,10,"Jerome Robinson",0,0,0,0,0,0
"18193",6673,0,0,0,0,0,0,0,0,0,0,0,0,0,0,0,0,1037954,"2023-12-19T00:00:00.000Z",57875092,10,"Gui Santos",0,0,0,0,0,0
"18194",6674,7,1,5,4,1,22,10,8,7,41,3,2,28,8,0,4,1037954,"2023-12-19T00:00:00.000Z",70,2,"Jaylen Brown",1,36,43,35,15,47.1
"18195",6675,7,0,5,9,2,17,5,3,3,41,3,0,15,8,2,0,1037954,"2023-12-19T00:00:00.000Z",434,2,"Jayson Tatum",2,23,30,22,15,41.1
"18196",6676,2,1,2,5,3,7,4,0,0,34,2,3,11,4,3,1,1037897,"2023-12-12T00:00:00.000Z",214,2,"Jrue Holiday",4,15,17,13,6,29.8
"18197",6677,1,0,2,4,3,5,3,0,0,20,1,1,9,3,0,0,1037897,"2023-12-12T00:00:00.000Z",17896060,2,"Sam Hauser",0,12,13,10,4,14.1
"18198",6678,1,0,3,2,0,3,1,0,0,22,2,0,2,5,1,0,1037897,"2023-12-12T00:00:00.000Z",219,2,"Al Horford",1,7,8,3,6,12.5
"18199",6679,3,1,3,5,2,5,2,0,0,12,0,1,6,3,2,1,1037897,"2023-12-12T00:00:00.000Z",3547276,2,"Payton Pritchard",3,9,12,9,6,22.1
"18200",6680,0,0,1,0,0,3,1,2,2,8,3,0,4,4,0,0,1037897,"2023-12-12T00:00:00.000Z",261,2,"Luke Kornet",0,8,8,4,4,8.8
"18201",6681,0,0,0,0,0,0,0,0,0,0,0,0,0,0,0,0,1037897,"2023-12-12T00:00:00.000Z",17896094,2,"Dalano Banton",0,0,0,0,0,0
"18202",6682,0,0,0,0,0,0,0,0,0,0,0,0,0,0,0,0,1037897,"2023-12-12T00:00:00.000Z",666468,2,"Oshae Brissett",0,0,0,0,0,0
"18203",6683,0,0,0,0,0,0,0,0,0,0,0,0,0,0,0,0,1037897,"2023-12-12T00:00:00.000Z",338,2,"Svi Mykhailiuk",0,0,0,0,0,0
"18204",6684,0,0,0,0,0,0,0,0,0,0,0,0,0,0,0,0,1037897,"2023-12-12T00:00:00.000Z",17553967,2,"Neemias Queta",0,0,0,0,0,0
"18205",6685,0,0,0,0,0,0,0,0,0,0,0,0,0,0,0,0,1037897,"2023-12-12T00:00:00.000Z",3547279,2,"Lamar Stevens",0,0,0,0,0,0
"18206",6686,0,0,0,0,0,0,0,0,0,0,0,0,0,0,0,0,1037897,"2023-12-12T00:00:00.000Z",38017707,2,"JD Davison",0,0,0,0,0,0
"18207",6687,0,0,0,0,0,0,0,0,0,0,0,0,0,0,0,0,1037897,"2023-12-12T00:00:00.000Z",56677864,2,"Jordan Walsh",0,0,0,0,0,0
"18208",6688,3,0,9,11,5,15,6,0,0,37,0,4,17,9,0,1,1037897,"2023-12-12T00:00:00.000Z",666908,6,"Max Strus",0,26,29,20,12,31.3
"18209",6689,3,1,2,6,2,6,2,2,2,20,1,3,8,3,0,0,1037897,"2023-12-12T00:00:00.000Z",666940,6,"Dean Wade",1,11,14,11,6,19.1
"18210",6690,5,2,3,0,0,9,6,5,2,36,2,4,14,5,3,2,1037897,"2023-12-12T00:00:00.000Z",9,6,"Jarrett Allen",5,19,24,19,10,40.5
"18211",6691,3,0,6,13,5,22,11,2,2,35,0,3,29,6,1,3,1037897,"2023-12-12T00:00:00.000Z",322,6,"Donovan Mitchell",1,35,38,32,9,40.7
"18212",6692,7,0,2,8,4,23,11,0,0,38,0,1,26,2,1,2,1037897,"2023-12-12T00:00:00.000Z",666581,6,"Darius Garland",1,28,35,33,9,39.9
"18213",6693,3,1,2,4,1,11,5,0,0,23,0,1,11,2,0,2,1037897,"2023-12-12T00:00:00.000Z",277,6,"Caris LeVert",1,13,16,14,5,18.9
"18214",6694,1,0,2,2,1,4,1,0,0,16,0,1,3,2,1,1,1037897,"2023-12-12T00:00:00.000Z",3547247,6,"Isaac Okoro",1,5,6,4,3,8.9
"18215",6695,1,0,2,1,1,1,1,0,0,23,0,1,3,2,0,1,1037897,"2023-12-12T00:00:00.000Z",344,6,"Georges Niang",0,5,6,4,3,5.9
"18216",6696,0,0,0,0,0,0,0,0,0,0,0,0,0,0,0,0,1037897,"2023-12-12T00:00:00.000Z",248,6,"Damian Jones",0,0,0,0,0,0
"18217",6697,0,0,0,0,0,0,0,0,0,0,0,0,0,0,0,0,1037897,"2023-12-12T00:00:00.000Z",3547299,6,"Sam Merrill",0,0,0,0,0,0
"18218",6698,5,2,4,4,1,13,3,7,7,37,0,5,14,4,1,0,1037899,"2023-12-12T00:00:00.000Z",125,5,"DeMar DeRozan",3,18,23,19,9,35.3
"18219",6699,0,1,2,5,2,8,2,2,1,31,0,1,7,2,0,1,1037899,"2023-12-12T00:00:00.000Z",3547248,5,"Patrick Williams",1,9,9,7,2,11.4
"18220",6700,5,2,12,4,1,21,12,1,1,33,4,1,26,16,0,3,1037899,"2023-12-12T00:00:00.000Z",460,5,"Nikola Vucevic",2,42,47,31,21,55.7
"18221",6701,2,1,3,12,4,19,7,4,3,37,1,6,21,4,1,4,1037867,"2023-12-01T00:00:00.000Z",313,23,"De'Anthony Melton",2,25,27,23,6,30.8
"18222",6702,4,1,6,7,3,19,13,1,0,37,3,2,29,9,5,2,1037868,"2023-12-01T00:00:00.000Z",17896055,28,"Scottie Barnes",6,38,42,33,13,61.8
"18223",6703,3,0,5,4,0,16,7,8,7,34,3,3,21,8,0,3,1037868,"2023-12-01T00:00:00.000Z",416,28,"Pascal Siakam",0,29,32,24,11,32.1
"18224",6704,1,2,8,0,0,9,6,0,0,28,4,4,12,12,0,1,1037868,"2023-12-01T00:00:00.000Z",373,28,"Jakob Poeltl",2,24,25,13,13,32.9
"18225",6705,3,2,4,6,1,13,4,0,0,27,1,5,9,5,1,3,1037868,"2023-12-01T00:00:00.000Z",18,28,"OG Anunoby",3,14,17,12,8,25.5
"18226",6706,1,0,1,7,4,14,6,0,0,31,3,1,16,4,1,1,1037869,"2023-12-01T00:00:00.000Z",247,7,"Derrick Jones Jr.",1,20,21,17,5,24.3
"18227",6707,3,1,6,9,3,12,4,6,5,31,2,3,16,8,1,1,1037869,"2023-12-01T00:00:00.000Z",666965,7,"Grant Williams",2,24,27,19,11,35.1
"18228",6708,1,2,4,0,0,5,2,0,0,23,1,1,4,5,1,2,1037869,"2023-12-01T00:00:00.000Z",56677840,7,"Dereck Lively II",3,9,10,5,6,18.5
"18229",6709,5,0,2,3,1,10,4,1,1,31,0,0,10,2,3,3,1037869,"2023-12-01T00:00:00.000Z",3547258,7,"Josh Green",3,12,17,15,7,25.9
"18230",6710,5,0,5,5,0,15,3,5,4,36,0,2,10,5,0,1,1037869,"2023-12-01T00:00:00.000Z",228,7,"Kyrie Irving",0,15,20,15,10,22.5
"18231",6711,5,0,3,4,0,9,4,2,0,21,2,1,8,5,0,2,1037869,"2023-12-01T00:00:00.000Z",38017679,7,"Jaden Hardy",0,13,18,13,10,19.5
"18232",6712,2,2,4,0,0,4,2,2,1,18,3,1,5,7,1,1,1037869,"2023-12-01T00:00:00.000Z",217,7,"Richaun Holmes",3,12,14,7,9,24.4
"18233",6713,2,0,0,1,0,1,0,2,2,11,0,0,2,0,0,0,1037869,"2023-12-01T00:00:00.000Z",56677859,7,"Olivier-Maxence Prosper",0,2,4,4,2,5
"18234",6714,2,0,2,4,2,10,5,0,0,16,0,2,12,2,1,0,1037869,"2023-12-01T00:00:00.000Z",114,7,"Seth Curry",1,14,16,14,4,20.4
"18235",6715,1,0,1,4,2,7,2,0,0,14,2,2,6,3,0,0,1037869,"2023-12-01T00:00:00.000Z",329,7,"Markieff Morris",0,9,10,7,4,11.1
"18236",6716,0,0,1,1,0,1,0,2,1,4,0,0,1,1,0,0,1037869,"2023-12-01T00:00:00.000Z",17554004,7,"AJ Lawson",0,2,2,1,1,2.2
"18237",6717,0,0,0,1,0,4,2,1,0,4,0,0,4,0,1,0,1037869,"2023-12-01T00:00:00.000Z",56677873,7,"Dexter Dennis",1,4,4,4,0,7
"18238",6718,0,0,0,0,0,0,0,0,0,0,0,0,0,0,0,0,1037869,"2023-12-01T00:00:00.000Z",379,7,"Dwight Powell",0,0,0,0,0,0
"18239",6719,0,0,0,0,0,0,0,0,0,0,0,0,0,0,0,0,1037869,"2023-12-01T00:00:00.000Z",17896028,7,"Greg Brown III",0,0,0,0,0,0
"18240",6720,0,0,0,0,0,0,0,0,0,0,0,0,0,0,0,0,1037869,"2023-12-01T00:00:00.000Z",132,7,"Luka Doncic",0,0,0,0,0,0
"18241",6721,0,0,0,0,0,0,0,0,0,0,0,0,0,0,0,0,1037869,"2023-12-01T00:00:00.000Z",151,7,"Dante Exum",0,0,0,0,0,0
"18242",6722,0,0,0,0,0,0,0,0,0,0,0,0,0,0,0,0,1037869,"2023-12-01T00:00:00.000Z",191,7,"Tim Hardaway Jr.",0,0,0,0,0,0
"18243",6723,0,0,0,0,0,0,0,0,0,0,0,0,0,0,0,0,1037869,"2023-12-01T00:00:00.000Z",257,7,"Maxi Kleber",0,0,0,0,0,0
"18244",6724,3,1,5,3,0,9,2,2,2,24,1,2,6,6,1,1,1037869,"2023-12-01T00:00:00.000Z",38017729,15,"David Roddy",2,12,15,9,9,22.7
"18245",6725,2,2,3,3,0,8,2,0,0,14,1,5,4,4,0,1,1037869,"2023-12-01T00:00:00.000Z",231,15,"Jaren Jackson Jr.",2,8,10,6,6,16.8
"18246",6726,0,0,0,0,0,0,0,0,0,0,0,0,0,0,0,0,3277529,"2023-11-28T00:00:00.000Z",3547299,6,"Sam Merrill",0,0,0,0,0,0
"18247",6727,3,0,8,4,1,11,6,5,5,27,1,1,18,9,0,2,3277528,"2023-11-28T00:00:00.000Z",666679,3,"Cameron Johnson",0,27,30,21,12,31.3
"18248",6728,2,1,4,4,1,9,2,0,0,26,5,4,5,9,1,0,3277528,"2023-11-28T00:00:00.000Z",158,3,"Dorian Finney-Smith",2,14,16,7,11,24.8
"18249",6729,0,4,6,0,0,10,7,4,1,32,2,1,15,8,1,0,3277528,"2023-11-28T00:00:00.000Z",666508,3,"Nicolas Claxton",5,23,23,15,8,39.6
"18250",6730,5,0,9,3,1,17,9,3,3,38,1,3,22,10,0,5,3277528,"2023-11-28T00:00:00.000Z",61,3,"Mikal Bridges",0,32,37,27,15,36.5
"18251",6731,8,0,8,11,3,18,5,10,10,38,1,0,23,9,4,1,3277528,"2023-11-28T00:00:00.000Z",130,3,"Spencer Dinwiddie",4,32,40,31,17,56.8
"18252",6732,2,0,4,0,0,4,2,1,1,15,1,2,5,5,0,0,3277528,"2023-11-28T00:00:00.000Z",17896038,3,"Day'Ron Sharpe",0,10,12,7,7,14
"18253",6733,4,2,5,12,6,12,6,0,0,31,2,5,18,7,1,1,3277528,"2023-11-28T00:00:00.000Z",351,3,"Royce O'Neale",3,25,29,22,11,40.4
"18254",6734,0,0,0,0,0,0,0,0,0,0,0,0,0,0,0,0,3277528,"2023-11-28T00:00:00.000Z",9051997,3,"Armoni Brooks",0,0,0,0,0,0
"18255",6735,0,0,0,0,0,0,0,0,0,0,0,0,0,0,0,0,3277528,"2023-11-28T00:00:00.000Z",174,3,"Harry Giles III",0,0,0,0,0,0
"18256",6736,0,0,0,4,0,8,0,0,0,15,1,1,0,1,0,0,3277529,"2023-11-28T00:00:00.000Z",38017689,1,"AJ Griffin",0,1,1,0,1,1.2
"18257",6737,2,0,7,1,1,8,4,5,4,22,2,0,13,9,0,0,3277529,"2023-11-28T00:00:00.000Z",3547244,1,"Onyeka Okongwu",0,22,24,15,11,26.8
"18258",6738,2,0,3,3,0,3,0,0,0,17,0,0,0,3,0,0,3277529,"2023-11-28T00:00:00.000Z",301,1,"Wesley Matthews",0,3,5,2,5,6.6
"18259",6739,0,0,0,0,0,1,0,0,0,4,0,0,0,0,0,0,3277529,"2023-11-28T00:00:00.000Z",3547297,1,"Trent Forrest",0,0,0,0,0,0
"18260",6740,0,0,1,0,0,6,1,0,0,4,2,1,2,3,0,1,3277529,"2023-11-28T00:00:00.000Z",666564,1,"Bruno Fernando",0,5,5,2,3,4.6
"18261",6741,0,0,1,1,0,1,0,0,0,4,0,0,0,1,0,0,3277529,"2023-11-28T00:00:00.000Z",666754,1,"Garrison Mathews",0,1,1,0,1,1.2
"18262",6742,0,0,0,0,0,0,0,0,0,0,0,0,0,0,0,0,3277529,"2023-11-28T00:00:00.000Z",319,1,"Patty Mills",0,0,0,0,0,0
"18263",6743,0,0,0,0,0,0,0,0,0,0,0,0,0,0,0,0,3277529,"2023-11-28T00:00:00.000Z",56677838,1,"Kobe Bufkin",0,0,0,0,0,0
"18264",6744,0,0,0,0,0,0,0,0,0,0,0,0,0,0,0,0,3277529,"2023-11-28T00:00:00.000Z",56677806,1,"Mouhamed Gueye",0,0,0,0,0,0
"18265",6745,0,0,0,0,0,0,0,0,0,0,0,0,0,0,0,0,3277529,"2023-11-28T00:00:00.000Z",17896040,1,"Jalen Johnson",0,0,0,0,0,0
"18266",6746,0,0,0,0,0,0,0,0,0,0,0,0,0,0,0,0,3277529,"2023-11-28T00:00:00.000Z",56677855,1,"Seth Lundy",0,0,0,0,0,0
"18267",6747,0,0,0,0,0,0,0,0,0,0,0,0,0,0,0,0,3277529,"2023-11-28T00:00:00.000Z",56677875,1,"Miles Norris",0,0,0,0,0,0
"18268",6748,2,0,8,4,0,18,6,7,5,35,2,2,17,10,1,2,3277528,"2023-11-28T00:00:00.000Z",416,28,"Pascal Siakam",1,27,29,19,12,33
"18269",6749,4,2,6,0,0,5,3,0,0,25,3,2,6,9,1,1,3277528,"2023-11-28T00:00:00.000Z",373,28,"Jakob Poeltl",3,15,19,10,13,30.8
"18270",6750,6,0,7,7,3,19,5,5,4,36,4,4,17,11,3,1,3277528,"2023-11-28T00:00:00.000Z",17896055,28,"Scottie Barnes",3,28,34,23,17,47.2
"18271",6751,0,0,0,0,0,0,0,0,0,4,0,0,0,0,0,0,1037793,"2023-11-20T00:00:00.000Z",56677799,10,"Trayce Jackson-Davis",0,0,0,0,0,0
"18272",6752,0,0,0,0,0,0,0,0,0,1,0,0,0,0,0,0,1037620,"2023-10-28T00:00:00.000Z",56677857,5,"Julian Phillips",0,0,0,0,0,0
"18273",6753,0,0,0,1,1,1,1,0,0,1,0,0,3,0,0,0,1037620,"2023-10-28T00:00:00.000Z",38017719,5,"Dalen Terry",0,3,3,3,0,3
"18274",6754,0,0,0,0,0,0,0,0,0,1,0,0,0,0,0,0,1037620,"2023-10-28T00:00:00.000Z",17896116,5,"Terry Taylor",0,0,0,0,0,0
"18275",6755,0,0,0,0,0,0,0,0,0,0,0,0,0,0,0,0,1037620,"2023-10-28T00:00:00.000Z",27,5,"Lonzo Ball",0,0,0,0,0,0
"18276",6756,0,0,0,0,0,0,0,0,0,0,0,0,0,0,0,0,1037620,"2023-10-28T00:00:00.000Z",56677874,5,"Onuralp Bitim",0,0,0,0,0,0
"18277",6757,0,0,0,0,0,0,0,0,0,0,0,0,0,0,0,0,1037620,"2023-10-28T00:00:00.000Z",45969255,5,"Justin Lewis",0,0,0,0,0,0
"18278",6758,0,0,0,0,0,0,0,0,0,0,0,0,0,0,0,0,1037620,"2023-10-28T00:00:00.000Z",56677860,5,"Adama Sanogo",0,0,0,0,0,0
"18279",6759,10,0,3,4,2,10,5,3,3,29,2,3,15,5,0,2,3277479,"2023-11-21T00:00:00.000Z",3547251,22,"Cole Anthony",0,20,30,25,15,34
"18280",6760,1,0,1,1,0,1,0,0,0,4,0,0,0,1,1,0,3277479,"2023-11-21T00:00:00.000Z",38017724,22,"Caleb Houstan",1,1,2,1,2,5.7
"18281",6761,2,0,2,5,3,13,7,6,6,43,0,3,23,2,2,0,3277481,"2023-11-21T00:00:00.000Z",200,23,"Tobias Harris",2,25,27,25,4,34.4
"18282",6762,0,0,0,0,0,0,0,0,0,0,0,0,0,0,0,0,1037793,"2023-11-20T00:00:00.000Z",47738533,11,"Jeenathan Williams",0,0,0,0,0,0
"18283",6763,2,0,4,4,1,5,2,0,0,27,0,5,5,4,0,2,3277481,"2023-11-21T00:00:00.000Z",33,23,"Nicolas Batum",0,9,11,7,6,10.8
"18284",6764,5,5,10,3,1,21,9,16,13,41,3,6,32,13,2,6,3277481,"2023-11-21T00:00:00.000Z",145,23,"Joel Embiid",7,45,50,37,18,70.1
"18285",6765,3,0,2,6,1,14,5,3,2,41,4,3,13,6,2,1,3277481,"2023-11-21T00:00:00.000Z",313,23,"De'Anthony Melton",2,19,22,16,9,29.7
"18286",6766,6,0,4,12,3,28,11,7,5,47,0,2,30,4,1,1,3277481,"2023-11-21T00:00:00.000Z",3547254,23,"Tyrese Maxey",1,34,40,36,10,45.8
"18287",6767,0,1,3,1,0,2,1,0,0,21,1,3,2,4,2,1,3277481,"2023-11-21T00:00:00.000Z",45,23,"Patrick Beverley",3,6,6,2,4,14.8
"18288",6768,0,0,0,0,0,0,0,0,0,0,0,0,0,0,0,0,3277481,"2023-11-21T00:00:00.000Z",28,23,"Mo Bamba",0,0,0,0,0,0
"18289",6769,2,0,2,4,1,18,8,1,0,31,2,2,17,4,3,0,3277479,"2023-11-21T00:00:00.000Z",17896026,22,"Franz Wagner",3,21,23,19,6,33.8
"18290",6770,3,1,4,3,2,20,10,3,3,32,1,2,25,5,0,3,3277479,"2023-11-21T00:00:00.000Z",38017683,22,"Paolo Banchero",1,30,33,28,8,35.5
"18291",6771,6,5,4,0,0,6,2,4,1,31,3,1,5,7,2,1,3277479,"2023-11-21T00:00:00.000Z",666442,22,"Goga Bitadze",7,12,18,11,13,42.4
"18292",6772,4,0,2,4,2,10,6,4,4,21,1,3,18,3,2,2,3277479,"2023-11-21T00:00:00.000Z",17896073,22,"Jalen Suggs",2,21,25,22,7,31.6
"18293",6773,1,0,3,3,0,7,2,2,1,23,2,3,5,5,1,0,3277479,"2023-11-21T00:00:00.000Z",56677827,22,"Anthony Black",1,10,11,6,6,15.5
"18294",6774,1,0,1,2,1,3,2,1,1,13,1,2,6,2,0,1,3277479,"2023-11-21T00:00:00.000Z",226,22,"Joe Ingles",0,8,9,7,3,8.9
"18295",6775,1,0,1,5,2,7,4,0,0,23,0,3,10,1,1,0,3277479,"2023-11-21T00:00:00.000Z",196,22,"Gary Harris",1,11,12,11,2,15.7
"18296",6776,0,0,0,0,0,0,0,0,0,0,0,0,0,0,0,0,1037753,"2023-11-15T00:00:00.000Z",56677854,17,"Chris Livingston",0,0,0,0,0,0
"18297",6777,0,0,0,0,0,0,0,0,0,0,0,0,0,0,0,0,1037754,"2023-11-15T00:00:00.000Z",27,5,"Lonzo Ball",0,0,0,0,0,0
"18298",6778,0,0,0,0,0,0,0,0,0,0,0,0,0,0,0,0,1037754,"2023-11-15T00:00:00.000Z",125,5,"DeMar DeRozan",0,0,0,0,0,0
"18299",6779,0,0,0,0,0,0,0,0,0,0,0,0,0,0,0,0,1037754,"2023-11-15T00:00:00.000Z",45969255,5,"Justin Lewis",0,0,0,0,0,0
"18300",6780,0,0,0,0,0,0,0,0,0,0,0,0,0,0,0,0,1037754,"2023-11-15T00:00:00.000Z",56677860,5,"Adama Sanogo",0,0,0,0,0,0
"18301",6781,0,0,0,0,0,0,0,0,0,0,0,0,0,0,0,0,1037754,"2023-11-15T00:00:00.000Z",38017719,5,"Dalen Terry",0,0,0,0,0,0
"18302",6782,3,0,2,4,0,16,5,3,3,30,0,0,13,2,0,1,1037754,"2023-11-15T00:00:00.000Z",17896026,22,"Franz Wagner",0,15,18,16,5,18.9
"18303",6783,3,0,8,4,2,12,4,10,7,33,1,0,17,9,1,1,1037754,"2023-11-15T00:00:00.000Z",38017683,22,"Paolo Banchero",1,26,29,20,12,34.3
"18304",6784,2,0,5,0,0,10,6,4,3,26,6,5,15,11,2,0,1037754,"2023-11-15T00:00:00.000Z",666442,22,"Goga Bitadze",2,26,28,17,13,37.2
"18305",6785,5,0,2,7,2,8,2,4,4,26,0,4,10,2,3,4,1037754,"2023-11-15T00:00:00.000Z",17896073,22,"Jalen Suggs",3,12,17,15,7,24.9
"18306",6786,2,0,2,2,0,8,3,2,1,27,2,3,7,4,0,2,1037754,"2023-11-15T00:00:00.000Z",56677827,22,"Anthony Black",0,11,13,9,6,12.8
"18307",6787,1,0,2,3,1,3,1,0,0,18,0,1,3,2,0,0,1037754,"2023-11-15T00:00:00.000Z",226,22,"Joe Ingles",0,5,6,4,3,6.9
"18308",6788,0,0,0,0,0,0,0,0,0,0,0,0,0,0,0,0,1037752,"2023-11-15T00:00:00.000Z",56677788,23,"Terquavion Smith",0,0,0,0,0,0
"18309",6789,2,1,1,8,2,9,3,0,0,35,1,2,8,2,0,0,1037752,"2023-11-15T00:00:00.000Z",17896060,2,"Sam Hauser",1,10,12,10,4,16.4
"18310",6790,6,0,6,10,4,23,10,6,5,39,2,1,29,8,2,3,1037752,"2023-11-15T00:00:00.000Z",434,2,"Jayson Tatum",2,37,43,35,14,50.6
"18311",6791,3,5,7,8,4,9,5,0,0,29,1,2,14,8,0,0,1037752,"2023-11-15T00:00:00.000Z",219,2,"Al Horford",5,22,25,17,11,43.1
"18312",6792,5,0,3,8,4,12,7,10,9,36,0,3,27,3,1,2,1037752,"2023-11-15T00:00:00.000Z",473,2,"Derrick White",1,30,35,32,8,39.1
"18313",6793,3,2,8,9,2,18,8,1,0,36,2,0,18,10,1,1,1037752,"2023-11-15T00:00:00.000Z",214,2,"Jrue Holiday",3,28,31,21,13,42.5
"18314",6794,3,0,1,3,1,5,2,0,0,23,1,0,5,2,0,0,1037752,"2023-11-15T00:00:00.000Z",3547276,2,"Payton Pritchard",0,7,10,8,5,11.9
"18315",6795,0,0,2,5,2,14,7,0,0,32,0,1,16,2,5,1,1037756,"2023-11-15T00:00:00.000Z",666860,14,"Cameron Reddish",5,18,18,16,2,32.4
"18316",6796,11,1,8,7,3,15,9,8,7,35,2,1,28,10,4,6,1037756,"2023-11-15T00:00:00.000Z",237,14,"LeBron James",5,38,49,39,21,65.5
"18317",6797,1,4,9,1,0,9,3,3,3,35,0,4,9,9,0,5,1037756,"2023-11-15T00:00:00.000Z",117,14,"Anthony Davis",4,18,19,10,10,28.3
"18318",6798,0,0,2,4,1,7,3,0,0,26,0,2,7,2,1,0,1037756,"2023-11-15T00:00:00.000Z",383,14,"Taurean Prince",1,9,9,7,2,12.4
"18319",6799,5,1,2,6,4,20,12,0,0,35,3,3,28,5,0,2,1037756,"2023-11-15T00:00:00.000Z",405,14,"D'Angelo Russell",1,33,38,33,10,42.5
"18320",6800,0,0,1,0,0,0,0,4,3,13,0,4,3,1,1,2,1037756,"2023-11-15T00:00:00.000Z",666626,14,"Jaxson Hayes",1,4,4,3,1,5.2
"18321",6801,0,0,0,0,0,0,0,0,0,0,0,0,0,0,0,0,1037705,"2023-11-08T00:00:00.000Z",56677782,18,"Leonard Miller",0,0,0,0,0,0
"18322",6802,0,0,0,0,0,0,0,0,0,0,0,0,0,0,0,0,1037702,"2023-11-08T00:00:00.000Z",117,14,"Anthony Davis",0,0,0,0,0,0
"18323",6803,0,0,0,0,0,0,0,0,0,0,0,0,0,0,0,0,1037699,"2023-11-08T00:00:00.000Z",666679,3,"Cameron Johnson",0,0,0,0,0,0
"18324",6804,0,0,0,0,0,0,0,0,0,0,0,0,0,0,0,0,1037699,"2023-11-08T00:00:00.000Z",17896041,3,"Keon Johnson",0,0,0,0,0,0
"18325",6805,0,0,0,0,0,0,0,0,0,0,0,0,0,0,0,0,1037699,"2023-11-08T00:00:00.000Z",417,3,"Ben Simmons",0,0,0,0,0,0
"18326",6806,3,1,3,1,0,3,1,1,1,21,3,3,3,6,1,0,1037699,"2023-11-08T00:00:00.000Z",450,13,"PJ Tucker",2,9,12,6,9,20.7
"18327",6807,0,0,1,2,0,6,2,0,0,6,1,0,4,2,0,1,1037699,"2023-11-08T00:00:00.000Z",17896031,13,"Nah'Shon Hyland",0,6,6,4,2,5.4
"18328",6808,1,0,4,2,0,2,0,0,0,19,0,1,0,4,0,2,1037699,"2023-11-08T00:00:00.000Z",666743,13,"Terance Mann",0,4,5,1,5,4.3
"18329",6809,1,2,1,5,2,8,4,0,0,23,0,2,10,1,3,1,1037699,"2023-11-08T00:00:00.000Z",380,13,"Norman Powell",5,11,12,11,2,26.7
"18330",6810,0,0,0,0,0,0,0,0,0,0,0,0,0,0,0,0,1037699,"2023-11-08T00:00:00.000Z",17896022,13,"Brandon Boston Jr.",0,0,0,0,0,0
"18331",6811,0,0,0,0,0,0,0,0,0,0,0,0,0,0,0,0,1037699,"2023-11-08T00:00:00.000Z",56677856,13,"Jordan Miller",0,0,0,0,0,0
"18332",6812,0,0,0,0,0,0,0,0,0,0,0,0,0,0,0,0,1037699,"2023-11-08T00:00:00.000Z",371,13,"Mason Plumlee",0,0,0,0,0,0
"18333",6813,0,0,0,0,0,0,0,0,0,0,0,0,0,0,0,0,1037699,"2023-11-08T00:00:00.000Z",17896051,13,"Joshua Primo",0,0,0,0,0,0
"18334",6814,1,2,3,7,2,9,3,0,0,37,1,4,8,4,0,1,1037704,"2023-11-08T00:00:00.000Z",3547267,9,"Isaiah Stewart",2,12,13,9,5,19.3
"18335",6815,5,0,9,1,0,10,5,1,1,28,3,5,11,12,0,2,1037704,"2023-11-08T00:00:00.000Z",38017694,9,"Jalen Duren",0,23,28,16,17,30.9
"18336",6816,8,0,6,8,2,27,11,10,9,39,2,2,33,8,0,5,1037704,"2023-11-08T00:00:00.000Z",17896075,9,"Cade Cunningham",0,41,49,41,16,49.6
"18337",6817,4,0,5,3,0,15,6,2,2,29,0,1,14,5,1,1,1037704,"2023-11-08T00:00:00.000Z",3547241,9,"Killian Hayes",1,19,23,18,9,28
"18338",6818,2,1,0,0,0,6,5,2,2,20,2,4,12,2,0,1,1037704,"2023-11-08T00:00:00.000Z",24,9,"Marvin Bagley III",1,14,16,14,4,19.4
"18339",6819,0,0,0,0,0,0,0,0,0,0,0,0,0,0,0,0,1037704,"2023-11-08T00:00:00.000Z",56677729,9,"Malcolm Cazalon",0,0,0,0,0,0
"18340",6820,0,0,0,0,0,0,0,0,0,0,0,0,0,0,0,0,1037704,"2023-11-08T00:00:00.000Z",197,9,"Joe Harris",0,0,0,0,0,0
"18341",6821,0,0,0,0,0,0,0,0,0,0,0,0,0,0,0,0,1037704,"2023-11-08T00:00:00.000Z",38017682,9,"Jaden Ivey",0,0,0,0,0,0
"18342",6822,0,0,0,0,0,0,0,0,0,0,0,0,0,0,0,0,1037697,"2023-11-08T00:00:00.000Z",56677832,12,"Jarace Walker",0,0,0,0,0,0
"18343",6823,0,0,0,0,0,0,0,0,0,0,0,0,0,0,0,0,1037697,"2023-11-08T00:00:00.000Z",38017701,12,"Kendall Brown",0,0,0,0,0,0
"18344",6824,0,0,0,0,0,0,0,0,0,0,0,0,0,0,0,0,1037697,"2023-11-08T00:00:00.000Z",56677842,29,"Brice Sensabaugh",0,0,0,0,0,0
"18345",6825,2,1,2,7,2,13,4,2,1,35,0,2,11,2,1,4,1037698,"2023-11-08T00:00:00.000Z",70,2,"Jaylen Brown",2,13,15,13,4,18.4
"18346",6826,0,0,0,0,0,0,0,0,0,0,0,0,0,0,0,0,1037672,"2023-11-04T00:00:00.000Z",56677832,12,"Jarace Walker",0,0,0,0,0,0
"18347",6827,0,0,0,0,0,0,0,0,0,0,0,0,0,0,0,0,1037672,"2023-11-04T00:00:00.000Z",56677866,4,"Leaky Black",0,0,0,0,0,0
"18348",6828,0,0,0,0,0,0,0,0,0,0,0,0,0,0,0,0,1037672,"2023-11-04T00:00:00.000Z",62,4,"Miles Bridges",0,0,0,0,0,0
"18349",6829,0,0,0,0,0,0,0,0,0,0,0,0,0,0,0,0,1037672,"2023-11-04T00:00:00.000Z",38017708,4,"Bryce McGowens",0,0,0,0,0,0
"18350",6830,0,0,5,8,4,11,5,1,1,24,0,3,15,5,1,1,1037674,"2023-11-04T00:00:00.000Z",56677837,19,"Jordan Hawkins",1,20,20,15,5,23
"18351",6831,5,1,2,2,1,4,3,0,0,22,1,0,7,3,1,0,1037674,"2023-11-04T00:00:00.000Z",38017677,19,"Dyson Daniels",2,10,15,12,8,24.1
"18352",6832,1,0,1,3,0,4,1,2,2,17,1,2,4,2,0,1,1037674,"2023-11-04T00:00:00.000Z",17896017,19,"Matt Ryan",0,6,7,5,3,6.9
"18353",6833,0,0,0,0,0,0,0,0,0,1,0,0,0,0,0,0,1037674,"2023-11-04T00:00:00.000Z",38017663,19,"E.J. Liddell",0,0,0,0,0,0
"18354",6834,0,0,0,0,0,0,0,0,0,0,0,0,0,0,0,0,1037674,"2023-11-04T00:00:00.000Z",491,19,"Cody Zeller",0,0,0,0,0,0
"18355",6835,0,0,0,0,0,1,0,0,0,4,0,0,0,0,0,0,1037673,"2023-11-04T00:00:00.000Z",56677867,14,"Alex Fudge",0,0,0,0,0,0
"18356",6836,0,0,0,0,0,0,0,0,0,4,0,0,0,0,0,1,1037673,"2023-11-04T00:00:00.000Z",56677836,14,"Maxwell Lewis",0,0,0,0,0,-1
"18357",6837,0,0,0,2,0,2,0,0,0,4,0,1,0,0,0,0,1037673,"2023-11-04T00:00:00.000Z",56677868,14,"D'Moi Hodge",0,0,0,0,0,0
"18358",6838,0,0,0,0,0,0,0,0,0,0,0,0,0,0,0,0,1037673,"2023-11-04T00:00:00.000Z",666609,14,"Rui Hachimura",0,0,0,0,0,0
"18359",6839,0,0,0,0,0,0,0,0,0,0,0,0,0,0,0,0,1037673,"2023-11-04T00:00:00.000Z",56677835,14,"Jalen Hood-Schifino",0,0,0,0,0,0
"18360",6840,0,0,0,0,0,0,0,0,0,0,0,0,0,0,0,0,1037673,"2023-11-04T00:00:00.000Z",383,14,"Taurean Prince",0,0,0,0,0,0
"18361",6841,0,0,0,0,0,0,0,0,0,0,0,0,0,0,0,0,1037673,"2023-11-04T00:00:00.000Z",457,14,"Jarred Vanderbilt",0,0,0,0,0,0
"18362",6842,0,0,3,1,1,3,3,0,0,15,1,1,7,4,0,0,1037672,"2023-11-04T00:00:00.000Z",18678001,4,"JT Thor",0,11,11,7,4,11.8
"18363",6843,0,0,0,0,0,0,0,0,0,0,0,0,0,0,0,0,1037672,"2023-11-04T00:00:00.000Z",422,4,"Ish Smith",0,0,0,0,0,0
"18364",6844,0,0,0,0,0,0,0,0,0,0,0,0,0,0,0,0,1037672,"2023-11-04T00:00:00.000Z",56677846,4,"Nick Smith Jr.",0,0,0,0,0,0
"18365",6845,0,0,0,0,0,0,0,0,0,0,0,0,0,0,0,0,1037672,"2023-11-04T00:00:00.000Z",17896037,4,"James Bouknight",0,0,0,0,0,0
"18366",6846,0,0,0,0,0,0,0,0,0,0,0,0,0,0,0,0,1037674,"2023-11-04T00:00:00.000Z",17896097,19,"Jose Alvarado",0,0,0,0,0,0
"18367",6847,0,0,0,0,0,0,0,0,0,0,0,0,0,0,0,0,1037674,"2023-11-04T00:00:00.000Z",3547293,19,"Naji Marshall",0,0,0,0,0,0
"18368",6848,0,0,0,0,0,0,0,0,0,0,0,0,0,0,0,0,1037674,"2023-11-04T00:00:00.000Z",56677838,1,"Kobe Bufkin",0,0,0,0,0,0
"18369",6849,0,0,0,0,0,0,0,0,0,0,0,0,0,0,0,0,1037674,"2023-11-04T00:00:00.000Z",56677855,1,"Seth Lundy",0,0,0,0,0,0
"18370",6850,0,0,0,0,0,0,0,0,0,0,0,0,0,0,0,0,1037674,"2023-11-04T00:00:00.000Z",301,1,"Wesley Matthews",0,0,0,0,0,0
"18371",6851,2,0,5,7,3,12,4,4,4,26,3,2,15,8,1,0,1037643,"2023-10-30T00:00:00.000Z",17896073,22,"Jalen Suggs",1,23,25,17,10,30.6
"18372",6852,0,0,0,0,0,0,0,0,0,0,0,0,0,0,0,0,1037643,"2023-10-30T00:00:00.000Z",56677835,14,"Jalen Hood-Schifino",0,0,0,0,0,0
"18373",6853,0,0,0,0,0,0,0,0,0,0,0,0,0,0,0,0,1037643,"2023-10-30T00:00:00.000Z",457,14,"Jarred Vanderbilt",0,0,0,0,0,0
"18374",6854,4,0,6,7,2,17,5,4,4,37,2,4,16,8,2,2,1037643,"2023-10-30T00:00:00.000Z",17896026,22,"Franz Wagner",2,24,28,20,12,35.6
"18375",6855,5,0,4,5,1,14,4,2,0,31,1,3,9,5,0,2,1037643,"2023-10-30T00:00:00.000Z",38017683,22,"Paolo Banchero",0,14,19,14,10,20.5
"18376",6856,1,1,6,3,1,8,4,2,1,35,2,4,10,8,0,0,1037643,"2023-10-30T00:00:00.000Z",85,22,"Wendell Carter Jr.",1,18,19,11,9,24.1
"18377",6857,1,2,1,0,0,1,1,2,2,19,1,2,4,2,0,2,1037644,"2023-10-31T00:00:00.000Z",444,6,"Tristan Thompson",2,6,7,5,3,11.9
"18378",6858,0,0,0,0,0,0,0,0,0,0,0,0,0,0,0,0,1037644,"2023-10-31T00:00:00.000Z",9,6,"Jarrett Allen",0,0,0,0,0,0
"18379",6859,0,0,0,0,0,0,0,0,0,0,0,0,0,0,0,0,1037644,"2023-10-31T00:00:00.000Z",666581,6,"Darius Garland",0,0,0,0,0,0
"18380",6860,0,0,0,0,0,0,0,0,0,0,0,0,0,0,0,0,1037644,"2023-10-31T00:00:00.000Z",666676,6,"Ty Jerome",0,0,0,0,0,0
"18381",6861,0,0,0,0,0,0,0,0,0,0,0,0,0,0,0,0,1037644,"2023-10-31T00:00:00.000Z",277,6,"Caris LeVert",0,0,0,0,0,0
"18382",6862,0,0,0,0,0,0,0,0,0,0,0,0,0,0,0,0,1037644,"2023-10-31T00:00:00.000Z",404,6,"Ricky Rubio",0,0,0,0,0,0
"18383",6863,0,0,2,5,3,13,5,4,3,25,1,2,16,3,0,1,1037644,"2023-10-31T00:00:00.000Z",666423,20,"RJ Barrett",0,19,19,16,3,18.6
"18384",6864,2,0,7,5,2,14,5,10,7,31,3,1,19,10,1,1,1037644,"2023-10-31T00:00:00.000Z",387,20,"Julius Randle",1,29,31,21,12,36
"18385",6865,2,2,1,4,1,10,3,5,4,30,1,1,11,2,0,2,1037645,"2023-10-31T00:00:00.000Z",356,24,"Josh Okogie",2,13,15,13,4,20.4
"18386",6866,7,0,2,3,1,19,12,2,1,37,0,0,26,2,2,5,1037645,"2023-10-31T00:00:00.000Z",140,24,"Kevin Durant",2,28,35,33,9,39.9
"18387",6867,4,2,12,5,2,10,4,2,2,30,0,4,12,12,1,0,1037645,"2023-10-31T00:00:00.000Z",349,24,"Jusuf Nurkic",3,24,28,16,16,41.4
"18388",6868,3,1,6,7,5,9,5,4,4,37,1,2,19,7,0,2,1037645,"2023-10-31T00:00:00.000Z",8,24,"Grayson Allen",1,26,29,22,10,32.9
"18389",6869,6,0,2,9,4,14,8,0,0,36,0,1,20,2,0,4,1037645,"2023-10-31T00:00:00.000Z",178,24,"Eric Gordon",0,22,28,26,8,27.4
"18390",6870,4,2,8,0,0,3,1,2,1,17,1,1,3,9,1,2,1037645,"2023-10-31T00:00:00.000Z",147,24,"Drew Eubanks",3,12,16,7,13,26.8
"18391",6871,0,0,2,2,0,7,3,0,0,15,2,3,6,4,1,1,1037645,"2023-10-31T00:00:00.000Z",18678058,24,"Jordan Goodwin",1,10,10,6,4,12.8
"18392",6872,1,0,2,2,2,3,2,0,0,18,0,5,6,2,2,1,1037645,"2023-10-31T00:00:00.000Z",666729,24,"Nassir Little",2,8,9,7,3,14.9
"18393",6873,0,0,0,0,0,0,0,0,0,0,0,0,0,0,0,0,1037645,"2023-10-31T00:00:00.000Z",3547095,24,"Udoka Azubuike",0,0,0,0,0,0
"18394",6874,0,0,0,0,0,0,0,0,0,0,0,0,0,0,0,0,1037645,"2023-10-31T00:00:00.000Z",32,24,"Keita Bates-Diop",0,0,0,0,0,0
"18395",6875,0,0,0,0,0,0,0,0,0,0,0,0,0,0,0,0,1037645,"2023-10-31T00:00:00.000Z",666451,24,"Bol Bol",0,0,0,0,0,0
"18396",6876,0,0,0,0,0,0,0,0,0,1,0,0,0,0,0,0,1037593,"2023-10-24T00:00:00.000Z",17896007,8,"Braxton Key",0,0,0,0,0,0
"18397",6877,0,0,0,0,0,1,1,0,0,1,0,0,2,0,0,0,1037593,"2023-10-24T00:00:00.000Z",56677582,8,"Jalen Pickett",0,2,2,2,0,2
"18398",6878,0,0,0,0,0,0,0,0,0,0,0,0,0,0,0,0,1037593,"2023-10-24T00:00:00.000Z",56677776,8,"Julian Strawther",0,0,0,0,0,0
"18399",6879,0,0,0,0,0,0,0,0,0,0,0,0,0,0,0,0,1037593,"2023-10-24T00:00:00.000Z",666489,8,"Vlatko Cancar",0,0,0,0,0,0
"18400",6880,0,0,0,0,0,0,0,0,0,0,0,0,0,0,0,0,1037593,"2023-10-24T00:00:00.000Z",17896103,8,"Jay Huff",0,0,0,0,0,0
"18401",6881,0,0,0,0,0,0,0,0,0,0,0,0,0,0,0,0,1037593,"2023-10-24T00:00:00.000Z",56677871,8,"Hunter Tyson",0,0,0,0,0,0
"18402",6882,1,1,2,6,4,8,6,2,2,30,1,0,18,3,0,1,1037593,"2023-10-24T00:00:00.000Z",383,14,"Taurean Prince",1,21,22,19,4,25.1
"18403",6883,5,0,7,4,1,16,10,1,0,29,1,1,21,8,1,0,1037593,"2023-10-24T00:00:00.000Z",237,14,"LeBron James",1,29,34,26,13,41.1
"18404",6884,4,2,7,2,1,17,6,4,4,34,1,3,17,8,0,2,1037593,"2023-10-24T00:00:00.000Z",117,14,"Anthony Davis",2,25,29,21,12,36.6
"18405",6885,0,0,1,3,0,10,3,0,0,15,2,2,6,3,0,0,1037593,"2023-10-24T00:00:00.000Z",666609,14,"Rui Hachimura",0,9,9,6,3,9.6
"18406",6886,0,1,2,2,1,4,2,2,2,18,2,2,7,4,0,0,1037593,"2023-10-24T00:00:00.000Z",666860,14,"Cameron Reddish",1,11,11,7,4,14.8
"18407",6887,0,0,1,0,0,0,0,0,0,7,0,1,0,1,0,0,1037593,"2023-10-24T00:00:00.000Z",666626,14,"Jaxson Hayes",0,1,1,0,1,1.2
"18408",6888,0,0,0,0,0,0,0,0,0,1,0,0,0,0,0,0,1037593,"2023-10-24T00:00:00.000Z",38017697,14,"Max Christie",0,0,0,0,0,0
"18409",6889,0,0,0,0,0,0,0,0,0,1,0,0,0,0,0,0,1037593,"2023-10-24T00:00:00.000Z",56677836,14,"Maxwell Lewis",0,0,0,0,0,0
"18410",6890,3,1,6,11,3,18,6,0,0,36,1,3,15,7,0,3,1037594,"2023-10-24T00:00:00.000Z",443,10,"Klay Thompson",1,22,25,18,10,27.9
"18411",6891,0,1,0,3,0,12,4,3,2,27,1,3,10,1,0,0,1037594,"2023-10-24T00:00:00.000Z",475,10,"Andrew Wiggins",1,11,11,10,1,14.2
"18412",6892,1,0,6,0,0,6,3,1,1,28,5,2,7,11,0,2,1037594,"2023-10-24T00:00:00.000Z",282,10,"Kevon Looney",0,18,19,8,12,19.7
"18413",6893,9,0,5,6,0,15,4,7,6,34,1,0,14,6,2,1,1037594,"2023-10-24T00:00:00.000Z",367,10,"Chris Paul",2,20,29,23,15,39.7
"18414",6894,1,0,4,14,4,20,8,7,7,31,1,5,27,5,1,2,1037594,"2023-10-24T00:00:00.000Z",115,10,"Stephen Curry",1,32,33,28,6,35.5
"18415",6895,1,0,0,0,0,0,0,0,0,4,1,0,0,1,0,0,1037594,"2023-10-24T00:00:00.000Z",251,10,"Cory Joseph",0,1,2,1,2,2.7
"18416",6896,4,0,4,2,1,11,4,7,5,31,4,2,14,8,2,2,1037593,"2023-10-24T00:00:00.000Z",17553995,14,"Austin Reaves",2,22,26,18,12,33.6
"18417",6897,7,0,4,5,2,12,4,2,1,36,0,3,11,4,1,3,1037593,"2023-10-24T00:00:00.000Z",405,14,"D'Angelo Russell",1,15,22,18,11,26.3
"18418",6898,2,0,0,4,0,8,3,0,0,22,1,3,6,1,1,2,1037593,"2023-10-24T00:00:00.000Z",1603383,14,"Gabe Vincent",1,7,9,8,3,11.2
"18419",6899,0,0,3,1,0,4,3,2,1,16,1,1,7,4,0,1,1037593,"2023-10-24T00:00:00.000Z",486,14,"Christian Wood",0,11,11,7,4,10.8
"18420",6900,0,0,0,0,0,0,0,0,0,0,0,0,0,0,0,0,1037594,"2023-10-24T00:00:00.000Z",56677799,10,"Trayce Jackson-Davis",0,0,0,0,0,0
"18421",6901,3,0,2,6,3,9,5,2,1,28,3,2,14,5,0,1,1038103,"2024-01-08T00:00:00.000Z",666743,13,"Terance Mann",0,19,22,17,8,23.5
"18422",6902,2,1,3,3,1,15,8,0,0,32,0,1,17,3,5,3,1038103,"2024-01-08T00:00:00.000Z",274,13,"Kawhi Leonard",6,20,22,19,5,38.6
"18423",6903,3,1,6,0,0,9,8,6,3,28,2,3,19,8,1,0,1038103,"2024-01-08T00:00:00.000Z",493,13,"Ivica Zubac",2,27,30,22,11,39.1
"18424",6904,0,0,6,9,4,19,10,2,1,31,1,2,25,7,1,1,1038103,"2024-01-08T00:00:00.000Z",172,13,"Paul George",1,32,32,25,7,35.4
"18425",6905,10,0,7,4,3,8,6,4,4,30,0,1,19,7,0,3,1038103,"2024-01-08T00:00:00.000Z",192,13,"James Harden",0,26,36,29,17,39.4
"18426",6906,7,0,0,1,0,6,3,3,3,15,2,2,9,2,2,1,1038103,"2024-01-08T00:00:00.000Z",472,13,"Russell Westbrook",2,11,18,16,9,26.9
"18427",6907,0,0,2,1,1,5,4,0,0,23,0,3,9,2,0,0,1038103,"2024-01-08T00:00:00.000Z",666511,13,"Amir Coffey",0,11,11,9,2,11.4
"18428",6908,3,1,1,1,0,6,3,0,0,14,2,3,6,3,1,1,1038103,"2024-01-08T00:00:00.000Z",439,13,"Daniel Theis",2,9,12,9,6,19.1
"18429",6909,1,0,4,3,2,6,4,4,4,24,1,1,14,5,0,1,1038103,"2024-01-08T00:00:00.000Z",380,13,"Norman Powell",0,19,20,15,6,20.5
"18430",6910,0,0,0,1,1,2,2,0,0,5,0,2,5,0,0,1,1038103,"2024-01-08T00:00:00.000Z",17896022,13,"Brandon Boston Jr.",0,5,5,5,0,4
"18431",6911,0,0,0,0,0,0,0,0,0,5,0,1,0,0,1,0,1038103,"2024-01-08T00:00:00.000Z",56677849,13,"Kobe Brown",1,0,0,0,0,3
"18432",6912,3,0,2,0,0,0,0,2,1,5,0,0,1,2,0,0,1038103,"2024-01-08T00:00:00.000Z",371,13,"Mason Plumlee",0,3,6,4,5,7.9
"18433",6913,0,0,0,0,0,0,0,0,0,0,0,0,0,0,0,0,1038103,"2024-01-08T00:00:00.000Z",17896031,13,"Nah'Shon Hyland",0,0,0,0,0,0
"18434",6914,0,0,0,0,0,0,0,0,0,0,0,0,0,0,0,0,1038103,"2024-01-08T00:00:00.000Z",450,13,"PJ Tucker",0,0,0,0,0,0
"18435",6915,0,0,0,0,0,0,0,0,0,1,0,0,0,0,0,0,1038102,"2024-01-08T00:00:00.000Z",2148,17,"Thanasis Antetokounmpo",0,0,0,0,0,0
"18436",6916,0,0,0,0,0,0,0,0,0,0,0,0,0,0,0,0,1038103,"2024-01-08T00:00:00.000Z",24417679,13,"Xavier Moon",0,0,0,0,0,0
"18437",6917,0,0,0,0,0,0,0,0,0,0,0,0,0,0,0,0,1038103,"2024-01-08T00:00:00.000Z",17896051,13,"Joshua Primo",0,0,0,0,0,0
"18438",6918,2,0,3,3,1,3,1,5,5,31,0,1,8,3,0,1,1038103,"2024-01-08T00:00:00.000Z",8,24,"Grayson Allen",0,11,13,10,5,13.6
"18439",6919,2,1,7,6,3,17,10,8,7,35,0,2,30,7,0,3,1038103,"2024-01-08T00:00:00.000Z",140,24,"Kevin Durant",1,37,39,32,9,41.4
"18440",6920,2,0,2,2,1,8,3,2,1,21,1,1,8,3,1,0,1038103,"2024-01-08T00:00:00.000Z",349,24,"Jusuf Nurkic",1,11,13,10,5,17.6
"18441",6921,2,0,3,2,0,15,7,2,1,35,0,4,15,3,2,2,1038103,"2024-01-08T00:00:00.000Z",37,24,"Bradley Beal",2,18,20,17,5,25.6
"18442",6922,5,0,0,6,2,14,8,2,2,34,0,4,20,0,0,6,1038103,"2024-01-08T00:00:00.000Z",57,24,"Devin Booker",0,20,25,25,5,21.5
"18443",6923,2,0,1,7,2,8,3,4,4,25,0,1,12,1,0,1,1038103,"2024-01-08T00:00:00.000Z",178,24,"Eric Gordon",0,13,15,14,3,15.2
"18444",6924,0,1,2,0,0,1,1,2,2,8,0,1,4,2,0,0,1038103,"2024-01-08T00:00:00.000Z",314,24,"Chimezie Metu",1,6,6,4,2,9.4
"18445",6925,0,2,2,0,0,1,0,0,0,16,2,2,0,4,0,0,1038103,"2024-01-08T00:00:00.000Z",147,24,"Drew Eubanks",2,4,4,0,4,10.8
"18446",6926,3,0,0,1,0,5,3,2,2,24,1,3,8,1,0,3,1038050,"2024-01-01T00:00:00.000Z",286,16,"Kyle Lowry",0,9,12,11,4,10.7
"18447",6927,3,2,2,5,1,11,7,2,2,22,2,2,17,4,0,1,1038050,"2024-01-01T00:00:00.000Z",285,16,"Kevin Love",2,21,24,20,7,31.3
"18448",6928,2,0,1,7,3,8,3,6,6,26,0,1,15,1,0,1,1038050,"2024-01-01T00:00:00.000Z",397,16,"Duncan Robinson",0,16,18,17,3,18.2
"18449",6929,0,0,0,1,0,1,0,0,0,12,0,2,0,0,0,0,1038050,"2024-01-01T00:00:00.000Z",3547257,16,"R.J. Hampton",0,0,0,0,0,0
"18450",6930,1,0,0,0,0,0,0,0,0,3,0,0,0,0,0,0,1038050,"2024-01-01T00:00:00.000Z",74,16,"Thomas Bryant",0,0,1,1,1,1.5
"18451",6931,1,0,0,2,1,2,1,0,0,3,0,0,3,0,0,0,1038050,"2024-01-01T00:00:00.000Z",38017696,16,"Nikola Jovic",0,3,4,4,1,4.5
"18452",6932,1,0,5,9,3,17,5,2,2,32,0,1,15,5,0,2,1038047,"2024-01-01T00:00:00.000Z",56677823,4,"Brandon Miller",0,20,21,16,6,20.5
"18453",6933,4,0,2,0,0,12,5,0,0,29,1,2,10,3,0,4,1038047,"2024-01-01T00:00:00.000Z",422,4,"Ish Smith",0,13,17,14,7,15.6
"18454",6934,6,2,2,3,0,6,0,4,2,25,1,0,2,3,2,0,1038047,"2024-01-01T00:00:00.000Z",666748,4,"Cody Martin",4,5,11,8,9,26.6
"18455",6935,0,0,5,3,1,5,2,1,1,26,1,2,6,6,0,2,1038047,"2024-01-01T00:00:00.000Z",666950,4,"P.J. Washington",0,12,12,6,6,11.2
"18456",6936,2,1,1,3,1,8,2,0,0,19,2,2,5,3,0,2,1038047,"2024-01-01T00:00:00.000Z",56677846,4,"Nick Smith Jr.",1,8,10,7,5,12.6
"18457",6938,2,0,0,0,0,1,0,0,0,4,0,0,0,0,0,0,1038047,"2024-01-01T00:00:00.000Z",17896037,4,"James Bouknight",0,0,2,2,2,3
"18458",6939,0,1,2,0,0,2,1,0,0,4,0,0,2,2,0,0,1038047,"2024-01-01T00:00:00.000Z",18678001,4,"JT Thor",1,4,4,2,2,7.4
"18459",6940,0,0,0,0,0,0,0,0,0,0,0,0,0,0,0,0,1038047,"2024-01-01T00:00:00.000Z",347,4,"Frank Ntilikina",0,0,0,0,0,0
"18460",6941,0,0,0,0,0,0,0,0,0,0,0,0,0,0,0,0,1038047,"2024-01-01T00:00:00.000Z",56677848,4,"Amari Bailey",0,0,0,0,0,0
"18461",6942,0,0,0,0,0,0,0,0,0,0,0,0,0,0,0,0,1038047,"2024-01-01T00:00:00.000Z",3547239,4,"LaMelo Ball",0,0,0,0,0,0
"18462",6943,1,3,3,7,1,14,4,0,0,37,5,2,9,8,1,0,1038054,"2024-01-02T00:00:00.000Z",666541,21,"Luguentz Dort",4,17,18,10,9,32.1
"18463",6944,1,2,1,2,2,9,6,2,2,31,0,3,16,1,3,5,1038054,"2024-01-02T00:00:00.000Z",38017703,21,"Jalen Williams",5,17,18,17,2,28.7
"18464",6945,7,4,3,5,3,9,5,2,1,33,0,1,14,3,0,1,1038054,"2024-01-02T00:00:00.000Z",38017685,21,"Chet Holmgren",4,17,24,21,10,39.1
"18465",6946,6,0,7,7,4,14,8,3,3,27,1,0,23,8,0,3,1038054,"2024-01-02T00:00:00.000Z",17896065,21,"Josh Giddey",0,31,37,29,14,38.6
"18466",6947,7,0,6,5,3,22,14,8,5,37,0,5,36,6,1,0,1038054,"2024-01-02T00:00:00.000Z",175,21,"Shai Gilgeous-Alexander",1,42,49,43,13,56.7
"18467",6948,0,0,3,3,2,5,4,0,0,13,0,1,10,3,0,1,1038054,"2024-01-02T00:00:00.000Z",3547272,21,"Isaiah Joe",0,13,13,10,3,12.6
"18468",6949,0,0,0,0,0,0,0,0,0,0,0,0,0,0,0,0,1038054,"2024-01-02T00:00:00.000Z",44,21,"Davis Bertans",0,0,0,0,0,0
"18469",6950,0,0,0,0,0,0,0,0,0,0,0,0,0,0,0,0,1038054,"2024-01-02T00:00:00.000Z",17896036,21,"Tre Mann",0,0,0,0,0,0
"18470",6951,7,3,3,6,2,18,10,0,0,35,1,3,22,4,4,3,1038026,"2023-12-29T00:00:00.000Z",200,23,"Tobias Harris",7,26,33,29,11,55.3
"18471",6952,0,2,1,4,1,6,3,0,0,27,0,1,7,1,1,1,1038029,"2023-12-29T00:00:00.000Z",666923,25,"Matisse Thybulle",3,8,8,7,1,16.2
"18472",6953,1,1,3,2,1,11,7,13,10,30,6,4,25,9,1,1,1038029,"2023-12-29T00:00:00.000Z",38017711,25,"Jabari Walker",2,34,35,26,10,42.3
"18473",6954,0,0,0,0,0,0,0,0,0,0,0,0,0,0,0,0,1038029,"2023-12-29T00:00:00.000Z",47957121,25,"Justin Minaya",0,0,0,0,0,0
"18474",6955,0,0,0,0,0,0,0,0,0,0,0,0,0,0,0,0,1038029,"2023-12-29T00:00:00.000Z",56677791,25,"Kris Murray",0,0,0,0,0,0
"18475",6956,0,0,0,0,0,0,0,0,0,0,0,0,0,0,0,0,1038029,"2023-12-29T00:00:00.000Z",56677829,25,"Rayan Rupert",0,0,0,0,0,0
"18476",6957,0,0,0,0,0,0,0,0,0,0,0,0,0,0,0,0,1038029,"2023-12-29T00:00:00.000Z",17896120,25,"Ish Wainright",0,0,0,0,0,0
"18477",6958,0,0,0,0,0,0,0,0,0,0,0,0,0,0,0,0,1038029,"2023-12-29T00:00:00.000Z",22,25,"Deandre Ayton",0,0,0,0,0,0
"18478",6959,0,0,0,0,0,0,0,0,0,0,0,0,0,0,0,0,1038029,"2023-12-29T00:00:00.000Z",56783340,25,"Duop Reath",0,0,0,0,0,0
"18479",6960,0,0,0,0,0,0,0,0,0,0,0,0,0,0,0,0,1038029,"2023-12-29T00:00:00.000Z",38017690,25,"Shaedon Sharpe",0,0,0,0,0,0
"18480",6961,1,0,1,8,6,9,6,0,0,23,0,1,18,1,0,2,1038029,"2023-12-29T00:00:00.000Z",305,27,"Doug McDermott",0,19,20,19,2,18.7
"18481",6962,2,0,1,1,0,2,1,0,0,7,0,1,2,1,0,0,1038029,"2023-12-29T00:00:00.000Z",17896059,27,"Sandro Mamukelashvili",0,3,5,4,3,6.2
"18482",6963,0,0,0,0,0,0,0,0,0,0,0,0,0,0,0,0,1038029,"2023-12-29T00:00:00.000Z",38017693,27,"Blake Wesley",0,0,0,0,0,0
"18483",6964,6,0,5,4,2,9,6,0,0,20,1,1,14,6,0,4,1038030,"2023-12-29T00:00:00.000Z",472,13,"Russell Westbrook",0,20,26,20,12,26.2
"18484",6965,1,0,6,4,1,12,5,2,2,25,0,2,13,6,0,1,1038030,"2023-12-29T00:00:00.000Z",380,13,"Norman Powell",0,19,20,14,7,20.7
"18485",6966,0,2,1,1,0,3,2,2,1,13,1,3,5,2,0,1,1038030,"2023-12-29T00:00:00.000Z",439,13,"Daniel Theis",2,7,7,5,2,12.4
"18486",6967,0,0,0,0,0,0,0,0,0,0,0,0,0,0,0,0,1038030,"2023-12-29T00:00:00.000Z",17896031,13,"Nah'Shon Hyland",0,0,0,0,0,0
"18487",6968,0,0,0,0,0,0,0,0,0,0,0,0,0,0,0,0,1038030,"2023-12-29T00:00:00.000Z",56677856,13,"Jordan Miller",0,0,0,0,0,0
"18488",6969,0,0,0,0,0,0,0,0,0,0,0,0,0,0,0,0,1038030,"2023-12-29T00:00:00.000Z",17896051,13,"Joshua Primo",0,0,0,0,0,0
"18489",6970,0,0,0,0,0,0,0,0,0,0,0,0,0,0,0,0,1038030,"2023-12-29T00:00:00.000Z",450,13,"PJ Tucker",0,0,0,0,0,0
"18490",6971,0,0,0,0,0,0,0,0,0,0,0,0,0,0,0,0,1038030,"2023-12-29T00:00:00.000Z",274,13,"Kawhi Leonard",0,0,0,0,0,0
"18491",6972,0,0,0,0,0,0,0,0,0,0,0,0,0,0,0,0,1038030,"2023-12-29T00:00:00.000Z",24417679,13,"Xavier Moon",0,0,0,0,0,0
"18492",6973,0,0,0,0,0,0,0,0,0,0,0,0,0,0,0,0,1038029,"2023-12-29T00:00:00.000Z",17895854,27,"Charles Bassey",0,0,0,0,0,0
"18493",6974,0,0,0,0,0,0,0,0,0,0,0,0,0,0,0,0,1038029,"2023-12-29T00:00:00.000Z",56677817,27,"Sidy Cissoko",0,0,0,0,0,0
"18494",6975,0,0,0,0,0,0,0,0,0,0,0,0,0,0,0,0,1038029,"2023-12-29T00:00:00.000Z",17896049,27,"David Duke Jr.",0,0,0,0,0,0
"18495",6976,2,0,1,3,0,7,2,2,1,19,0,0,5,1,1,0,1038001,"2023-12-26T00:00:00.000Z",17895966,11,"Jalen Green",1,6,8,7,3,12.2
"18496",6977,9,1,4,7,1,18,7,3,3,40,0,2,18,4,2,3,1038001,"2023-12-26T00:00:00.000Z",458,11,"Fred VanVleet",3,22,31,27,13,42.3
"18497",6978,1,0,5,2,1,13,7,2,1,26,3,3,16,8,2,0,1038001,"2023-12-26T00:00:00.000Z",38017695,11,"Tari Eason",2,24,25,17,9,33.1
"18498",6979,0,0,0,0,0,1,1,0,0,11,0,2,2,0,0,1,1038001,"2023-12-26T00:00:00.000Z",188,11,"Jeff Green",0,2,2,2,0,1
"18499",6980,0,0,0,0,0,0,0,0,0,0,0,0,0,0,0,0,1038001,"2023-12-26T00:00:00.000Z",75,11,"Reggie Bullock",0,0,0,0,0,0
"18500",6981,0,0,0,0,0,0,0,0,0,0,0,0,0,0,0,0,1038001,"2023-12-26T00:00:00.000Z",3547281,11,"Nate Hinton",0,0,0,0,0,0
"18501",6982,8,0,5,8,2,17,7,8,8,27,1,6,24,6,0,3,1038004,"2023-12-26T00:00:00.000Z",100,29,"Jordan Clarkson",0,30,38,32,14,40.2
"18502",6983,4,0,0,5,2,11,4,1,0,24,0,3,10,0,1,2,1038004,"2023-12-26T00:00:00.000Z",56677834,29,"Keyonte George",1,10,14,14,4,17
"18503",6984,1,4,4,1,1,10,5,0,0,18,3,2,11,7,1,1,1038004,"2023-12-26T00:00:00.000Z",38017705,29,"Walker Kessler",5,18,19,12,8,34.9
"18504",6985,0,0,2,4,2,5,3,0,0,23,1,1,8,3,0,1,1038004,"2023-12-26T00:00:00.000Z",38017739,29,"Simone Fontecchio",0,11,11,8,3,10.6
"18505",6986,1,0,3,4,2,6,4,0,0,20,1,0,10,4,0,0,1038004,"2023-12-26T00:00:00.000Z",38017620,29,"Ochai Agbaji",0,14,15,11,5,16.3
"18506",6987,0,0,1,2,0,3,0,0,0,2,0,0,0,1,0,1,1038004,"2023-12-26T00:00:00.000Z",56677824,29,"Taylor Hendricks",0,1,1,0,1,0.2
"18507",6988,0,0,0,0,0,0,0,0,0,0,0,0,0,0,0,0,1038004,"2023-12-26T00:00:00.000Z",666650,29,"Talen Horton-Tucker",0,0,0,0,0,0
"18508",6989,6,0,2,3,2,17,8,7,7,40,0,3,25,2,1,1,1038000,"2023-12-26T00:00:00.000Z",125,5,"DeMar DeRozan",1,27,33,31,8,38.4
"18509",6990,0,0,0,1,0,7,2,2,2,25,1,2,6,1,1,1,1038000,"2023-12-26T00:00:00.000Z",3547248,5,"Patrick Williams",1,7,7,6,1,9.2
"18510",6991,1,2,15,0,0,13,11,2,2,39,10,4,24,25,3,2,1038000,"2023-12-26T00:00:00.000Z",137,5,"Andre Drummond",5,49,50,25,26,68.5
"18511",6992,5,0,3,5,1,10,2,6,6,29,2,2,11,5,2,1,1038000,"2023-12-26T00:00:00.000Z",89,5,"Alex Caruso",2,16,21,16,10,29.5
"18512",6993,5,0,5,7,0,22,7,8,5,37,0,2,19,5,0,1,1038000,"2023-12-26T00:00:00.000Z",666956,5,"Coby White",0,24,29,24,10,31.5
"18513",6994,4,0,3,4,2,14,6,6,5,35,4,1,19,7,3,0,1038000,"2023-12-26T00:00:00.000Z",17895983,5,"Ayo Dosunmu",3,26,30,23,11,42.4
"18514",6995,0,2,4,6,5,9,7,2,1,33,0,4,20,4,1,1,1038003,"2023-12-26T00:00:00.000Z",666541,21,"Luguentz Dort",3,24,24,20,4,32.8
"18515",6996,3,2,1,6,4,11,7,3,3,26,0,3,21,1,0,1,1038003,"2023-12-26T00:00:00.000Z",38017703,21,"Jalen Williams",2,22,25,24,4,31.7
"18516",6997,5,1,4,6,3,13,8,2,1,29,0,4,20,4,0,1,1038003,"2023-12-26T00:00:00.000Z",38017685,21,"Chet Holmgren",1,24,29,25,9,34.3
"18517",6998,7,0,2,2,0,7,4,2,2,25,0,3,10,2,0,2,1038003,"2023-12-26T00:00:00.000Z",17896065,21,"Josh Giddey",0,12,19,17,9,20.9
"18518",6999,9,1,6,3,0,19,14,7,6,33,0,3,34,6,2,3,1038003,"2023-12-26T00:00:00.000Z",175,21,"Shai Gilgeous-Alexander",3,40,49,43,15,60.7
"18519",7000,2,0,1,3,2,4,3,0,0,16,1,3,8,2,0,0,1038003,"2023-12-26T00:00:00.000Z",3547272,21,"Isaiah Joe",0,10,12,10,4,13.4
"18520",7001,0,0,0,0,0,0,0,0,0,0,0,0,0,0,0,0,1037951,"2023-12-18T00:00:00.000Z",17896033,20,"Miles McBride",0,0,0,0,0,0
"18521",7002,0,0,0,0,0,0,0,0,0,0,0,0,0,0,0,0,1037951,"2023-12-18T00:00:00.000Z",666474,20,"Charles Brown",0,0,0,0,0,0
"18522",7003,3,1,6,5,3,6,3,0,0,34,1,1,9,7,0,1,1037952,"2023-12-19T00:00:00.000Z",38017731,15,"Vince Williams Jr.",1,16,19,12,10,23.9
"18523",7004,4,0,3,6,3,15,7,0,0,28,0,2,17,3,1,1,1037953,"2023-12-19T00:00:00.000Z",315,17,"Khris Middleton",1,20,24,21,7,28.6
"18524",7005,16,1,12,2,0,12,4,6,3,34,2,1,11,14,2,3,1037953,"2023-12-19T00:00:00.000Z",15,17,"Giannis Antetokounmpo",3,25,41,27,30,57.8
"18525",7006,1,6,0,5,0,14,6,2,2,32,5,3,14,5,0,0,1037953,"2023-12-19T00:00:00.000Z",283,17,"Brook Lopez",6,19,20,15,6,39.5
"18526",7007,2,0,3,5,1,7,3,0,0,28,1,1,7,4,1,0,1037953,"2023-12-19T00:00:00.000Z",38,17,"Malik Beasley",1,11,13,9,6,17.8
"18527",7008,4,0,3,12,7,22,14,5,5,35,0,0,40,3,3,1,1037953,"2023-12-19T00:00:00.000Z",278,17,"Damian Lillard",3,43,47,44,7,57.6
"18528",7009,2,0,9,6,3,16,10,0,0,26,1,3,23,10,2,0,1037953,"2023-12-19T00:00:00.000Z",377,17,"Bobby Portis",2,33,35,25,12,44
"18529",7010,2,0,3,6,1,8,1,0,0,18,0,2,3,3,1,0,1037953,"2023-12-19T00:00:00.000Z",105,17,"Pat Connaughton",1,6,8,5,5,12.6
"18530",7011,2,0,1,3,2,4,2,2,1,15,2,2,7,3,1,1,1037953,"2023-12-19T00:00:00.000Z",56677852,17,"Andre Jackson Jr.",1,10,12,9,5,15.6
"18531",7012,0,0,0,2,0,6,2,3,3,13,0,1,7,0,0,0,1037953,"2023-12-19T00:00:00.000Z",368,17,"Cameron Payne",0,7,7,7,0,7
"18532",7013,0,0,1,0,0,0,0,0,0,6,0,0,0,1,0,0,1037953,"2023-12-19T00:00:00.000Z",38017676,17,"MarJon Beauchamp",0,1,1,0,1,1.2
"18533",7014,0,0,0,1,0,1,0,0,0,2,0,0,0,0,0,0,1037953,"2023-12-19T00:00:00.000Z",38017733,17,"A.J. Green",0,0,0,0,0,0
"18534",7015,0,0,1,1,1,1,1,0,0,2,0,0,3,1,0,0,1037953,"2023-12-19T00:00:00.000Z",284,17,"Robin Lopez",0,4,4,3,1,4.2
"18535",7016,1,0,0,0,0,0,0,0,0,1,0,0,0,0,0,0,1037953,"2023-12-19T00:00:00.000Z",2148,17,"Thanasis Antetokounmpo",0,0,1,1,1,1.5
"18536",7017,0,0,0,0,0,0,0,0,0,0,0,0,0,0,0,0,1037953,"2023-12-19T00:00:00.000Z",666453,17,"Marques Bolden",0,0,0,0,0,0
"18537",7018,0,0,0,0,0,0,0,0,0,0,0,0,0,0,0,0,1037953,"2023-12-19T00:00:00.000Z",112,17,"Jae Crowder",0,0,0,0,0,0
"18538",7019,0,0,0,0,0,0,0,0,0,0,0,0,0,0,0,0,1037953,"2023-12-19T00:00:00.000Z",56677854,17,"Chris Livingston",0,0,0,0,0,0
"18539",7020,0,0,0,0,0,0,0,0,0,0,0,0,0,0,0,0,1037953,"2023-12-19T00:00:00.000Z",38017691,17,"TyTy Washington Jr.",0,0,0,0,0,0
"18540",7021,0,0,0,0,0,0,0,0,0,0,0,0,0,0,0,0,1037953,"2023-12-19T00:00:00.000Z",666960,17,"Lindell Wigginton",0,0,0,0,0,0
"18541",7022,3,0,2,4,2,11,5,0,0,27,0,1,12,2,0,1,1037953,"2023-12-19T00:00:00.000Z",38017692,27,"Malaki Branham",0,14,17,15,5,17.9
"18542",7023,1,0,2,2,0,6,3,4,4,19,0,1,10,2,0,0,1037953,"2023-12-19T00:00:00.000Z",359,27,"Cedi Osman",0,12,13,11,3,13.9
"18543",7024,5,0,1,1,0,11,7,0,0,24,0,1,14,1,1,2,1037953,"2023-12-19T00:00:00.000Z",3547274,27,"Tre Jones",1,15,20,19,6,23.7
"18544",7025,2,0,2,1,0,2,0,0,0,13,0,3,0,2,0,0,1037953,"2023-12-19T00:00:00.000Z",305,27,"Doug McDermott",0,2,4,2,4,5.4
"18545",7026,0,0,0,0,0,0,0,0,0,0,0,0,0,0,0,0,1037906,"2023-12-13T00:00:00.000Z",3547285,15,"Xavier Tillman",0,0,0,0,0,0
"18546",7027,0,0,0,0,0,0,0,0,0,0,0,0,0,0,0,0,1037906,"2023-12-13T00:00:00.000Z",3,15,"Steven Adams",0,0,0,0,0,0
"18547",7028,0,0,0,0,0,0,0,0,0,0,0,0,0,0,0,0,1037906,"2023-12-13T00:00:00.000Z",3547287,15,"Desmond Bane",0,0,0,0,0,0
"18548",7029,0,0,0,0,0,0,0,0,0,0,0,0,0,0,0,0,1037906,"2023-12-13T00:00:00.000Z",666505,15,"Brandon Clarke",0,0,0,0,0,0
"18549",7030,0,0,0,0,0,0,0,0,0,0,0,0,0,0,0,0,1037906,"2023-12-13T00:00:00.000Z",56677830,15,"GG Jackson",0,0,0,0,0,0
"18550",7031,2,0,1,1,0,2,1,0,0,14,1,4,2,2,0,0,1037907,"2023-12-13T00:00:00.000Z",56677852,17,"Andre Jackson Jr.",0,4,6,4,4,7.4
"18551",7032,4,0,0,2,0,4,0,2,1,14,0,1,1,0,0,1,1037907,"2023-12-13T00:00:00.000Z",368,17,"Cameron Payne",0,1,5,5,4,6
"18552",7033,0,0,0,0,0,0,0,0,0,1,0,0,0,0,0,0,1037907,"2023-12-13T00:00:00.000Z",38017733,17,"A.J. Green",0,0,0,0,0,0
"18553",7034,0,0,0,0,0,0,0,0,0,0,0,0,0,0,0,0,1037908,"2023-12-13T00:00:00.000Z",56677835,14,"Jalen Hood-Schifino",0,0,0,0,0,0
"18554",7035,0,0,0,0,0,0,0,0,0,0,0,0,0,0,0,0,1037908,"2023-12-13T00:00:00.000Z",56677836,14,"Maxwell Lewis",0,0,0,0,0,0
"18555",7036,0,0,0,0,0,0,0,0,0,0,0,0,0,0,0,0,1037908,"2023-12-13T00:00:00.000Z",1603383,14,"Gabe Vincent",0,0,0,0,0,0
"18556",7037,0,0,0,0,0,0,0,0,0,1,0,1,0,0,0,0,1037907,"2023-12-13T00:00:00.000Z",284,17,"Robin Lopez",0,0,0,0,0,0
"18557",7038,0,0,0,0,0,0,0,0,0,1,0,0,0,0,0,1,1037907,"2023-12-13T00:00:00.000Z",2148,17,"Thanasis Antetokounmpo",0,0,0,0,0,-1
"18558",7039,0,0,0,0,0,0,0,0,0,0,0,0,0,0,0,0,1037907,"2023-12-13T00:00:00.000Z",666453,17,"Marques Bolden",0,0,0,0,0,0
"18559",7040,0,0,7,8,4,13,7,7,5,25,1,2,23,8,0,0,1037910,"2023-12-13T00:00:00.000Z",297,29,"Lauri Markkanen",0,31,31,23,8,32.6
"18560",7041,2,0,3,10,3,12,4,4,4,31,3,4,15,6,2,2,1037910,"2023-12-13T00:00:00.000Z",38017739,29,"Simone Fontecchio",2,21,23,17,8,29.2
"18561",7042,8,0,9,2,1,9,3,2,2,30,1,3,9,10,0,4,1037910,"2023-12-13T00:00:00.000Z",358,29,"Kelly Olynyk",0,19,27,17,18,29
"18562",7043,7,0,3,8,3,18,10,3,3,30,1,4,26,4,0,2,1037910,"2023-12-13T00:00:00.000Z",413,29,"Collin Sexton",0,30,37,33,11,39.3
"18563",7044,4,2,5,5,1,18,9,10,8,38,1,3,27,6,1,2,1037909,"2023-12-13T00:00:00.000Z",140,24,"Kevin Durant",3,33,37,31,10,47.2
"18564",7045,0,0,1,3,2,8,3,0,0,20,3,2,8,4,2,1,1037909,"2023-12-13T00:00:00.000Z",314,24,"Chimezie Metu",2,12,12,8,4,17.8
"18565",7046,3,2,16,2,0,15,7,2,1,31,6,3,15,22,0,0,1037909,"2023-12-13T00:00:00.000Z",349,24,"Jusuf Nurkic",2,37,40,18,25,51.9
"18566",7047,4,0,1,2,2,9,6,0,0,34,0,1,14,1,1,2,1037909,"2023-12-13T00:00:00.000Z",37,24,"Bradley Beal",1,15,19,18,5,22.2
"18567",7048,12,0,5,6,2,15,9,15,14,40,1,5,34,6,0,2,1037909,"2023-12-13T00:00:00.000Z",57,24,"Devin Booker",0,40,52,46,18,57.2
"18568",7049,3,0,5,5,2,7,4,0,0,27,2,2,10,7,0,2,1037909,"2023-12-13T00:00:00.000Z",666729,24,"Nassir Little",0,17,20,13,10,20.9
"18569",7050,0,0,0,2,0,2,0,0,0,7,1,2,0,1,0,0,1037909,"2023-12-13T00:00:00.000Z",470,24,"Yuta Watanabe",0,1,1,0,1,1.2
"18570",7051,0,0,1,2,0,10,3,6,6,31,0,2,12,1,2,2,1037878,"2023-12-02T00:00:00.000Z",666656,1,"De'Andre Hunter",2,13,13,12,1,17.2
"18571",7052,2,0,3,3,1,7,4,0,0,13,0,0,9,3,1,1,7049315,"2023-12-06T00:00:00.000Z",3547249,28,"Precious Achiuwa",1,12,14,11,5,17.6
"18572",7053,0,0,4,1,0,2,0,0,0,10,0,0,0,4,0,1,7049315,"2023-12-06T00:00:00.000Z",58,28,"Chris Boucher",0,4,4,0,4,3.8
"18573",7054,0,0,2,1,0,4,1,2,2,15,1,0,4,3,0,0,7049316,"2023-12-06T00:00:00.000Z",328,23,"Marcus Morris",0,7,7,4,3,7.6
"18574",7055,1,0,1,3,1,8,5,1,1,19,1,1,12,2,1,1,7049316,"2023-12-06T00:00:00.000Z",360,23,"Kelly Oubre Jr.",1,14,15,13,3,17.9
"18575",7056,0,0,1,0,0,0,0,0,0,4,0,1,0,1,0,1,7049316,"2023-12-06T00:00:00.000Z",108,23,"Robert Covington",0,1,1,0,1,0.2
"18576",7057,0,0,1,1,0,1,0,0,0,10,0,3,0,1,0,0,7049316,"2023-12-06T00:00:00.000Z",3547270,23,"Paul Reed",0,1,1,0,1,1.2
"18577",7058,0,0,0,0,0,0,0,0,0,0,0,0,0,0,0,0,7049316,"2023-12-06T00:00:00.000Z",2175,23,"Danuel House Jr.",0,0,0,0,0,0
"18578",7059,0,0,0,0,0,0,0,0,0,0,0,0,0,0,0,0,7049316,"2023-12-06T00:00:00.000Z",260,23,"Furkan Korkmaz",0,0,0,0,0,0
"18579",7060,0,0,0,0,0,0,0,0,0,0,0,0,0,0,0,0,7049316,"2023-12-06T00:00:00.000Z",3547294,23,"Kenyon Martin Jr.",0,0,0,0,0,0
"18580",7061,0,0,0,0,0,0,0,0,0,0,0,0,0,0,0,0,7049316,"2023-12-06T00:00:00.000Z",17896025,23,"Jaden Springer",0,0,0,0,0,0
"18581",7062,0,0,0,0,0,0,0,0,0,0,0,0,0,0,0,0,7049316,"2023-12-06T00:00:00.000Z",56913527,23,"Ricky Council IV",0,0,0,0,0,0
"18582",7063,0,0,0,0,0,0,0,0,0,0,0,0,0,0,0,0,7049316,"2023-12-06T00:00:00.000Z",17554001,23,"Javonte Smart",0,0,0,0,0,0
"18583",7064,0,0,0,0,0,0,0,0,0,0,0,0,0,0,0,0,7049316,"2023-12-06T00:00:00.000Z",56677788,23,"Terquavion Smith",0,0,0,0,0,0
"18584",7065,2,0,4,3,1,15,6,1,1,36,0,1,14,4,0,1,7049317,"2023-12-06T00:00:00.000Z",666656,1,"De'Andre Hunter",0,18,20,16,6,20.8
"18585",7066,1,0,3,6,3,13,7,4,4,37,4,1,21,7,1,3,7049317,"2023-12-06T00:00:00.000Z",3547256,1,"Saddiq Bey",1,28,29,22,8,30.9
"18586",7067,1,2,8,0,0,6,4,2,1,29,4,5,9,12,0,1,7049317,"2023-12-06T00:00:00.000Z",83,1,"Clint Capela",2,21,22,10,13,29.9
"18587",7068,9,0,10,5,1,16,6,0,0,32,0,3,13,10,1,0,7049317,"2023-12-06T00:00:00.000Z",334,1,"Dejounte Murray",1,23,32,22,19,41.5
"18588",7069,9,2,0,9,3,24,11,5,5,37,1,2,30,1,0,5,7049317,"2023-12-06T00:00:00.000Z",490,1,"Trae Young",2,31,40,39,10,45.7
"18589",7070,1,0,4,9,4,14,7,2,2,27,0,2,20,4,0,0,7049317,"2023-12-06T00:00:00.000Z",53,1,"Bogdan Bogdanovic",0,24,25,21,5,26.3
"18590",7071,0,0,1,0,0,0,0,0,0,7,0,3,0,1,1,1,7049317,"2023-12-06T00:00:00.000Z",666754,1,"Garrison Mathews",1,1,1,0,1,3.2
"18591",7072,0,0,0,0,0,0,0,0,0,0,0,0,0,0,0,0,7049317,"2023-12-06T00:00:00.000Z",666564,1,"Bruno Fernando",0,0,0,0,0,0
"18592",7073,0,0,0,0,0,0,0,0,0,0,0,0,0,0,0,0,7049317,"2023-12-06T00:00:00.000Z",3547297,1,"Trent Forrest",0,0,0,0,0,0
"18593",7074,0,0,0,0,0,0,0,0,0,0,0,0,0,0,0,0,7049317,"2023-12-06T00:00:00.000Z",38017689,1,"AJ Griffin",0,0,0,0,0,0
"18594",7075,6,1,7,10,5,13,8,2,2,39,1,2,23,8,1,2,7049315,"2023-12-06T00:00:00.000Z",18,28,"OG Anunoby",2,31,37,29,14,45.6
"18595",7076,0,0,0,0,0,0,0,0,0,0,0,0,0,0,0,0,1037871,"2023-12-01T00:00:00.000Z",335,8,"Jamal Murray",0,0,0,0,0,0
"18596",7077,0,0,0,0,0,0,0,0,0,0,0,0,0,0,0,0,1037871,"2023-12-01T00:00:00.000Z",56677582,8,"Jalen Pickett",0,0,0,0,0,0
"18597",7078,0,0,0,0,0,0,0,0,0,0,0,0,0,0,0,0,1037871,"2023-12-01T00:00:00.000Z",56677871,8,"Hunter Tyson",0,0,0,0,0,0
"18598",7079,7,0,8,5,2,16,9,0,0,39,0,2,20,8,1,3,1037872,"2023-12-02T00:00:00.000Z",274,13,"Kawhi Leonard",1,28,35,27,15,40.1
"18599",7080,6,0,6,8,4,17,8,5,5,38,0,5,25,6,1,1,1037872,"2023-12-02T00:00:00.000Z",172,13,"Paul George",1,31,37,31,12,43.2
"18600",7081,1,3,6,0,0,6,6,0,0,23,1,4,12,7,0,3,1037872,"2023-12-02T00:00:00.000Z",493,13,"Ivica Zubac",3,19,20,13,8,27.9
"18601",7082,2,0,1,5,1,6,1,0,0,24,1,1,3,2,1,0,1037872,"2023-12-02T00:00:00.000Z",666743,13,"Terance Mann",1,5,7,5,4,11.4
"18602",7083,9,0,5,7,2,14,7,5,5,35,0,4,21,5,1,1,1037872,"2023-12-02T00:00:00.000Z",192,13,"James Harden",1,26,35,30,14,42.5
"18603",7084,2,1,6,4,2,5,2,4,2,19,0,0,8,6,0,0,1037872,"2023-12-02T00:00:00.000Z",472,13,"Russell Westbrook",1,14,16,10,8,21.2
"18604",7085,3,0,1,3,0,3,0,0,0,11,0,1,0,1,0,0,1037872,"2023-12-02T00:00:00.000Z",56677849,13,"Kobe Brown",0,1,4,3,4,5.7
"18605",7086,1,2,2,2,0,11,6,0,0,22,2,3,12,4,1,1,1037872,"2023-12-02T00:00:00.000Z",439,13,"Daniel Theis",3,16,17,13,5,26.3
"18606",7087,0,0,0,5,2,12,5,0,0,29,1,1,12,1,0,2,1037872,"2023-12-02T00:00:00.000Z",380,13,"Norman Powell",0,13,13,12,1,11.2
"18607",7088,0,0,0,0,0,0,0,0,0,0,0,0,0,0,0,0,1037872,"2023-12-02T00:00:00.000Z",666511,13,"Amir Coffey",0,0,0,0,0,0
"18608",7089,0,0,0,0,0,0,0,0,0,0,0,0,0,0,0,0,1037872,"2023-12-02T00:00:00.000Z",38017725,13,"Moussa Diabate",0,0,0,0,0,0
"18609",7090,0,0,0,0,0,0,0,0,0,0,0,0,0,0,0,0,1037872,"2023-12-02T00:00:00.000Z",17896031,13,"Nah'Shon Hyland",0,0,0,0,0,0
"18610",7091,0,0,0,0,0,0,0,0,0,0,0,0,0,0,0,0,1037872,"2023-12-02T00:00:00.000Z",24417679,13,"Xavier Moon",0,0,0,0,0,0
"18611",7092,0,0,0,0,0,0,0,0,0,0,0,0,0,0,0,0,1037872,"2023-12-02T00:00:00.000Z",450,13,"PJ Tucker",0,0,0,0,0,0
"18612",7093,1,0,2,6,3,7,3,0,0,32,1,4,9,3,1,1,1037873,"2023-12-02T00:00:00.000Z",68,18,"Troy Brown Jr.",1,12,13,10,4,16.1
"18613",7094,10,0,5,7,1,9,3,8,7,34,0,2,14,5,0,1,1037873,"2023-12-02T00:00:00.000Z",104,18,"Mike Conley",0,19,29,24,15,34
"18614",7095,4,0,4,0,0,6,2,7,7,26,2,3,11,6,2,2,1037873,"2023-12-02T00:00:00.000Z",12,18,"Kyle Anderson",2,17,21,15,10,28.2
"18615",7096,2,0,3,6,3,14,9,2,2,24,2,0,23,5,1,2,1037873,"2023-12-02T00:00:00.000Z",667378,18,"Naz Reid",1,28,30,25,7,33
"18616",7097,2,0,1,2,0,8,2,2,2,23,0,2,6,1,1,0,1037873,"2023-12-02T00:00:00.000Z",320,18,"Shake Milton",1,7,9,8,3,13.2
"18617",7098,0,0,0,0,0,0,0,0,0,0,0,0,0,0,0,0,1037873,"2023-12-02T00:00:00.000Z",17896056,18,"Luka Garza",0,0,0,0,0,0
"18618",7099,0,0,0,0,0,0,0,0,0,0,0,0,0,0,0,0,1037873,"2023-12-02T00:00:00.000Z",38017715,18,"Josh Minott",0,0,0,0,0,0
"18619",7100,3,3,4,6,3,20,12,18,15,35,1,3,42,5,1,3,1037874,"2023-12-02T00:00:00.000Z",61,3,"Mikal Bridges",4,47,50,45,8,61.5
"18620",7101,5,1,3,5,0,11,4,3,3,37,2,1,11,5,1,2,1037824,"2023-11-25T00:00:00.000Z",391,16,"Josh Richardson",2,16,21,16,10,28.5
"18621",7102,0,0,0,0,0,0,0,0,0,0,0,0,0,0,0,0,1037823,"2023-11-25T00:00:00.000Z",260,23,"Furkan Korkmaz",0,0,0,0,0,0
"18622",7103,0,0,0,0,0,0,0,0,0,0,0,0,0,0,0,0,1037823,"2023-11-25T00:00:00.000Z",3547294,23,"Kenyon Martin Jr.",0,0,0,0,0,0
"18623",7104,0,0,0,0,0,0,0,0,0,0,0,0,0,0,0,0,1037823,"2023-11-25T00:00:00.000Z",17896025,23,"Jaden Springer",0,0,0,0,0,0
"18624",7105,5,0,9,6,2,13,8,2,1,35,1,2,19,10,2,1,1037824,"2023-11-25T00:00:00.000Z",666679,3,"Cameron Johnson",2,29,34,24,15,43.5
"18625",7106,3,1,3,4,2,9,7,0,0,34,2,0,16,5,0,0,1037824,"2023-11-25T00:00:00.000Z",158,3,"Dorian Finney-Smith",1,21,24,19,8,29.5
"18626",7107,0,3,4,0,0,7,5,4,3,24,2,1,13,6,2,0,1037824,"2023-11-25T00:00:00.000Z",666508,3,"Nicolas Claxton",5,19,19,13,6,35.2
"18627",7108,3,1,5,6,3,19,8,5,5,33,1,2,24,6,2,3,1037824,"2023-11-25T00:00:00.000Z",61,3,"Mikal Bridges",3,30,33,27,9,41.7
"18628",7109,11,0,2,7,2,9,4,4,4,36,0,2,14,2,2,3,1037824,"2023-11-25T00:00:00.000Z",130,3,"Spencer Dinwiddie",2,16,27,25,13,35.9
"18629",7110,1,2,4,0,0,1,0,4,4,12,0,2,4,4,0,0,1037824,"2023-11-25T00:00:00.000Z",17896038,3,"Day'Ron Sharpe",2,8,9,5,5,16.3
"18630",7111,0,0,2,1,1,5,3,0,0,13,0,4,7,2,1,1,1037824,"2023-11-25T00:00:00.000Z",17896058,3,"Trendon Watford",1,9,9,7,2,11.4
"18631",7112,0,0,1,5,2,6,2,2,2,14,0,1,8,1,0,2,1037824,"2023-11-25T00:00:00.000Z",464,3,"Lonnie Walker IV",0,9,9,8,1,7.2
"18632",7113,4,1,1,5,2,6,2,0,0,29,1,4,6,2,2,1,1037824,"2023-11-25T00:00:00.000Z",351,3,"Royce O'Neale",3,8,12,10,6,22.4
"18633",7114,0,0,2,2,0,3,0,0,0,4,1,0,0,3,0,0,1037824,"2023-11-25T00:00:00.000Z",9051997,3,"Armoni Brooks",0,3,3,0,3,3.6
"18634",7115,0,1,0,0,0,0,0,2,1,3,0,0,1,0,0,0,1037824,"2023-11-25T00:00:00.000Z",56677841,3,"Dariq Whitehead",1,1,1,1,0,4
"18635",7116,0,0,1,0,0,0,0,0,0,3,0,0,0,1,0,0,1037824,"2023-11-25T00:00:00.000Z",56677843,3,"Noah Clowney",0,1,1,0,1,1.2
"18636",7117,0,0,0,0,0,0,0,0,0,0,0,0,0,0,0,0,1037824,"2023-11-25T00:00:00.000Z",174,3,"Harry Giles III",0,0,0,0,0,0
"18637",7118,0,0,0,0,0,0,0,0,0,0,0,0,0,0,0,0,1037824,"2023-11-25T00:00:00.000Z",17896041,3,"Keon Johnson",0,0,0,0,0,0
"18638",7119,2,0,5,4,1,8,3,2,2,17,1,2,9,6,0,3,1037825,"2023-11-25T00:00:00.000Z",3547242,30,"Deni Avdija",0,15,17,11,8,16.2
"18639",7120,8,0,5,5,2,10,4,2,2,25,2,1,12,7,0,5,1037825,"2023-11-25T00:00:00.000Z",265,30,"Kyle Kuzma",0,19,27,20,15,27.4
"18640",7121,0,2,3,0,0,8,6,0,0,18,1,2,12,4,0,0,1037825,"2023-11-25T00:00:00.000Z",666577,30,"Daniel Gafford",2,16,16,12,4,22.8
"18641",7122,2,0,1,10,1,14,3,3,3,28,0,2,10,1,0,0,1037825,"2023-11-25T00:00:00.000Z",17896045,30,"Corey Kispert",0,11,13,12,3,14.2
"18642",7123,0,0,0,0,0,0,0,0,0,0,0,0,0,0,0,0,1037824,"2023-11-25T00:00:00.000Z",3547257,16,"R.J. Hampton",0,0,0,0,0,0
"18643",7124,0,0,0,0,0,0,0,0,0,0,0,0,0,0,0,0,1037824,"2023-11-25T00:00:00.000Z",666633,16,"Tyler Herro",0,0,0,0,0,0
"18644",7125,0,0,0,0,0,0,0,0,0,0,0,0,0,0,0,0,1037824,"2023-11-25T00:00:00.000Z",397,16,"Duncan Robinson",0,0,0,0,0,0
"18645",7126,3,1,6,0,0,15,11,7,5,33,4,6,27,10,2,4,1037785,"2023-11-19T00:00:00.000Z",117,14,"Anthony Davis",3,37,40,30,13,48.5
"18646",7127,0,0,1,2,1,4,2,4,3,21,1,3,8,2,1,1,1037784,"2023-11-19T00:00:00.000Z",56677791,25,"Kris Murray",1,10,10,8,2,12.4
"18647",7128,0,1,0,4,2,6,2,2,1,13,2,0,7,2,0,0,1037784,"2023-11-19T00:00:00.000Z",47957121,25,"Justin Minaya",1,9,9,7,2,12.4
"18648",7129,5,0,1,2,0,4,1,0,0,16,1,0,2,2,0,2,1037784,"2023-11-19T00:00:00.000Z",44477062,25,"Jamaree Bouyea",0,4,9,7,7,9.9
"18649",7130,1,0,0,3,1,5,1,2,1,12,1,0,4,1,1,1,1037784,"2023-11-19T00:00:00.000Z",56677829,25,"Rayan Rupert",1,5,6,5,2,8.7
"18650",7131,0,0,0,0,0,1,1,0,0,7,1,0,2,1,1,0,1037784,"2023-11-19T00:00:00.000Z",666476,25,"Moses Brown",1,3,3,2,1,6.2
"18651",7132,0,0,0,0,0,0,0,0,0,0,0,0,0,0,0,0,1037784,"2023-11-19T00:00:00.000Z",65,25,"Malcolm Brogdon",0,0,0,0,0,0
"18652",7133,0,0,0,0,0,0,0,0,0,0,0,0,0,0,0,0,1037784,"2023-11-19T00:00:00.000Z",56677747,25,"Scoot Henderson",0,0,0,0,0,0
"18653",7134,0,0,0,0,0,0,0,0,0,0,0,0,0,0,0,0,1037784,"2023-11-19T00:00:00.000Z",419,25,"Anfernee Simons",0,0,0,0,0,0
"18654",7135,0,0,0,0,0,0,0,0,0,0,0,0,0,0,0,0,1037784,"2023-11-19T00:00:00.000Z",17896120,25,"Ish Wainright",0,0,0,0,0,0
"18655",7136,0,0,0,0,0,0,0,0,0,0,0,0,0,0,0,0,1037784,"2023-11-19T00:00:00.000Z",476,25,"Robert Williams III",0,0,0,0,0,0
"18656",7137,0,0,1,0,0,2,1,0,0,21,0,1,2,1,1,1,1037784,"2023-11-19T00:00:00.000Z",56677833,21,"Cason Wallace",1,3,3,2,1,5.2
"18657",7138,1,0,0,3,2,6,4,2,2,22,0,1,12,0,0,0,1037784,"2023-11-19T00:00:00.000Z",666541,21,"Luguentz Dort",0,12,13,13,1,13.5
"18658",7139,0,2,6,2,2,6,6,2,2,20,0,1,16,6,0,0,1037784,"2023-11-19T00:00:00.000Z",38017685,21,"Chet Holmgren",2,22,22,16,6,29.2
"18659",7140,5,0,4,0,0,6,3,0,0,23,0,1,6,4,1,4,1037784,"2023-11-19T00:00:00.000Z",17896065,21,"Josh Giddey",1,10,15,11,9,17.3
"18660",7141,4,0,3,1,1,13,10,7,7,22,0,2,28,3,1,3,1037784,"2023-11-19T00:00:00.000Z",175,21,"Shai Gilgeous-Alexander",1,31,35,32,7,37.6
"18661",7142,1,0,1,6,5,6,5,0,0,14,0,0,15,1,1,1,1037784,"2023-11-19T00:00:00.000Z",3547272,21,"Isaiah Joe",1,16,17,16,2,19.7
"18662",7143,2,1,2,5,1,5,1,0,0,11,0,0,3,2,0,0,1037784,"2023-11-19T00:00:00.000Z",44,21,"Davis Bertans",1,5,7,5,4,11.4
"18663",7144,2,0,3,3,1,7,3,0,0,24,2,1,7,5,0,3,1037784,"2023-11-19T00:00:00.000Z",17896036,21,"Tre Mann",0,12,14,9,7,13
"18664",7145,4,1,2,2,1,15,6,8,7,39,3,3,20,5,1,2,1037786,"2023-11-20T00:00:00.000Z",204,4,"Gordon Hayward",2,25,29,24,9,36
"18665",7146,5,0,15,7,2,13,3,6,6,45,0,1,14,15,1,1,1037786,"2023-11-20T00:00:00.000Z",62,4,"Miles Bridges",1,29,34,19,20,41.5
"18666",7147,2,3,8,0,0,14,8,2,2,33,8,4,18,16,1,1,1037786,"2023-11-20T00:00:00.000Z",38017698,4,"Mark Williams",4,34,36,20,18,51.2
"18667",7148,4,1,3,4,1,12,4,0,0,40,4,2,9,7,2,2,1037786,"2023-11-20T00:00:00.000Z",56677823,4,"Brandon Miller",3,16,20,13,11,30.4
"18668",7149,8,1,7,11,5,27,15,1,1,41,2,5,36,9,2,5,1037786,"2023-11-20T00:00:00.000Z",3547239,4,"LaMelo Ball",3,45,53,44,17,62.8
"18669",7150,2,0,2,6,1,6,1,0,0,14,0,1,3,2,0,1,1037786,"2023-11-20T00:00:00.000Z",38017708,4,"Bryce McGowens",0,5,7,5,4,7.4
"18670",7151,1,1,2,0,0,5,3,2,2,16,1,0,8,3,1,1,3277448,"2023-11-17T00:00:00.000Z",24,9,"Marvin Bagley III",2,11,12,9,4,18.1
"18671",7152,0,0,0,0,0,0,0,0,0,0,0,0,0,0,0,0,3277448,"2023-11-17T00:00:00.000Z",404,6,"Ricky Rubio",0,0,0,0,0,0
"18672",7153,2,0,5,1,0,8,4,3,1,17,5,4,9,10,0,5,3277448,"2023-11-17T00:00:00.000Z",56677826,9,"Ausar Thompson",0,19,21,11,12,19
"18673",7154,0,1,7,4,1,10,5,0,0,31,4,3,11,11,1,0,3277448,"2023-11-17T00:00:00.000Z",259,9,"Kevin Knox",2,22,22,11,11,30.2
"18674",7155,2,3,6,4,1,11,4,2,2,31,4,0,11,10,1,1,3277448,"2023-11-17T00:00:00.000Z",3547267,9,"Isaiah Stewart",4,21,23,13,12,37
"18675",7156,8,0,4,7,2,21,9,0,0,34,1,4,20,5,0,4,3277448,"2023-11-17T00:00:00.000Z",17896075,9,"Cade Cunningham",0,25,33,28,13,34
"18676",7157,2,1,0,2,0,6,2,0,0,22,0,0,4,0,1,0,3277448,"2023-11-17T00:00:00.000Z",3547241,9,"Killian Hayes",2,4,6,6,2,13
"18677",7158,1,0,1,9,2,14,4,0,0,24,2,3,10,3,1,0,3277448,"2023-11-17T00:00:00.000Z",77,9,"Alec Burks",1,13,14,11,4,18.1
"18678",7159,0,0,0,0,0,0,0,0,0,4,0,1,0,0,0,0,3277450,"2023-11-17T00:00:00.000Z",38017693,27,"Blake Wesley",0,0,0,0,0,0
"18679",7160,0,0,0,0,0,0,0,0,0,0,0,0,0,0,0,0,3277450,"2023-11-17T00:00:00.000Z",38017730,27,"Dominick Barlow",0,0,0,0,0,0
"18680",7161,0,0,0,0,0,0,0,0,0,0,0,0,0,0,0,0,3277450,"2023-11-17T00:00:00.000Z",3547274,27,"Tre Jones",0,0,0,0,0,0
"18681",7162,0,0,0,0,0,0,0,0,0,0,0,0,0,0,0,0,3277450,"2023-11-17T00:00:00.000Z",3547246,27,"Devin Vassell",0,0,0,0,0,0
"18682",7163,1,0,2,6,1,7,2,3,2,26,0,2,7,2,1,1,3277450,"2023-11-17T00:00:00.000Z",30,26,"Harrison Barnes",1,9,10,8,3,12.9
"18683",7164,3,0,5,4,0,10,3,0,0,38,1,2,6,6,1,2,3277450,"2023-11-17T00:00:00.000Z",38017688,26,"Keegan Murray",1,12,15,9,9,18.7
"18684",7165,7,1,12,3,2,13,9,8,7,35,2,5,27,14,1,4,3277450,"2023-11-17T00:00:00.000Z",406,26,"Domantas Sabonis",2,41,48,34,21,56.3
"18685",7166,2,1,0,4,1,9,4,0,0,25,0,2,9,0,3,0,3277450,"2023-11-17T00:00:00.000Z",221,26,"Kevin Huerter",4,9,11,11,2,24
"18686",7167,7,0,8,11,5,24,14,13,10,41,0,2,43,8,1,1,3277450,"2023-11-17T00:00:00.000Z",161,26,"De'Aaron Fox",1,51,58,50,15,65.1
"18687",7168,8,0,3,9,6,11,7,0,0,25,1,3,20,4,1,1,3277450,"2023-11-17T00:00:00.000Z",324,26,"Malik Monk",1,24,32,28,12,38.8
"18688",7169,1,0,1,4,0,5,0,0,0,10,0,0,0,1,0,2,3277449,"2023-11-17T00:00:00.000Z",56677828,28,"Gradey Dick",0,1,2,1,2,0.7
"18689",7170,0,0,0,0,0,0,0,0,0,0,0,0,0,0,0,0,3277449,"2023-11-17T00:00:00.000Z",17553967,2,"Neemias Queta",0,0,0,0,0,0
"18690",7171,0,0,0,0,0,0,0,0,0,0,0,0,0,0,0,0,3277449,"2023-11-17T00:00:00.000Z",3547279,2,"Lamar Stevens",0,0,0,0,0,0
"18691",7172,0,0,0,0,0,0,0,0,0,0,0,0,0,0,0,0,3277449,"2023-11-17T00:00:00.000Z",38017707,2,"JD Davison",0,0,0,0,0,0
"18692",7173,0,0,0,0,0,0,0,0,0,0,0,0,0,0,0,0,3277449,"2023-11-17T00:00:00.000Z",3547295,2,"Nathan Knight",0,0,0,0,0,0
"18693",7174,3,0,7,5,3,19,11,1,0,30,2,1,25,9,0,0,3277452,"2023-11-17T00:00:00.000Z",38017709,8,"Christian Braun",0,34,37,28,12,40.3
"18694",7175,0,0,0,1,0,5,2,0,0,7,0,0,4,0,0,0,3277449,"2023-11-17T00:00:00.000Z",666762,28,"Jalen McDaniels",0,4,4,4,0,4
"18695",7176,4,2,12,0,0,12,9,8,8,39,4,2,26,16,2,3,1037723,"2023-11-11T00:00:00.000Z",4,16,"Bam Adebayo",4,42,46,30,20,60.2
"18696",7177,2,0,3,10,1,15,5,0,0,30,0,3,11,3,1,1,1037723,"2023-11-11T00:00:00.000Z",397,16,"Duncan Robinson",1,14,16,13,5,19.6
"18697",7178,4,0,3,6,4,8,4,5,5,33,0,1,17,3,1,3,1037723,"2023-11-11T00:00:00.000Z",286,16,"Kyle Lowry",1,20,24,21,7,26.6
"18698",7179,0,0,2,4,3,7,6,1,1,23,0,0,16,2,0,1,1037723,"2023-11-11T00:00:00.000Z",391,16,"Josh Richardson",0,18,18,16,2,17.4
"18699",7180,2,0,4,3,1,4,2,2,2,14,0,0,7,4,0,1,1037723,"2023-11-11T00:00:00.000Z",285,16,"Kevin Love",0,11,13,9,6,13.8
"18700",7181,2,1,1,3,1,8,4,0,0,28,1,3,9,2,3,2,1037723,"2023-11-11T00:00:00.000Z",19465585,16,"Dru Smith",4,11,13,11,4,24.4
"18701",7182,0,0,0,0,0,0,0,0,0,1,0,0,0,0,0,0,1037723,"2023-11-11T00:00:00.000Z",38017734,16,"Jamal Cain",0,0,0,0,0,0
"18702",7183,0,0,3,2,1,2,1,0,0,14,0,1,3,3,1,0,1037722,"2023-11-11T00:00:00.000Z",376,28,"Otto Porter Jr.",1,6,6,3,3,9.6
"18703",7184,1,0,1,4,2,7,5,1,0,23,0,0,12,1,0,1,1037722,"2023-11-11T00:00:00.000Z",3547275,28,"Malachi Flynn",0,13,14,13,2,13.7
"18704",7185,1,0,5,3,2,4,2,0,0,22,0,2,6,5,0,0,1037722,"2023-11-11T00:00:00.000Z",58,28,"Chris Boucher",0,11,12,7,6,13.5
"18705",7186,1,0,1,2,0,4,1,2,2,15,0,1,4,1,0,1,1037722,"2023-11-11T00:00:00.000Z",56677828,28,"Gradey Dick",0,5,6,5,2,5.7
"18706",7187,0,0,1,0,0,2,0,0,0,9,0,2,0,1,0,0,1037722,"2023-11-11T00:00:00.000Z",666762,28,"Jalen McDaniels",0,1,1,0,1,1.2
"18707",7188,0,0,1,0,0,2,1,0,0,4,0,0,2,1,1,0,1037722,"2023-11-11T00:00:00.000Z",436,28,"Garrett Temple",1,3,3,2,1,6.2
"18708",7189,2,0,0,0,0,3,2,0,0,4,1,0,4,1,0,0,1037722,"2023-11-11T00:00:00.000Z",489,28,"Thaddeus Young",0,5,7,6,3,8.2
"18709",7190,0,0,0,0,0,0,0,0,0,0,0,0,0,0,0,0,1037722,"2023-11-11T00:00:00.000Z",56677805,28,"Javon Freeman-Liberty",0,0,0,0,0,0
"18710",7191,0,0,0,0,0,0,0,0,0,0,0,0,0,0,0,0,1037722,"2023-11-11T00:00:00.000Z",38017717,28,"Ron Harper Jr.",0,0,0,0,0,0
"18711",7192,0,0,0,0,0,0,0,0,0,0,0,0,0,0,0,0,1037722,"2023-11-11T00:00:00.000Z",38017710,28,"Christian Koloko",0,0,0,0,0,0
"18712",7193,0,0,0,0,0,0,0,0,0,0,0,0,0,0,0,0,1037722,"2023-11-11T00:00:00.000Z",56677869,28,"Markquis Nowell",0,0,0,0,0,0
"18713",7194,0,0,0,0,0,0,0,0,0,0,0,0,0,0,0,0,1037722,"2023-11-11T00:00:00.000Z",3089,28,"Gary Trent Jr.",0,0,0,0,0,0
"18714",7195,2,1,4,6,4,16,9,3,2,31,0,1,24,4,1,1,1037725,"2023-11-12T00:00:00.000Z",666423,20,"RJ Barrett",2,28,30,26,6,36.8
"18715",7196,5,0,4,4,1,16,8,8,6,27,1,1,23,5,3,3,1037725,"2023-11-12T00:00:00.000Z",387,20,"Julius Randle",3,28,33,28,10,42.5
"18716",7197,0,0,4,0,0,7,5,2,0,24,5,2,10,9,1,0,1037725,"2023-11-12T00:00:00.000Z",399,20,"Mitchell Robinson",1,19,19,10,9,23.8
"18717",7198,1,0,1,4,2,12,7,4,4,27,0,2,20,1,1,1,1037725,"2023-11-12T00:00:00.000Z",73,20,"Jalen Brunson",1,21,22,21,2,24.7
"18718",7199,1,0,1,5,2,5,2,0,0,23,0,1,6,1,1,0,1037725,"2023-11-12T00:00:00.000Z",17895858,20,"Quentin Grimes",1,7,8,7,2,11.7
"18719",7200,2,0,3,2,0,6,3,0,0,27,1,1,6,4,0,0,1037725,"2023-11-12T00:00:00.000Z",202,20,"Josh Hart",0,10,12,8,6,13.8
"18720",7201,0,0,0,0,0,0,0,0,0,0,0,0,0,0,0,0,1037687,"2023-11-06T00:00:00.000Z",56913527,23,"Ricky Council IV",0,0,0,0,0,0
"18721",7202,0,0,0,0,0,0,0,0,0,0,0,0,0,0,0,0,1037687,"2023-11-06T00:00:00.000Z",17554001,23,"Javonte Smart",0,0,0,0,0,0
"18722",7203,0,0,0,0,0,0,0,0,0,0,0,0,0,0,0,0,1037687,"2023-11-06T00:00:00.000Z",56677788,23,"Terquavion Smith",0,0,0,0,0,0
"18723",7204,6,0,4,4,2,8,5,4,4,28,1,1,16,5,1,1,1037687,"2023-11-06T00:00:00.000Z",3547242,30,"Deni Avdija",1,21,27,22,11,33
"18724",7205,4,1,4,5,4,20,12,1,0,30,2,2,28,6,0,2,1037687,"2023-11-06T00:00:00.000Z",265,30,"Kyle Kuzma",1,34,38,32,10,42.2
"18725",7206,3,5,4,0,0,7,6,0,0,30,3,5,12,7,0,4,1037687,"2023-11-06T00:00:00.000Z",666577,30,"Daniel Gafford",5,19,22,15,10,35.9
"18726",7207,6,1,1,9,4,15,8,3,3,31,0,4,23,1,0,2,1037687,"2023-11-06T00:00:00.000Z",666848,30,"Jordan Poole",1,24,30,29,7,34.2
"18727",7208,1,0,1,0,0,8,2,0,0,14,2,0,4,3,0,0,1037687,"2023-11-06T00:00:00.000Z",38017687,30,"Johnny Davis",0,7,8,5,4,9.1
"18728",7209,2,0,2,2,0,8,4,2,2,22,1,2,10,3,1,1,1037685,"2023-11-06T00:00:00.000Z",38017686,12,"Bennedict Mathurin",1,13,15,12,5,18.6
"18729",7210,2,0,3,4,1,10,6,3,3,38,4,2,16,7,4,1,1037684,"2023-11-06T00:00:00.000Z",56677826,9,"Ausar Thompson",4,23,25,18,9,38.4
"18730",7211,4,1,9,5,3,9,5,4,4,39,2,3,17,11,0,3,1037684,"2023-11-06T00:00:00.000Z",3547267,9,"Isaiah Stewart",1,28,32,21,15,36.2
"18731",7212,1,0,2,0,0,8,4,2,2,24,0,1,10,2,0,1,1037684,"2023-11-06T00:00:00.000Z",24,9,"Marvin Bagley III",0,12,13,11,3,12.9
"18732",7213,5,0,4,6,1,18,7,7,6,40,0,2,21,4,2,5,1037684,"2023-11-06T00:00:00.000Z",17896075,9,"Cade Cunningham",2,25,30,26,9,34.3
"18733",7214,7,1,4,4,3,12,8,2,2,34,0,3,21,4,1,0,1037684,"2023-11-06T00:00:00.000Z",3547241,9,"Killian Hayes",2,25,32,28,11,42.3
"18734",7215,0,0,0,0,0,0,0,0,0,0,0,0,0,0,0,0,1037684,"2023-11-06T00:00:00.000Z",56677729,9,"Malcolm Cazalon",0,0,0,0,0,0
"18735",7216,0,0,0,0,0,0,0,0,0,0,0,0,0,0,0,0,1037684,"2023-11-06T00:00:00.000Z",38017694,9,"Jalen Duren",0,0,0,0,0,0
"18736",7217,0,0,0,0,0,0,0,0,0,0,0,0,0,0,0,0,1037684,"2023-11-06T00:00:00.000Z",197,9,"Joe Harris",0,0,0,0,0,0
"18737",7218,1,0,2,3,1,11,6,6,6,27,0,3,19,2,2,1,1037685,"2023-11-06T00:00:00.000Z",3547243,12,"Obi Toppin",2,21,22,20,3,27.9
"18738",7219,2,1,7,1,1,7,5,4,4,21,4,3,15,11,0,0,1037685,"2023-11-06T00:00:00.000Z",452,12,"Myles Turner",1,26,28,17,13,34.2
"18739",7220,4,0,5,3,1,7,3,0,0,24,0,1,7,5,0,0,1037685,"2023-11-06T00:00:00.000Z",69,12,"Bruce Brown",0,12,16,11,9,19
"18740",7221,8,1,2,7,3,19,9,2,2,27,0,1,23,2,1,2,1037685,"2023-11-06T00:00:00.000Z",3547245,12,"Tyrese Haliburton",2,25,33,31,10,41.4
"18741",7222,2,0,2,6,5,8,7,0,0,21,0,1,19,2,1,4,1037685,"2023-11-06T00:00:00.000Z",210,12,"Buddy Hield",1,21,23,21,4,23.4
"18742",7223,2,0,1,4,3,8,5,2,2,16,1,0,15,2,2,0,1037685,"2023-11-06T00:00:00.000Z",3547250,12,"Aaron Nesmith",2,17,19,17,4,26.4
"18743",7224,2,0,6,1,1,4,4,0,0,12,1,3,9,7,0,1,1037685,"2023-11-06T00:00:00.000Z",3547264,12,"Jalen Smith",0,16,18,11,9,19.4
"18744",7225,8,0,2,5,3,7,3,0,0,16,0,3,9,2,0,2,1037685,"2023-11-06T00:00:00.000Z",38017507,12,"Andrew Nembhard",0,11,19,17,10,21.4
"18745",7226,0,0,0,0,0,0,0,0,0,0,0,0,0,0,0,0,1037641,"2023-10-30T00:00:00.000Z",17896078,21,"Aaron Wiggins",0,0,0,0,0,0
"18746",7227,0,0,0,0,0,0,0,0,0,0,0,0,0,0,0,0,1037641,"2023-10-30T00:00:00.000Z",56677853,21,"Keyontae Johnson",0,0,0,0,0,0
"18747",7228,0,0,0,0,0,0,0,0,0,0,0,0,0,0,0,0,1037641,"2023-10-30T00:00:00.000Z",27924547,21,"Lindy Waters III",0,0,0,0,0,0
"18748",7229,0,0,1,0,0,0,0,0,0,2,0,0,0,1,0,0,1037641,"2023-10-30T00:00:00.000Z",42097199,9,"Jared Rhoden",0,1,1,0,1,1.2
"18749",7230,0,0,0,0,0,0,0,0,0,2,0,0,0,0,1,0,1037641,"2023-10-30T00:00:00.000Z",44477024,9,"Stanley Umude",1,0,0,0,0,3
"18750",7231,0,0,0,0,0,0,0,0,0,0,0,0,0,0,0,0,1037641,"2023-10-30T00:00:00.000Z",56677729,9,"Malcolm Cazalon",0,0,0,0,0,0
"18751",7232,0,0,0,0,0,0,0,0,0,0,0,0,0,0,0,0,1037641,"2023-10-30T00:00:00.000Z",3547240,9,"James Wiseman",0,0,0,0,0,0
"18752",7233,0,0,0,0,0,0,0,0,0,0,0,0,0,0,0,0,1037641,"2023-10-30T00:00:00.000Z",54,9,"Bojan Bogdanovic",0,0,0,0,0,0
"18753",7234,0,0,0,0,0,0,0,0,0,0,0,0,0,0,0,0,1037641,"2023-10-30T00:00:00.000Z",17896071,9,"Isaiah Livers",0,0,0,0,0,0
"18754",7235,0,0,0,0,0,0,0,0,0,0,0,0,0,0,0,0,1037641,"2023-10-30T00:00:00.000Z",330,9,"Monte Morris",0,0,0,0,0,0
"18755",7236,2,0,0,4,1,6,1,0,0,20,1,0,3,1,1,0,1037642,"2023-10-30T00:00:00.000Z",56677834,29,"Keyonte George",1,4,6,5,3,10.2
"18756",7237,2,0,1,2,0,5,0,0,0,15,1,0,0,2,0,0,1037642,"2023-10-30T00:00:00.000Z",38017620,29,"Ochai Agbaji",0,2,4,2,4,5.4
"18757",7238,1,0,2,1,0,2,0,0,0,6,0,1,0,2,0,0,1037642,"2023-10-30T00:00:00.000Z",139,29,"Kris Dunn",0,2,3,1,3,3.9
"18758",7239,0,0,0,0,0,0,0,0,0,0,0,0,0,0,0,0,1037642,"2023-10-30T00:00:00.000Z",38017739,29,"Simone Fontecchio",0,0,0,0,0,0
"18759",7240,0,0,0,0,0,0,0,0,0,0,0,0,0,0,0,0,1037642,"2023-10-30T00:00:00.000Z",666881,29,"Luka Samanic",0,0,0,0,0,0
"18760",7241,0,0,0,0,0,0,0,0,0,0,0,0,0,0,0,0,1037642,"2023-10-30T00:00:00.000Z",11891374,29,"Omer Yurtseven",0,0,0,0,0,0
"18761",7242,0,0,0,0,0,0,0,0,0,0,0,0,0,0,0,0,1037642,"2023-10-30T00:00:00.000Z",17896023,29,"Josh Christopher",0,0,0,0,0,0
"18762",7243,0,0,0,0,0,0,0,0,0,0,0,0,0,0,0,0,1037642,"2023-10-30T00:00:00.000Z",56677824,29,"Taylor Hendricks",0,0,0,0,0,0
"18763",7244,0,0,0,0,0,0,0,0,0,0,0,0,0,0,0,0,1037642,"2023-10-30T00:00:00.000Z",38017630,29,"Johnny Juzang",0,0,0,0,0,0
"18764",7245,0,0,0,0,0,0,0,0,0,0,0,0,0,0,0,0,1037642,"2023-10-30T00:00:00.000Z",19465584,29,"Micah Potter",0,0,0,0,0,0
"18765",7246,1,1,0,2,0,4,1,2,2,26,0,3,4,0,0,0,1037643,"2023-10-30T00:00:00.000Z",383,14,"Taurean Prince",1,4,5,5,1,8.5
"18766",7247,4,1,3,6,2,17,7,4,3,33,0,0,19,3,3,5,1037643,"2023-10-30T00:00:00.000Z",237,14,"LeBron James",4,22,26,23,7,35.6
"18767",7248,5,3,17,1,0,18,12,3,2,38,2,3,26,19,1,1,1037643,"2023-10-30T00:00:00.000Z",117,14,"Anthony Davis",4,45,50,31,24,67.3
"18768",7249,3,1,3,4,1,12,5,0,0,31,0,0,11,3,0,3,1037643,"2023-10-30T00:00:00.000Z",17553995,14,"Austin Reaves",1,14,17,14,6,19.1
"18769",7250,8,1,2,6,3,14,10,5,5,36,0,4,28,2,1,3,1037643,"2023-10-30T00:00:00.000Z",405,14,"D'Angelo Russell",2,30,38,36,10,45.4
"18770",7251,0,0,0,0,0,0,0,0,0,0,0,0,0,0,0,0,1037624,"2023-10-28T00:00:00.000Z",192,23,"James Harden",0,0,0,0,0,0
"18771",7252,2,1,2,4,1,10,3,0,0,19,1,3,7,3,0,1,1037623,"2023-10-28T00:00:00.000Z",344,6,"Georges Niang",1,10,12,9,5,15.6
"18772",7253,1,0,0,0,0,0,0,0,0,4,0,0,0,0,0,0,1037623,"2023-10-28T00:00:00.000Z",56677872,6,"Craig Porter",0,0,1,1,1,1.5
"18773",7254,2,0,1,0,0,3,2,0,0,8,4,0,4,5,0,0,1037623,"2023-10-28T00:00:00.000Z",444,6,"Tristan Thompson",0,9,11,6,7,13
"18774",7255,0,0,0,0,0,0,0,0,0,0,0,0,0,0,0,0,1037623,"2023-10-28T00:00:00.000Z",9,6,"Jarrett Allen",0,0,0,0,0,0
"18775",7256,0,0,0,0,0,0,0,0,0,0,0,0,0,0,0,0,1037623,"2023-10-28T00:00:00.000Z",666581,6,"Darius Garland",0,0,0,0,0,0
"18776",7257,0,0,0,0,0,0,0,0,0,0,0,0,0,0,0,0,1037623,"2023-10-28T00:00:00.000Z",666676,6,"Ty Jerome",0,0,0,0,0,0
"18777",7258,0,0,0,0,0,0,0,0,0,0,0,0,0,0,0,0,1037623,"2023-10-28T00:00:00.000Z",322,6,"Donovan Mitchell",0,0,0,0,0,0
"18778",7259,0,0,0,0,0,0,0,0,0,0,0,0,0,0,0,0,1037623,"2023-10-28T00:00:00.000Z",404,6,"Ricky Rubio",0,0,0,0,0,0
"18779",7260,1,0,0,3,1,10,5,3,2,17,0,0,13,0,0,0,1037623,"2023-10-28T00:00:00.000Z",38017686,12,"Bennedict Mathurin",0,13,14,14,1,14.5
"18780",7261,0,1,2,1,0,5,2,0,0,18,2,1,4,4,0,1,1037623,"2023-10-28T00:00:00.000Z",3547243,12,"Obi Toppin",1,8,8,4,4,10.8
"18781",7262,1,2,11,5,1,14,7,5,5,29,1,5,20,12,0,2,1037623,"2023-10-28T00:00:00.000Z",452,12,"Myles Turner",2,32,33,21,13,39.9
"18782",7263,2,0,4,1,0,8,3,0,0,32,0,3,6,4,1,0,1037623,"2023-10-28T00:00:00.000Z",69,12,"Bruce Brown",1,10,12,8,6,16.8
"18783",7264,13,0,7,7,4,16,7,3,3,32,1,2,21,8,0,1,1037623,"2023-10-28T00:00:00.000Z",3547245,12,"Tyrese Haliburton",0,29,42,34,21,49.1
"18784",7265,4,0,2,2,0,5,2,0,0,25,0,4,4,2,2,1,1037623,"2023-10-28T00:00:00.000Z",38017507,12,"Andrew Nembhard",2,6,10,8,6,17.4
"18785",7266,1,0,0,1,1,1,1,0,0,3,0,1,3,0,0,0,1037622,"2023-10-28T00:00:00.000Z",666971,20,"Dylan Windler",0,3,4,4,1,4.5
"18786",7267,0,0,0,0,0,0,0,0,0,0,0,0,0,0,0,0,1037622,"2023-10-28T00:00:00.000Z",19,20,"Ryan Arcidiacono",0,0,0,0,0,0
"18787",7268,0,0,0,0,0,0,0,0,0,0,0,0,0,0,0,0,1037622,"2023-10-28T00:00:00.000Z",160,20,"Evan Fournier",0,0,0,0,0,0
"18788",7269,0,0,0,0,0,0,0,0,0,0,0,0,0,0,0,0,1037622,"2023-10-28T00:00:00.000Z",666474,20,"Charles Brown",0,0,0,0,0,0
"18789",7270,0,0,0,0,0,0,0,0,0,0,0,0,0,0,0,0,1037622,"2023-10-28T00:00:00.000Z",56677795,20,"Jacob Toppin",0,0,0,0,0,0
"18790",7271,0,0,0,0,0,0,0,0,0,0,0,0,0,0,0,0,1037622,"2023-10-28T00:00:00.000Z",17896089,20,"Duane Washington Jr.",0,0,0,0,0,0
"18791",7272,2,0,0,2,2,4,2,1,1,13,0,1,7,0,1,3,1037624,"2023-10-28T00:00:00.000Z",3547275,28,"Malachi Flynn",1,7,9,9,2,10
"18792",7273,0,0,0,0,0,0,0,0,0,0,0,0,0,0,0,0,1037622,"2023-10-28T00:00:00.000Z",18677986,19,"Trey Murphy III",0,0,0,0,0,0
"18793",7274,0,0,0,0,0,0,0,0,0,0,0,0,0,0,0,0,1037622,"2023-10-28T00:00:00.000Z",38017726,19,"Dereon Seabron",0,0,0,0,0,0
"18794",7275,2,1,3,6,1,16,7,4,3,30,0,0,18,3,1,3,1037622,"2023-10-28T00:00:00.000Z",666423,20,"RJ Barrett",2,21,23,20,5,27.6
"18795",7276,0,0,0,0,0,0,0,0,0,0,0,0,0,0,0,0,1038126,"2024-01-12T00:00:00.000Z",19465326,11,"Jock Landale",0,0,0,0,0,0
"18796",7277,0,0,0,0,0,0,0,0,0,0,0,0,0,0,0,0,1038125,"2024-01-12T00:00:00.000Z",56677832,12,"Jarace Walker",0,0,0,0,0,0
"18797",7278,0,0,0,0,0,0,0,0,0,0,0,0,0,0,0,0,1038125,"2024-01-12T00:00:00.000Z",56677794,12,"Isaiah Wong",0,0,0,0,0,0
"18798",7279,1,1,5,0,0,2,2,2,1,12,0,0,5,5,0,0,1038128,"2024-01-12T00:00:00.000Z",137,5,"Andre Drummond",1,10,11,6,6,15.5
"18799",7280,0,0,0,0,0,0,0,0,0,0,0,0,0,0,0,0,1038128,"2024-01-12T00:00:00.000Z",87,5,"Jevon Carter",0,0,0,0,0,0
"18800",7281,0,0,0,0,0,0,0,0,0,0,0,0,0,0,0,0,1038128,"2024-01-12T00:00:00.000Z",110,5,"Torrey Craig",0,0,0,0,0,0
"18801",7282,3,0,2,3,1,8,4,0,0,24,0,1,9,2,2,4,1038130,"2024-01-12T00:00:00.000Z",3547259,18,"Jaden McDaniels",2,11,14,12,5,17.9
"18802",7283,1,0,7,3,3,8,7,7,6,28,1,2,23,8,2,0,1038130,"2024-01-12T00:00:00.000Z",447,18,"Karl-Anthony Towns",2,31,32,24,9,40.1
"18803",7284,0,2,12,0,0,11,9,8,6,29,5,2,24,17,0,1,1038130,"2024-01-12T00:00:00.000Z",176,18,"Rudy Gobert",2,41,41,24,17,49.4
"18804",7285,6,1,3,3,0,9,4,2,1,27,0,2,9,3,1,0,1038130,"2024-01-12T00:00:00.000Z",3547238,18,"Anthony Edwards",2,12,18,15,9,27.6
"18805",7286,10,0,4,5,3,7,3,0,0,20,0,1,9,4,0,0,1038130,"2024-01-12T00:00:00.000Z",104,18,"Mike Conley",0,13,23,19,14,28.8
"18806",7287,1,0,2,0,0,2,1,0,0,15,0,2,2,2,0,2,1038130,"2024-01-12T00:00:00.000Z",12,18,"Kyle Anderson",0,4,5,3,3,3.9
"18807",7288,3,0,2,2,0,3,1,0,0,19,0,1,2,2,2,2,1038130,"2024-01-12T00:00:00.000Z",666400,18,"Nickeil Alexander-Walker",2,4,7,5,5,12.9
"18808",7289,5,0,0,2,0,3,1,0,0,13,0,2,2,0,1,2,1038130,"2024-01-12T00:00:00.000Z",666767,18,"Jordan McLaughlin",1,2,7,7,5,10.5
"18809",7290,2,0,0,0,0,5,3,0,0,10,0,1,6,0,0,0,1038130,"2024-01-12T00:00:00.000Z",320,18,"Shake Milton",0,6,8,8,2,9
"18810",7291,0,1,0,0,0,3,0,2,2,9,0,2,2,0,1,0,1038130,"2024-01-12T00:00:00.000Z",38017715,18,"Josh Minott",2,2,2,2,0,8
"18811",7292,3,0,1,5,2,5,2,0,0,9,1,1,6,2,0,3,1038130,"2024-01-12T00:00:00.000Z",68,18,"Troy Brown Jr.",0,8,11,9,5,9.9
"18812",7293,0,0,0,0,0,2,2,0,0,8,0,2,4,0,2,0,1038130,"2024-01-12T00:00:00.000Z",38017700,18,"Wendell Moore Jr.",2,4,4,4,0,10
"18813",7294,0,1,2,2,0,4,2,0,0,8,0,2,4,2,1,1,1038130,"2024-01-12T00:00:00.000Z",56677782,18,"Leonard Miller",2,6,6,4,2,11.4
"18814",7295,0,0,0,0,0,0,0,0,0,0,0,0,0,0,0,0,1038130,"2024-01-12T00:00:00.000Z",17895968,18,"Daishen Nix",0,0,0,0,0,0
"18815",7296,5,0,5,5,2,21,15,8,7,41,1,5,39,6,0,1,1038128,"2024-01-12T00:00:00.000Z",125,5,"DeMar DeRozan",0,45,50,44,11,52.7
"18816",7297,2,1,1,6,2,6,2,0,0,29,1,0,6,2,0,0,1038128,"2024-01-12T00:00:00.000Z",89,5,"Alex Caruso",1,8,10,8,4,14.4
"18817",7298,2,0,5,5,2,12,6,0,0,33,2,1,14,7,0,3,1038128,"2024-01-12T00:00:00.000Z",460,5,"Nikola Vucevic",0,21,23,16,9,22.4
"18818",7299,7,1,8,8,4,15,9,3,3,35,0,3,25,8,0,1,1038128,"2024-01-12T00:00:00.000Z",268,5,"Zach LaVine",1,33,40,32,15,47.1
"18819",7300,7,0,4,7,5,13,9,3,2,37,0,4,25,4,0,1,1038128,"2024-01-12T00:00:00.000Z",666956,5,"Coby White",0,29,36,32,11,39.3
"18820",7301,1,0,0,2,1,3,2,0,0,8,1,0,5,1,0,0,1038080,"2024-01-05T00:00:00.000Z",666885,22,"Admiral Schofield",0,6,7,6,2,7.7
"18821",7302,0,0,0,0,0,0,0,0,0,0,0,0,0,0,0,0,1038080,"2024-01-05T00:00:00.000Z",666442,22,"Goga Bitadze",0,0,0,0,0,0
"18822",7303,0,0,0,0,0,0,0,0,0,0,0,0,0,0,0,0,1038080,"2024-01-05T00:00:00.000Z",85,22,"Wendell Carter Jr.",0,0,0,0,0,0
"18823",7304,0,0,0,0,0,0,0,0,0,0,0,0,0,0,0,0,1038080,"2024-01-05T00:00:00.000Z",165,22,"Markelle Fultz",0,0,0,0,0,0
"18824",7305,0,0,0,0,0,0,0,0,0,0,0,0,0,0,0,0,1038080,"2024-01-05T00:00:00.000Z",196,22,"Gary Harris",0,0,0,0,0,0
"18825",7306,0,0,0,0,0,0,0,0,0,0,0,0,0,0,0,0,1038080,"2024-01-05T00:00:00.000Z",38017607,22,"Kevon Harris",0,0,0,0,0,0
"18826",7307,9,1,3,0,0,11,6,7,6,37,1,3,18,4,2,2,1038084,"2024-01-05T00:00:00.000Z",416,28,"Pascal Siakam",3,22,31,27,13,43.3
"18827",7308,2,3,5,0,0,10,7,0,0,23,1,6,14,6,0,3,1038084,"2024-01-05T00:00:00.000Z",373,28,"Jakob Poeltl",3,20,22,16,8,30.2
"18828",7309,0,0,1,1,1,5,2,0,0,22,0,2,5,1,1,2,1038062,"2024-01-03T00:00:00.000Z",3089,28,"Gary Trent Jr.",1,6,6,5,1,7.2
"18829",7310,5,0,7,3,1,11,6,4,3,29,0,0,16,7,0,0,1038062,"2024-01-03T00:00:00.000Z",409,28,"Dennis Schroder",0,23,28,21,12,31.9
"18830",7311,0,0,3,2,0,2,0,0,0,7,0,2,0,3,0,0,1038062,"2024-01-03T00:00:00.000Z",2309958,28,"Jontay Porter",0,3,3,0,3,3.6
"18831",7312,0,0,0,0,0,0,0,0,0,0,0,0,0,0,0,0,1038062,"2024-01-03T00:00:00.000Z",666762,28,"Jalen McDaniels",0,0,0,0,0,0
"18832",7313,0,0,0,0,0,0,0,0,0,0,0,0,0,0,0,0,1038062,"2024-01-03T00:00:00.000Z",436,28,"Garrett Temple",0,0,0,0,0,0
"18833",7314,0,0,0,0,0,0,0,0,0,0,0,0,0,0,0,0,1038062,"2024-01-03T00:00:00.000Z",489,28,"Thaddeus Young",0,0,0,0,0,0
"18834",7315,0,0,0,0,0,0,0,0,0,0,0,0,0,0,0,0,1038062,"2024-01-03T00:00:00.000Z",56677828,28,"Gradey Dick",0,0,0,0,0,0
"18835",7316,0,0,0,0,0,0,0,0,0,0,0,0,0,0,0,0,1038062,"2024-01-03T00:00:00.000Z",56677805,28,"Javon Freeman-Liberty",0,0,0,0,0,0
"18836",7317,0,0,0,0,0,0,0,0,0,0,0,0,0,0,0,0,1038062,"2024-01-03T00:00:00.000Z",38017710,28,"Christian Koloko",0,0,0,0,0,0
"18837",7318,0,0,0,0,0,0,0,0,0,0,0,0,0,0,0,0,1038062,"2024-01-03T00:00:00.000Z",56677869,28,"Markquis Nowell",0,0,0,0,0,0
"18838",7319,0,0,0,0,0,0,0,0,0,0,0,0,0,0,0,0,1038090,"2024-01-07T00:00:00.000Z",56677841,3,"Dariq Whitehead",0,0,0,0,0,0
"18839",7320,0,0,0,0,0,0,0,0,0,0,0,0,0,0,0,0,1038090,"2024-01-07T00:00:00.000Z",56677722,3,"Jalen Wilson",0,0,0,0,0,0
"18840",7321,1,0,5,2,0,4,1,4,3,29,1,4,5,6,1,2,1038090,"2024-01-07T00:00:00.000Z",56677850,25,"Toumani Camara",1,11,12,6,7,14.7
"18841",7322,1,1,2,7,3,24,11,2,2,42,0,2,27,2,1,0,1038090,"2024-01-07T00:00:00.000Z",182,25,"Jerami Grant",2,29,30,28,3,36.9
"18842",7323,1,3,10,4,3,10,5,3,2,41,3,4,15,13,1,1,1038090,"2024-01-07T00:00:00.000Z",56783340,25,"Duop Reath",4,28,29,16,14,43.1
"18843",7324,11,0,4,10,5,25,13,8,7,45,0,2,38,4,0,2,1038090,"2024-01-07T00:00:00.000Z",419,25,"Anfernee Simons",0,42,53,49,15,57.3
"18844",7325,4,0,2,3,2,8,3,2,2,30,1,2,10,3,0,2,1038090,"2024-01-07T00:00:00.000Z",56677747,25,"Scoot Henderson",0,13,17,14,7,17.6
"18845",7326,3,2,1,4,1,5,2,2,2,20,1,0,7,2,2,1,1038053,"2024-01-02T00:00:00.000Z",38017677,19,"Dyson Daniels",4,9,12,10,5,24.9
"18846",7327,0,0,0,0,0,0,0,0,0,0,0,0,0,0,0,0,1038053,"2024-01-02T00:00:00.000Z",17896017,19,"Matt Ryan",0,0,0,0,0,0
"18847",7328,0,0,0,0,0,0,0,0,0,0,0,0,0,0,0,0,1038053,"2024-01-02T00:00:00.000Z",38017726,19,"Dereon Seabron",0,0,0,0,0,0
"18848",7329,2,0,4,9,5,12,6,0,0,27,0,2,17,4,1,1,1038053,"2024-01-02T00:00:00.000Z",666679,3,"Cameron Johnson",1,21,23,19,6,26.8
"18849",7330,1,0,3,4,1,6,1,0,0,20,1,1,3,4,2,0,1038053,"2024-01-02T00:00:00.000Z",158,3,"Dorian Finney-Smith",2,7,8,4,5,15.3
"18850",7331,1,2,3,0,0,7,4,0,0,23,0,1,8,3,0,0,1038053,"2024-01-02T00:00:00.000Z",666508,3,"Nicolas Claxton",2,11,12,9,4,19.1
"18851",7332,2,0,1,5,2,11,4,3,3,29,2,0,13,3,0,4,1038053,"2024-01-02T00:00:00.000Z",61,3,"Mikal Bridges",0,16,18,15,5,15.6
"18852",7333,5,0,0,4,0,6,0,0,0,21,0,1,0,0,0,1,1038053,"2024-01-02T00:00:00.000Z",130,3,"Spencer Dinwiddie",0,0,5,5,5,6.5
"18853",7334,5,0,4,5,0,6,0,0,0,28,4,3,0,8,1,3,1038053,"2024-01-02T00:00:00.000Z",351,3,"Royce O'Neale",1,8,13,5,13,17.1
"18854",7335,2,0,4,5,2,6,3,0,0,22,1,5,8,5,0,2,1038052,"2024-01-02T00:00:00.000Z",38017731,15,"Vince Williams Jr.",0,13,15,10,7,15
"18855",7336,0,0,0,0,0,0,0,0,0,1,0,0,0,0,0,0,1038052,"2024-01-02T00:00:00.000Z",17896027,15,"Ziaire Williams",0,0,0,0,0,0
"18856",7337,1,0,1,2,1,2,1,0,0,24,0,2,3,1,2,1,1038056,"2024-01-02T00:00:00.000Z",30,26,"Harrison Barnes",2,4,5,4,2,10.7
"18857",7338,2,0,2,6,1,12,4,2,1,37,1,5,10,3,3,1,1038056,"2024-01-02T00:00:00.000Z",38017688,26,"Keegan Murray",3,13,15,12,5,24.6
"18858",7339,4,0,10,1,1,21,11,1,0,35,9,5,23,19,1,11,1038056,"2024-01-02T00:00:00.000Z",406,26,"Domantas Sabonis",1,42,46,27,23,43.8
"18859",7340,4,0,3,4,2,11,5,0,0,29,4,1,12,7,1,1,1038056,"2024-01-02T00:00:00.000Z",17896030,26,"Chris Duarte",1,19,23,16,11,28.4
"18860",7341,6,1,5,10,3,25,11,8,5,38,0,2,30,5,1,3,1038056,"2024-01-02T00:00:00.000Z",161,26,"De'Aaron Fox",2,35,41,36,11,48
"18861",7342,0,0,1,1,1,3,1,2,1,14,0,1,4,1,0,1,1038056,"2024-01-02T00:00:00.000Z",17553994,26,"Davion Mitchell",0,5,5,4,1,4.2
"18862",7343,2,1,2,5,2,7,2,0,0,20,1,2,6,3,0,1,1038056,"2024-01-02T00:00:00.000Z",324,26,"Malik Monk",1,9,11,8,5,14.6
"18863",7344,0,0,2,2,0,4,1,2,2,12,0,3,4,2,0,0,1038056,"2024-01-02T00:00:00.000Z",221,26,"Kevin Huerter",0,6,6,4,2,6.4
"18864",7345,3,0,4,0,0,1,1,2,1,13,0,2,3,4,0,1,1038056,"2024-01-02T00:00:00.000Z",273,26,"Alex Len",0,7,10,6,7,11.3
"18865",7346,1,0,3,5,3,6,3,0,0,17,0,0,9,3,0,0,1038056,"2024-01-02T00:00:00.000Z",290,26,"Trey Lyles",0,12,13,10,4,14.1
"18866",7347,0,0,0,0,0,0,0,0,0,1,0,0,0,0,0,0,1038056,"2024-01-02T00:00:00.000Z",666925,26,"Juan Toscano-Anderson",0,0,0,0,0,0
"18867",7348,0,0,0,0,0,0,0,0,0,0,0,0,0,0,0,0,1038056,"2024-01-02T00:00:00.000Z",17896044,26,"Kessler Edwards",0,0,0,0,0,0
"18868",7349,0,0,0,0,0,0,0,0,0,0,0,0,0,0,0,0,1038056,"2024-01-02T00:00:00.000Z",38017714,26,"Keon Ellis",0,0,0,0,0,0
"18869",7350,0,0,0,0,0,0,0,0,0,0,0,0,0,0,0,0,1038056,"2024-01-02T00:00:00.000Z",306,26,"JaVale McGee",0,0,0,0,0,0
"18870",7351,3,0,3,4,1,7,1,0,0,23,0,2,3,3,3,1,1038020,"2023-12-28T00:00:00.000Z",383,14,"Taurean Prince",3,6,9,6,6,19.1
"18871",7352,2,0,7,7,3,18,10,4,3,31,0,0,26,7,1,2,1038018,"2023-12-28T00:00:00.000Z",666633,16,"Tyler Herro",1,33,35,28,9,38.4
"18872",7353,3,0,0,2,0,6,3,2,1,25,2,3,7,2,0,1,1038018,"2023-12-28T00:00:00.000Z",3547257,16,"R.J. Hampton",0,9,12,10,5,12.9
"18873",7354,4,0,7,3,1,5,2,3,3,13,0,1,8,7,0,1,1038018,"2023-12-28T00:00:00.000Z",285,16,"Kevin Love",0,15,19,12,11,21.4
"18874",7355,1,0,0,1,0,2,1,0,0,14,1,3,2,1,0,0,1038014,"2023-12-28T00:00:00.000Z",17896116,5,"Terry Taylor",0,3,4,3,2,4.7
"18875",7356,1,3,2,0,0,3,2,2,2,18,1,1,6,3,1,2,1038014,"2023-12-28T00:00:00.000Z",38017719,5,"Dalen Terry",4,9,10,7,4,21.1
"18876",7357,9,0,3,7,4,10,5,2,2,29,0,3,16,3,0,1,1038020,"2023-12-28T00:00:00.000Z",405,14,"D'Angelo Russell",0,19,28,25,12,32.1
"18877",7358,4,0,2,3,2,8,6,2,2,24,0,4,16,2,1,1,1038020,"2023-12-28T00:00:00.000Z",17553995,14,"Austin Reaves",1,18,22,20,6,26.4
"18878",7359,4,1,5,3,3,4,3,0,0,23,0,2,9,5,0,2,1038020,"2023-12-28T00:00:00.000Z",486,14,"Christian Wood",1,14,18,13,9,22
"18879",7360,1,0,0,1,0,5,1,0,0,7,0,1,2,0,1,1,1038020,"2023-12-28T00:00:00.000Z",56677835,14,"Jalen Hood-Schifino",1,2,3,3,1,5.5
"18880",7361,0,0,1,0,0,7,5,0,0,7,1,0,10,2,0,0,1038020,"2023-12-28T00:00:00.000Z",666626,14,"Jaxson Hayes",0,12,12,10,2,12.4
"18881",7362,0,0,0,0,0,0,0,0,0,0,0,0,0,0,0,0,1038020,"2023-12-28T00:00:00.000Z",56677738,14,"Colin Castleton",0,0,0,0,0,0
"18882",7363,0,0,0,0,0,0,0,0,0,0,0,0,0,0,0,0,1038020,"2023-12-28T00:00:00.000Z",56677867,14,"Alex Fudge",0,0,0,0,0,0
"18883",7364,0,0,0,0,0,0,0,0,0,0,0,0,0,0,0,0,1038020,"2023-12-28T00:00:00.000Z",56677868,14,"D'Moi Hodge",0,0,0,0,0,0
"18884",7365,0,0,0,0,0,0,0,0,0,0,0,0,0,0,0,0,1038020,"2023-12-28T00:00:00.000Z",56677836,14,"Maxwell Lewis",0,0,0,0,0,0
"18885",7366,0,0,0,0,0,0,0,0,0,0,0,0,0,0,0,0,1038020,"2023-12-28T00:00:00.000Z",666860,14,"Cameron Reddish",0,0,0,0,0,0
"18886",7367,0,0,0,0,0,0,0,0,0,0,0,0,0,0,0,0,1038020,"2023-12-28T00:00:00.000Z",1603383,14,"Gabe Vincent",0,0,0,0,0,0
"18887",7368,1,0,2,4,3,6,3,2,1,22,0,3,10,2,0,1,1038020,"2023-12-28T00:00:00.000Z",38017708,4,"Bryce McGowens",0,12,13,11,3,12.9
"18888",7369,5,1,4,10,4,20,7,2,2,33,1,3,20,5,0,3,1038020,"2023-12-28T00:00:00.000Z",62,4,"Miles Bridges",1,25,30,25,10,33.5
"18889",7370,1,2,7,0,0,5,5,3,1,26,3,3,11,10,1,0,1038020,"2023-12-28T00:00:00.000Z",3547282,4,"Nick Richards",3,21,22,12,11,33.5
"18890",7371,2,1,0,5,3,9,5,4,4,29,1,0,17,1,1,3,1038020,"2023-12-28T00:00:00.000Z",56677823,4,"Brandon Miller",2,18,20,19,3,24.2
"18891",7372,8,0,6,3,1,14,5,9,7,32,0,0,18,6,1,4,1038020,"2023-12-28T00:00:00.000Z",403,4,"Terry Rozier",1,24,32,26,14,36.2
"18892",7373,4,1,3,4,1,7,2,2,1,22,0,0,6,3,1,2,1038017,"2023-12-28T00:00:00.000Z",3547285,15,"Xavier Tillman",2,9,13,10,7,19.6
"18893",7374,0,0,0,0,0,0,0,0,0,0,0,0,0,0,0,0,1038017,"2023-12-28T00:00:00.000Z",3,15,"Steven Adams",0,0,0,0,0,0
"18894",7375,0,0,0,0,0,0,0,0,0,0,0,0,0,0,0,0,1038017,"2023-12-28T00:00:00.000Z",666505,15,"Brandon Clarke",0,0,0,0,0,0
"18895",7376,0,0,0,0,0,0,0,0,0,0,0,0,0,0,0,0,1037983,"2023-12-23T00:00:00.000Z",226,22,"Joe Ingles",0,0,0,0,0,0
"18896",7377,0,0,0,0,0,0,0,0,0,0,0,0,0,0,0,0,1037977,"2023-12-22T00:00:00.000Z",47738533,11,"Jeenathan Williams",0,0,0,0,0,0
"18897",7378,1,0,2,1,0,4,1,2,1,22,2,3,3,4,0,1,1037977,"2023-12-22T00:00:00.000Z",247,7,"Derrick Jones Jr.",0,7,8,4,5,8.3
"18898",7379,2,1,4,3,0,5,0,0,0,26,0,2,0,4,2,0,1037977,"2023-12-22T00:00:00.000Z",666965,7,"Grant Williams",3,4,6,2,6,16.8
"18899",7380,0,0,2,4,1,4,1,2,1,12,0,0,4,2,0,0,1037977,"2023-12-22T00:00:00.000Z",329,7,"Markieff Morris",0,6,6,4,2,6.4
"18900",7381,0,1,6,0,0,5,5,2,1,22,5,4,11,11,1,1,1037979,"2023-12-22T00:00:00.000Z",3547095,24,"Udoka Azubuike",2,22,22,11,11,29.2
"18901",7382,0,0,1,1,0,6,1,2,1,14,2,2,3,3,1,1,1037979,"2023-12-22T00:00:00.000Z",18678058,24,"Jordan Goodwin",1,6,6,3,3,8.6
"18902",7383,0,0,3,2,0,6,3,4,4,13,1,1,10,4,0,1,1037979,"2023-12-22T00:00:00.000Z",314,24,"Chimezie Metu",0,14,14,10,4,13.8
"18903",7384,0,0,2,3,0,4,1,0,0,12,0,2,2,2,0,0,1037979,"2023-12-22T00:00:00.000Z",470,24,"Yuta Watanabe",0,4,4,2,2,4.4
"18904",7385,4,1,2,3,0,8,2,2,2,20,1,2,6,3,0,1,1037979,"2023-12-22T00:00:00.000Z",3547298,24,"Saben Lee",1,9,13,10,7,17.6
"18905",7386,0,0,0,3,0,8,3,0,0,16,0,3,6,0,1,1,1037979,"2023-12-22T00:00:00.000Z",666729,24,"Nassir Little",1,6,6,6,0,8
"18906",7387,0,0,0,0,0,2,1,0,0,3,1,0,2,1,0,0,1037979,"2023-12-22T00:00:00.000Z",666451,24,"Bol Bol",0,3,3,2,1,3.2
"18907",7388,0,0,0,0,0,0,0,0,0,0,0,0,0,0,0,0,1037979,"2023-12-22T00:00:00.000Z",32,24,"Keita Bates-Diop",0,0,0,0,0,0
"18908",7389,0,0,0,0,0,0,0,0,0,0,0,0,0,0,0,0,1037979,"2023-12-22T00:00:00.000Z",37,24,"Bradley Beal",0,0,0,0,0,0
"18909",7390,0,0,0,0,0,0,0,0,0,0,0,0,0,0,0,0,1037978,"2023-12-22T00:00:00.000Z",475,10,"Andrew Wiggins",0,0,0,0,0,0
"18910",7391,4,0,2,0,0,5,2,3,3,20,2,1,7,4,1,0,1037978,"2023-12-22T00:00:00.000Z",3547242,30,"Deni Avdija",1,11,15,11,8,20.8
"18911",7392,3,0,9,5,1,11,3,1,0,25,0,2,7,9,0,3,1037978,"2023-12-22T00:00:00.000Z",265,30,"Kyle Kuzma",0,16,19,10,12,19.3
"18912",7393,1,0,3,0,0,7,5,6,5,23,1,1,15,4,1,1,1037978,"2023-12-22T00:00:00.000Z",666577,30,"Daniel Gafford",1,19,20,16,5,23.3
"18913",7394,3,0,2,12,3,21,7,9,8,27,1,3,25,3,2,1,1037978,"2023-12-22T00:00:00.000Z",666848,30,"Jordan Poole",2,28,31,28,6,38.1
"18914",7395,6,0,2,2,2,8,6,0,0,25,1,0,14,3,1,0,1037978,"2023-12-22T00:00:00.000Z",249,30,"Tyus Jones",1,17,23,20,9,29.6
"18915",7396,2,1,3,2,1,8,3,0,0,32,0,1,7,3,1,2,1037978,"2023-12-22T00:00:00.000Z",56677844,30,"Bilal Coulibaly",2,10,12,9,5,17.6
"18916",7397,2,2,7,7,1,20,6,9,7,28,1,1,20,8,4,2,1037982,"2023-12-23T00:00:00.000Z",666950,4,"P.J. Washington",6,28,30,22,10,48.6
"18917",7398,0,0,0,0,0,0,0,0,0,0,0,0,0,0,0,0,1037982,"2023-12-23T00:00:00.000Z",3547239,4,"LaMelo Ball",0,0,0,0,0,0
"18918",7399,0,0,0,0,0,0,0,0,0,0,0,0,0,0,0,0,1037982,"2023-12-23T00:00:00.000Z",347,4,"Frank Ntilikina",0,0,0,0,0,0
"18919",7400,0,0,0,0,0,0,0,0,0,0,0,0,0,0,0,0,1037982,"2023-12-23T00:00:00.000Z",38017698,4,"Mark Williams",0,0,0,0,0,0
"18920",7401,0,0,0,0,0,0,0,0,0,0,0,0,0,0,0,0,1037963,"2023-12-20T00:00:00.000Z",296,11,"Boban Marjanovic",0,0,0,0,0,0
"18921",7402,0,0,0,0,0,0,0,0,0,0,0,0,0,0,0,0,1037963,"2023-12-20T00:00:00.000Z",47738533,11,"Jeenathan Williams",0,0,0,0,0,0
"18922",7403,0,0,0,0,0,0,0,0,0,0,0,0,0,0,0,0,1037963,"2023-12-20T00:00:00.000Z",38017695,11,"Tari Eason",0,0,0,0,0,0
"18923",7404,2,1,2,0,0,3,2,4,1,21,3,2,5,5,0,1,1037969,"2023-12-21T00:00:00.000Z",3547285,15,"Xavier Tillman",1,10,12,7,7,16
"18924",7405,0,0,0,0,0,0,0,0,0,0,0,0,0,0,0,0,1037969,"2023-12-21T00:00:00.000Z",38017729,15,"David Roddy",0,0,0,0,0,0
"18925",7406,0,0,0,0,0,0,0,0,0,0,0,0,0,0,0,0,1037969,"2023-12-21T00:00:00.000Z",401,15,"Derrick Rose",0,0,0,0,0,0
"18926",7407,0,0,0,0,0,0,0,0,0,0,0,0,0,0,0,0,1037969,"2023-12-21T00:00:00.000Z",3,15,"Steven Adams",0,0,0,0,0,0
"18927",7408,0,0,0,0,0,0,0,0,0,0,0,0,0,0,0,0,1037969,"2023-12-21T00:00:00.000Z",666505,15,"Brandon Clarke",0,0,0,0,0,0
"18928",7409,0,0,0,0,0,0,0,0,0,0,0,0,0,0,0,0,1037969,"2023-12-21T00:00:00.000Z",56677830,15,"GG Jackson",0,0,0,0,0,0
"18929",7410,0,0,0,0,0,0,0,0,0,0,0,0,0,0,0,0,1037969,"2023-12-21T00:00:00.000Z",254,15,"Luke Kennard",0,0,0,0,0,0
"18930",7411,0,0,0,0,0,0,0,0,0,0,0,0,0,0,0,0,1037969,"2023-12-21T00:00:00.000Z",38017728,15,"Jake LaRavia",0,0,0,0,0,0
"18931",7412,0,0,0,0,0,0,0,0,0,0,0,0,0,0,0,0,1037969,"2023-12-21T00:00:00.000Z",420,15,"Marcus Smart",0,0,0,0,0,0
"18932",7413,4,0,4,13,5,14,5,0,0,32,2,2,15,6,2,2,1037969,"2023-12-21T00:00:00.000Z",210,12,"Buddy Hield",2,21,25,19,10,32.2
"18933",7414,1,0,3,9,5,14,8,2,1,28,2,3,22,5,2,1,1037969,"2023-12-21T00:00:00.000Z",3547243,12,"Obi Toppin",2,27,28,23,6,34.5
"18934",7415,2,3,3,2,0,10,5,5,5,36,3,5,15,6,1,4,1037969,"2023-12-21T00:00:00.000Z",452,12,"Myles Turner",4,21,23,17,8,33.2
"18935",7416,2,1,3,1,0,4,1,2,2,28,1,4,4,4,0,0,1037969,"2023-12-21T00:00:00.000Z",69,12,"Bruce Brown",1,8,10,6,6,14.8
"18936",7417,14,0,4,12,2,19,7,2,1,38,0,2,17,4,0,4,1037969,"2023-12-21T00:00:00.000Z",3547245,12,"Tyrese Haliburton",0,21,35,31,18,38.8
"18937",7418,0,1,1,3,0,4,1,3,3,8,0,1,5,1,0,0,1037966,"2023-12-21T00:00:00.000Z",77,9,"Alec Burks",1,6,6,5,1,9.2
"18938",7419,0,0,2,5,2,8,3,0,0,13,1,0,8,3,0,2,1037966,"2023-12-21T00:00:00.000Z",56677792,9,"Marcus Sasser",0,11,11,8,3,9.6
"18939",7420,0,0,0,0,0,0,0,0,0,0,0,0,0,0,0,0,1037966,"2023-12-21T00:00:00.000Z",197,9,"Joe Harris",0,0,0,0,0,0
"18940",7421,0,0,0,0,0,0,0,0,0,0,0,0,0,0,0,0,1037966,"2023-12-21T00:00:00.000Z",3547241,9,"Killian Hayes",0,0,0,0,0,0
"18941",7422,0,0,0,0,0,0,0,0,0,0,0,0,0,0,0,0,1037966,"2023-12-21T00:00:00.000Z",259,9,"Kevin Knox",0,0,0,0,0,0
"18942",7423,2,2,0,4,2,11,6,5,5,39,3,2,19,3,1,0,1037964,"2023-12-20T00:00:00.000Z",247,7,"Derrick Jones Jr.",3,22,24,21,5,34.6
"18943",7424,4,1,4,4,1,7,4,0,0,31,5,6,9,9,0,0,1037964,"2023-12-20T00:00:00.000Z",666965,7,"Grant Williams",1,18,22,13,13,28.8
"18944",7425,1,0,0,0,0,1,1,2,1,17,1,2,3,1,0,0,1037964,"2023-12-20T00:00:00.000Z",379,7,"Dwight Powell",0,4,5,4,2,5.7
"18945",7426,1,0,6,15,5,21,8,4,4,36,0,0,25,6,1,1,1037933,"2023-12-16T00:00:00.000Z",191,7,"Tim Hardaway Jr.",1,31,32,26,7,35.7
"18946",7427,2,2,1,0,0,3,0,0,0,9,3,3,0,4,0,0,1037931,"2023-12-16T00:00:00.000Z",17896038,3,"Day'Ron Sharpe",2,4,6,2,6,13.8
"18947",7428,0,0,0,0,0,1,1,0,0,8,1,1,2,1,0,1,1037931,"2023-12-16T00:00:00.000Z",56677722,3,"Jalen Wilson",0,3,3,2,1,2.2
"18948",7429,0,0,0,0,0,0,0,0,0,0,0,0,0,0,0,0,1037931,"2023-12-16T00:00:00.000Z",174,3,"Harry Giles III",0,0,0,0,0,0
"18949",7430,0,0,0,0,0,0,0,0,0,0,0,0,0,0,0,0,1037931,"2023-12-16T00:00:00.000Z",421,3,"Dennis Smith Jr.",0,0,0,0,0,0
"18950",7431,0,0,0,0,0,0,0,0,0,0,0,0,0,0,0,0,1037931,"2023-12-16T00:00:00.000Z",9051997,3,"Armoni Brooks",0,0,0,0,0,0
"18951",7432,0,0,0,0,0,0,0,0,0,0,0,0,0,0,0,0,1037931,"2023-12-16T00:00:00.000Z",56677843,3,"Noah Clowney",0,0,0,0,0,0
"18952",7433,0,0,0,0,0,0,0,0,0,0,0,0,0,0,0,0,1037931,"2023-12-16T00:00:00.000Z",17896041,3,"Keon Johnson",0,0,0,0,0,0
"18953",7434,0,0,0,0,0,0,0,0,0,0,0,0,0,0,0,0,1037931,"2023-12-16T00:00:00.000Z",417,3,"Ben Simmons",0,0,0,0,0,0
"18954",7435,0,0,0,0,0,0,0,0,0,0,0,0,0,0,0,0,1037931,"2023-12-16T00:00:00.000Z",464,3,"Lonnie Walker IV",0,0,0,0,0,0
"18955",7436,0,0,0,0,0,0,0,0,0,0,0,0,0,0,0,0,1037931,"2023-12-16T00:00:00.000Z",56677841,3,"Dariq Whitehead",0,0,0,0,0,0
"18956",7437,4,0,1,0,0,7,3,0,0,18,0,0,6,1,1,0,1037927,"2023-12-16T00:00:00.000Z",422,4,"Ish Smith",1,7,11,10,5,16.2
"18957",7438,1,0,0,4,1,8,4,0,0,26,1,2,9,1,0,0,1037927,"2023-12-16T00:00:00.000Z",56677846,4,"Nick Smith Jr.",0,10,11,10,2,11.7
"18958",7439,0,0,1,5,3,5,3,0,0,7,0,1,9,1,0,0,1037927,"2023-12-16T00:00:00.000Z",17896037,4,"James Bouknight",0,10,10,9,1,10.2
"18959",7440,0,0,0,2,0,3,1,2,1,7,0,0,3,0,0,1,1037927,"2023-12-16T00:00:00.000Z",56677848,4,"Amari Bailey",0,3,3,3,0,2
"18960",7441,2,1,1,0,0,1,1,0,0,7,0,0,2,1,1,1,1037927,"2023-12-16T00:00:00.000Z",56677866,4,"Leaky Black",2,3,5,4,3,11.2
"18961",7442,2,0,3,3,2,8,5,0,0,21,3,3,12,6,1,2,1037931,"2023-12-16T00:00:00.000Z",407,10,"Dario Saric",1,18,20,14,8,23.2
"18962",7443,1,0,3,1,1,9,4,5,5,26,2,0,14,5,1,0,1037931,"2023-12-16T00:00:00.000Z",475,10,"Andrew Wiggins",1,19,20,15,6,24.5
"18963",7444,1,0,1,0,0,3,1,0,0,12,2,0,2,3,0,0,1037931,"2023-12-16T00:00:00.000Z",17553992,10,"Moses Moody",0,5,6,3,4,7.1
"18964",7445,0,0,0,0,0,0,0,0,0,0,0,0,0,0,0,0,1037931,"2023-12-16T00:00:00.000Z",185,10,"Draymond Green",0,0,0,0,0,0
"18965",7446,0,0,0,0,0,0,0,0,0,0,0,0,0,0,0,0,1037931,"2023-12-16T00:00:00.000Z",56677799,10,"Trayce Jackson-Davis",0,0,0,0,0,0
"18966",7447,0,0,0,0,0,0,0,0,0,0,0,0,0,0,0,0,1037931,"2023-12-16T00:00:00.000Z",251,10,"Cory Joseph",0,0,0,0,0,0
"18967",7448,2,0,2,5,3,11,6,1,1,33,2,1,16,4,1,0,1037934,"2023-12-16T00:00:00.000Z",30,26,"Harrison Barnes",1,20,22,18,6,26.8
"18968",7449,2,0,7,15,12,23,16,4,3,36,1,1,47,8,2,0,1037934,"2023-12-16T00:00:00.000Z",38017688,26,"Keegan Murray",2,55,57,49,10,65.6
"18969",7450,8,0,8,1,0,10,9,4,2,35,2,1,20,10,2,6,1037934,"2023-12-16T00:00:00.000Z",406,26,"Domantas Sabonis",2,30,38,28,18,44
"18970",7451,1,0,3,2,0,4,1,0,0,19,2,4,2,5,1,2,1037899,"2023-12-12T00:00:00.000Z",110,5,"Torrey Craig",1,7,8,3,6,10.5
"18971",7452,0,0,0,0,0,0,0,0,0,0,0,0,0,0,0,0,1037898,"2023-12-12T00:00:00.000Z",379,7,"Dwight Powell",0,0,0,0,0,0
"18972",7453,0,0,0,0,0,0,0,0,0,0,0,0,0,0,0,0,1037898,"2023-12-12T00:00:00.000Z",3547258,7,"Josh Green",0,0,0,0,0,0
"18973",7454,0,0,0,0,0,0,0,0,0,0,0,0,0,0,0,0,1037898,"2023-12-12T00:00:00.000Z",228,7,"Kyrie Irving",0,0,0,0,0,0
"18974",7455,0,0,0,0,0,0,0,0,0,0,0,0,0,0,0,0,1037898,"2023-12-12T00:00:00.000Z",247,7,"Derrick Jones Jr.",0,0,0,0,0,0
"18975",7456,1,0,1,0,0,1,1,0,0,12,3,0,2,4,0,0,1037897,"2023-12-12T00:00:00.000Z",444,6,"Tristan Thompson",0,6,7,3,5,8.3
"18976",7457,0,0,0,0,0,0,0,0,0,0,0,0,0,0,0,0,1037897,"2023-12-12T00:00:00.000Z",56677847,6,"Emoni Bates",0,0,0,0,0,0
"18977",7458,0,0,0,0,0,0,0,0,0,0,0,0,0,0,0,0,1037897,"2023-12-12T00:00:00.000Z",666676,6,"Ty Jerome",0,0,0,0,0,0
"18978",7459,0,0,0,0,0,0,0,0,0,0,0,0,0,0,0,0,1037897,"2023-12-12T00:00:00.000Z",17896076,6,"Evan Mobley",0,0,0,0,0,0
"18979",7460,0,0,0,0,0,0,0,0,0,0,0,0,0,0,0,0,1037897,"2023-12-12T00:00:00.000Z",38017662,6,"Isaiah Mobley",0,0,0,0,0,0
"18980",7461,0,0,0,0,0,0,0,0,0,0,0,0,0,0,0,0,1037897,"2023-12-12T00:00:00.000Z",404,6,"Ricky Rubio",0,0,0,0,0,0
"18981",7462,1,1,0,2,0,2,0,2,2,11,0,1,2,0,0,0,1037899,"2023-12-12T00:00:00.000Z",38017719,5,"Dalen Terry",1,2,3,3,1,6.5
"18982",7463,1,0,1,1,0,1,0,0,0,7,0,1,0,1,0,1,1037899,"2023-12-12T00:00:00.000Z",56677857,5,"Julian Phillips",0,1,2,1,2,1.7
"18983",7464,0,0,0,0,0,1,1,0,0,1,1,0,2,1,0,0,1037899,"2023-12-12T00:00:00.000Z",17896116,5,"Terry Taylor",0,3,3,2,1,3.2
"18984",7465,0,0,0,0,0,0,0,0,0,0,0,0,0,0,0,0,1037899,"2023-12-12T00:00:00.000Z",27,5,"Lonzo Ball",0,0,0,0,0,0
"18985",7466,0,0,0,0,0,0,0,0,0,0,0,0,0,0,0,0,1037899,"2023-12-12T00:00:00.000Z",56677874,5,"Onuralp Bitim",0,0,0,0,0,0
"18986",7467,0,0,0,0,0,0,0,0,0,0,0,0,0,0,0,0,1037899,"2023-12-12T00:00:00.000Z",268,5,"Zach LaVine",0,0,0,0,0,0
"18987",7468,0,0,0,0,0,0,0,0,0,0,0,0,0,0,0,0,1037899,"2023-12-12T00:00:00.000Z",45969255,5,"Justin Lewis",0,0,0,0,0,0
"18988",7469,0,0,0,0,0,0,0,0,0,0,0,0,0,0,0,0,1037899,"2023-12-12T00:00:00.000Z",56677860,5,"Adama Sanogo",0,0,0,0,0,0
"18989",7470,0,0,7,8,2,16,6,4,3,32,0,1,17,7,1,0,1037899,"2023-12-12T00:00:00.000Z",375,8,"Michael Porter Jr.",1,24,24,17,7,28.4
"18990",7471,6,0,2,2,1,13,6,2,1,32,5,1,14,7,0,0,1037899,"2023-12-12T00:00:00.000Z",177,8,"Aaron Gordon",0,21,27,20,13,31.4
"18991",7472,6,0,6,0,0,5,2,0,0,16,3,1,4,9,0,0,1037899,"2023-12-12T00:00:00.000Z",246,8,"Nikola Jokic",0,13,19,10,15,23.8
"18992",7473,0,0,1,0,0,4,2,0,0,12,0,2,4,1,0,0,1037899,"2023-12-12T00:00:00.000Z",81,8,"Kentavious Caldwell-Pope",0,5,5,4,1,5.2
"18993",7474,6,0,2,8,5,16,9,2,2,32,0,4,25,2,0,2,1037899,"2023-12-12T00:00:00.000Z",236,8,"Reggie Jackson",0,27,33,31,8,34.4
"18994",7475,2,1,1,4,2,6,4,4,3,23,1,1,13,2,0,3,1037899,"2023-12-12T00:00:00.000Z",38017709,8,"Christian Braun",1,15,17,15,4,18.4
"18995",7476,4,0,5,7,6,13,8,0,0,27,1,3,22,6,1,0,7049320,"2023-12-06T00:00:00.000Z",213,11,"Aaron Holiday",1,28,32,26,10,38.2
"18996",7477,0,0,0,0,0,0,0,0,0,0,0,0,0,0,0,0,7049318,"2023-12-06T00:00:00.000Z",17895854,27,"Charles Bassey",0,0,0,0,0,0
"18997",7478,0,0,0,0,0,0,0,0,0,0,0,0,0,0,0,0,7049320,"2023-12-06T00:00:00.000Z",19465326,11,"Jock Landale",0,0,0,0,0,0
"18998",7479,0,0,0,0,0,0,0,0,0,0,0,0,0,0,0,0,7049320,"2023-12-06T00:00:00.000Z",357,11,"Victor Oladipo",0,0,0,0,0,0
"18999",7480,0,0,0,0,0,0,0,0,0,0,0,0,0,0,0,0,7049320,"2023-12-06T00:00:00.000Z",56677809,11,"Jermaine Samuels Jr.",0,0,0,0,0,0
"19000",7481,0,0,0,0,0,0,0,0,0,0,0,0,0,0,0,0,7049320,"2023-12-06T00:00:00.000Z",56677825,11,"Amen Thompson",0,0,0,0,0,0
"19001",7482,0,0,0,0,0,0,0,0,0,0,0,0,0,0,0,0,7049320,"2023-12-06T00:00:00.000Z",56677831,11,"Cam Whitmore",0,0,0,0,0,0
"19002",7483,0,0,1,3,0,5,0,4,4,14,2,1,4,3,0,1,7049320,"2023-12-06T00:00:00.000Z",666541,21,"Luguentz Dort",0,7,7,4,3,6.6
"19003",7484,3,0,5,1,0,13,5,3,3,33,0,2,13,5,1,2,7049320,"2023-12-06T00:00:00.000Z",38017703,21,"Jalen Williams",1,18,21,16,8,24.5
"19004",7485,2,6,4,4,0,9,2,0,0,26,1,2,4,5,1,1,7049320,"2023-12-06T00:00:00.000Z",38017685,21,"Chet Holmgren",7,9,11,6,7,33
"19005",7486,6,0,3,5,2,11,3,0,0,25,1,3,8,4,1,0,7049320,"2023-12-06T00:00:00.000Z",17896065,21,"Josh Giddey",1,12,18,14,10,24.8
"19006",7487,6,1,3,0,0,18,13,9,7,37,0,4,33,3,6,2,7049320,"2023-12-06T00:00:00.000Z",175,21,"Shai Gilgeous-Alexander",7,36,42,39,9,64.6
"19007",7488,0,0,0,2,0,4,0,2,2,12,0,1,2,0,0,0,7049320,"2023-12-06T00:00:00.000Z",38017706,21,"Jaylin Williams",0,2,2,2,0,2
"19008",7489,0,0,1,4,1,5,1,0,0,14,0,1,3,1,0,1,7049320,"2023-12-06T00:00:00.000Z",3547272,21,"Isaiah Joe",0,4,4,3,1,3.2
"19009",7490,0,1,3,2,1,5,2,0,0,25,0,3,5,3,2,0,7049320,"2023-12-06T00:00:00.000Z",56677833,21,"Cason Wallace",3,8,8,5,3,17.6
"19010",7491,4,0,3,4,2,8,4,0,0,24,0,0,10,3,2,1,7049320,"2023-12-06T00:00:00.000Z",17896036,21,"Tre Mann",2,13,17,14,7,24.6
"19011",7492,0,0,1,0,0,4,4,4,3,15,0,3,11,1,1,0,7049320,"2023-12-06T00:00:00.000Z",17896078,21,"Aaron Wiggins",1,12,12,11,1,15.2
"19012",7493,1,2,2,4,2,5,3,2,0,15,0,1,8,2,0,0,7049320,"2023-12-06T00:00:00.000Z",480,21,"Kenrich Williams",2,10,11,9,3,17.9
"19013",7494,0,0,0,0,0,0,0,0,0,0,0,0,0,0,0,0,7049320,"2023-12-06T00:00:00.000Z",44,21,"Davis Bertans",0,0,0,0,0,0
"19014",7495,0,0,0,0,0,0,0,0,0,0,0,0,0,0,0,0,7049320,"2023-12-06T00:00:00.000Z",4197029,21,"Vasilije Micic",0,0,0,0,0,0
"19015",7496,0,0,0,0,0,0,0,0,0,0,0,0,0,0,0,0,7049320,"2023-12-06T00:00:00.000Z",3547271,21,"Aleksej Pokusevski",0,0,0,0,0,0
"19016",7497,0,0,0,0,0,0,0,0,0,0,0,0,0,0,0,0,7049320,"2023-12-06T00:00:00.000Z",24572055,21,"Olivier Sarr",0,0,0,0,0,0
"19017",7498,0,0,0,0,0,0,0,0,0,0,0,0,0,0,0,0,7049320,"2023-12-06T00:00:00.000Z",38017716,21,"Ousmane Dieng",0,0,0,0,0,0
"19018",7499,0,0,0,0,0,0,0,0,0,0,0,0,0,0,0,0,7049320,"2023-12-06T00:00:00.000Z",56677853,21,"Keyontae Johnson",0,0,0,0,0,0
"19019",7500,7,0,6,5,1,9,2,0,0,26,0,1,5,6,2,0,7049321,"2023-12-06T00:00:00.000Z",151,7,"Dante Exum",2,11,18,12,13,28.7
"19020",7501,0,0,0,0,0,0,0,0,0,0,0,0,0,0,0,0,1037859,"2023-11-30T00:00:00.000Z",38017696,16,"Nikola Jovic",0,0,0,0,0,0
"19021",7502,0,0,0,0,0,0,0,0,0,0,0,0,0,0,0,0,1037864,"2023-11-30T00:00:00.000Z",56677855,1,"Seth Lundy",0,0,0,0,0,0
"19022",7503,0,0,0,0,0,0,0,0,0,0,0,0,0,0,0,0,1037864,"2023-11-30T00:00:00.000Z",56677875,1,"Miles Norris",0,0,0,0,0,0
"19023",7504,3,0,3,15,5,19,7,0,0,41,0,2,19,3,2,1,1037861,"2023-11-30T00:00:00.000Z",38,17,"Malik Beasley",2,22,25,22,6,32.1
"19024",7505,13,1,4,6,1,16,7,4,3,43,1,1,18,5,2,7,1037861,"2023-11-30T00:00:00.000Z",278,17,"Damian Lillard",3,23,36,31,18,45.5
"19025",7506,0,0,3,4,1,7,3,0,0,22,0,1,7,3,0,2,1037861,"2023-11-30T00:00:00.000Z",38017676,17,"MarJon Beauchamp",0,10,10,7,3,8.6
"19026",7507,2,0,8,2,0,8,2,0,0,31,1,3,4,9,2,0,1037861,"2023-11-30T00:00:00.000Z",377,17,"Bobby Portis",2,13,15,6,11,23.8
"19027",7508,0,0,0,0,0,0,0,0,0,0,0,0,0,0,0,0,1037861,"2023-11-30T00:00:00.000Z",38017733,17,"A.J. Green",0,0,0,0,0,0
"19028",7509,0,0,0,0,0,0,0,0,0,0,0,0,0,0,0,0,1037861,"2023-11-30T00:00:00.000Z",284,17,"Robin Lopez",0,0,0,0,0,0
"19029",7510,0,0,0,0,0,0,0,0,0,0,0,0,0,0,0,0,1037861,"2023-11-30T00:00:00.000Z",666453,17,"Marques Bolden",0,0,0,0,0,0
"19030",7511,0,0,0,0,0,0,0,0,0,0,0,0,0,0,0,0,1037861,"2023-11-30T00:00:00.000Z",105,17,"Pat Connaughton",0,0,0,0,0,0
"19031",7512,0,0,0,0,0,0,0,0,0,0,0,0,0,0,0,0,1037861,"2023-11-30T00:00:00.000Z",112,17,"Jae Crowder",0,0,0,0,0,0
"19032",7513,1,0,3,2,0,6,1,7,5,20,1,1,7,4,0,1,1037863,"2023-11-30T00:00:00.000Z",486,14,"Christian Wood",0,11,12,8,5,12.3
"19033",7514,0,0,0,0,0,0,0,0,0,0,0,0,0,0,0,0,1037863,"2023-11-30T00:00:00.000Z",666609,14,"Rui Hachimura",0,0,0,0,0,0
"19034",7515,0,0,0,0,0,0,0,0,0,0,0,0,0,0,0,0,1037863,"2023-11-30T00:00:00.000Z",666626,14,"Jaxson Hayes",0,0,0,0,0,0
"19035",7516,0,0,0,0,0,0,0,0,0,0,0,0,0,0,0,0,1037861,"2023-11-30T00:00:00.000Z",56677854,17,"Chris Livingston",0,0,0,0,0,0
"19036",7517,0,0,0,0,0,0,0,0,0,0,0,0,0,0,0,0,1037861,"2023-11-30T00:00:00.000Z",38017691,17,"TyTy Washington Jr.",0,0,0,0,0,0
"19037",7518,5,0,5,4,2,7,4,4,3,27,0,2,13,5,1,0,1037865,"2023-11-30T00:00:00.000Z",407,10,"Dario Saric",1,18,23,18,10,29.5
"19038",7519,2,0,2,2,0,2,0,2,1,22,0,1,1,2,0,0,1037865,"2023-11-30T00:00:00.000Z",251,10,"Cory Joseph",0,3,5,3,4,6.4
"19039",7520,3,1,5,5,3,8,6,4,2,23,1,0,17,6,1,1,1037865,"2023-11-30T00:00:00.000Z",17553979,10,"Jonathan Kuminga",2,23,26,20,9,33.7
"19040",7521,0,0,0,0,0,0,0,0,0,0,0,0,0,0,0,0,1037865,"2023-11-30T00:00:00.000Z",56677799,10,"Trayce Jackson-Davis",0,0,0,0,0,0
"19041",7522,0,0,0,0,0,0,0,0,0,0,0,0,0,0,0,0,1037865,"2023-11-30T00:00:00.000Z",45658838,10,"Lester Quinones",0,0,0,0,0,0
"19042",7523,0,0,0,0,0,0,0,0,0,0,0,0,0,0,0,0,1037865,"2023-11-30T00:00:00.000Z",398,10,"Jerome Robinson",0,0,0,0,0,0
"19043",7524,0,0,0,0,0,0,0,0,0,0,0,0,0,0,0,0,1037865,"2023-11-30T00:00:00.000Z",57875092,10,"Gui Santos",0,0,0,0,0,0
"19044",7525,0,0,0,0,0,0,0,0,0,0,0,0,0,0,0,0,1037865,"2023-11-30T00:00:00.000Z",371,13,"Mason Plumlee",0,0,0,0,0,0
"19045",7526,0,0,0,0,0,0,0,0,0,0,0,0,0,0,0,0,1037825,"2023-11-25T00:00:00.000Z",56677838,1,"Kobe Bufkin",0,0,0,0,0,0
"19046",7527,0,0,0,0,0,0,0,0,0,0,0,0,0,0,0,0,1037825,"2023-11-25T00:00:00.000Z",56677806,1,"Mouhamed Gueye",0,0,0,0,0,0
"19047",7528,0,0,0,0,0,0,0,0,0,0,0,0,0,0,0,0,1037825,"2023-11-25T00:00:00.000Z",56677855,1,"Seth Lundy",0,0,0,0,0,0
"19048",7529,0,0,0,0,0,0,0,0,0,0,0,0,0,0,0,0,1037825,"2023-11-25T00:00:00.000Z",56677875,1,"Miles Norris",0,0,0,0,0,0
"19049",7530,2,3,4,9,3,10,3,6,4,28,0,5,13,4,0,1,1037832,"2023-11-26T00:00:00.000Z",666950,4,"P.J. Washington",3,17,19,15,6,28.8
"19050",7531,4,0,2,0,0,3,2,0,0,17,0,2,4,2,1,1,1037832,"2023-11-26T00:00:00.000Z",422,4,"Ish Smith",1,6,10,8,6,14.4
"19051",7532,0,0,0,3,2,4,2,0,0,9,0,1,6,0,0,0,1037832,"2023-11-26T00:00:00.000Z",18678001,4,"JT Thor",0,6,6,6,0,6
"19052",7533,0,0,0,0,0,0,0,0,0,0,0,0,0,0,0,0,1037832,"2023-11-26T00:00:00.000Z",56677846,4,"Nick Smith Jr.",0,0,0,0,0,0
"19053",7534,0,0,0,0,0,0,0,0,0,0,0,0,0,0,0,0,1037832,"2023-11-26T00:00:00.000Z",56677848,4,"Amari Bailey",0,0,0,0,0,0
"19054",7535,0,0,0,0,0,0,0,0,0,0,0,0,0,0,0,0,1037832,"2023-11-26T00:00:00.000Z",17896037,4,"James Bouknight",0,0,0,0,0,0
"19055",7536,2,0,1,5,2,9,5,0,0,17,0,1,12,1,0,1,1037825,"2023-11-25T00:00:00.000Z",414,30,"Landry Shamet",0,13,15,14,3,15.2
"19056",7537,0,0,0,0,0,0,0,0,0,0,0,0,0,0,0,0,1037825,"2023-11-25T00:00:00.000Z",666848,30,"Jordan Poole",0,0,0,0,0,0
"19057",7538,0,0,0,0,0,0,0,0,0,0,0,0,0,0,0,0,1037825,"2023-11-25T00:00:00.000Z",38017704,30,"Patrick Baldwin Jr.",0,0,0,0,0,0
"19058",7539,0,0,0,0,0,0,0,0,0,0,0,0,0,0,0,0,1037825,"2023-11-25T00:00:00.000Z",38124126,30,"John Butler Jr.",0,0,0,0,0,0
"19059",7540,0,0,0,0,0,0,0,0,0,0,0,0,0,0,0,0,1037825,"2023-11-25T00:00:00.000Z",167,30,"Danilo Gallinari",0,0,0,0,0,0
"19060",7541,0,0,0,0,0,0,0,0,0,0,0,0,0,0,0,0,1037825,"2023-11-25T00:00:00.000Z",38017712,30,"Ryan Rollins",0,0,0,0,0,0
"19061",7542,0,0,0,0,0,0,0,0,0,0,0,0,0,0,0,0,1037825,"2023-11-25T00:00:00.000Z",487,30,"Delon Wright",0,0,0,0,0,0
"19062",7543,0,0,3,5,3,11,7,3,3,31,1,4,20,4,2,2,1037825,"2023-11-25T00:00:00.000Z",666656,1,"De'Andre Hunter",2,24,24,20,4,28.8
"19063",7544,1,1,0,2,1,4,3,2,1,9,1,0,8,1,2,0,1037825,"2023-11-25T00:00:00.000Z",17896040,1,"Jalen Johnson",3,9,10,9,2,19.7
"19064",7545,1,0,4,0,0,14,6,2,0,18,7,2,12,11,0,0,1037825,"2023-11-25T00:00:00.000Z",83,1,"Clint Capela",0,23,24,13,12,26.7
"19065",7546,10,0,5,6,1,14,4,2,2,27,0,0,11,5,4,0,1037825,"2023-11-25T00:00:00.000Z",334,1,"Dejounte Murray",4,16,26,21,15,44
"19066",7547,0,0,0,0,0,0,0,0,0,0,0,0,0,0,0,0,1037833,"2023-11-26T00:00:00.000Z",666505,15,"Brandon Clarke",0,0,0,0,0,0
"19067",7548,0,0,0,0,0,0,0,0,0,0,0,0,0,0,0,0,1037833,"2023-11-26T00:00:00.000Z",56677830,15,"GG Jackson",0,0,0,0,0,0
"19068",7549,0,0,0,0,0,0,0,0,0,0,0,0,0,0,0,0,1037833,"2023-11-26T00:00:00.000Z",254,15,"Luke Kennard",0,0,0,0,0,0
"19069",7550,0,0,0,0,0,0,0,0,0,0,0,0,0,0,0,0,1037833,"2023-11-26T00:00:00.000Z",38017728,15,"Jake LaRavia",0,0,0,0,0,0
"19070",7551,2,5,5,3,1,14,8,6,6,27,5,5,23,10,1,2,3277502,"2023-11-24T00:00:00.000Z",452,12,"Myles Turner",6,33,35,25,12,54
"19071",7552,0,0,0,0,0,0,0,0,0,0,0,0,0,0,0,0,3277501,"2023-11-24T00:00:00.000Z",38017717,28,"Ron Harper Jr.",0,0,0,0,0,0
"19072",7553,0,0,0,0,0,0,0,0,0,0,0,0,0,0,0,0,3277501,"2023-11-24T00:00:00.000Z",38017710,28,"Christian Koloko",0,0,0,0,0,0
"19073",7554,0,0,0,0,0,0,0,0,0,0,0,0,0,0,0,0,3277501,"2023-11-24T00:00:00.000Z",56677869,28,"Markquis Nowell",0,0,0,0,0,0
"19074",7555,4,1,3,1,0,16,7,9,5,39,0,3,19,3,1,2,3277501,"2023-11-24T00:00:00.000Z",125,5,"DeMar DeRozan",2,22,26,23,7,32.6
"19075",7556,1,0,1,2,1,3,2,2,2,18,1,0,7,2,0,0,3277501,"2023-11-24T00:00:00.000Z",89,5,"Alex Caruso",0,9,10,8,3,10.9
"19076",7557,5,0,8,2,1,8,4,0,0,36,0,3,9,8,1,1,3277501,"2023-11-24T00:00:00.000Z",460,5,"Nikola Vucevic",1,17,22,14,13,28.1
"19077",7558,3,0,4,8,4,23,16,0,0,38,0,4,36,4,1,5,3277501,"2023-11-24T00:00:00.000Z",268,5,"Zach LaVine",1,40,43,39,7,43.3
"19078",7559,3,0,2,7,4,9,5,0,0,34,1,4,14,3,0,3,3277501,"2023-11-24T00:00:00.000Z",666956,5,"Coby White",0,17,20,17,6,19.1
"19079",7560,1,1,3,1,0,3,1,4,3,19,2,2,5,5,0,1,3277501,"2023-11-24T00:00:00.000Z",110,5,"Torrey Craig",1,10,11,6,6,14.5
"19080",7561,0,0,2,0,0,4,1,0,0,6,3,2,2,5,0,0,3277501,"2023-11-24T00:00:00.000Z",137,5,"Andre Drummond",0,7,7,2,5,8
"19081",7562,1,0,1,2,0,4,1,0,0,13,0,1,2,1,1,0,3277501,"2023-11-24T00:00:00.000Z",17895983,5,"Ayo Dosunmu",1,3,4,3,2,7.7
"19082",7563,1,0,1,1,0,2,0,0,0,11,0,0,0,1,0,0,3277501,"2023-11-24T00:00:00.000Z",87,5,"Jevon Carter",0,1,2,1,2,2.7
"19083",7564,0,0,0,0,0,0,0,0,0,0,0,0,0,0,0,0,3277500,"2023-11-24T00:00:00.000Z",666971,20,"Dylan Windler",0,0,0,0,0,0
"19084",7565,3,0,2,5,3,14,7,6,6,37,0,1,23,2,1,2,3277500,"2023-11-24T00:00:00.000Z",79,16,"Jimmy Butler",1,25,28,26,5,30.9
"19085",7566,3,0,3,5,1,6,1,2,2,24,0,1,5,3,2,2,3277500,"2023-11-24T00:00:00.000Z",3092,16,"Haywood Highsmith",2,8,11,8,6,17.1
"19086",7567,2,0,10,1,0,16,8,6,5,35,2,4,21,12,2,2,3277500,"2023-11-24T00:00:00.000Z",4,16,"Bam Adebayo",2,33,35,23,14,42.4
"19087",7568,2,0,5,5,2,9,4,0,0,33,3,3,10,8,2,1,3277500,"2023-11-24T00:00:00.000Z",286,16,"Kyle Lowry",2,18,20,12,10,27.6
"19088",7569,2,0,1,4,2,10,5,3,3,34,1,3,15,2,2,2,3277500,"2023-11-24T00:00:00.000Z",391,16,"Josh Richardson",2,17,19,17,4,24.4
"19089",7570,0,0,0,0,0,0,0,0,0,0,0,0,0,0,0,0,3277500,"2023-11-24T00:00:00.000Z",74,16,"Thomas Bryant",0,0,0,0,0,0
"19090",7571,0,0,0,0,0,0,0,0,0,0,0,0,0,0,0,0,3277500,"2023-11-24T00:00:00.000Z",38017734,16,"Jamal Cain",0,0,0,0,0,0
"19091",7572,2,0,1,9,4,13,6,0,0,20,0,3,16,1,1,0,3277501,"2023-11-24T00:00:00.000Z",3089,28,"Gary Trent Jr.",1,17,19,18,3,23.2
"19092",7573,1,0,1,2,0,2,0,2,2,14,0,1,2,1,1,1,3277501,"2023-11-24T00:00:00.000Z",3547275,28,"Malachi Flynn",1,3,4,3,2,6.7
"19093",7574,0,0,1,0,0,0,0,2,2,9,0,1,2,1,0,1,3277501,"2023-11-24T00:00:00.000Z",56677828,28,"Gradey Dick",0,3,3,2,1,2.2
"19094",7575,2,0,1,3,2,8,2,2,2,30,1,4,8,2,0,2,3277503,"2023-11-24T00:00:00.000Z",66,11,"Dillon Brooks",0,10,12,10,4,11.4
"19095",7576,0,0,0,0,0,0,0,0,0,0,0,0,0,0,0,0,1037786,"2023-11-20T00:00:00.000Z",403,4,"Terry Rozier",0,0,0,0,0,0
"19096",7577,0,0,0,0,0,0,0,0,0,0,0,0,0,0,0,0,1037787,"2023-11-20T00:00:00.000Z",259,9,"Kevin Knox",0,0,0,0,0,0
"19097",7578,0,0,0,0,0,0,0,0,0,0,0,0,0,0,0,0,1037787,"2023-11-20T00:00:00.000Z",54,9,"Bojan Bogdanovic",0,0,0,0,0,0
"19098",7579,0,0,0,0,0,0,0,0,0,0,0,0,0,0,0,0,1037787,"2023-11-20T00:00:00.000Z",56677729,9,"Malcolm Cazalon",0,0,0,0,0,0
"19099",7580,0,0,0,0,0,0,0,0,0,0,0,0,0,0,0,0,1037787,"2023-11-20T00:00:00.000Z",197,9,"Joe Harris",0,0,0,0,0,0
"19100",7581,0,0,0,0,0,0,0,0,0,0,0,0,0,0,0,0,1037787,"2023-11-20T00:00:00.000Z",330,9,"Monte Morris",0,0,0,0,0,0
"19101",7582,0,0,0,0,0,0,0,0,0,0,0,0,0,0,0,0,1037787,"2023-11-20T00:00:00.000Z",42097199,9,"Jared Rhoden",0,0,0,0,0,0
"19102",7583,2,1,9,9,4,15,5,1,0,38,2,3,14,11,0,4,1037787,"2023-11-20T00:00:00.000Z",375,8,"Michael Porter Jr.",1,25,27,16,13,29.2
"19103",7584,2,2,4,0,0,14,7,0,0,29,2,3,14,6,0,0,1037788,"2023-11-20T00:00:00.000Z",666577,30,"Daniel Gafford",2,20,22,16,8,30.2
"19104",7585,1,0,1,9,3,26,11,5,5,33,0,4,30,1,0,0,1037788,"2023-11-20T00:00:00.000Z",666848,30,"Jordan Poole",0,31,32,31,2,32.7
"19105",7586,3,0,2,1,0,13,9,0,0,26,0,0,18,2,0,0,1037788,"2023-11-20T00:00:00.000Z",249,30,"Tyus Jones",0,20,23,21,5,24.9
"19106",7587,0,0,0,0,0,0,0,0,0,1,0,0,0,0,0,0,1037788,"2023-11-20T00:00:00.000Z",18677954,30,"Jared Butler",0,0,0,0,0,0
"19107",7588,0,0,0,0,0,0,0,0,0,0,0,0,0,0,0,0,1037788,"2023-11-20T00:00:00.000Z",38017704,30,"Patrick Baldwin Jr.",0,0,0,0,0,0
"19108",7589,0,0,0,0,0,0,0,0,0,0,0,0,0,0,0,0,1037788,"2023-11-20T00:00:00.000Z",38124126,30,"John Butler Jr.",0,0,0,0,0,0
"19109",7590,7,0,4,1,0,10,4,4,3,37,4,1,11,8,1,2,1037787,"2023-11-20T00:00:00.000Z",177,8,"Aaron Gordon",1,19,26,18,15,32.1
"19110",7591,5,1,5,4,1,8,4,0,0,15,0,1,9,5,0,1,1037787,"2023-11-20T00:00:00.000Z",246,8,"Nikola Jokic",1,14,19,14,10,24.5
"19111",7592,3,2,2,5,2,17,8,2,2,36,1,2,20,3,2,3,1037787,"2023-11-20T00:00:00.000Z",81,8,"Kentavious Caldwell-Pope",4,23,26,23,6,37.1
"19112",7593,6,1,3,3,1,15,9,3,2,32,0,2,21,3,1,0,1037787,"2023-11-20T00:00:00.000Z",236,8,"Reggie Jackson",2,24,30,27,9,39.6
"19113",7594,2,1,5,2,2,10,5,4,3,32,1,2,15,6,1,2,1037787,"2023-11-20T00:00:00.000Z",38017709,8,"Christian Braun",2,21,23,17,8,29.2
"19114",7595,2,2,1,0,0,2,1,2,2,14,0,1,4,1,0,1,1037787,"2023-11-20T00:00:00.000Z",38017721,8,"Peyton Watson",2,5,7,6,3,13.2
"19115",7596,0,0,0,0,0,0,0,0,0,0,0,0,0,0,0,0,1037787,"2023-11-20T00:00:00.000Z",38017727,8,"Collin Gillespie",0,0,0,0,0,0
"19116",7597,0,0,0,0,0,0,0,0,0,0,0,0,0,0,0,0,1037787,"2023-11-20T00:00:00.000Z",215,8,"Justin Holiday",0,0,0,0,0,0
"19117",7598,0,0,0,0,0,0,0,0,0,0,0,0,0,0,0,0,1037787,"2023-11-20T00:00:00.000Z",250,8,"DeAndre Jordan",0,0,0,0,0,0
"19118",7599,0,0,0,0,0,0,0,0,0,0,0,0,0,0,0,0,1037787,"2023-11-20T00:00:00.000Z",56677871,8,"Hunter Tyson",0,0,0,0,0,0
"19119",7600,0,0,0,0,0,0,0,0,0,0,0,0,0,0,0,0,1037787,"2023-11-20T00:00:00.000Z",666489,8,"Vlatko Cancar",0,0,0,0,0,0
"19120",7601,0,0,0,0,0,0,0,0,0,0,0,0,0,0,0,0,1037756,"2023-11-15T00:00:00.000Z",56677738,14,"Colin Castleton",0,0,0,0,0,0
"19121",7602,0,0,0,0,0,0,0,0,0,0,0,0,0,0,0,0,1037756,"2023-11-15T00:00:00.000Z",56677867,14,"Alex Fudge",0,0,0,0,0,0
"19122",7603,0,0,0,0,0,0,0,0,0,0,0,0,0,0,0,0,1037756,"2023-11-15T00:00:00.000Z",56677835,14,"Jalen Hood-Schifino",0,0,0,0,0,0
"19123",7604,0,0,0,0,0,0,0,0,0,0,0,0,0,0,0,0,1037756,"2023-11-15T00:00:00.000Z",457,14,"Jarred Vanderbilt",0,0,0,0,0,0
"19124",7605,0,0,0,0,0,0,0,0,0,0,0,0,0,0,0,0,1037756,"2023-11-15T00:00:00.000Z",1603383,14,"Gabe Vincent",0,0,0,0,0,0
"19125",7606,2,0,1,6,3,10,5,0,0,38,0,3,13,1,4,2,1037756,"2023-11-15T00:00:00.000Z",30,26,"Harrison Barnes",4,14,16,15,3,27.2
"19126",7607,2,0,6,7,2,9,3,2,1,31,0,2,9,6,2,1,1037756,"2023-11-15T00:00:00.000Z",38017688,26,"Keegan Murray",2,15,17,11,8,24.2
"19127",7608,7,1,11,1,1,19,13,2,2,39,5,3,29,16,3,4,1037756,"2023-11-15T00:00:00.000Z",406,26,"Domantas Sabonis",4,45,52,36,23,66.7
"19128",7609,1,0,0,0,0,2,2,0,0,4,0,1,4,0,0,0,1037756,"2023-11-15T00:00:00.000Z",17896030,26,"Chris Duarte",0,4,5,5,1,5.5
"19129",7610,0,0,0,0,0,0,0,0,0,1,0,0,0,0,0,0,1037756,"2023-11-15T00:00:00.000Z",17896044,26,"Kessler Edwards",0,0,0,0,0,0
"19130",7611,0,0,0,0,0,0,0,0,0,1,0,0,0,0,0,0,1037756,"2023-11-15T00:00:00.000Z",56677862,26,"Jalen Slawson",0,0,0,0,0,0
"19131",7612,0,0,0,0,0,0,0,0,0,1,0,0,0,0,0,0,1037756,"2023-11-15T00:00:00.000Z",17895941,26,"Filip Petrusev",0,0,0,0,0,0
"19132",7613,0,0,0,0,0,0,0,0,0,0,0,0,0,0,0,0,1037756,"2023-11-15T00:00:00.000Z",17553994,26,"Davion Mitchell",0,0,0,0,0,0
"19133",7614,1,2,2,4,3,7,4,2,1,23,1,2,12,3,0,2,1037757,"2023-11-15T00:00:00.000Z",38017711,25,"Jabari Walker",2,15,16,13,4,21.1
"19134",7615,0,0,0,0,0,0,0,0,0,3,0,0,0,0,0,0,1037757,"2023-11-15T00:00:00.000Z",17896120,25,"Ish Wainright",0,0,0,0,0,0
"19135",7616,0,0,0,0,0,0,0,0,0,0,0,0,0,0,0,0,1037757,"2023-11-15T00:00:00.000Z",65,25,"Malcolm Brogdon",0,0,0,0,0,0
"19136",7617,0,0,0,0,0,0,0,0,0,0,0,0,0,0,0,0,1037757,"2023-11-15T00:00:00.000Z",56677747,25,"Scoot Henderson",0,0,0,0,0,0
"19137",7618,0,0,0,0,0,0,0,0,0,0,0,0,0,0,0,0,1037757,"2023-11-15T00:00:00.000Z",419,25,"Anfernee Simons",0,0,0,0,0,0
"19138",7619,0,0,0,0,0,0,0,0,0,0,0,0,0,0,0,0,1037757,"2023-11-15T00:00:00.000Z",476,25,"Robert Williams III",0,0,0,0,0,0
"19139",7620,2,1,2,3,0,3,0,0,0,33,1,1,0,3,0,0,1037757,"2023-11-15T00:00:00.000Z",666940,6,"Dean Wade",1,3,5,2,5,9.6
"19140",7621,3,3,3,5,2,19,12,11,10,35,2,0,36,5,1,4,1037758,"2023-11-16T00:00:00.000Z",79,16,"Jimmy Butler",4,41,44,39,8,54.5
"19141",7622,0,0,1,3,0,5,2,2,2,23,0,3,6,1,0,1,1037758,"2023-11-16T00:00:00.000Z",3092,16,"Haywood Highsmith",0,7,7,6,1,6.2
"19142",7623,4,1,5,0,0,15,8,4,4,33,2,2,20,7,2,2,1037758,"2023-11-16T00:00:00.000Z",4,16,"Bam Adebayo",3,27,31,24,11,41.4
"19143",7624,2,0,0,10,6,14,8,4,4,38,0,3,26,0,0,0,1037758,"2023-11-16T00:00:00.000Z",397,16,"Duncan Robinson",0,26,28,28,2,29
"19144",7625,3,0,2,1,1,4,1,0,0,24,1,3,3,3,3,0,1037758,"2023-11-16T00:00:00.000Z",286,16,"Kyle Lowry",3,6,9,6,6,20.1
"19145",7626,0,0,0,0,0,0,0,0,0,0,0,0,0,0,0,0,1037726,"2023-11-12T00:00:00.000Z",417,3,"Ben Simmons",0,0,0,0,0,0
"19146",7627,1,0,1,1,0,5,0,0,0,23,0,1,0,1,2,1,1037726,"2023-11-12T00:00:00.000Z",249,30,"Tyus Jones",2,1,2,1,2,7.7
"19147",7628,4,0,2,5,0,8,2,4,4,26,1,1,8,3,1,1,1037726,"2023-11-12T00:00:00.000Z",17896045,30,"Corey Kispert",1,11,15,12,7,19.6
"19148",7629,3,0,6,7,4,12,8,1,0,34,1,0,20,7,4,2,1037726,"2023-11-12T00:00:00.000Z",56677844,30,"Bilal Coulibaly",4,27,30,23,10,42.9
"19149",7630,3,0,3,3,1,7,3,5,5,20,0,1,12,3,1,0,1037726,"2023-11-12T00:00:00.000Z",167,30,"Danilo Gallinari",1,15,18,15,6,23.1
"19150",7631,1,0,4,4,2,7,3,0,0,20,1,1,8,5,0,1,1037726,"2023-11-12T00:00:00.000Z",414,30,"Landry Shamet",0,13,14,9,6,14.5
"19151",7632,0,0,0,0,0,0,0,0,0,0,0,0,0,0,0,0,1037726,"2023-11-12T00:00:00.000Z",38017704,30,"Patrick Baldwin Jr.",0,0,0,0,0,0
"19152",7633,0,0,0,0,0,0,0,0,0,0,0,0,0,0,0,0,1037726,"2023-11-12T00:00:00.000Z",18677954,30,"Jared Butler",0,0,0,0,0,0
"19153",7634,0,0,0,0,0,0,0,0,0,0,0,0,0,0,0,0,1037726,"2023-11-12T00:00:00.000Z",38017687,30,"Johnny Davis",0,0,0,0,0,0
"19154",7635,0,0,0,0,0,0,0,0,0,0,0,0,0,0,0,0,1037726,"2023-11-12T00:00:00.000Z",3547302,30,"Anthony Gill",0,0,0,0,0,0
"19155",7636,0,0,0,0,0,0,0,0,0,0,0,0,0,0,0,0,1037726,"2023-11-12T00:00:00.000Z",337,30,"Mike Muscala",0,0,0,0,0,0
"19156",7637,0,0,0,0,0,0,0,0,0,0,0,0,0,0,0,0,1037726,"2023-11-12T00:00:00.000Z",38017712,30,"Ryan Rollins",0,0,0,0,0,0
"19157",7638,0,0,0,0,0,0,0,0,0,0,0,0,0,0,0,0,1037726,"2023-11-12T00:00:00.000Z",38124126,30,"John Butler Jr.",0,0,0,0,0,0
"19158",7639,0,0,0,0,0,0,0,0,0,0,0,0,0,0,0,0,1037726,"2023-11-12T00:00:00.000Z",17896106,30,"Eugene Omoruyi",0,0,0,0,0,0
"19159",7640,0,0,0,0,0,0,0,0,0,0,0,0,0,0,0,0,1037726,"2023-11-12T00:00:00.000Z",487,30,"Delon Wright",0,0,0,0,0,0
"19160",7641,3,2,4,4,1,16,6,2,1,37,1,3,14,5,1,0,1037727,"2023-11-12T00:00:00.000Z",274,13,"Kawhi Leonard",3,19,22,17,8,33.5
"19161",7642,7,0,6,7,3,16,8,9,7,37,1,5,26,7,2,7,1037727,"2023-11-12T00:00:00.000Z",172,13,"Paul George",2,33,40,33,14,43.9
"19162",7643,1,0,6,0,0,4,2,2,2,23,0,3,6,6,1,1,1037727,"2023-11-12T00:00:00.000Z",493,13,"Ivica Zubac",1,12,13,7,7,16.7
"19163",7644,3,1,2,7,1,12,4,2,2,29,2,0,11,4,1,1,1037727,"2023-11-12T00:00:00.000Z",192,13,"James Harden",2,15,18,14,7,25.3
"19164",7645,5,0,8,4,1,13,5,2,1,31,1,3,12,9,3,4,1037727,"2023-11-12T00:00:00.000Z",472,13,"Russell Westbrook",3,21,26,17,14,35.3
"19165",7646,3,0,2,7,4,13,7,6,2,31,0,5,20,2,0,0,1037727,"2023-11-12T00:00:00.000Z",380,13,"Norman Powell",0,22,25,23,5,26.9
"19166",7647,0,0,2,0,0,2,1,0,0,12,1,1,2,3,0,0,1037727,"2023-11-12T00:00:00.000Z",38017725,13,"Moussa Diabate",0,5,5,2,3,5.6
"19167",7648,1,0,1,2,1,2,1,0,0,13,1,1,3,2,1,0,1037727,"2023-11-12T00:00:00.000Z",450,13,"PJ Tucker",1,5,6,4,3,9.9
"19168",7649,3,0,2,3,1,7,3,0,0,27,1,2,7,3,0,1,1037727,"2023-11-12T00:00:00.000Z",666743,13,"Terance Mann",0,10,13,10,6,14.1
"19169",7650,0,0,0,0,0,0,0,0,0,0,0,0,0,0,0,0,1037727,"2023-11-12T00:00:00.000Z",56677849,13,"Kobe Brown",0,0,0,0,0,0
"19170",7651,1,0,2,3,2,3,2,0,0,30,0,5,6,2,0,0,1037696,"2023-11-08T00:00:00.000Z",56677844,30,"Bilal Coulibaly",0,8,9,7,3,9.9
"19171",7652,2,1,4,7,4,11,7,2,0,20,0,3,18,4,0,1,1037696,"2023-11-08T00:00:00.000Z",167,30,"Danilo Gallinari",1,22,24,20,6,27.8
"19172",7653,0,0,0,0,0,3,0,0,0,4,1,0,0,1,0,0,1037696,"2023-11-08T00:00:00.000Z",3547302,30,"Anthony Gill",0,1,1,0,1,1.2
"19173",7654,0,1,0,0,0,0,0,0,0,3,0,0,0,0,0,0,1037696,"2023-11-08T00:00:00.000Z",38017687,30,"Johnny Davis",1,0,0,0,0,3
"19174",7655,4,0,4,7,4,18,9,0,0,39,5,1,22,9,2,3,1037697,"2023-11-08T00:00:00.000Z",38017686,12,"Bennedict Mathurin",2,31,35,26,13,41.8
"19175",7656,0,1,1,3,0,7,3,0,0,19,0,2,6,1,3,1,1037697,"2023-11-08T00:00:00.000Z",3547243,12,"Obi Toppin",4,7,7,6,1,18.2
"19176",7657,0,3,3,2,0,12,8,8,6,23,3,2,22,6,0,0,1037697,"2023-11-08T00:00:00.000Z",452,12,"Myles Turner",3,28,28,22,6,38.2
"19177",7658,0,1,4,4,1,11,4,0,0,32,0,2,9,4,2,2,1037697,"2023-11-08T00:00:00.000Z",69,12,"Bruce Brown",3,13,13,9,4,20.8
"19178",7659,13,0,5,6,1,12,6,3,3,31,1,0,16,6,1,2,1037697,"2023-11-08T00:00:00.000Z",3547245,12,"Tyrese Haliburton",1,22,35,29,19,43.7
"19179",7660,1,1,3,12,2,16,4,0,0,22,0,2,10,3,1,1,1037697,"2023-11-08T00:00:00.000Z",210,12,"Buddy Hield",2,13,14,11,4,20.1
"19180",7661,0,0,1,6,4,13,9,2,2,30,1,4,24,2,2,1,1037697,"2023-11-08T00:00:00.000Z",3547250,12,"Aaron Nesmith",2,26,26,24,2,31.4
"19181",7662,1,1,8,0,0,8,5,7,6,25,3,0,16,11,2,1,1037697,"2023-11-08T00:00:00.000Z",3547264,12,"Jalen Smith",3,27,28,17,12,38.7
"19182",7663,1,2,3,0,0,3,3,0,0,15,1,1,6,4,1,0,1037700,"2023-11-08T00:00:00.000Z",17895854,27,"Charles Bassey",3,10,11,7,5,21.3
"19183",7664,0,0,1,0,0,1,1,2,0,3,0,0,2,1,0,0,1037700,"2023-11-08T00:00:00.000Z",38017730,27,"Dominick Barlow",0,3,3,2,1,3.2
"19184",7665,0,0,0,2,0,2,0,0,0,3,0,0,0,0,0,0,1037700,"2023-11-08T00:00:00.000Z",38017649,27,"Julian Champagnie",0,0,0,0,0,0
"19185",7666,0,0,0,0,0,0,0,0,0,0,0,0,0,0,0,0,1037700,"2023-11-08T00:00:00.000Z",180,27,"Devonte' Graham",0,0,0,0,0,0
"19186",7667,0,0,3,6,2,7,2,0,0,18,0,4,6,3,0,1,1037706,"2023-11-08T00:00:00.000Z",3547272,21,"Isaiah Joe",0,9,9,6,3,8.6
"19187",7668,0,0,0,0,0,0,0,0,0,0,0,0,0,0,0,0,1037706,"2023-11-08T00:00:00.000Z",17896036,21,"Tre Mann",0,0,0,0,0,0
"19188",7669,0,0,0,0,0,0,0,0,0,0,0,0,0,0,0,0,1037706,"2023-11-08T00:00:00.000Z",4197029,21,"Vasilije Micic",0,0,0,0,0,0
"19189",7670,0,0,0,0,0,0,0,0,0,0,0,0,0,0,0,0,1037706,"2023-11-08T00:00:00.000Z",3547271,21,"Aleksej Pokusevski",0,0,0,0,0,0
"19190",7671,6,0,2,9,5,17,8,3,3,32,0,2,24,2,1,0,1037700,"2023-11-08T00:00:00.000Z",666423,20,"RJ Barrett",1,26,32,30,8,38.4
"19191",7672,5,0,12,6,2,19,8,8,5,31,4,1,23,16,1,2,1037700,"2023-11-08T00:00:00.000Z",387,20,"Julius Randle",1,39,44,28,21,50.7
"19192",7673,1,0,7,0,0,4,3,6,2,31,5,3,8,12,0,0,1037700,"2023-11-08T00:00:00.000Z",399,20,"Mitchell Robinson",0,20,21,9,13,23.9
"19193",7674,6,0,2,8,5,19,8,4,4,33,0,2,25,2,0,0,1037700,"2023-11-08T00:00:00.000Z",73,20,"Jalen Brunson",0,27,33,31,8,36.4
"19194",7675,3,0,1,4,2,5,3,0,0,19,0,0,8,1,0,0,1037700,"2023-11-08T00:00:00.000Z",17895858,20,"Quentin Grimes",0,9,12,11,4,13.7
"19195",7676,3,0,3,9,4,19,8,2,2,31,1,3,22,4,0,5,3277351,"2023-11-03T00:00:00.000Z",265,30,"Kyle Kuzma",0,26,29,25,7,26.3
"19196",7677,3,0,4,0,0,15,8,2,2,30,0,3,18,4,0,4,3277351,"2023-11-03T00:00:00.000Z",4,16,"Bam Adebayo",0,22,25,21,7,23.3
"19197",7678,9,0,10,7,4,17,9,2,2,37,0,3,24,10,2,3,3277351,"2023-11-03T00:00:00.000Z",666633,16,"Tyler Herro",2,34,43,33,19,52.5
"19198",7679,7,0,1,4,1,4,1,0,0,26,2,1,3,3,2,2,3277351,"2023-11-03T00:00:00.000Z",286,16,"Kyle Lowry",2,6,13,10,10,21.1
"19199",7680,0,1,2,0,0,7,5,2,1,18,2,4,11,4,0,2,3277351,"2023-11-03T00:00:00.000Z",74,16,"Thomas Bryant",1,15,15,11,4,16.8
"19200",7681,0,0,0,0,0,0,0,0,0,0,0,0,0,0,0,0,3277353,"2023-11-03T00:00:00.000Z",56677858,10,"Brandin Podziemski",0,0,0,0,0,0
"19201",7682,0,0,0,0,0,0,0,0,0,0,0,0,0,0,0,0,3277353,"2023-11-03T00:00:00.000Z",45658838,10,"Lester Quinones",0,0,0,0,0,0
"19202",7683,1,0,9,0,0,4,0,0,0,29,6,4,0,15,0,0,3277350,"2023-11-03T00:00:00.000Z",399,20,"Mitchell Robinson",0,15,16,1,16,19.5
"19203",7684,2,0,4,10,5,11,6,0,0,34,0,3,17,4,0,1,3277350,"2023-11-03T00:00:00.000Z",17895858,20,"Quentin Grimes",0,21,23,19,6,23.8
"19204",7685,4,0,3,8,2,30,17,11,9,42,2,3,45,5,1,4,3277350,"2023-11-03T00:00:00.000Z",73,20,"Jalen Brunson",1,50,54,49,9,56
"19205",7686,1,0,3,3,1,10,5,3,3,22,0,1,14,3,0,1,3277350,"2023-11-03T00:00:00.000Z",3547269,20,"Immanuel Quickley",0,17,18,15,4,18.1
"19206",7687,0,0,2,0,0,3,2,0,0,18,1,3,4,3,0,2,3277350,"2023-11-03T00:00:00.000Z",201,20,"Isaiah Hartenstein",0,7,7,4,3,5.6
"19207",7688,0,0,3,4,1,8,1,0,0,18,1,0,3,4,0,1,3277350,"2023-11-03T00:00:00.000Z",131,20,"Donte DiVincenzo",0,7,7,3,4,6.8
"19208",7689,0,0,0,1,0,1,0,0,0,2,0,0,0,0,0,0,3277350,"2023-11-03T00:00:00.000Z",17896033,20,"Miles McBride",0,0,0,0,0,0
"19209",7690,0,0,0,0,0,0,0,0,0,0,0,0,0,0,0,0,3277350,"2023-11-03T00:00:00.000Z",666675,20,"DaQuan Jeffries",0,0,0,0,0,0
"19210",7691,6,0,1,8,4,11,7,0,0,29,0,0,18,1,1,2,3277351,"2023-11-03T00:00:00.000Z",397,16,"Duncan Robinson",1,19,25,24,7,29.2
"19211",7692,5,0,3,2,1,6,4,1,1,25,0,2,10,3,0,2,3277351,"2023-11-03T00:00:00.000Z",391,16,"Josh Richardson",0,13,18,15,8,19.1
"19212",7693,3,0,2,1,0,5,4,1,1,22,3,1,9,5,1,0,3277351,"2023-11-03T00:00:00.000Z",56677785,16,"Jaime Jaquez Jr.",1,14,17,12,8,22.5
"19213",7694,0,0,0,0,0,0,0,0,0,0,0,0,0,0,0,0,3277351,"2023-11-03T00:00:00.000Z",38017696,16,"Nikola Jovic",0,0,0,0,0,0
"19214",7695,0,0,0,0,0,0,0,0,0,0,0,0,0,0,0,0,3277351,"2023-11-03T00:00:00.000Z",285,16,"Kevin Love",0,0,0,0,0,0
"19215",7696,0,0,0,0,0,0,0,0,0,0,0,0,0,0,0,0,3277351,"2023-11-03T00:00:00.000Z",39398582,16,"Orlando Robinson",0,0,0,0,0,0
"19216",7697,0,0,0,0,0,0,0,0,0,0,0,0,0,0,0,0,3277351,"2023-11-03T00:00:00.000Z",19465585,16,"Dru Smith",0,0,0,0,0,0
"19217",7698,0,0,0,0,0,0,0,0,0,0,0,0,0,0,0,0,3277351,"2023-11-03T00:00:00.000Z",38017734,16,"Jamal Cain",0,0,0,0,0,0
"19218",7699,0,0,9,0,0,3,3,1,0,15,1,1,6,10,0,0,3277352,"2023-11-03T00:00:00.000Z",17896038,3,"Day'Ron Sharpe",0,16,16,6,10,18
"19219",7700,0,0,0,0,0,0,0,0,0,0,0,0,0,0,0,0,3277352,"2023-11-03T00:00:00.000Z",9051997,3,"Armoni Brooks",0,0,0,0,0,0
"19220",7701,1,1,6,3,3,5,4,0,0,25,0,2,11,6,0,1,1037636,"2023-10-30T00:00:00.000Z",3547256,1,"Saddiq Bey",1,17,18,12,7,21.7
"19221",7702,8,0,1,3,1,10,4,1,1,32,0,1,10,1,1,1,1037637,"2023-10-30T00:00:00.000Z",409,28,"Dennis Schroder",1,11,19,18,9,25.2
"19222",7703,0,0,5,3,0,7,2,0,0,21,1,3,4,6,2,0,1037637,"2023-10-30T00:00:00.000Z",56677828,28,"Gradey Dick",2,10,10,4,6,17.2
"19223",7704,2,0,1,1,0,7,1,3,1,19,0,2,3,1,1,0,1037637,"2023-10-30T00:00:00.000Z",3089,28,"Gary Trent Jr.",1,4,6,5,3,10.2
"19224",7705,0,0,1,2,0,5,3,0,0,15,0,1,6,1,1,1,1037637,"2023-10-30T00:00:00.000Z",3547275,28,"Malachi Flynn",1,7,7,6,1,9.2
"19225",7706,1,1,4,0,0,4,1,2,2,17,3,2,4,7,0,1,1037637,"2023-10-30T00:00:00.000Z",58,28,"Chris Boucher",1,11,12,5,8,15.9
"19226",7707,1,0,0,1,0,1,0,0,0,5,0,1,0,0,0,0,1037637,"2023-10-30T00:00:00.000Z",666762,28,"Jalen McDaniels",0,0,1,1,1,1.5
"19227",7708,0,0,0,0,0,0,0,0,0,0,0,0,0,0,0,0,1037637,"2023-10-30T00:00:00.000Z",38017717,28,"Ron Harper Jr.",0,0,0,0,0,0
"19228",7709,0,0,0,0,0,0,0,0,0,0,0,0,0,0,0,0,1037637,"2023-10-30T00:00:00.000Z",376,28,"Otto Porter Jr.",0,0,0,0,0,0
"19229",7710,0,0,0,0,0,0,0,0,0,0,0,0,0,0,0,0,1037637,"2023-10-30T00:00:00.000Z",436,28,"Garrett Temple",0,0,0,0,0,0
"19230",7711,0,0,0,0,0,0,0,0,0,0,0,0,0,0,0,0,1037637,"2023-10-30T00:00:00.000Z",489,28,"Thaddeus Young",0,0,0,0,0,0
"19231",7712,1,0,0,0,0,1,0,0,0,10,0,2,0,0,0,1,1037641,"2023-10-30T00:00:00.000Z",197,9,"Joe Harris",0,0,1,1,1,0.5
"19232",7713,2,0,2,2,2,4,2,0,0,14,0,1,6,2,1,0,1037641,"2023-10-30T00:00:00.000Z",56677792,9,"Marcus Sasser",1,8,10,8,4,14.4
"19233",7714,0,0,0,0,0,0,0,0,0,0,0,0,0,0,0,0,1037634,"2023-10-30T00:00:00.000Z",56677861,12,"Ben Sheppard",0,0,0,0,0,0
"19234",7715,0,0,0,0,0,0,0,0,0,0,0,0,0,0,0,0,1037634,"2023-10-30T00:00:00.000Z",439,12,"Daniel Theis",0,0,0,0,0,0
"19235",7716,0,0,0,0,0,0,0,0,0,0,0,0,0,0,0,0,1037634,"2023-10-30T00:00:00.000Z",56677832,12,"Jarace Walker",0,0,0,0,0,0
"19236",7717,2,0,3,1,1,2,2,0,0,17,2,2,5,5,0,3,1037640,"2023-10-30T00:00:00.000Z",340,19,"Larry Nance Jr.",0,10,12,7,7,11
"19237",7718,2,0,2,7,3,9,4,1,1,27,1,2,12,3,0,2,1037640,"2023-10-30T00:00:00.000Z",17896017,19,"Matt Ryan",0,15,17,14,5,16.6
"19238",7719,0,0,1,0,0,2,0,2,0,5,1,0,0,2,0,0,1037640,"2023-10-30T00:00:00.000Z",491,19,"Cody Zeller",0,2,2,0,2,2.4
"19239",7720,0,0,0,0,0,0,0,0,0,0,0,0,0,0,0,0,1037640,"2023-10-30T00:00:00.000Z",38017663,19,"E.J. Liddell",0,0,0,0,0,0
"19240",7721,0,0,0,0,0,0,0,0,0,0,0,0,0,0,0,0,1037640,"2023-10-30T00:00:00.000Z",17896097,19,"Jose Alvarado",0,0,0,0,0,0
"19241",7722,0,0,0,0,0,0,0,0,0,0,0,0,0,0,0,0,1037640,"2023-10-30T00:00:00.000Z",3547293,19,"Naji Marshall",0,0,0,0,0,0
"19242",7723,0,0,0,0,0,0,0,0,0,0,0,0,0,0,0,0,1037640,"2023-10-30T00:00:00.000Z",18677986,19,"Trey Murphy III",0,0,0,0,0,0
"19243",7724,0,0,0,0,0,0,0,0,0,0,0,0,0,0,0,0,1037640,"2023-10-30T00:00:00.000Z",38017726,19,"Dereon Seabron",0,0,0,0,0,0
"19244",7725,0,0,2,2,1,8,4,2,0,20,1,2,9,3,0,3,1037640,"2023-10-30T00:00:00.000Z",475,10,"Andrew Wiggins",0,12,12,9,3,9.6
"19245",7726,2,0,0,3,1,3,1,2,0,13,0,1,3,0,0,1,1037636,"2023-10-30T00:00:00.000Z",666400,18,"Nickeil Alexander-Walker",0,3,5,5,2,5
"19246",7727,0,0,0,0,0,0,0,0,0,0,0,0,0,0,0,0,1037637,"2023-10-30T00:00:00.000Z",376,28,"Otto Porter Jr.",0,0,0,0,0,0
"19247",7728,0,0,0,0,0,0,0,0,0,0,0,0,0,0,0,0,1037637,"2023-10-30T00:00:00.000Z",436,28,"Garrett Temple",0,0,0,0,0,0
"19248",7729,0,0,0,0,0,0,0,0,0,0,0,0,0,0,0,0,1037637,"2023-10-30T00:00:00.000Z",489,28,"Thaddeus Young",0,0,0,0,0,0
"19249",7730,1,0,0,0,0,1,0,0,0,10,0,2,0,0,0,1,1037641,"2023-10-30T00:00:00.000Z",197,9,"Joe Harris",0,0,1,1,1,0.5
"19250",7731,2,0,2,2,2,4,2,0,0,14,0,1,6,2,1,0,1037641,"2023-10-30T00:00:00.000Z",56677792,9,"Marcus Sasser",1,8,10,8,4,14.4
"19251",7732,0,0,0,0,0,0,0,0,0,0,0,0,0,0,0,0,1037634,"2023-10-30T00:00:00.000Z",56677861,12,"Ben Sheppard",0,0,0,0,0,0
"19252",7733,0,0,0,0,0,0,0,0,0,0,0,0,0,0,0,0,1037634,"2023-10-30T00:00:00.000Z",439,12,"Daniel Theis",0,0,0,0,0,0
"19253",7734,0,0,0,0,0,0,0,0,0,0,0,0,0,0,0,0,1037634,"2023-10-30T00:00:00.000Z",56677832,12,"Jarace Walker",0,0,0,0,0,0
"19254",7735,2,0,3,1,1,2,2,0,0,17,2,2,5,5,0,3,1037640,"2023-10-30T00:00:00.000Z",340,19,"Larry Nance Jr.",0,10,12,7,7,11
"19255",7736,2,0,2,7,3,9,4,1,1,27,1,2,12,3,0,2,1037640,"2023-10-30T00:00:00.000Z",17896017,19,"Matt Ryan",0,15,17,14,5,16.6
"19256",7737,0,0,1,0,0,2,0,2,0,5,1,0,0,2,0,0,1037640,"2023-10-30T00:00:00.000Z",491,19,"Cody Zeller",0,2,2,0,2,2.4
"19257",7738,0,0,0,0,0,0,0,0,0,0,0,0,0,0,0,0,1037640,"2023-10-30T00:00:00.000Z",38017663,19,"E.J. Liddell",0,0,0,0,0,0
"19258",7739,0,0,0,0,0,0,0,0,0,0,0,0,0,0,0,0,1037640,"2023-10-30T00:00:00.000Z",17896097,19,"Jose Alvarado",0,0,0,0,0,0
"19259",7740,0,0,0,0,0,0,0,0,0,0,0,0,0,0,0,0,1037640,"2023-10-30T00:00:00.000Z",3547293,19,"Naji Marshall",0,0,0,0,0,0
"19260",7741,0,0,0,0,0,0,0,0,0,0,0,0,0,0,0,0,1037640,"2023-10-30T00:00:00.000Z",18677986,19,"Trey Murphy III",0,0,0,0,0,0
"19261",7742,0,0,0,0,0,0,0,0,0,0,0,0,0,0,0,0,1037640,"2023-10-30T00:00:00.000Z",38017726,19,"Dereon Seabron",0,0,0,0,0,0
"19262",7743,0,0,2,2,1,8,4,2,0,20,1,2,9,3,0,3,1037640,"2023-10-30T00:00:00.000Z",475,10,"Andrew Wiggins",0,12,12,9,3,9.6
"19263",7744,7,1,5,2,0,8,3,0,0,21,1,2,6,6,0,1,1037640,"2023-10-30T00:00:00.000Z",185,10,"Draymond Green",1,12,19,13,13,25.7
"19264",7745,1,0,5,0,0,5,3,2,2,24,2,2,8,7,1,1,1037640,"2023-10-30T00:00:00.000Z",282,10,"Kevon Looney",1,15,16,9,8,19.9
"19265",7746,0,4,2,0,0,10,5,4,3,20,8,2,13,10,0,2,1037640,"2023-10-30T00:00:00.000Z",56677799,10,"Trayce Jackson-Davis",4,23,23,13,10,35
"19266",7747,1,0,1,1,0,1,0,0,0,5,0,2,0,1,0,0,1037640,"2023-10-30T00:00:00.000Z",251,10,"Cory Joseph",0,1,2,1,2,2.7
"19267",7748,0,0,0,0,0,0,0,0,0,0,0,0,0,0,0,0,1037637,"2023-10-30T00:00:00.000Z",3547249,28,"Precious Achiuwa",0,0,0,0,0,0
"19268",7749,0,0,0,0,0,0,0,0,0,0,0,0,0,0,0,0,1037637,"2023-10-30T00:00:00.000Z",56677805,28,"Javon Freeman-Liberty",0,0,0,0,0,0
"19269",7750,0,0,0,0,0,0,0,0,0,0,0,0,0,0,0,0,1037637,"2023-10-30T00:00:00.000Z",38017710,28,"Christian Koloko",0,0,0,0,0,0
"19270",7751,0,0,0,0,0,0,0,0,0,0,0,0,0,0,0,0,1037607,"2023-10-26T00:00:00.000Z",284,17,"Robin Lopez",0,0,0,0,0,0
"19271",7752,0,0,0,0,0,0,0,0,0,2,0,0,0,0,0,0,1037606,"2023-10-25T00:00:00.000Z",56677829,25,"Rayan Rupert",0,0,0,0,0,0
"19272",7753,4,0,3,3,1,5,2,2,1,16,0,0,6,3,2,2,1037607,"2023-10-26T00:00:00.000Z",315,17,"Khris Middleton",2,9,13,10,7,19.6
"19273",7754,3,2,8,3,0,22,10,9,3,35,5,4,23,13,2,7,1037607,"2023-10-26T00:00:00.000Z",15,17,"Giannis Antetokounmpo",4,36,39,26,16,48.1
"19274",7755,0,0,1,4,3,7,5,0,0,29,1,4,13,2,0,2,1037607,"2023-10-26T00:00:00.000Z",283,17,"Brook Lopez",0,15,15,13,2,13.4
"19275",7756,3,0,4,1,1,4,2,0,0,31,0,1,5,4,2,2,1037607,"2023-10-26T00:00:00.000Z",38,17,"Malik Beasley",2,9,12,8,7,18.3
"19276",7757,4,0,8,12,4,20,9,17,17,37,0,2,39,8,0,0,1037607,"2023-10-26T00:00:00.000Z",278,17,"Damian Lillard",0,47,51,43,12,54.6
"19277",7758,2,0,4,1,1,4,3,2,2,27,0,3,9,4,2,1,1037607,"2023-10-26T00:00:00.000Z",112,17,"Jae Crowder",2,13,15,11,6,21.8
"19278",7759,2,1,2,4,1,6,2,2,2,20,0,0,7,2,0,0,1037607,"2023-10-26T00:00:00.000Z",105,17,"Pat Connaughton",1,9,11,9,4,15.4
"19279",7760,0,0,1,1,0,3,2,0,0,17,1,3,4,2,0,0,1037607,"2023-10-26T00:00:00.000Z",38017676,17,"MarJon Beauchamp",0,6,6,4,2,6.4
"19280",7761,0,0,0,0,0,0,0,0,0,0,0,0,0,0,0,0,1037607,"2023-10-26T00:00:00.000Z",2148,17,"Thanasis Antetokounmpo",0,0,0,0,0,0
"19281",7762,0,0,0,0,0,0,0,0,0,0,0,0,0,0,0,0,1037607,"2023-10-26T00:00:00.000Z",38017733,17,"A.J. Green",0,0,0,0,0,0
"19282",7763,0,0,0,0,0,0,0,0,0,0,0,0,0,0,0,0,1037608,"2023-10-26T00:00:00.000Z",56677738,14,"Colin Castleton",0,0,0,0,0,0
"19283",7764,0,0,0,0,0,0,0,0,0,0,0,0,0,0,0,0,1037608,"2023-10-26T00:00:00.000Z",38017697,14,"Max Christie",0,0,0,0,0,0
"19284",7765,0,0,0,0,0,0,0,0,0,0,0,0,0,0,0,0,1037608,"2023-10-26T00:00:00.000Z",56677868,14,"D'Moi Hodge",0,0,0,0,0,0
"19285",7766,0,0,0,0,0,0,0,0,0,0,0,0,0,0,0,0,1037608,"2023-10-26T00:00:00.000Z",56677836,14,"Maxwell Lewis",0,0,0,0,0,0
"19286",7767,0,0,3,6,5,11,9,4,4,32,1,4,27,4,1,3,1037607,"2023-10-26T00:00:00.000Z",360,23,"Kelly Oubre Jr.",1,31,31,27,4,31.8
"19287",7768,1,0,2,1,0,1,0,0,0,14,0,0,0,2,1,0,1037607,"2023-10-26T00:00:00.000Z",184,23,"Danny Green",1,2,3,1,3,6.9
"19288",7769,2,0,2,0,0,1,1,0,0,13,0,2,2,2,0,0,1037607,"2023-10-26T00:00:00.000Z",45,23,"Patrick Beverley",0,4,6,4,4,7.4
"19289",7770,2,1,3,1,0,2,1,2,1,12,1,4,3,4,0,2,1037607,"2023-10-26T00:00:00.000Z",3547270,23,"Paul Reed",1,7,9,5,6,11.8
"19290",7771,0,2,0,1,0,1,0,0,0,5,0,1,0,0,0,0,1037607,"2023-10-26T00:00:00.000Z",17896025,23,"Jaden Springer",2,0,0,0,0,6
"19291",7772,0,0,0,0,0,0,0,0,0,0,0,0,0,0,0,0,1037607,"2023-10-26T00:00:00.000Z",28,23,"Mo Bamba",0,0,0,0,0,0
"19292",7773,0,0,0,0,0,0,0,0,0,0,0,0,0,0,0,0,1037607,"2023-10-26T00:00:00.000Z",2175,23,"Danuel House Jr.",0,0,0,0,0,0
"19293",7774,0,0,0,0,0,0,0,0,0,0,0,0,0,0,0,0,1037607,"2023-10-26T00:00:00.000Z",260,23,"Furkan Korkmaz",0,0,0,0,0,0
"19294",7775,0,0,0,0,0,0,0,0,0,0,0,0,0,0,0,0,1037607,"2023-10-26T00:00:00.000Z",17895941,23,"Filip Petrusev",0,0,0,0,0,0
"19295",7776,8,1,2,5,2,17,11,5,4,34,0,3,28,2,1,3,1038114,"2024-01-10T00:00:00.000Z",175,21,"Shai Gilgeous-Alexander",2,30,38,36,10,45.4
"19296",7777,0,0,0,0,0,0,0,0,0,0,0,0,0,0,0,0,1038113,"2024-01-10T00:00:00.000Z",145,23,"Joel Embiid",0,0,0,0,0,0
"19297",7778,5,1,3,1,1,5,4,0,0,19,0,2,9,3,2,1,1038116,"2024-01-10T00:00:00.000Z",358,29,"Kelly Olynyk",3,12,17,14,8,28.1
"19298",7779,0,0,0,0,0,0,0,0,0,3,0,0,0,0,0,0,1038116,"2024-01-10T00:00:00.000Z",56677842,29,"Brice Sensabaugh",0,0,0,0,0,0
"19299",7780,1,0,0,0,0,0,0,2,1,3,0,0,1,0,0,0,1038116,"2024-01-10T00:00:00.000Z",666881,29,"Luka Samanic",0,1,2,2,1,2.5
"19300",7781,0,0,2,0,0,1,1,0,0,3,0,0,2,2,0,2,1038116,"2024-01-10T00:00:00.000Z",11891374,29,"Omer Yurtseven",0,4,4,2,2,2.4
"19301",7782,0,0,0,0,0,0,0,0,0,0,0,0,0,0,0,0,1038116,"2024-01-10T00:00:00.000Z",38017630,29,"Johnny Juzang",0,0,0,0,0,0
"19302",7783,0,0,0,0,0,0,0,0,0,0,0,0,0,0,0,0,1038116,"2024-01-10T00:00:00.000Z",19465584,29,"Micah Potter",0,0,0,0,0,0
"19303",7784,0,0,0,0,0,0,0,0,0,0,0,0,0,0,0,0,1038116,"2024-01-10T00:00:00.000Z",17896042,29,"Jason Preston",0,0,0,0,0,0
"19304",7785,1,0,3,3,1,9,2,0,0,24,1,2,5,4,0,1,1038116,"2024-01-10T00:00:00.000Z",375,8,"Michael Porter Jr.",0,9,10,6,5,10.3
"19305",7786,4,0,3,2,2,6,5,0,0,29,2,4,12,5,1,2,1038116,"2024-01-10T00:00:00.000Z",177,8,"Aaron Gordon",1,17,21,16,9,25
"19306",7787,6,0,10,1,1,9,8,12,10,30,1,3,27,11,1,6,1038116,"2024-01-10T00:00:00.000Z",246,8,"Nikola Jokic",1,38,44,33,17,46.2
"19307",7788,1,0,0,3,1,3,1,0,0,12,0,2,3,0,2,0,1038116,"2024-01-10T00:00:00.000Z",215,8,"Justin Holiday",2,3,4,4,1,10.5
"19308",7789,1,0,1,1,1,3,2,4,3,6,0,0,8,1,0,0,1038116,"2024-01-10T00:00:00.000Z",38017727,8,"Collin Gillespie",0,9,10,9,2,10.7
"19309",7790,7,2,1,4,2,18,10,7,7,38,2,3,29,3,1,0,1038118,"2024-01-10T00:00:00.000Z",274,13,"Kawhi Leonard",3,32,39,36,10,52.1
"19310",7791,6,1,7,9,5,22,12,0,0,38,0,4,29,7,2,0,1038118,"2024-01-10T00:00:00.000Z",172,13,"Paul George",3,36,42,35,13,55.4
"19311",7792,3,1,6,0,0,8,6,0,0,31,5,2,12,11,0,2,1038118,"2024-01-10T00:00:00.000Z",493,13,"Ivica Zubac",1,23,26,15,14,30.7
"19312",7793,1,0,0,3,3,5,5,0,0,24,2,1,13,2,0,1,1038118,"2024-01-10T00:00:00.000Z",666743,13,"Terance Mann",0,15,16,14,3,15.9
"19313",7794,11,0,5,7,2,13,5,2,2,34,0,4,14,5,1,3,1038118,"2024-01-10T00:00:00.000Z",192,13,"James Harden",1,19,30,25,16,36.5
"19314",7795,1,0,1,2,0,5,3,0,0,18,0,1,6,1,1,0,1038118,"2024-01-10T00:00:00.000Z",666511,13,"Amir Coffey",1,7,8,7,2,11.7
"19315",7796,0,0,0,0,0,0,0,0,0,0,0,0,0,0,0,0,1038118,"2024-01-10T00:00:00.000Z",17896022,13,"Brandon Boston Jr.",0,0,0,0,0,0
"19316",7797,0,0,0,0,0,0,0,0,0,0,0,0,0,0,0,0,1038118,"2024-01-10T00:00:00.000Z",56677849,13,"Kobe Brown",0,0,0,0,0,0
"19317",7798,0,0,0,0,0,0,0,0,0,0,0,0,0,0,0,0,1038118,"2024-01-10T00:00:00.000Z",17896031,13,"Nah'Shon Hyland",0,0,0,0,0,0
"19318",7799,0,0,0,0,0,0,0,0,0,0,0,0,0,0,0,0,1038118,"2024-01-10T00:00:00.000Z",371,13,"Mason Plumlee",0,0,0,0,0,0
"19319",7800,1,1,2,0,0,4,4,0,0,15,2,4,8,4,2,1,1038116,"2024-01-10T00:00:00.000Z",38017705,29,"Walker Kessler",3,12,13,9,5,22.3
"19320",7801,0,0,0,0,0,0,0,0,0,0,0,0,0,0,0,0,1038112,"2024-01-10T00:00:00.000Z",3547264,12,"Jalen Smith",0,0,0,0,0,0
"19321",7802,0,0,0,0,0,0,0,0,0,0,0,0,0,0,0,0,1038112,"2024-01-10T00:00:00.000Z",56677778,12,"Oscar Tshiebwe",0,0,0,0,0,0
"19322",7803,0,0,2,3,2,3,2,0,0,17,2,1,6,4,1,0,1038111,"2024-01-10T00:00:00.000Z",17896071,9,"Isaiah Livers",1,10,10,6,4,13.8
"19323",7804,2,0,2,5,3,13,8,0,0,33,0,1,19,2,1,4,1038111,"2024-01-10T00:00:00.000Z",54,9,"Bojan Bogdanovic",1,21,23,21,4,23.4
"19324",7805,2,0,10,0,0,16,10,1,1,30,2,4,21,12,0,1,1038111,"2024-01-10T00:00:00.000Z",38017694,9,"Jalen Duren",0,33,35,23,14,37.4
"19325",7806,5,2,3,10,2,18,7,5,3,30,0,0,19,3,2,1,1038111,"2024-01-10T00:00:00.000Z",38017682,9,"Jaden Ivey",4,22,27,24,8,41.1
"19326",7807,12,0,3,0,0,8,2,0,0,32,1,1,4,4,0,1,1038111,"2024-01-10T00:00:00.000Z",3547241,9,"Killian Hayes",0,8,20,16,16,25.8
"19327",7808,0,0,1,5,2,11,5,0,0,24,3,2,12,4,0,0,1038111,"2024-01-10T00:00:00.000Z",259,9,"Kevin Knox",0,16,16,12,4,16.8
"19328",7809,2,0,2,5,1,13,5,4,4,20,0,1,15,2,0,1,1038111,"2024-01-10T00:00:00.000Z",77,9,"Alec Burks",0,17,19,17,4,19.4
"19329",7810,5,0,1,1,0,7,3,0,0,16,1,2,6,2,0,1,1038111,"2024-01-10T00:00:00.000Z",56677792,9,"Marcus Sasser",0,8,13,11,7,14.9
"19330",7811,1,1,6,3,0,6,1,1,1,15,0,4,3,6,0,1,1038111,"2024-01-10T00:00:00.000Z",56677826,9,"Ausar Thompson",1,9,10,4,7,13.7
"19331",7812,3,0,3,0,0,1,1,2,1,17,0,2,3,3,0,0,1038111,"2024-01-10T00:00:00.000Z",3547240,9,"James Wiseman",0,6,9,6,6,11.1
"19332",7813,0,0,1,0,0,0,0,0,0,6,0,1,0,1,0,0,1038111,"2024-01-10T00:00:00.000Z",197,9,"Joe Harris",0,1,1,0,1,1.2
"19333",7814,0,0,0,0,0,0,0,0,0,0,0,0,0,0,0,0,1038111,"2024-01-10T00:00:00.000Z",24,9,"Marvin Bagley III",0,0,0,0,0,0
"19334",7815,0,0,0,0,0,0,0,0,0,0,0,0,0,0,0,0,1038111,"2024-01-10T00:00:00.000Z",3547267,9,"Isaiah Stewart",0,0,0,0,0,0
"19335",7816,0,0,0,0,0,0,0,0,0,0,0,0,0,0,0,0,1038111,"2024-01-10T00:00:00.000Z",56677729,9,"Malcolm Cazalon",0,0,0,0,0,0
"19336",7817,0,0,1,0,0,3,1,0,0,16,0,1,2,1,0,0,1038110,"2024-01-10T00:00:00.000Z",422,4,"Ish Smith",0,3,3,2,1,3.2
"19337",7819,0,0,3,2,0,7,1,0,0,21,2,2,2,5,0,0,1038110,"2024-01-10T00:00:00.000Z",18678001,4,"JT Thor",0,7,7,2,5,8
"19338",7820,1,0,3,8,2,15,4,2,1,25,0,3,11,3,0,2,1038110,"2024-01-10T00:00:00.000Z",56677846,4,"Nick Smith Jr.",0,14,15,12,4,14.1
"19339",7821,1,0,0,6,2,8,3,0,0,20,0,0,8,0,0,0,1038110,"2024-01-10T00:00:00.000Z",17896037,4,"James Bouknight",0,8,9,9,1,9.5
"19340",7822,0,0,0,0,0,0,0,0,0,0,0,0,0,0,0,0,1038110,"2024-01-10T00:00:00.000Z",347,4,"Frank Ntilikina",0,0,0,0,0,0
"19341",7823,0,0,0,0,0,0,0,0,0,0,0,0,0,0,0,0,1038110,"2024-01-10T00:00:00.000Z",56677848,4,"Amari Bailey",0,0,0,0,0,0
"19342",7824,0,0,0,0,0,0,0,0,0,0,0,0,0,0,0,0,1038111,"2024-01-10T00:00:00.000Z",17896075,9,"Cade Cunningham",0,0,0,0,0,0
"19343",7825,0,0,0,0,0,0,0,0,0,0,0,0,0,0,0,0,1038111,"2024-01-10T00:00:00.000Z",330,9,"Monte Morris",0,0,0,0,0,0
"19344",7826,0,0,0,0,0,0,0,0,0,0,0,0,0,0,0,0,1038079,"2024-01-05T00:00:00.000Z",47957121,25,"Justin Minaya",0,0,0,0,0,0
"19345",7827,0,0,0,0,0,0,0,0,0,0,0,0,0,0,0,0,1038089,"2024-01-07T00:00:00.000Z",17896049,27,"David Duke Jr.",0,0,0,0,0,0
"19346",7828,0,0,3,3,1,4,2,2,1,16,1,0,6,4,0,1,1038080,"2024-01-05T00:00:00.000Z",38017709,8,"Christian Braun",0,10,10,6,4,9.8
"19347",7829,3,0,2,5,1,12,5,0,0,17,1,0,11,3,0,1,1038080,"2024-01-05T00:00:00.000Z",236,8,"Reggie Jackson",0,14,17,14,6,18.1
"19348",7830,0,0,1,0,0,1,1,2,1,11,1,4,3,2,1,2,1038080,"2024-01-05T00:00:00.000Z",3547268,8,"Zeke Nnaji",1,5,5,3,2,6.4
"19349",7831,1,0,1,1,0,1,0,0,0,10,0,1,0,1,0,0,1038080,"2024-01-05T00:00:00.000Z",215,8,"Justin Holiday",0,1,2,1,2,2.7
"19350",7832,1,0,2,2,1,3,1,0,0,6,0,1,3,2,0,0,1038080,"2024-01-05T00:00:00.000Z",17896007,8,"Braxton Key",0,5,6,4,3,6.9
"19351",7833,0,0,0,0,0,0,0,0,0,0,0,0,0,0,0,0,1038080,"2024-01-05T00:00:00.000Z",38017727,8,"Collin Gillespie",0,0,0,0,0,0
"19352",7834,0,0,0,0,0,0,0,0,0,0,0,0,0,0,0,0,1038080,"2024-01-05T00:00:00.000Z",17896103,8,"Jay Huff",0,0,0,0,0,0
"19353",7835,0,0,0,0,0,0,0,0,0,0,0,0,0,0,0,0,1038080,"2024-01-05T00:00:00.000Z",250,8,"DeAndre Jordan",0,0,0,0,0,0
"19354",7836,0,0,0,0,0,0,0,0,0,0,0,0,0,0,0,0,1038076,"2024-01-05T00:00:00.000Z",17896037,4,"James Bouknight",0,0,0,0,0,0
"19355",7837,0,0,0,0,0,0,0,0,0,0,0,0,0,0,0,0,1038079,"2024-01-05T00:00:00.000Z",476,25,"Robert Williams III",0,0,0,0,0,0
"19356",7838,0,0,0,0,0,0,0,0,0,0,0,0,0,0,0,0,1038088,"2024-01-06T00:00:00.000Z",666453,17,"Marques Bolden",0,0,0,0,0,0
"19357",7839,0,0,0,0,0,0,0,0,0,0,0,0,0,0,0,0,1038088,"2024-01-06T00:00:00.000Z",112,17,"Jae Crowder",0,0,0,0,0,0
"19358",7840,0,0,0,0,0,0,0,0,0,0,0,0,0,0,0,0,1038088,"2024-01-06T00:00:00.000Z",56677854,17,"Chris Livingston",0,0,0,0,0,0
"19359",7841,0,0,0,0,0,0,0,0,0,0,0,0,0,0,0,0,1038088,"2024-01-06T00:00:00.000Z",38017691,17,"TyTy Washington Jr.",0,0,0,0,0,0
"19360",7842,0,0,0,0,0,0,0,0,0,0,0,0,0,0,0,0,1038088,"2024-01-06T00:00:00.000Z",666960,17,"Lindell Wigginton",0,0,0,0,0,0
"19361",7843,1,0,3,3,1,3,1,0,0,24,1,0,3,4,0,0,1038081,"2024-01-05T00:00:00.000Z",38017696,16,"Nikola Jovic",0,7,8,4,5,9.3
"19362",7844,1,1,9,0,0,19,11,7,6,36,2,2,28,11,0,1,1038081,"2024-01-05T00:00:00.000Z",4,16,"Bam Adebayo",1,39,40,29,12,44.7
"19363",7845,6,0,4,7,1,17,4,0,0,35,0,2,9,4,0,1,1038081,"2024-01-05T00:00:00.000Z",666633,16,"Tyler Herro",0,13,19,15,10,21.8
"19364",7846,4,0,2,6,2,7,2,0,0,23,1,2,6,3,0,4,1038081,"2024-01-05T00:00:00.000Z",286,16,"Kyle Lowry",0,9,13,10,7,11.6
"19365",7847,2,0,4,6,3,9,6,6,5,20,3,4,20,7,0,2,1038081,"2024-01-05T00:00:00.000Z",285,16,"Kevin Love",0,27,29,22,9,29.4
"19366",7848,1,0,3,6,4,14,9,0,0,31,0,2,22,3,2,0,1038080,"2024-01-05T00:00:00.000Z",375,8,"Michael Porter Jr.",2,25,26,23,4,33.1
"19367",7849,3,1,1,6,1,7,1,2,1,27,0,3,4,1,1,3,1038081,"2024-01-05T00:00:00.000Z",397,16,"Duncan Robinson",2,5,8,7,4,12.7
"19368",7850,7,0,7,6,1,9,2,5,5,29,1,3,10,8,2,0,1038081,"2024-01-05T00:00:00.000Z",391,16,"Josh Richardson",2,18,25,17,15,36.1
"19369",7851,0,0,0,0,0,0,0,0,0,0,0,0,0,0,0,0,1038055,"2024-01-02T00:00:00.000Z",165,22,"Markelle Fultz",0,0,0,0,0,0
"19370",7852,2,0,4,1,1,4,4,0,0,22,0,2,9,4,3,0,1038058,"2024-01-03T00:00:00.000Z",3547250,12,"Aaron Nesmith",3,13,15,11,6,25.8
"19371",7853,3,0,5,4,1,8,5,2,2,19,2,2,13,7,0,1,1038058,"2024-01-03T00:00:00.000Z",3547264,12,"Jalen Smith",0,20,23,16,10,24.9
"19372",7854,2,2,7,4,1,9,6,4,2,30,0,4,15,7,0,2,1038058,"2024-01-03T00:00:00.000Z",452,12,"Myles Turner",2,22,24,17,9,30.4
"19373",7855,2,0,5,1,0,7,5,6,5,28,0,6,15,5,0,4,1038058,"2024-01-03T00:00:00.000Z",69,12,"Bruce Brown",0,20,22,17,7,20
"19374",7856,12,3,2,11,5,20,10,6,6,34,0,1,31,2,1,0,1038058,"2024-01-03T00:00:00.000Z",3547245,12,"Tyrese Haliburton",4,33,45,43,14,63.4
"19375",7857,0,0,0,4,2,8,3,3,2,13,0,1,10,0,1,0,1038058,"2024-01-03T00:00:00.000Z",210,12,"Buddy Hield",1,10,10,10,0,13
"19376",7858,1,1,3,2,0,10,4,2,1,20,3,1,9,6,0,0,1038058,"2024-01-03T00:00:00.000Z",377,17,"Bobby Portis",1,15,16,10,7,20.7
"19377",7859,2,0,1,2,1,3,2,3,2,10,0,3,7,1,0,0,1038058,"2024-01-03T00:00:00.000Z",368,17,"Cameron Payne",0,8,10,9,3,11.2
"19378",7860,0,0,0,0,0,0,0,0,0,0,0,0,0,0,0,0,1038058,"2024-01-03T00:00:00.000Z",666960,17,"Lindell Wigginton",0,0,0,0,0,0
"19379",7861,0,0,0,0,0,0,0,0,0,0,0,0,0,0,0,0,1038058,"2024-01-03T00:00:00.000Z",666453,17,"Marques Bolden",0,0,0,0,0,0
"19380",7862,0,0,0,0,0,0,0,0,0,0,0,0,0,0,0,0,1038058,"2024-01-03T00:00:00.000Z",112,17,"Jae Crowder",0,0,0,0,0,0
"19381",7863,0,0,0,0,0,0,0,0,0,0,0,0,0,0,0,0,1038058,"2024-01-03T00:00:00.000Z",38017733,17,"A.J. Green",0,0,0,0,0,0
"19382",7864,0,0,0,0,0,0,0,0,0,0,0,0,0,0,0,0,1038058,"2024-01-03T00:00:00.000Z",38017691,17,"TyTy Washington Jr.",0,0,0,0,0,0
"19383",7865,0,0,0,0,0,0,0,0,0,0,0,0,0,0,0,0,1038057,"2024-01-03T00:00:00.000Z",38017662,6,"Isaiah Mobley",0,0,0,0,0,0
"19384",7866,0,0,0,0,0,0,0,0,0,0,0,0,0,0,0,0,1038057,"2024-01-03T00:00:00.000Z",404,6,"Ricky Rubio",0,0,0,0,0,0
"19385",7867,4,0,4,3,1,11,3,0,0,21,2,1,7,6,1,3,1038057,"2024-01-03T00:00:00.000Z",3547242,30,"Deni Avdija",1,13,17,11,10,20.2
"19386",7868,3,0,2,6,2,12,7,0,0,23,0,1,16,2,1,1,1038057,"2024-01-03T00:00:00.000Z",265,30,"Kyle Kuzma",1,18,21,19,5,24.9
"19387",7869,1,1,2,0,0,8,6,1,0,20,3,2,12,5,0,0,1038057,"2024-01-03T00:00:00.000Z",666577,30,"Daniel Gafford",1,17,18,13,6,22.5
"19388",7870,2,0,0,4,2,11,3,0,0,23,3,3,8,3,0,1,1038057,"2024-01-03T00:00:00.000Z",666848,30,"Jordan Poole",0,11,13,10,5,13.6
"19389",7871,2,1,2,2,1,11,4,0,0,21,0,0,9,2,1,0,1038057,"2024-01-03T00:00:00.000Z",249,30,"Tyus Jones",2,11,13,11,4,20.4
"19390",7872,1,2,4,4,1,12,2,2,0,32,1,4,5,5,3,2,1038057,"2024-01-03T00:00:00.000Z",56677844,30,"Bilal Coulibaly",5,10,11,6,6,25.5
"19391",7873,1,0,1,1,1,2,2,0,0,9,0,0,5,1,0,0,1038057,"2024-01-03T00:00:00.000Z",18677954,30,"Jared Butler",0,6,7,6,2,7.7
"19392",7874,0,0,0,0,0,3,1,0,0,5,0,0,2,0,0,0,1038057,"2024-01-03T00:00:00.000Z",38017687,30,"Johnny Davis",0,2,2,2,0,2
"19393",7875,0,0,0,0,0,0,0,0,0,0,0,0,0,0,0,0,1038057,"2024-01-03T00:00:00.000Z",167,30,"Danilo Gallinari",0,0,0,0,0,0
"19394",7876,0,0,2,1,0,1,0,0,0,8,0,1,0,2,0,1,1038031,"2023-12-30T00:00:00.000Z",3547257,16,"R.J. Hampton",0,2,2,0,2,1.4
"19395",7877,0,0,0,0,0,0,0,0,0,0,0,0,0,0,0,0,1038030,"2023-12-29T00:00:00.000Z",666505,15,"Brandon Clarke",0,0,0,0,0,0
"19396",7878,0,0,0,0,0,0,0,0,0,0,0,0,0,0,0,0,1038030,"2023-12-29T00:00:00.000Z",56677830,15,"GG Jackson",0,0,0,0,0,0
"19397",7879,0,0,0,0,0,0,0,0,0,0,0,0,0,0,0,0,1038030,"2023-12-29T00:00:00.000Z",254,15,"Luke Kennard",0,0,0,0,0,0
"19398",7880,0,0,0,0,0,0,0,0,0,0,0,0,0,0,0,0,1038030,"2023-12-29T00:00:00.000Z",38017728,15,"Jake LaRavia",0,0,0,0,0,0
"19399",7881,0,0,0,0,0,0,0,0,0,0,0,0,0,0,0,0,1038030,"2023-12-29T00:00:00.000Z",401,15,"Derrick Rose",0,0,0,0,0,0
"19400",7882,2,1,4,5,1,9,4,6,3,31,3,4,12,7,2,0,1038031,"2023-12-30T00:00:00.000Z",38017739,29,"Simone Fontecchio",3,19,21,14,9,32.4
"19401",7883,1,0,3,8,1,13,4,4,3,26,2,4,12,5,2,0,1038031,"2023-12-30T00:00:00.000Z",297,29,"Lauri Markkanen",2,17,18,13,6,25.5
"19402",7884,0,0,6,6,2,11,4,0,0,21,0,3,10,6,0,1,1038031,"2023-12-30T00:00:00.000Z",101,29,"John Collins",0,16,16,10,6,16.2
"19403",7885,6,1,1,1,0,5,1,0,0,18,0,3,2,1,2,1,1038031,"2023-12-30T00:00:00.000Z",139,29,"Kris Dunn",3,3,9,8,7,20.2
"19404",7886,5,0,1,4,1,14,8,6,5,26,1,1,22,2,1,3,1038031,"2023-12-30T00:00:00.000Z",413,29,"Collin Sexton",1,24,29,27,7,31.9
"19405",7887,0,2,8,0,0,5,5,0,0,23,0,1,10,8,0,0,1038031,"2023-12-30T00:00:00.000Z",38017705,29,"Walker Kessler",2,18,18,10,8,25.6
"19406",7888,2,0,6,8,5,10,6,5,4,28,0,3,21,6,0,2,1038031,"2023-12-30T00:00:00.000Z",56677834,29,"Keyonte George",0,27,29,23,8,29.2
"19407",7889,3,0,2,5,1,10,3,2,2,25,0,0,9,2,0,0,1038031,"2023-12-30T00:00:00.000Z",100,29,"Jordan Clarkson",0,11,14,12,5,15.9
"19408",7890,10,1,3,1,0,12,8,3,3,27,3,5,19,6,1,3,1038031,"2023-12-30T00:00:00.000Z",358,29,"Kelly Olynyk",2,25,35,29,16,44.2
"19409",7891,0,1,0,3,0,4,0,2,0,15,0,1,0,0,0,0,1038031,"2023-12-30T00:00:00.000Z",38017620,29,"Ochai Agbaji",1,0,0,0,0,3
"19410",7892,0,0,0,0,0,0,0,0,0,0,0,0,0,0,0,0,1038031,"2023-12-30T00:00:00.000Z",666650,29,"Talen Horton-Tucker",0,0,0,0,0,0
"19411",7893,0,0,0,0,0,0,0,0,0,0,0,0,0,0,0,0,1038031,"2023-12-30T00:00:00.000Z",666881,29,"Luka Samanic",0,0,0,0,0,0
"19412",7894,0,0,0,0,0,0,0,0,0,0,0,0,0,0,0,0,1038031,"2023-12-30T00:00:00.000Z",11891374,29,"Omer Yurtseven",0,0,0,0,0,0
"19413",7895,0,0,0,0,0,0,0,0,0,0,0,0,0,0,0,0,1038031,"2023-12-30T00:00:00.000Z",17896023,29,"Josh Christopher",0,0,0,0,0,0
"19414",7896,0,0,0,0,0,0,0,0,0,0,0,0,0,0,0,0,1038031,"2023-12-30T00:00:00.000Z",56677824,29,"Taylor Hendricks",0,0,0,0,0,0
"19415",7897,0,0,0,0,0,0,0,0,0,0,0,0,0,0,0,0,1038031,"2023-12-30T00:00:00.000Z",38017630,29,"Johnny Juzang",0,0,0,0,0,0
"19416",7898,0,0,0,0,0,0,0,0,0,0,0,0,0,0,0,0,1038031,"2023-12-30T00:00:00.000Z",19465584,29,"Micah Potter",0,0,0,0,0,0
"19417",7899,3,0,7,6,2,14,7,5,3,37,0,2,19,7,0,4,1038032,"2023-12-30T00:00:00.000Z",54,9,"Bojan Bogdanovic",0,26,29,22,10,27.9
"19418",7900,2,1,2,8,3,14,7,0,0,31,0,2,17,2,1,1,1038032,"2023-12-30T00:00:00.000Z",259,9,"Kevin Knox",2,19,21,19,4,27.4
"19419",7901,0,0,0,0,0,0,0,0,0,0,0,0,0,0,0,0,1038006,"2023-12-26T00:00:00.000Z",347,4,"Frank Ntilikina",0,0,0,0,0,0
"19420",7902,5,0,1,2,0,8,3,2,2,24,1,2,8,2,1,1,1038006,"2023-12-26T00:00:00.000Z",204,4,"Gordon Hayward",1,10,15,13,7,19.9
"19421",7903,5,2,10,10,3,23,9,0,0,38,1,5,21,11,0,2,1038006,"2023-12-26T00:00:00.000Z",62,4,"Miles Bridges",2,32,37,26,16,45.7
"19422",7904,1,0,2,1,1,8,5,2,1,24,0,1,12,2,2,0,1038008,"2023-12-27T00:00:00.000Z",3547242,30,"Deni Avdija",2,14,15,13,3,21.9
"19423",7905,7,0,2,5,1,13,6,2,1,30,2,3,14,4,0,5,1038008,"2023-12-27T00:00:00.000Z",265,30,"Kyle Kuzma",0,18,25,21,11,24.3
"19424",7906,1,1,6,0,0,9,5,2,2,30,2,2,12,8,4,0,1038008,"2023-12-27T00:00:00.000Z",666577,30,"Daniel Gafford",5,20,21,13,9,38.1
"19425",7907,4,1,2,7,1,12,5,4,3,27,2,1,14,4,0,2,1038008,"2023-12-27T00:00:00.000Z",666848,30,"Jordan Poole",1,18,22,18,8,25.8
"19426",7908,5,0,1,6,1,12,5,0,0,31,1,2,11,2,2,1,1038008,"2023-12-27T00:00:00.000Z",249,30,"Tyus Jones",2,13,18,16,7,25.9
"19427",7909,2,0,1,5,2,8,5,1,1,21,1,2,13,2,1,2,1038008,"2023-12-27T00:00:00.000Z",17896045,30,"Corey Kispert",1,15,17,15,4,19.4
"19428",7910,2,0,4,4,1,8,4,2,1,25,0,2,10,4,0,1,1038008,"2023-12-27T00:00:00.000Z",56677844,30,"Bilal Coulibaly",0,14,16,12,6,16.8
"19429",7911,0,0,4,0,0,3,0,0,0,7,2,0,0,6,0,1,1038008,"2023-12-27T00:00:00.000Z",337,30,"Mike Muscala",0,6,6,0,6,6.2
"19430",7912,0,0,1,1,0,2,0,0,0,5,0,0,0,1,0,0,1038008,"2023-12-27T00:00:00.000Z",167,30,"Danilo Gallinari",0,1,1,0,1,1.2
"19431",7913,1,0,0,1,1,5,3,0,0,11,0,0,7,0,0,3,1038008,"2023-12-27T00:00:00.000Z",414,30,"Landry Shamet",0,7,8,8,1,5.5
"19432",7914,0,1,0,0,0,0,0,0,0,5,0,0,0,0,0,0,1038008,"2023-12-27T00:00:00.000Z",3547302,30,"Anthony Gill",1,0,0,0,0,3
"19433",7915,0,0,0,0,0,1,0,0,0,6,0,1,0,0,0,0,1038008,"2023-12-27T00:00:00.000Z",38017687,30,"Johnny Davis",0,0,0,0,0,0
"19434",7916,0,0,0,2,0,2,0,0,0,6,0,1,0,0,0,0,1038008,"2023-12-27T00:00:00.000Z",38017704,30,"Patrick Baldwin Jr.",0,0,0,0,0,0
"19435",7917,0,0,0,0,0,3,1,0,0,6,0,0,2,0,0,0,1038008,"2023-12-27T00:00:00.000Z",38017712,30,"Ryan Rollins",0,2,2,2,0,2
"19436",7918,1,0,1,1,0,4,3,2,1,6,0,2,7,1,2,1,1038008,"2023-12-27T00:00:00.000Z",17896106,30,"Eugene Omoruyi",2,8,9,8,2,14.7
"19437",7920,0,0,0,0,0,0,0,0,0,0,0,0,0,0,0,0,1038008,"2023-12-27T00:00:00.000Z",18677954,30,"Jared Butler",0,0,0,0,0,0
"19438",7921,0,0,0,0,0,0,0,0,0,0,0,0,0,0,0,0,1038008,"2023-12-27T00:00:00.000Z",487,30,"Delon Wright",0,0,0,0,0,0
"19439",7922,11,0,5,2,0,15,9,5,4,32,1,3,22,6,1,4,1038008,"2023-12-27T00:00:00.000Z",416,28,"Pascal Siakam",1,28,39,33,17,44.7
"19440",7923,2,0,4,7,3,16,11,2,1,29,2,1,26,6,0,1,1038008,"2023-12-27T00:00:00.000Z",18,28,"OG Anunoby",0,32,34,28,8,35.2
"19441",7924,2,1,5,0,0,6,4,4,2,21,3,4,10,8,2,2,1038008,"2023-12-27T00:00:00.000Z",373,28,"Jakob Poeltl",3,18,20,12,10,29.6
"19442",7925,8,2,7,8,4,16,8,0,0,34,5,0,20,12,3,2,1038008,"2023-12-27T00:00:00.000Z",17896055,28,"Scottie Barnes",5,32,40,28,20,59.4
"19443",7926,0,0,0,0,0,0,0,0,0,0,0,0,0,0,0,0,1037988,"2023-12-23T00:00:00.000Z",17896116,5,"Terry Taylor",0,0,0,0,0,0
"19444",7927,0,0,0,0,0,0,0,0,0,0,0,0,0,0,0,0,1037988,"2023-12-23T00:00:00.000Z",27,5,"Lonzo Ball",0,0,0,0,0,0
"19445",7928,0,0,0,0,0,0,0,0,0,0,0,0,0,0,0,0,1037988,"2023-12-23T00:00:00.000Z",56677874,5,"Onuralp Bitim",0,0,0,0,0,0
"19446",7930,0,0,0,0,0,0,0,0,0,0,0,0,0,0,0,0,1037988,"2023-12-23T00:00:00.000Z",268,5,"Zach LaVine",0,0,0,0,0,0
"19447",7931,0,0,0,0,0,0,0,0,0,0,0,0,0,0,0,0,1037988,"2023-12-23T00:00:00.000Z",56677860,5,"Adama Sanogo",0,0,0,0,0,0
"19448",7932,3,0,3,5,0,9,3,7,6,34,0,2,12,3,0,1,1037988,"2023-12-23T00:00:00.000Z",3547247,6,"Isaac Okoro",0,15,18,15,6,19.1
"19449",7933,1,0,6,10,3,12,4,0,0,36,1,1,11,7,2,1,1037988,"2023-12-23T00:00:00.000Z",666940,6,"Dean Wade",2,18,19,12,8,25.9
"19450",7934,7,1,9,1,0,9,6,10,7,35,8,0,19,17,1,0,1037988,"2023-12-23T00:00:00.000Z",9,6,"Jarrett Allen",2,36,43,26,24,55.9
"19451",7935,7,1,1,17,5,22,9,3,3,41,0,2,26,1,2,3,1037988,"2023-12-23T00:00:00.000Z",666908,6,"Max Strus",3,27,34,33,8,43.7
"19452",7936,8,1,6,3,1,14,8,5,2,39,1,1,19,7,1,3,1037988,"2023-12-23T00:00:00.000Z",56677872,6,"Craig Porter",2,26,34,27,15,42.4
"19453",7937,0,0,4,5,1,12,3,0,0,21,1,4,7,5,0,2,1037988,"2023-12-23T00:00:00.000Z",344,6,"Georges Niang",0,12,12,7,5,11
"19454",7938,0,1,0,2,1,2,1,0,0,9,0,0,3,0,0,0,1037988,"2023-12-23T00:00:00.000Z",56677847,6,"Emoni Bates",1,3,3,3,0,6
"19455",7939,1,0,2,2,1,4,2,1,1,12,0,5,6,2,1,1,1037988,"2023-12-23T00:00:00.000Z",248,6,"Damian Jones",1,8,9,7,3,11.9
"19456",7940,0,0,0,0,0,0,0,0,0,0,0,0,0,0,0,0,1037988,"2023-12-23T00:00:00.000Z",277,6,"Caris LeVert",0,0,0,0,0,0
"19457",7941,0,0,0,0,0,0,0,0,0,0,0,0,0,0,0,0,1037988,"2023-12-23T00:00:00.000Z",3547299,6,"Sam Merrill",0,0,0,0,0,0
"19458",7942,0,0,0,0,0,0,0,0,0,0,0,0,0,0,0,0,1037988,"2023-12-23T00:00:00.000Z",38017662,6,"Isaiah Mobley",0,0,0,0,0,0
"19459",7943,1,1,2,0,0,5,5,4,4,22,2,4,14,4,1,0,1037990,"2023-12-23T00:00:00.000Z",379,7,"Dwight Powell",2,18,19,15,5,26.3
"19460",7944,0,0,2,1,0,3,0,0,0,12,0,1,0,2,0,0,1037990,"2023-12-23T00:00:00.000Z",56677859,7,"Olivier-Maxence Prosper",0,2,2,0,2,2.4
"19461",7945,5,1,4,5,4,9,8,0,0,33,1,5,20,5,1,0,1037986,"2023-12-23T00:00:00.000Z",3547267,9,"Isaiah Stewart",2,25,30,25,10,39.5
"19462",7946,7,2,6,6,3,11,6,10,8,35,0,4,23,6,0,3,1037986,"2023-12-23T00:00:00.000Z",38017682,9,"Jaden Ivey",2,29,36,30,13,43.7
"19463",7947,6,0,3,5,1,20,9,4,3,33,0,4,22,3,0,2,1037986,"2023-12-23T00:00:00.000Z",17896075,9,"Cade Cunningham",0,25,31,28,9,32.6
"19464",7948,0,0,0,0,0,0,0,0,0,0,0,0,0,0,0,0,1037990,"2023-12-23T00:00:00.000Z",329,7,"Markieff Morris",0,0,0,0,0,0
"19465",7949,0,0,0,0,0,0,0,0,0,0,0,0,0,0,0,0,1037990,"2023-12-23T00:00:00.000Z",3547258,7,"Josh Green",0,0,0,0,0,0
"19466",7950,0,0,0,0,0,0,0,0,0,0,0,0,0,0,0,0,1037990,"2023-12-23T00:00:00.000Z",228,7,"Kyrie Irving",0,0,0,0,0,0
"19467",7951,0,0,0,0,0,1,1,0,0,2,0,0,2,0,0,0,1037965,"2023-12-20T00:00:00.000Z",3547279,2,"Lamar Stevens",0,2,2,2,0,2
"19468",7952,0,0,0,0,0,0,0,0,0,0,0,0,0,0,0,0,1037965,"2023-12-20T00:00:00.000Z",17896094,2,"Dalano Banton",0,0,0,0,0,0
"19469",7953,0,0,0,0,0,0,0,0,0,0,0,0,0,0,0,0,1037965,"2023-12-20T00:00:00.000Z",38017707,2,"JD Davison",0,0,0,0,0,0
"19470",7954,0,0,0,0,0,0,0,0,0,0,0,0,0,0,0,0,1037965,"2023-12-20T00:00:00.000Z",219,2,"Al Horford",0,0,0,0,0,0
"19471",7955,0,0,0,0,0,0,0,0,0,0,0,0,0,0,0,0,1037965,"2023-12-20T00:00:00.000Z",261,2,"Luke Kornet",0,0,0,0,0,0
"19472",7956,0,0,0,0,0,0,0,0,0,0,0,0,0,0,0,0,1037972,"2023-12-21T00:00:00.000Z",56677782,18,"Leonard Miller",0,0,0,0,0,0
"19473",7957,0,0,0,0,0,0,0,0,0,0,0,0,0,0,0,0,1037972,"2023-12-21T00:00:00.000Z",38017715,18,"Josh Minott",0,0,0,0,0,0
"19474",7958,0,0,0,0,0,0,0,0,0,0,0,0,0,0,0,0,1037972,"2023-12-21T00:00:00.000Z",17895968,18,"Daishen Nix",0,0,0,0,0,0
"19475",7959,2,0,0,2,0,8,3,2,2,37,1,1,8,1,1,1,1037972,"2023-12-21T00:00:00.000Z",666860,14,"Cameron Reddish",1,9,11,10,3,14.2
"19476",7960,0,0,4,5,2,12,7,6,2,34,1,3,18,5,1,2,1037972,"2023-12-21T00:00:00.000Z",666609,14,"Rui Hachimura",1,23,23,18,5,25
"19477",7961,4,3,7,1,1,20,11,9,8,39,1,2,31,8,0,1,1037972,"2023-12-21T00:00:00.000Z",117,14,"Anthony Davis",3,39,43,35,12,54.6
"19478",7962,1,0,5,4,4,6,5,0,0,37,0,4,14,5,0,3,1037972,"2023-12-21T00:00:00.000Z",383,14,"Taurean Prince",0,19,20,15,6,18.5
"19479",7963,8,3,4,6,2,19,7,1,1,38,0,1,17,4,2,4,1037972,"2023-12-21T00:00:00.000Z",405,14,"D'Angelo Russell",5,21,29,25,12,44.8
"19480",7964,0,0,4,1,0,3,0,0,0,14,1,3,0,5,0,0,1037972,"2023-12-21T00:00:00.000Z",457,14,"Jarred Vanderbilt",0,5,5,0,5,6
"19481",7965,5,0,5,4,1,14,7,5,5,27,2,2,20,7,2,4,1037972,"2023-12-21T00:00:00.000Z",17553995,14,"Austin Reaves",2,27,32,25,12,37.9
"19482",7966,0,0,0,0,0,0,0,0,0,0,0,0,0,0,0,0,1037970,"2023-12-21T00:00:00.000Z",38017733,17,"A.J. Green",0,0,0,0,0,0
"19483",7967,0,0,0,0,0,0,0,0,0,0,0,0,0,0,0,0,1037971,"2023-12-21T00:00:00.000Z",56677853,21,"Keyontae Johnson",0,0,0,0,0,0
"19484",7968,0,0,0,0,0,0,0,0,0,0,0,0,0,0,0,0,1037971,"2023-12-21T00:00:00.000Z",3547271,21,"Aleksej Pokusevski",0,0,0,0,0,0
"19485",7969,0,0,0,0,0,0,0,0,0,0,0,0,0,0,0,0,1037971,"2023-12-21T00:00:00.000Z",27924547,21,"Lindy Waters III",0,0,0,0,0,0
"19486",7970,0,0,0,0,0,0,0,0,0,0,0,0,0,0,0,0,1037970,"2023-12-21T00:00:00.000Z",284,17,"Robin Lopez",0,0,0,0,0,0
"19487",7971,0,0,0,0,0,0,0,0,0,0,0,0,0,0,0,0,1037970,"2023-12-21T00:00:00.000Z",666453,17,"Marques Bolden",0,0,0,0,0,0
"19488",7972,0,0,0,0,0,0,0,0,0,0,0,0,0,0,0,0,1037970,"2023-12-21T00:00:00.000Z",112,17,"Jae Crowder",0,0,0,0,0,0
"19489",7973,0,0,0,0,0,0,0,0,0,0,0,0,0,0,0,0,1037970,"2023-12-21T00:00:00.000Z",56677854,17,"Chris Livingston",0,0,0,0,0,0
"19490",7974,0,0,0,0,0,0,0,0,0,0,0,0,0,0,0,0,1037966,"2023-12-21T00:00:00.000Z",38017694,9,"Jalen Duren",0,0,0,0,0,0
"19491",7975,0,0,0,0,0,0,0,0,0,0,0,0,0,0,0,0,1037966,"2023-12-21T00:00:00.000Z",330,9,"Monte Morris",0,0,0,0,0,0
"19492",7976,0,0,0,0,0,0,0,0,0,0,0,0,0,0,0,0,1037942,"2023-12-18T00:00:00.000Z",38017507,12,"Andrew Nembhard",0,0,0,0,0,0
"19493",7977,5,2,8,9,2,25,13,4,4,40,0,1,32,8,3,1,1037945,"2023-12-18T00:00:00.000Z",3547238,18,"Anthony Edwards",5,40,45,37,13,63.1
"19494",7978,0,0,0,0,0,0,0,0,0,0,0,0,0,0,0,0,1037942,"2023-12-18T00:00:00.000Z",56677861,12,"Ben Sheppard",0,0,0,0,0,0
"19495",7979,0,0,0,0,0,0,0,0,0,0,0,0,0,0,0,0,1037942,"2023-12-18T00:00:00.000Z",3547264,12,"Jalen Smith",0,0,0,0,0,0
"19496",7980,6,0,1,5,4,5,4,0,0,33,0,1,12,1,1,4,1037945,"2023-12-18T00:00:00.000Z",104,18,"Mike Conley",1,13,19,18,7,21.2
"19497",7981,1,1,3,6,1,13,5,4,4,21,1,2,15,4,1,1,1037945,"2023-12-18T00:00:00.000Z",667378,18,"Naz Reid",2,19,20,16,5,26.3
"19498",7982,5,1,2,0,0,4,2,2,1,22,0,2,5,2,0,1,1037945,"2023-12-18T00:00:00.000Z",12,18,"Kyle Anderson",1,7,12,10,7,16.9
"19499",7983,3,0,0,4,2,5,2,2,2,22,1,2,8,1,1,0,1037945,"2023-12-18T00:00:00.000Z",666400,18,"Nickeil Alexander-Walker",1,9,12,11,4,16.7
"19500",7984,1,0,1,1,1,1,1,0,0,5,0,0,3,1,0,1,1037945,"2023-12-18T00:00:00.000Z",68,18,"Troy Brown Jr.",0,4,5,4,2,4.7
"19501",7985,0,0,0,0,0,0,0,0,0,0,0,0,0,0,0,0,1037945,"2023-12-18T00:00:00.000Z",666767,18,"Jordan McLaughlin",0,0,0,0,0,0
"19502",7986,0,0,0,0,0,0,0,0,0,0,0,0,0,0,0,0,1037945,"2023-12-18T00:00:00.000Z",320,18,"Shake Milton",0,0,0,0,0,0
"19503",7987,0,0,0,0,0,0,0,0,0,0,0,0,0,0,0,0,1037941,"2023-12-18T00:00:00.000Z",357,11,"Victor Oladipo",0,0,0,0,0,0
"19504",7988,0,0,0,0,0,0,0,0,0,0,0,0,0,0,0,0,1037941,"2023-12-18T00:00:00.000Z",56677809,11,"Jermaine Samuels Jr.",0,0,0,0,0,0
"19505",7989,0,0,0,1,0,3,0,0,0,5,0,0,0,0,0,0,1037944,"2023-12-18T00:00:00.000Z",17896071,9,"Isaiah Livers",0,0,0,0,0,0
"19506",7990,2,0,5,0,0,5,5,2,0,25,2,2,10,7,0,2,1037944,"2023-12-18T00:00:00.000Z",3547240,9,"James Wiseman",0,17,19,12,9,19.4
"19507",7991,1,1,1,1,1,3,2,0,0,21,0,6,5,1,1,0,1037944,"2023-12-18T00:00:00.000Z",56677792,9,"Marcus Sasser",2,6,7,6,2,13.7
"19508",7992,0,0,0,0,0,0,0,0,0,0,0,0,0,0,0,0,1037944,"2023-12-18T00:00:00.000Z",3547241,9,"Killian Hayes",0,0,0,0,0,0
"19509",7993,0,0,0,0,0,0,0,0,0,0,0,0,0,0,0,0,1037944,"2023-12-18T00:00:00.000Z",259,9,"Kevin Knox",0,0,0,0,0,0
"19510",7994,0,0,0,0,0,0,0,0,0,0,0,0,0,0,0,0,1037944,"2023-12-18T00:00:00.000Z",3547267,9,"Isaiah Stewart",0,0,0,0,0,0
"19511",7995,0,0,0,0,0,0,0,0,0,0,0,0,0,0,0,0,1037944,"2023-12-18T00:00:00.000Z",56677729,9,"Malcolm Cazalon",0,0,0,0,0,0
"19512",7996,0,0,0,0,0,0,0,0,0,0,0,0,0,0,0,0,1037944,"2023-12-18T00:00:00.000Z",38017694,9,"Jalen Duren",0,0,0,0,0,0
"19513",7997,9,1,7,6,2,17,9,4,4,40,1,0,24,8,0,2,1037943,"2023-12-18T00:00:00.000Z",666956,5,"Coby White",1,32,41,33,17,48.1
"19514",7998,0,0,0,0,0,0,0,0,0,0,0,0,0,0,0,0,1037944,"2023-12-18T00:00:00.000Z",330,9,"Monte Morris",0,0,0,0,0,0
"19515",7999,0,0,0,0,0,0,0,0,0,0,0,0,0,0,0,0,1037944,"2023-12-18T00:00:00.000Z",42097199,9,"Jared Rhoden",0,0,0,0,0,0
"19516",8000,0,0,0,0,0,0,0,0,0,0,0,0,0,0,0,0,1037944,"2023-12-18T00:00:00.000Z",44477024,9,"Stanley Umude",0,0,0,0,0,0
"19517",8001,4,0,0,3,2,8,5,6,5,20,0,3,17,0,1,1,1037921,"2023-12-15T00:00:00.000Z",3547251,22,"Cole Anthony",1,17,21,21,4,25
"19518",8002,0,0,1,2,2,3,2,0,0,4,0,0,6,1,0,1,1037920,"2023-12-15T00:00:00.000Z",3547207,12,"Jordan Nwora",0,7,7,6,1,6.2
"19519",8003,1,0,0,0,0,1,1,0,0,4,0,0,2,0,0,0,1037920,"2023-12-15T00:00:00.000Z",56677778,12,"Oscar Tshiebwe",0,2,3,3,1,3.5
"19520",8004,0,0,0,0,0,0,0,0,0,0,0,0,0,0,0,0,1037920,"2023-12-15T00:00:00.000Z",242,12,"James Johnson",0,0,0,0,0,0
"19521",8005,0,0,0,0,0,0,0,0,0,0,0,0,0,0,0,0,1037920,"2023-12-15T00:00:00.000Z",38017701,12,"Kendall Brown",0,0,0,0,0,0
"19522",8006,0,0,0,0,0,0,0,0,0,0,0,0,0,0,0,0,1037920,"2023-12-15T00:00:00.000Z",38017507,12,"Andrew Nembhard",0,0,0,0,0,0
"19523",8007,0,0,0,0,0,0,0,0,0,0,0,0,0,0,0,0,1037920,"2023-12-15T00:00:00.000Z",3547264,12,"Jalen Smith",0,0,0,0,0,0
"19524",8008,0,0,0,0,0,0,0,0,0,1,0,0,0,0,0,0,1037922,"2023-12-15T00:00:00.000Z",319,1,"Patty Mills",0,0,0,0,0,0
"19525",8009,0,0,0,0,0,0,0,0,0,0,0,0,0,0,0,0,1037922,"2023-12-15T00:00:00.000Z",301,1,"Wesley Matthews",0,0,0,0,0,0
"19526",8010,0,0,0,0,0,0,0,0,0,0,0,0,0,0,0,0,1037922,"2023-12-15T00:00:00.000Z",56677838,1,"Kobe Bufkin",0,0,0,0,0,0
"19527",8011,0,0,0,0,0,0,0,0,0,0,0,0,0,0,0,0,1037922,"2023-12-15T00:00:00.000Z",38017689,1,"AJ Griffin",0,0,0,0,0,0
"19528",8012,0,0,0,0,0,0,0,0,0,0,0,0,0,0,0,0,1037921,"2023-12-15T00:00:00.000Z",85,22,"Wendell Carter Jr.",0,0,0,0,0,0
"19529",8013,0,0,0,0,0,0,0,0,0,0,0,0,0,0,0,0,1037921,"2023-12-15T00:00:00.000Z",165,22,"Markelle Fultz",0,0,0,0,0,0
"19530",8014,0,0,0,0,0,0,0,0,0,0,0,0,0,0,0,0,1037921,"2023-12-15T00:00:00.000Z",38017607,22,"Kevon Harris",0,0,0,0,0,0
"19531",8015,0,0,0,1,0,1,0,0,0,4,0,0,0,0,0,0,1037918,"2023-12-15T00:00:00.000Z",56677837,19,"Jordan Hawkins",0,0,0,0,0,0
"19532",8016,0,0,0,0,0,0,0,0,0,0,0,0,0,0,0,0,1037918,"2023-12-15T00:00:00.000Z",17896021,19,"Jeremiah Robinson-Earl",0,0,0,0,0,0
"19533",8017,0,0,0,0,0,0,0,0,0,0,0,0,0,0,0,0,1037918,"2023-12-15T00:00:00.000Z",491,19,"Cody Zeller",0,0,0,0,0,0
"19534",8018,0,0,0,0,0,0,0,0,0,0,0,0,0,0,0,0,1037918,"2023-12-15T00:00:00.000Z",3547260,19,"Kira Lewis Jr.",0,0,0,0,0,0
"19535",8019,1,1,0,2,2,5,5,1,1,36,2,4,13,2,2,2,1037925,"2023-12-15T00:00:00.000Z",8,24,"Grayson Allen",3,15,16,14,3,23.9
"19536",8020,6,0,3,9,4,21,10,7,5,36,0,1,29,3,0,0,1037925,"2023-12-15T00:00:00.000Z",140,24,"Kevin Durant",0,32,38,35,9,41.6
"19537",8021,2,0,8,2,1,13,9,2,2,30,4,2,21,12,1,3,1037925,"2023-12-15T00:00:00.000Z",349,24,"Jusuf Nurkic",1,33,35,23,14,38.4
"19538",8022,1,0,0,1,1,2,2,1,1,4,0,0,6,0,0,0,1037925,"2023-12-15T00:00:00.000Z",37,24,"Bradley Beal",0,6,7,7,1,7.5
"19539",8023,9,0,1,5,1,26,11,6,5,37,1,4,28,2,0,3,1037925,"2023-12-15T00:00:00.000Z",57,24,"Devin Booker",0,30,39,37,11,40.9
"19540",8024,1,0,2,3,1,5,2,0,0,26,2,2,5,4,0,0,1037925,"2023-12-15T00:00:00.000Z",666729,24,"Nassir Little",0,9,10,6,5,11.3
"19541",8025,9,0,3,3,1,5,1,0,0,23,0,3,3,3,0,1,1037925,"2023-12-15T00:00:00.000Z",18678058,24,"Jordan Goodwin",0,6,15,12,12,19.1
"19542",8026,0,0,0,0,0,0,0,0,0,0,0,0,0,0,0,0,1037906,"2023-12-13T00:00:00.000Z",420,15,"Marcus Smart",0,0,0,0,0,0
"19543",8027,0,0,0,0,0,0,0,0,0,0,0,0,0,0,0,0,1037906,"2023-12-13T00:00:00.000Z",56677831,11,"Cam Whitmore",0,0,0,0,0,0
"19544",8028,4,0,5,7,2,14,3,2,1,32,1,1,9,6,1,1,1037906,"2023-12-13T00:00:00.000Z",38017729,15,"David Roddy",1,15,19,13,10,24.2
"19545",8029,2,1,6,8,3,24,15,13,11,40,1,4,44,7,4,3,1037906,"2023-12-13T00:00:00.000Z",231,15,"Jaren Jackson Jr.",5,51,53,46,9,67.4
"19546",8030,1,0,5,0,0,2,1,6,1,24,1,5,3,6,0,2,1037906,"2023-12-13T00:00:00.000Z",48,15,"Bismack Biyombo",0,9,10,4,7,9.7
"19547",8031,1,0,6,4,2,5,2,6,4,28,1,6,10,7,1,0,1037906,"2023-12-13T00:00:00.000Z",38017731,15,"Vince Williams Jr.",1,17,18,11,8,22.9
"19548",8032,6,1,3,4,1,14,7,4,4,31,1,4,19,4,0,1,1037906,"2023-12-13T00:00:00.000Z",401,15,"Derrick Rose",1,23,29,25,10,34.8
"19549",8033,3,0,4,6,0,8,1,3,3,26,0,2,5,4,0,1,1037906,"2023-12-13T00:00:00.000Z",17896027,15,"Ziaire Williams",0,9,12,8,7,13.3
"19550",8034,1,0,0,2,0,3,0,0,0,8,0,1,0,0,0,1,1037906,"2023-12-13T00:00:00.000Z",666809,15,"Jaylen Nowell",0,0,1,1,1,0.5
"19551",8035,1,2,5,2,1,4,3,0,0,16,0,4,7,5,0,1,1037906,"2023-12-13T00:00:00.000Z",17896067,15,"Santi Aldama",2,12,13,8,6,19.5
"19552",8036,1,0,0,1,0,1,0,0,0,7,0,0,0,0,1,0,1037906,"2023-12-13T00:00:00.000Z",666703,15,"John Konchar",1,0,1,1,1,4.5
"19553",8037,2,0,0,3,0,6,2,0,0,15,0,3,4,0,0,1,1037906,"2023-12-13T00:00:00.000Z",38017728,15,"Jake LaRavia",0,4,6,6,2,6
"19554",8038,3,0,0,1,1,1,1,0,0,13,0,0,3,0,0,0,1037906,"2023-12-13T00:00:00.000Z",48248287,15,"Jacob Gilyard",0,3,6,6,3,7.5
"19555",8039,0,0,0,0,0,0,0,0,0,0,0,0,0,0,0,0,1037906,"2023-12-13T00:00:00.000Z",38017732,15,"Kenneth Lofton Jr.",0,0,0,0,0,0
"19556",8040,0,0,0,0,0,0,0,0,0,0,0,0,0,0,0,0,1037906,"2023-12-13T00:00:00.000Z",3547285,15,"Xavier Tillman",0,0,0,0,0,0
"19557",8041,0,0,0,0,0,0,0,0,0,0,0,0,0,0,0,0,1037906,"2023-12-13T00:00:00.000Z",3,15,"Steven Adams",0,0,0,0,0,0
"19558",8042,0,0,0,0,0,0,0,0,0,0,0,0,0,0,0,0,1037906,"2023-12-13T00:00:00.000Z",3547287,15,"Desmond Bane",0,0,0,0,0,0
"19559",8043,0,0,0,0,0,0,0,0,0,0,0,0,0,0,0,0,1037906,"2023-12-13T00:00:00.000Z",666505,15,"Brandon Clarke",0,0,0,0,0,0
"19560",8044,0,0,0,0,0,0,0,0,0,0,0,0,0,0,0,0,1037906,"2023-12-13T00:00:00.000Z",56677830,15,"GG Jackson",0,0,0,0,0,0
"19561",8045,0,0,0,0,0,0,0,0,0,0,0,0,0,0,0,0,1037908,"2023-12-13T00:00:00.000Z",38017693,27,"Blake Wesley",0,0,0,0,0,0
"19562",8046,0,0,0,0,0,0,0,0,0,0,0,0,0,0,0,0,1037908,"2023-12-13T00:00:00.000Z",38017730,27,"Dominick Barlow",0,0,0,0,0,0
"19563",8047,0,0,0,0,0,0,0,0,0,0,0,0,0,0,0,0,1037908,"2023-12-13T00:00:00.000Z",17895854,27,"Charles Bassey",0,0,0,0,0,0
"19564",8048,0,0,0,0,0,0,0,0,0,0,0,0,0,0,0,0,1037908,"2023-12-13T00:00:00.000Z",56677865,27,"Charles Bediako",0,0,0,0,0,0
"19565",8049,0,0,0,0,0,0,0,0,0,0,0,0,0,0,0,0,1037908,"2023-12-13T00:00:00.000Z",56677817,27,"Sidy Cissoko",0,0,0,0,0,0
"19566",8050,0,0,0,0,0,0,0,0,0,0,0,0,0,0,0,0,1037908,"2023-12-13T00:00:00.000Z",56677870,27,"Sir'Jabari Rice",0,0,0,0,0,0
"19567",8051,2,1,3,0,0,7,4,4,3,27,5,4,11,8,2,2,1037889,"2023-12-11T00:00:00.000Z",201,20,"Isaiah Hartenstein",3,19,21,13,10,30.6
"19568",8052,4,2,8,5,4,15,12,1,1,29,1,1,29,9,1,6,1037888,"2023-12-11T00:00:00.000Z",335,8,"Jamal Murray",3,38,42,33,13,48.8
"19569",8053,2,0,1,11,6,16,8,0,0,28,0,1,22,1,5,2,1037888,"2023-12-11T00:00:00.000Z",56677776,8,"Julian Strawther",5,23,25,24,3,39.2
"19570",8054,6,0,1,5,1,10,5,1,1,19,0,0,12,1,0,1,1037888,"2023-12-11T00:00:00.000Z",236,8,"Reggie Jackson",0,13,19,18,7,21.2
"19571",8055,1,0,2,0,0,3,2,2,2,11,0,2,6,2,0,0,1037888,"2023-12-11T00:00:00.000Z",38017709,8,"Christian Braun",0,8,9,7,3,9.9
"19572",8056,1,2,3,1,0,2,1,1,1,12,1,3,3,4,0,1,1037888,"2023-12-11T00:00:00.000Z",3547268,8,"Zeke Nnaji",2,7,8,4,5,14.3
"19573",8057,0,0,0,0,0,0,0,0,0,0,0,0,0,0,0,0,1037888,"2023-12-11T00:00:00.000Z",215,8,"Justin Holiday",0,0,0,0,0,0
"19574",8058,0,0,0,0,0,0,0,0,0,0,0,0,0,0,0,0,1037888,"2023-12-11T00:00:00.000Z",250,8,"DeAndre Jordan",0,0,0,0,0,0
"19575",8059,0,0,0,0,0,0,0,0,0,0,0,0,0,0,0,0,1037888,"2023-12-11T00:00:00.000Z",56677582,8,"Jalen Pickett",0,0,0,0,0,0
"19576",8060,6,0,12,3,0,11,5,4,3,33,1,4,13,13,1,4,1037892,"2023-12-11T00:00:00.000Z",315,17,"Khris Middleton",1,26,32,19,19,36.6
"19577",8061,6,0,11,0,0,13,9,18,14,41,1,2,32,12,2,2,1037892,"2023-12-11T00:00:00.000Z",15,17,"Giannis Antetokounmpo",2,44,50,38,18,59.4
"19578",8062,3,3,1,6,2,11,6,6,5,40,2,4,19,3,1,1,1037892,"2023-12-11T00:00:00.000Z",283,17,"Brook Lopez",4,22,25,22,6,38.1
"19579",8063,2,0,4,8,5,11,7,0,0,40,0,2,19,4,1,0,1037892,"2023-12-11T00:00:00.000Z",38,17,"Malik Beasley",1,23,25,21,6,29.8
"19580",8064,9,1,4,9,2,17,3,7,6,41,0,2,14,4,0,2,1037892,"2023-12-11T00:00:00.000Z",278,17,"Damian Lillard",1,18,27,23,13,33.3
"19581",8065,0,0,0,1,0,2,1,0,0,14,0,1,2,0,0,0,1037892,"2023-12-11T00:00:00.000Z",38017676,17,"MarJon Beauchamp",0,2,2,2,0,2
"19582",8066,5,0,0,2,1,4,2,0,0,18,0,2,5,0,0,1,1037892,"2023-12-11T00:00:00.000Z",368,17,"Cameron Payne",0,5,10,10,5,11.5
"19583",8067,3,0,5,5,4,6,4,0,0,13,0,1,12,5,0,0,1037892,"2023-12-11T00:00:00.000Z",38017733,17,"A.J. Green",0,17,20,15,8,22.5
"19584",8068,0,0,0,0,0,0,0,0,0,0,0,0,0,0,0,0,1037892,"2023-12-11T00:00:00.000Z",2148,17,"Thanasis Antetokounmpo",0,0,0,0,0,0
"19585",8069,0,0,0,0,0,0,0,0,0,0,0,0,0,0,0,0,1037892,"2023-12-11T00:00:00.000Z",56677852,17,"Andre Jackson Jr.",0,0,0,0,0,0
"19586",8070,0,0,0,0,0,0,0,0,0,0,0,0,0,0,0,0,1037892,"2023-12-11T00:00:00.000Z",284,17,"Robin Lopez",0,0,0,0,0,0
"19587",8071,0,0,0,0,0,0,0,0,0,0,0,0,0,0,0,0,1037886,"2023-12-11T00:00:00.000Z",666885,22,"Admiral Schofield",0,0,0,0,0,0
"19588",8072,0,0,0,0,0,0,0,0,0,0,0,0,0,0,0,0,1037886,"2023-12-11T00:00:00.000Z",85,22,"Wendell Carter Jr.",0,0,0,0,0,0
"19589",8073,0,0,0,0,0,0,0,0,0,0,0,0,0,0,0,0,1037886,"2023-12-11T00:00:00.000Z",165,22,"Markelle Fultz",0,0,0,0,0,0
"19590",8074,0,1,1,0,0,2,1,2,1,20,1,2,3,2,0,0,1037888,"2023-12-11T00:00:00.000Z",38017721,8,"Peyton Watson",1,5,5,3,2,8.4
"19591",8075,0,0,0,0,0,0,0,0,0,0,0,0,0,0,0,0,1037888,"2023-12-11T00:00:00.000Z",56677871,8,"Hunter Tyson",0,0,0,0,0,0
"19592",8076,1,1,3,3,0,10,4,2,2,26,4,4,10,7,2,1,7996352,"2023-12-07T00:00:00.000Z",17896024,19,"Herbert Jones",3,17,18,11,8,27.9
"19593",8077,8,0,5,4,4,12,9,8,8,23,0,1,30,5,0,0,7996352,"2023-12-07T00:00:00.000Z",237,14,"LeBron James",0,35,43,38,13,48
"19594",8078,5,2,10,2,0,10,5,8,6,31,5,1,16,15,2,2,7996352,"2023-12-07T00:00:00.000Z",117,14,"Anthony Davis",4,31,36,21,20,51.5
"19595",8079,1,0,3,8,5,9,5,0,0,23,0,3,15,3,1,0,7996352,"2023-12-07T00:00:00.000Z",383,14,"Taurean Prince",1,18,19,16,4,23.1
"19596",8080,1,0,3,5,2,10,6,0,0,22,0,1,14,3,1,4,7996352,"2023-12-07T00:00:00.000Z",405,14,"D'Angelo Russell",1,17,18,15,4,18.1
"19597",8081,1,1,5,0,0,2,1,0,0,15,0,0,2,5,0,0,7996352,"2023-12-07T00:00:00.000Z",457,14,"Jarred Vanderbilt",1,7,8,3,6,12.5
"19598",8082,0,0,2,1,0,5,3,2,0,17,0,1,6,2,1,0,7996352,"2023-12-07T00:00:00.000Z",38017697,14,"Max Christie",1,8,8,6,2,11.4
"19599",8083,2,0,1,3,1,9,5,2,1,21,0,3,12,1,0,0,7996352,"2023-12-07T00:00:00.000Z",666609,14,"Rui Hachimura",0,13,15,14,3,16.2
"19600",8084,0,0,4,1,0,3,2,1,0,17,0,4,4,4,0,1,7996352,"2023-12-07T00:00:00.000Z",666626,14,"Jaxson Hayes",0,8,8,4,4,7.8
"19601",8085,1,1,3,0,0,3,0,2,1,8,1,1,1,4,0,1,7996352,"2023-12-07T00:00:00.000Z",56677835,14,"Jalen Hood-Schifino",1,5,6,2,5,9.3
"19602",8086,1,0,1,2,1,4,1,0,0,8,0,0,3,1,0,1,7996352,"2023-12-07T00:00:00.000Z",56677836,14,"Maxwell Lewis",0,4,5,4,2,4.7
"19603",8087,2,0,3,4,1,14,4,0,0,25,1,2,9,4,2,1,7996352,"2023-12-07T00:00:00.000Z",303,19,"CJ McCollum",2,13,15,11,6,21.8
"19604",8088,0,0,2,1,1,2,1,2,2,12,2,1,5,4,0,1,7996352,"2023-12-07T00:00:00.000Z",3547293,19,"Naji Marshall",0,9,9,5,4,8.8
"19605",8089,1,0,3,7,2,13,5,2,2,23,0,1,14,3,0,0,7996352,"2023-12-07T00:00:00.000Z",18677986,19,"Trey Murphy III",0,17,18,15,4,19.1
"19606",8090,4,0,2,3,2,7,3,0,0,20,0,1,8,2,2,1,7996352,"2023-12-07T00:00:00.000Z",17896097,19,"Jose Alvarado",2,10,14,12,6,21.4
"19607",8091,0,1,6,2,0,5,1,2,2,17,2,1,4,8,0,0,7996352,"2023-12-07T00:00:00.000Z",38017677,19,"Dyson Daniels",1,12,12,4,8,16.6
"19608",8092,0,0,2,3,0,8,2,0,0,12,0,1,4,2,0,0,7996352,"2023-12-07T00:00:00.000Z",56677837,19,"Jordan Hawkins",0,6,6,4,2,6.4
"19609",8093,1,0,1,0,0,1,0,2,2,12,1,2,2,2,0,0,7996352,"2023-12-07T00:00:00.000Z",491,19,"Cody Zeller",0,4,5,3,3,5.9
"19610",8094,0,0,0,1,0,3,1,0,0,7,0,0,2,0,0,1,7996352,"2023-12-07T00:00:00.000Z",3547260,19,"Kira Lewis Jr.",0,2,2,2,0,1
"19611",8095,1,0,2,0,0,2,0,0,0,6,0,0,0,2,0,0,7996352,"2023-12-07T00:00:00.000Z",17896021,19,"Jeremiah Robinson-Earl",0,2,3,1,3,3.9
"19612",8096,0,0,0,0,0,0,0,0,0,0,0,0,0,0,0,0,7996352,"2023-12-07T00:00:00.000Z",38017663,19,"E.J. Liddell",0,0,0,0,0,0
"19613",8097,0,0,0,0,0,0,0,0,0,0,0,0,0,0,0,0,7996352,"2023-12-07T00:00:00.000Z",340,19,"Larry Nance Jr.",0,0,0,0,0,0
"19614",8098,0,0,0,0,0,0,0,0,0,0,0,0,0,0,0,0,7996352,"2023-12-07T00:00:00.000Z",17896017,19,"Matt Ryan",0,0,0,0,0,0
"19615",8099,0,0,0,0,0,0,0,0,0,0,0,0,0,0,0,0,7996352,"2023-12-07T00:00:00.000Z",38017726,19,"Dereon Seabron",0,0,0,0,0,0
"19616",8100,4,0,2,3,2,4,3,0,0,29,2,1,8,4,0,0,7050284,"2023-12-08T00:00:00.000Z",33,23,"Nicolas Batum",0,12,16,12,8,18.8
"19617",8101,8,0,8,4,0,10,4,0,0,31,0,2,8,8,0,2,7049316,"2023-12-06T00:00:00.000Z",3547242,30,"Deni Avdija",0,16,24,16,16,27.6
"19618",8102,0,0,0,0,0,0,0,0,0,0,0,0,0,0,0,0,1037880,"2023-12-02T00:00:00.000Z",314,24,"Chimezie Metu",0,0,0,0,0,0
"19619",8103,0,0,0,0,0,0,0,0,0,0,0,0,0,0,0,0,1037880,"2023-12-02T00:00:00.000Z",37,24,"Bradley Beal",0,0,0,0,0,0
"19620",8104,0,0,0,0,0,0,0,0,0,0,0,0,0,0,0,0,1037880,"2023-12-02T00:00:00.000Z",178,24,"Eric Gordon",0,0,0,0,0,0
"19621",8105,0,0,0,0,0,0,0,0,0,0,0,0,0,0,0,0,1037880,"2023-12-02T00:00:00.000Z",48248287,15,"Jacob Gilyard",0,0,0,0,0,0
"19622",8106,0,0,0,0,0,0,0,0,0,0,0,0,0,0,0,0,1037880,"2023-12-02T00:00:00.000Z",199,15,"Shaquille Harrison",0,0,0,0,0,0
"19623",8107,0,0,0,0,0,0,0,0,0,0,0,0,0,0,0,0,1037880,"2023-12-02T00:00:00.000Z",38017732,15,"Kenneth Lofton Jr.",0,0,0,0,0,0
"19624",8108,5,0,3,2,0,13,9,7,7,30,1,2,25,4,0,3,1037881,"2023-12-02T00:00:00.000Z",413,29,"Collin Sexton",0,29,34,30,9,34.3
"19625",8109,0,0,0,0,0,0,0,0,0,0,0,0,0,0,0,0,1037881,"2023-12-02T00:00:00.000Z",56677842,29,"Brice Sensabaugh",0,0,0,0,0,0
"19626",8110,0,0,0,0,0,0,0,0,0,0,0,0,0,0,0,0,1037881,"2023-12-02T00:00:00.000Z",17896023,29,"Josh Christopher",0,0,0,0,0,0
"19627",8111,0,0,0,0,0,0,0,0,0,0,0,0,0,0,0,0,1037881,"2023-12-02T00:00:00.000Z",100,29,"Jordan Clarkson",0,0,0,0,0,0
"19628",8112,0,0,0,0,0,0,0,0,0,0,0,0,0,0,0,0,1037880,"2023-12-02T00:00:00.000Z",3,15,"Steven Adams",0,0,0,0,0,0
"19629",8113,0,0,0,0,0,0,0,0,0,0,0,0,0,0,0,0,1037880,"2023-12-02T00:00:00.000Z",666505,15,"Brandon Clarke",0,0,0,0,0,0
"19630",8114,0,0,0,0,0,0,0,0,0,0,0,0,0,0,0,0,1037880,"2023-12-02T00:00:00.000Z",56677830,15,"GG Jackson",0,0,0,0,0,0
"19631",8115,0,0,0,0,0,0,0,0,0,0,0,0,0,0,0,0,1037880,"2023-12-02T00:00:00.000Z",254,15,"Luke Kennard",0,0,0,0,0,0
"19632",8116,2,1,6,6,4,10,6,0,0,29,0,0,16,6,1,2,1037882,"2023-12-02T00:00:00.000Z",221,26,"Kevin Huerter",2,22,24,18,8,30.2
"19633",8117,16,1,3,6,3,22,10,4,3,38,1,1,26,4,3,1,1037882,"2023-12-02T00:00:00.000Z",161,26,"De'Aaron Fox",4,30,46,42,20,65.8
"19634",8118,4,0,3,7,4,14,9,4,4,28,0,1,26,3,2,3,1037882,"2023-12-02T00:00:00.000Z",324,26,"Malik Monk",2,29,33,30,7,38.6
"19635",8119,2,0,0,1,0,1,0,0,0,8,0,1,0,0,0,0,1037882,"2023-12-02T00:00:00.000Z",38017714,26,"Keon Ellis",0,0,2,2,2,3
"19636",8120,1,0,2,3,0,8,3,1,1,18,2,2,7,4,0,0,1037882,"2023-12-02T00:00:00.000Z",290,26,"Trey Lyles",0,11,12,8,5,13.3
"19637",8121,0,0,2,1,1,3,1,3,1,14,1,0,4,3,0,1,1037882,"2023-12-02T00:00:00.000Z",4197162,26,"Aleksandar Vezenkov",0,7,7,4,3,6.6
"19638",8122,0,3,3,0,0,4,4,0,0,12,1,3,8,4,0,0,1037882,"2023-12-02T00:00:00.000Z",306,26,"JaVale McGee",3,12,12,8,4,21.8
"19639",8123,0,0,0,0,0,0,0,0,0,0,0,0,0,0,0,0,1037882,"2023-12-02T00:00:00.000Z",17896030,26,"Chris Duarte",0,0,0,0,0,0
"19640",8124,0,0,0,0,0,0,0,0,0,0,0,0,0,0,0,0,1037882,"2023-12-02T00:00:00.000Z",17896044,26,"Kessler Edwards",0,0,0,0,0,0
"19641",8125,0,0,0,0,0,0,0,0,0,0,0,0,0,0,0,0,1037882,"2023-12-02T00:00:00.000Z",56677845,26,"Colby Jones",0,0,0,0,0,0
"19642",8126,0,0,0,0,0,0,0,0,0,0,0,0,0,0,0,0,1037880,"2023-12-02T00:00:00.000Z",56677830,15,"GG Jackson",0,0,0,0,0,0
"19643",8127,0,0,0,0,0,0,0,0,0,0,0,0,0,0,0,0,1037880,"2023-12-02T00:00:00.000Z",254,15,"Luke Kennard",0,0,0,0,0,0
"19644",8128,1,2,2,0,0,5,2,2,2,18,1,3,6,3,0,1,1037880,"2023-12-02T00:00:00.000Z",147,24,"Drew Eubanks",2,9,10,7,4,16.1
"19645",8129,0,0,1,2,1,2,1,2,1,15,1,3,4,2,1,2,1037880,"2023-12-02T00:00:00.000Z",470,24,"Yuta Watanabe",1,6,6,4,2,7.4
"19646",8130,0,0,0,0,0,0,0,0,0,0,0,0,0,0,0,0,1037880,"2023-12-02T00:00:00.000Z",3547095,24,"Udoka Azubuike",0,0,0,0,0,0
"19647",8131,0,0,0,0,0,0,0,0,0,0,0,0,0,0,0,0,1037880,"2023-12-02T00:00:00.000Z",666451,24,"Bol Bol",0,0,0,0,0,0
"19648",8132,1,1,4,1,0,7,4,3,3,25,1,3,11,5,0,0,1037883,"2023-12-02T00:00:00.000Z",666860,14,"Cameron Reddish",1,16,17,12,6,21.5
"19649",8133,2,0,3,6,2,11,7,2,2,20,0,5,18,3,0,1,1037878,"2023-12-02T00:00:00.000Z",368,17,"Cameron Payne",0,21,23,20,5,23.6
"19650",8134,0,0,0,0,0,0,0,0,0,0,0,0,0,0,0,0,1037878,"2023-12-02T00:00:00.000Z",666453,17,"Marques Bolden",0,0,0,0,0,0
"19651",8135,0,0,0,0,0,0,0,0,0,0,0,0,0,0,0,0,1037878,"2023-12-02T00:00:00.000Z",56677854,17,"Chris Livingston",0,0,0,0,0,0
"19652",8136,0,0,0,0,0,0,0,0,0,0,0,0,0,0,0,0,1037878,"2023-12-02T00:00:00.000Z",284,17,"Robin Lopez",0,0,0,0,0,0
"19653",8137,3,0,3,2,0,4,2,3,1,27,1,3,5,4,0,0,1037878,"2023-12-02T00:00:00.000Z",3547244,1,"Onyeka Okongwu",0,9,12,8,7,14.3
"19654",8138,0,0,0,0,0,0,0,0,0,0,0,0,0,0,0,0,1037878,"2023-12-02T00:00:00.000Z",319,1,"Patty Mills",0,0,0,0,0,0
"19655",8139,0,0,0,0,0,0,0,0,0,0,0,0,0,0,0,0,1037878,"2023-12-02T00:00:00.000Z",56677838,1,"Kobe Bufkin",0,0,0,0,0,0
"19656",8140,0,0,0,0,0,0,0,0,0,0,0,0,0,0,0,0,1037878,"2023-12-02T00:00:00.000Z",56677806,1,"Mouhamed Gueye",0,0,0,0,0,0
"19657",8141,0,0,0,0,0,0,0,0,0,0,0,0,0,0,0,0,1037878,"2023-12-02T00:00:00.000Z",17896040,1,"Jalen Johnson",0,0,0,0,0,0
"19658",8142,0,0,0,0,0,0,0,0,0,0,0,0,0,0,0,0,1037878,"2023-12-02T00:00:00.000Z",56677855,1,"Seth Lundy",0,0,0,0,0,0
"19659",8143,0,0,0,0,0,0,0,0,0,0,0,0,0,0,0,0,1037878,"2023-12-02T00:00:00.000Z",56677875,1,"Miles Norris",0,0,0,0,0,0
"19660",8144,7,1,4,4,0,17,7,5,2,35,0,0,16,4,1,5,1037883,"2023-12-02T00:00:00.000Z",237,14,"LeBron James",2,20,27,23,11,32.3
"19661",8145,3,5,8,0,0,22,10,9,7,37,6,2,27,14,0,1,1037883,"2023-12-02T00:00:00.000Z",117,14,"Anthony Davis",5,41,44,30,17,62.3
"19662",8146,1,0,6,5,3,7,4,0,0,29,0,0,11,6,2,1,1037883,"2023-12-02T00:00:00.000Z",383,14,"Taurean Prince",2,17,18,12,7,24.7
"19663",8147,7,0,2,5,1,10,4,0,0,26,0,2,9,2,5,0,1037883,"2023-12-02T00:00:00.000Z",405,14,"D'Angelo Russell",5,11,18,16,9,36.9
"19664",8148,2,0,7,3,3,7,4,2,1,29,0,3,12,7,0,0,1037883,"2023-12-02T00:00:00.000Z",38017697,14,"Max Christie",0,19,21,14,9,23.4
"19665",8149,1,0,3,2,0,2,0,0,0,14,1,1,0,4,0,0,1037883,"2023-12-02T00:00:00.000Z",457,14,"Jarred Vanderbilt",0,4,5,1,5,6.3
"19666",8150,0,0,0,0,0,0,0,0,0,0,0,0,0,0,0,0,7049314,"2023-12-06T00:00:00.000Z",56677830,15,"GG Jackson",0,0,0,0,0,0
"19667",8151,0,0,0,0,0,0,0,0,0,0,0,0,0,0,0,0,1037861,"2023-11-30T00:00:00.000Z",2148,17,"Thanasis Antetokounmpo",0,0,0,0,0,0
"19668",8152,6,0,9,4,2,21,11,6,5,40,1,2,29,10,1,4,1037861,"2023-11-30T00:00:00.000Z",460,5,"Nikola Vucevic",1,39,45,35,16,49
"19669",8153,6,0,5,3,1,8,6,2,1,39,1,2,14,6,3,2,1037861,"2023-11-30T00:00:00.000Z",17895983,5,"Ayo Dosunmu",3,20,26,20,12,37.2
"19670",8154,7,1,4,11,4,20,7,6,5,45,0,3,23,4,1,3,1037861,"2023-11-30T00:00:00.000Z",666956,5,"Coby White",2,27,34,30,11,41.3
"19671",8155,2,1,5,6,2,10,4,0,0,27,3,4,10,8,1,2,1037861,"2023-11-30T00:00:00.000Z",110,5,"Torrey Craig",2,18,20,12,10,26.6
"19672",8156,1,0,1,2,1,10,5,0,0,18,1,1,11,2,3,0,1037861,"2023-11-30T00:00:00.000Z",87,5,"Jevon Carter",3,13,14,12,3,23.9
"19673",8157,0,0,0,0,0,0,0,0,0,0,0,0,0,0,0,0,1037861,"2023-11-30T00:00:00.000Z",56677874,5,"Onuralp Bitim",0,0,0,0,0,0
"19674",8158,0,0,0,0,0,0,0,0,0,0,0,0,0,0,0,0,1037860,"2023-11-30T00:00:00.000Z",330,9,"Monte Morris",0,0,0,0,0,0
"19675",8159,0,0,0,0,0,0,0,0,0,0,0,0,0,0,0,0,1037860,"2023-11-30T00:00:00.000Z",42097199,9,"Jared Rhoden",0,0,0,0,0,0
"19676",8160,4,0,4,10,4,14,8,5,5,27,0,1,25,4,0,2,1037864,"2023-11-30T00:00:00.000Z",3547246,27,"Devin Vassell",0,29,33,29,8,33.8
"19677",8161,3,0,2,2,0,7,2,2,1,20,0,0,5,2,2,0,1037862,"2023-11-30T00:00:00.000Z",320,18,"Shake Milton",2,7,10,8,5,17.9
"19678",8162,0,0,1,4,1,5,1,0,0,10,0,0,3,1,0,0,1037862,"2023-11-30T00:00:00.000Z",17895968,18,"Daishen Nix",0,4,4,3,1,4.2
"19679",8163,0,0,0,0,0,0,0,0,0,0,0,0,0,0,0,0,1037862,"2023-11-30T00:00:00.000Z",17896056,18,"Luka Garza",0,0,0,0,0,0
"19680",8164,0,0,0,0,0,0,0,0,0,0,0,0,0,0,0,0,1037862,"2023-11-30T00:00:00.000Z",38017715,18,"Josh Minott",0,0,0,0,0,0
"19681",8165,0,0,0,0,0,0,0,0,0,0,0,0,0,0,0,0,1037862,"2023-11-30T00:00:00.000Z",38017700,18,"Wendell Moore Jr.",0,0,0,0,0,0
"19682",8166,0,0,0,0,0,0,0,0,0,0,0,0,0,0,0,0,1037862,"2023-11-30T00:00:00.000Z",56677851,18,"Jaylen Clark",0,0,0,0,0,0
"19683",8167,0,0,0,0,0,0,0,0,0,0,0,0,0,0,0,0,1037862,"2023-11-30T00:00:00.000Z",3547238,18,"Anthony Edwards",0,0,0,0,0,0
"19684",8168,0,0,0,0,0,0,0,0,0,0,0,0,0,0,0,0,1037862,"2023-11-30T00:00:00.000Z",3547259,18,"Jaden McDaniels",0,0,0,0,0,0
"19685",8169,0,0,0,0,0,0,0,0,0,0,0,0,0,0,0,0,1037859,"2023-11-30T00:00:00.000Z",3547207,12,"Jordan Nwora",0,0,0,0,0,0
"19686",8170,3,0,3,4,1,10,3,5,2,27,0,3,9,3,2,3,1037861,"2023-11-30T00:00:00.000Z",315,17,"Khris Middleton",2,12,15,12,6,20.1
"19687",8171,5,5,8,1,0,17,11,4,4,39,6,5,26,14,2,5,1037861,"2023-11-30T00:00:00.000Z",15,17,"Giannis Antetokounmpo",7,40,45,31,19,66.3
"19688",8172,7,0,2,3,1,5,1,1,0,24,0,1,3,2,0,2,1037864,"2023-11-30T00:00:00.000Z",3547274,27,"Tre Jones",0,5,12,10,9,13.9
"19689",8173,2,0,1,5,1,7,1,0,0,16,0,3,3,1,0,1,1037864,"2023-11-30T00:00:00.000Z",359,27,"Cedi Osman",0,4,6,5,3,6.2
"19690",8174,0,0,2,8,5,8,5,0,0,20,1,2,15,3,0,1,1037864,"2023-11-30T00:00:00.000Z",38017649,27,"Julian Champagnie",0,18,18,15,3,17.6
"19691",8175,0,0,0,0,0,0,0,0,0,0,0,0,0,0,0,0,1037864,"2023-11-30T00:00:00.000Z",180,27,"Devonte' Graham",0,0,0,0,0,0
"19692",8176,0,0,0,0,0,0,0,0,0,0,0,0,0,0,0,0,1037859,"2023-11-30T00:00:00.000Z",38017736,16,"Cole Swider",0,0,0,0,0,0
"19693",8177,4,0,4,10,4,14,8,5,5,27,0,1,25,4,0,2,1037864,"2023-11-30T00:00:00.000Z",3547246,27,"Devin Vassell",0,29,33,29,8,33.8
"19694",8178,3,0,2,2,0,7,2,2,1,20,0,0,5,2,2,0,1037862,"2023-11-30T00:00:00.000Z",320,18,"Shake Milton",2,7,10,8,5,17.9
"19695",8179,0,0,1,4,1,5,1,0,0,10,0,0,3,1,0,0,1037862,"2023-11-30T00:00:00.000Z",17895968,18,"Daishen Nix",0,4,4,3,1,4.2
"19696",8180,0,0,0,0,0,0,0,0,0,0,0,0,0,0,0,0,1037862,"2023-11-30T00:00:00.000Z",17896056,18,"Luka Garza",0,0,0,0,0,0
"19697",8181,0,0,0,0,0,0,0,0,0,0,0,0,0,0,0,0,1037862,"2023-11-30T00:00:00.000Z",38017715,18,"Josh Minott",0,0,0,0,0,0
"19698",8182,0,0,0,0,0,0,0,0,0,0,0,0,0,0,0,0,1037862,"2023-11-30T00:00:00.000Z",38017700,18,"Wendell Moore Jr.",0,0,0,0,0,0
"19699",8183,0,0,0,0,0,0,0,0,0,0,0,0,0,0,0,0,1037862,"2023-11-30T00:00:00.000Z",56677851,18,"Jaylen Clark",0,0,0,0,0,0
"19700",8184,0,0,0,0,0,0,0,0,0,0,0,0,0,0,0,0,1037862,"2023-11-30T00:00:00.000Z",3547238,18,"Anthony Edwards",0,0,0,0,0,0
"19701",8185,0,0,0,0,0,0,0,0,0,0,0,0,0,0,0,0,1037862,"2023-11-30T00:00:00.000Z",3547259,18,"Jaden McDaniels",0,0,0,0,0,0
"19702",8186,0,0,0,0,0,0,0,0,0,0,0,0,0,0,0,0,1037859,"2023-11-30T00:00:00.000Z",3547207,12,"Jordan Nwora",0,0,0,0,0,0
"19703",8187,3,0,3,4,1,10,3,5,2,27,0,3,9,3,2,3,1037861,"2023-11-30T00:00:00.000Z",315,17,"Khris Middleton",2,12,15,12,6,20.1
"19704",8188,5,5,8,1,0,17,11,4,4,39,6,5,26,14,2,5,1037861,"2023-11-30T00:00:00.000Z",15,17,"Giannis Antetokounmpo",7,40,45,31,19,66.3
"19705",8189,7,0,2,3,1,5,1,1,0,24,0,1,3,2,0,2,1037864,"2023-11-30T00:00:00.000Z",3547274,27,"Tre Jones",0,5,12,10,9,13.9
"19706",8190,2,0,1,5,1,7,1,0,0,16,0,3,3,1,0,1,1037864,"2023-11-30T00:00:00.000Z",359,27,"Cedi Osman",0,4,6,5,3,6.2
"19707",8191,0,0,2,8,5,8,5,0,0,20,1,2,15,3,0,1,1037864,"2023-11-30T00:00:00.000Z",38017649,27,"Julian Champagnie",0,18,18,15,3,17.6
"19708",8192,0,0,0,0,0,0,0,0,0,0,0,0,0,0,0,0,1037864,"2023-11-30T00:00:00.000Z",180,27,"Devonte' Graham",0,0,0,0,0,0
"19709",8193,0,0,0,0,0,0,0,0,0,0,0,0,0,0,0,0,1037864,"2023-11-30T00:00:00.000Z",17896059,27,"Sandro Mamukelashvili",0,0,0,0,0,0
"19710",8194,0,0,0,0,0,0,0,0,0,0,0,0,0,0,0,0,1037860,"2023-11-30T00:00:00.000Z",54,9,"Bojan Bogdanovic",0,0,0,0,0,0
"19711",8195,0,0,0,0,0,0,0,0,0,0,0,0,0,0,0,0,1037860,"2023-11-30T00:00:00.000Z",56677729,9,"Malcolm Cazalon",0,0,0,0,0,0
"19712",8196,0,0,0,0,0,0,0,0,0,0,0,0,0,0,0,0,1037860,"2023-11-30T00:00:00.000Z",197,9,"Joe Harris",0,0,0,0,0,0
"19713",8197,3,0,3,2,0,9,5,6,4,25,2,4,14,5,1,4,1037859,"2023-11-30T00:00:00.000Z",666747,16,"Caleb Martin",1,19,22,17,8,23.5
"19714",8198,0,0,4,10,6,12,7,0,0,39,0,5,20,4,0,1,1037861,"2023-11-30T00:00:00.000Z",283,17,"Brook Lopez",0,24,24,20,4,23.8
"19715",8199,0,0,0,0,0,0,0,0,0,0,0,0,0,0,0,0,1037864,"2023-11-30T00:00:00.000Z",305,27,"Doug McDermott",0,0,0,0,0,0
"19716",8200,0,0,0,0,0,0,0,0,0,0,0,0,0,0,0,0,1037864,"2023-11-30T00:00:00.000Z",56677838,1,"Kobe Bufkin",0,0,0,0,0,0
"19717",8201,0,0,0,0,0,0,0,0,0,0,0,0,0,0,0,0,3277527,"2023-11-28T00:00:00.000Z",3547295,2,"Nathan Knight",0,0,0,0,0,0
"19718",8202,1,0,2,2,0,4,0,4,1,10,1,3,1,3,1,1,3277528,"2023-11-28T00:00:00.000Z",3547249,28,"Precious Achiuwa",1,4,5,2,4,8.1
"19719",8203,1,0,0,3,1,5,2,0,0,16,0,1,5,0,0,0,3277528,"2023-11-28T00:00:00.000Z",3547275,28,"Malachi Flynn",0,5,6,6,1,6.5
"19720",8204,10,0,1,8,2,14,3,6,5,32,0,3,13,1,1,3,3277529,"2023-11-28T00:00:00.000Z",490,1,"Trae Young",1,14,24,23,11,29.2
"19721",8205,1,0,5,10,4,16,6,2,2,31,1,2,18,6,2,1,3277529,"2023-11-28T00:00:00.000Z",53,1,"Bogdan Bogdanovic",2,24,25,19,7,31.7
"19722",8206,6,1,6,8,3,23,12,5,3,35,2,1,30,8,0,3,3277527,"2023-11-28T00:00:00.000Z",70,2,"Jaylen Brown",1,38,44,36,14,48.6
"19723",8207,4,0,6,8,2,16,8,3,3,35,1,2,21,7,0,4,3277527,"2023-11-28T00:00:00.000Z",434,2,"Jayson Tatum",0,28,32,25,11,31.4
"19724",8208,6,3,9,6,4,8,6,0,0,28,0,3,16,9,2,3,3277527,"2023-11-28T00:00:00.000Z",219,2,"Al Horford",5,25,31,22,15,47.8
"19725",8209,7,0,3,3,2,7,5,2,2,28,0,4,14,3,2,0,3277527,"2023-11-28T00:00:00.000Z",473,2,"Derrick White",2,17,24,21,10,34.1
"19726",8210,9,0,6,5,4,8,5,0,0,33,1,3,14,7,1,3,3277527,"2023-11-28T00:00:00.000Z",214,2,"Jrue Holiday",1,21,30,23,16,35.9
"19727",8211,2,0,6,10,2,12,3,2,1,21,4,1,9,10,0,2,3277527,"2023-11-28T00:00:00.000Z",17896060,2,"Sam Hauser",0,19,21,11,12,22
"19728",8212,0,1,0,2,1,3,2,0,0,15,0,1,5,0,0,0,3277527,"2023-11-28T00:00:00.000Z",17896094,2,"Dalano Banton",1,5,5,5,0,8
"19729",8213,0,3,1,0,0,3,2,0,0,19,2,3,4,3,0,1,3277527,"2023-11-28T00:00:00.000Z",261,2,"Luke Kornet",3,7,7,4,3,15.6
"19730",8214,0,0,0,0,0,0,0,0,0,2,0,0,0,0,0,0,3277527,"2023-11-28T00:00:00.000Z",338,2,"Svi Mykhailiuk",0,0,0,0,0,0
"19731",8215,0,0,0,0,0,0,0,0,0,0,0,0,0,0,0,0,3277527,"2023-11-28T00:00:00.000Z",666468,2,"Oshae Brissett",0,0,0,0,0,0
"19732",8216,0,0,0,0,0,0,0,0,0,0,0,0,0,0,0,0,3277527,"2023-11-28T00:00:00.000Z",378,2,"Kristaps Porzingis",0,0,0,0,0,0
"19733",8217,0,0,0,0,0,0,0,0,0,0,0,0,0,0,0,0,3277527,"2023-11-28T00:00:00.000Z",56677864,2,"Jordan Walsh",0,0,0,0,0,0
"19734",8218,6,0,2,3,1,14,7,4,4,26,0,2,19,2,0,2,3277527,"2023-11-28T00:00:00.000Z",125,5,"DeMar DeRozan",0,21,27,25,8,28.4
"19735",8219,2,2,3,3,1,10,6,2,1,28,4,2,14,7,1,2,3277527,"2023-11-28T00:00:00.000Z",3547248,5,"Patrick Williams",3,21,23,16,9,32.4
"19736",8220,2,1,8,2,0,11,4,0,0,25,0,1,8,8,2,1,3277527,"2023-11-28T00:00:00.000Z",460,5,"Nikola Vucevic",3,16,18,10,10,28.6
"19737",8221,4,0,1,3,0,9,1,0,0,25,1,1,2,2,2,0,3277527,"2023-11-28T00:00:00.000Z",268,5,"Zach LaVine",2,4,8,6,6,16.4
"19738",8222,3,1,5,8,3,10,4,2,0,27,3,3,11,8,1,3,3277531,"2023-11-28T00:00:00.000Z",666950,4,"P.J. Washington",2,19,22,14,11,28.1
"19739",8223,1,0,1,0,0,3,2,0,0,14,0,1,4,1,0,3,3277531,"2023-11-28T00:00:00.000Z",422,4,"Ish Smith",0,5,6,5,2,3.7
"19740",8224,0,0,1,2,1,5,2,0,0,13,1,1,5,2,1,0,3277531,"2023-11-28T00:00:00.000Z",38017708,4,"Bryce McGowens",1,7,7,5,2,10.4
"19741",8225,0,0,2,0,0,0,0,0,0,13,0,1,0,2,0,1,3277531,"2023-11-28T00:00:00.000Z",18678001,4,"JT Thor",0,2,2,0,2,1.4
"19742",8226,0,0,1,2,1,5,2,0,0,13,1,1,5,2,1,0,3277531,"2023-11-28T00:00:00.000Z",38017708,4,"Bryce McGowens",1,7,7,5,2,10.4
"19743",8227,1,0,1,3,2,11,6,0,0,26,0,2,14,1,1,0,3277530,"2023-11-28T00:00:00.000Z",666747,16,"Caleb Martin",1,15,16,15,2,19.7
"19744",8228,0,0,0,0,0,0,0,0,0,0,0,0,0,0,0,0,3277530,"2023-11-28T00:00:00.000Z",39398582,16,"Orlando Robinson",0,0,0,0,0,0
"19745",8229,0,0,0,0,0,0,0,0,0,0,0,0,0,0,0,0,3277530,"2023-11-28T00:00:00.000Z",38017736,16,"Cole Swider",0,0,0,0,0,0
"19746",8230,1,1,1,1,1,4,2,0,0,13,1,2,5,2,2,0,3277528,"2023-11-28T00:00:00.000Z",666762,28,"Jalen McDaniels",3,7,8,6,3,17.9
"19747",8231,0,0,0,4,3,7,5,0,0,12,1,0,13,1,1,0,3277528,"2023-11-28T00:00:00.000Z",58,28,"Chris Boucher",1,14,14,13,1,17.2
"19748",8232,0,0,0,0,0,0,0,0,0,0,0,0,0,0,0,0,3277528,"2023-11-28T00:00:00.000Z",376,28,"Otto Porter Jr.",0,0,0,0,0,0
"19749",8233,0,0,0,0,0,0,0,0,0,0,0,0,0,0,0,0,3277528,"2023-11-28T00:00:00.000Z",436,28,"Garrett Temple",0,0,0,0,0,0
"19750",8234,0,0,0,0,0,0,0,0,0,0,0,0,0,0,0,0,3277528,"2023-11-28T00:00:00.000Z",489,28,"Thaddeus Young",0,0,0,0,0,0
"19751",8235,0,0,0,0,0,0,0,0,0,0,0,0,0,0,0,0,3277528,"2023-11-28T00:00:00.000Z",56677828,28,"Gradey Dick",0,0,0,0,0,0
"19752",8236,0,0,0,0,0,0,0,0,0,0,0,0,0,0,0,0,3277528,"2023-11-28T00:00:00.000Z",56677805,28,"Javon Freeman-Liberty",0,0,0,0,0,0
"19753",8237,0,0,0,0,0,0,0,0,0,0,0,0,0,0,0,0,3277528,"2023-11-28T00:00:00.000Z",38017717,28,"Ron Harper Jr.",0,0,0,0,0,0
"19754",8238,3,0,1,5,3,12,7,2,2,30,0,0,19,1,0,0,3277527,"2023-11-28T00:00:00.000Z",666956,5,"Coby White",0,20,23,22,4,24.7
"19755",8239,1,0,1,5,1,7,1,0,0,26,1,2,3,2,0,2,3277532,"2023-11-28T00:00:00.000Z",666400,18,"Nickeil Alexander-Walker",0,5,6,4,3,4.9
"19756",8240,3,0,10,3,1,8,2,8,8,32,0,4,13,10,0,6,3277532,"2023-11-28T00:00:00.000Z",447,18,"Karl-Anthony Towns",0,23,26,16,13,23.5
"19757",8241,0,4,10,0,0,10,6,6,5,36,6,1,17,16,1,1,3277532,"2023-11-28T00:00:00.000Z",176,18,"Rudy Gobert",5,33,33,17,16,50.2
"19758",8242,1,1,5,6,3,16,7,6,4,28,0,2,21,5,0,2,3277532,"2023-11-28T00:00:00.000Z",3547238,18,"Anthony Edwards",1,26,27,22,6,29.5
"19759",8243,2,0,0,3,1,10,4,2,1,24,0,3,10,0,1,0,3277527,"2023-11-28T00:00:00.000Z",17895983,5,"Ayo Dosunmu",1,10,12,12,2,16
"19760",8244,2,0,1,6,2,9,3,0,0,19,1,2,8,2,3,1,3277527,"2023-11-28T00:00:00.000Z",89,5,"Alex Caruso",3,10,12,10,4,21.4
"19761",8245,0,1,1,1,1,1,1,0,0,13,0,0,3,1,1,0,3277527,"2023-11-28T00:00:00.000Z",110,5,"Torrey Craig",2,4,4,3,1,10.2
"19762",8246,0,1,4,0,0,5,2,6,1,13,2,1,5,6,0,0,3277527,"2023-11-28T00:00:00.000Z",137,5,"Andre Drummond",1,11,11,5,6,15.2
"19763",8247,2,1,1,1,0,7,4,0,0,17,0,0,8,1,0,1,3277527,"2023-11-28T00:00:00.000Z",87,5,"Jevon Carter",1,9,11,10,3,14.2
"19764",8248,1,0,2,1,0,2,0,2,1,10,0,0,1,2,0,1,3277527,"2023-11-28T00:00:00.000Z",56677857,5,"Julian Phillips",0,3,4,2,3,3.9
"19765",8249,0,0,0,0,0,0,0,0,0,3,0,0,0,0,1,0,3277527,"2023-11-28T00:00:00.000Z",17896116,5,"Terry Taylor",1,0,0,0,0,3
"19766",8250,8,0,2,10,3,14,3,0,0,37,0,2,9,2,1,0,3277532,"2023-11-28T00:00:00.000Z",104,18,"Mike Conley",1,11,19,17,10,26.4
"19767",8251,2,2,3,2,0,6,2,0,0,22,1,1,4,4,1,1,1037836,"2023-11-26T00:00:00.000Z",38017721,8,"Peyton Watson",3,8,10,6,6,19.8
"19768",8252,0,0,0,0,0,0,0,0,0,2,0,1,0,0,0,1,1037836,"2023-11-26T00:00:00.000Z",56677582,8,"Jalen Pickett",0,0,0,0,0,-1
"19769",8253,0,0,1,0,0,0,0,0,0,1,0,0,0,1,0,0,1037836,"2023-11-26T00:00:00.000Z",56677871,8,"Hunter Tyson",0,1,1,0,1,1.2
"19770",8254,0,0,0,0,0,0,0,0,0,0,0,0,0,0,0,0,1037836,"2023-11-26T00:00:00.000Z",666489,8,"Vlatko Cancar",0,0,0,0,0,0
"19771",8255,0,0,0,0,0,0,0,0,0,0,0,0,0,0,0,0,1037836,"2023-11-26T00:00:00.000Z",177,8,"Aaron Gordon",0,0,0,0,0,0
"19772",8256,0,0,0,0,0,0,0,0,0,0,0,0,0,0,0,0,1037836,"2023-11-26T00:00:00.000Z",335,8,"Jamal Murray",0,0,0,0,0,0
"19773",8257,2,0,1,2,0,7,3,5,4,31,0,1,10,1,0,0,1037836,"2023-11-26T00:00:00.000Z",666682,27,"Keldon Johnson",0,11,13,12,3,14.2
"19774",8258,2,4,7,5,2,17,7,7,6,25,4,4,22,11,6,3,1037836,"2023-11-26T00:00:00.000Z",56677822,27,"Victor Wembanyama",10,33,35,24,13,65.2
"19775",8259,3,0,2,4,1,9,4,0,0,21,2,4,9,4,1,4,1037836,"2023-11-26T00:00:00.000Z",102,27,"Zach Collins",1,13,16,12,7,17.3
"19776",8260,4,0,6,5,1,18,8,4,3,39,0,1,20,6,0,0,1037834,"2023-11-26T00:00:00.000Z",268,5,"Zach LaVine",0,26,30,24,10,33.2
"19777",8261,4,1,4,12,5,16,7,4,4,38,1,3,23,5,0,1,1037834,"2023-11-26T00:00:00.000Z",666956,5,"Coby White",1,28,32,27,9,37
"19778",8262,0,0,0,0,0,0,0,0,0,0,0,0,0,0,0,0,1037836,"2023-11-26T00:00:00.000Z",56677817,27,"Sidy Cissoko",0,0,0,0,0,0
"19779",8263,0,0,0,0,0,0,0,0,0,0,0,0,0,0,0,0,1037836,"2023-11-26T00:00:00.000Z",56677870,27,"Sir'Jabari Rice",0,0,0,0,0,0
"19780",8264,0,0,0,0,0,0,0,0,0,0,0,0,0,0,0,0,1037836,"2023-11-26T00:00:00.000Z",38017693,27,"Blake Wesley",0,0,0,0,0,0
"19781",8265,4,0,4,3,2,7,4,0,0,29,3,3,10,7,3,0,1037839,"2023-11-27T00:00:00.000Z",33,23,"Nicolas Batum",3,17,21,14,11,33.4
"19782",8266,0,0,5,4,0,12,3,2,2,23,0,1,8,5,0,1,1037839,"2023-11-27T00:00:00.000Z",200,23,"Tobias Harris",0,13,13,8,5,13
"19783",8267,11,1,7,3,2,15,9,12,10,31,4,2,30,11,1,3,1037839,"2023-11-27T00:00:00.000Z",145,23,"Joel Embiid",2,41,52,41,22,62.7
"19784",8268,3,1,1,6,1,10,3,2,2,24,0,1,9,1,1,2,1037838,"2023-11-27T00:00:00.000Z",210,12,"Buddy Hield",2,10,13,12,4,18.7
"19785",8269,2,1,2,4,1,9,3,2,2,19,2,0,9,4,0,1,1037838,"2023-11-27T00:00:00.000Z",3547243,12,"Obi Toppin",1,13,15,11,6,18.8
"19786",8270,0,2,7,3,0,11,5,1,1,27,1,4,11,8,2,1,1037838,"2023-11-27T00:00:00.000Z",452,12,"Myles Turner",4,19,19,11,8,31.6
"19787",8271,3,0,3,5,1,10,5,0,0,33,0,4,11,3,2,2,1037838,"2023-11-27T00:00:00.000Z",69,12,"Bruce Brown",2,14,17,14,6,23.1
"19788",8272,9,0,2,6,3,17,11,9,8,36,0,1,33,2,0,3,1037838,"2023-11-27T00:00:00.000Z",3547245,12,"Tyrese Haliburton",0,35,44,42,11,45.9
"19789",8273,1,1,4,0,0,2,1,0,0,10,1,3,2,5,0,1,1037838,"2023-11-27T00:00:00.000Z",17896035,12,"Isaiah Jackson",1,7,8,3,6,11.5
"19790",8274,2,1,4,2,0,14,8,0,0,28,0,4,16,4,2,1,1037837,"2023-11-27T00:00:00.000Z",56677826,9,"Ausar Thompson",3,20,22,18,6,31.8
"19791",8275,0,0,6,7,1,11,3,0,0,29,2,2,7,8,1,0,1037837,"2023-11-27T00:00:00.000Z",3547267,9,"Isaiah Stewart",1,15,15,7,8,19.6
"19792",8276,3,0,1,7,4,13,7,1,1,26,0,1,19,1,1,0,1037836,"2023-11-26T00:00:00.000Z",3547246,27,"Devin Vassell",1,20,23,22,4,27.7
"19793",8277,6,0,4,1,0,8,4,2,2,22,0,2,10,4,0,1,1037836,"2023-11-26T00:00:00.000Z",3547274,27,"Tre Jones",0,14,20,16,10,22.8
"19794",8278,3,0,2,3,1,5,1,4,4,16,1,2,7,3,0,3,1037836,"2023-11-26T00:00:00.000Z",359,27,"Cedi Osman",0,10,13,10,6,12.1
"19795",8279,2,1,4,0,0,5,3,3,3,15,2,3,9,6,0,1,1037836,"2023-11-26T00:00:00.000Z",17895854,27,"Charles Bassey",1,15,17,11,8,21.2
"19796",8280,1,1,1,6,3,8,4,4,2,17,0,1,13,1,0,0,1037836,"2023-11-26T00:00:00.000Z",38017649,27,"Julian Champagnie",1,14,15,14,2,18.7
"19797",8281,1,0,0,2,0,2,0,0,0,12,0,0,0,0,0,0,1037836,"2023-11-26T00:00:00.000Z",305,27,"Doug McDermott",0,0,1,1,1,1.5
"19798",8282,3,0,0,1,0,2,1,0,0,7,0,0,2,0,0,0,1037836,"2023-11-26T00:00:00.000Z",180,27,"Devonte' Graham",0,2,5,5,3,6.5
"19799",8283,4,0,2,5,2,11,5,3,3,29,0,5,15,2,2,1,1037835,"2023-11-26T00:00:00.000Z",409,28,"Dennis Schroder",2,17,21,19,6,28.4
"19800",8284,0,0,1,7,1,13,5,2,2,26,0,0,13,1,1,1,1037835,"2023-11-26T00:00:00.000Z",3089,28,"Gary Trent Jr.",1,14,14,13,1,16.2
"19801",8285,0,0,0,0,0,0,0,0,0,0,0,0,0,0,0,0,1037835,"2023-11-26T00:00:00.000Z",56677828,28,"Gradey Dick",0,0,0,0,0,0
"19802",8286,0,0,0,0,0,0,0,0,0,0,0,0,0,0,0,0,1037835,"2023-11-26T00:00:00.000Z",56677805,28,"Javon Freeman-Liberty",0,0,0,0,0,0
"19803",8287,0,0,0,0,0,0,0,0,0,0,0,0,0,0,0,0,1037835,"2023-11-26T00:00:00.000Z",38017717,28,"Ron Harper Jr.",0,0,0,0,0,0
"19804",8288,2,0,0,0,0,0,0,0,0,6,0,1,0,0,1,0,1037836,"2023-11-26T00:00:00.000Z",17896059,27,"Sandro Mamukelashvili",1,0,2,2,2,6
"19805",8289,0,0,0,0,0,0,0,0,0,0,0,0,0,0,0,0,1037836,"2023-11-26T00:00:00.000Z",38017730,27,"Dominick Barlow",0,0,0,0,0,0
"19806",8290,0,0,0,0,0,0,0,0,0,0,0,0,0,0,0,0,1037836,"2023-11-26T00:00:00.000Z",56677865,27,"Charles Bediako",0,0,0,0,0,0
"19807",8291,0,0,0,0,0,0,0,0,0,0,0,0,0,0,0,0,1037834,"2023-11-26T00:00:00.000Z",666508,3,"Nicolas Claxton",0,0,0,0,0,0
"19808",8292,0,0,0,0,0,0,0,0,0,0,0,0,0,0,0,0,1037834,"2023-11-26T00:00:00.000Z",56677843,3,"Noah Clowney",0,0,0,0,0,0
"19809",8293,2,1,4,2,0,14,8,0,0,28,0,4,16,4,2,1,1037837,"2023-11-27T00:00:00.000Z",56677826,9,"Ausar Thompson",3,20,22,18,6,31.8
"19810",8294,0,0,6,7,1,11,3,0,0,29,2,2,7,8,1,0,1037837,"2023-11-27T00:00:00.000Z",3547267,9,"Isaiah Stewart",1,15,15,7,8,19.6
"19811",8295,3,5,7,0,0,8,5,5,2,33,7,5,12,14,1,6,1037837,"2023-11-27T00:00:00.000Z",38017694,9,"Jalen Duren",6,26,29,15,17,45.3
"19812",8296,7,1,5,3,2,12,6,2,1,33,2,3,15,7,1,3,1037837,"2023-11-27T00:00:00.000Z",38017682,9,"Jaden Ivey",2,22,29,22,14,36.9
"19813",8297,7,0,4,7,2,22,10,4,4,32,1,2,26,5,1,1,1037837,"2023-11-27T00:00:00.000Z",17896075,9,"Cade Cunningham",1,31,38,33,12,44.5
"19814",8298,3,0,1,8,2,11,3,0,0,23,0,1,8,1,1,2,1037837,"2023-11-27T00:00:00.000Z",17896071,9,"Isaiah Livers",1,9,12,11,4,14.7
"19815",8299,3,1,0,5,1,10,3,0,0,22,1,1,7,1,0,1,1037837,"2023-11-27T00:00:00.000Z",56677792,9,"Marcus Sasser",1,8,11,10,4,14.7
"19816",8300,3,3,3,0,0,1,0,0,0,16,1,1,0,4,0,0,1037837,"2023-11-27T00:00:00.000Z",3547241,9,"Killian Hayes",3,4,7,3,7,18.3
"19817",8301,0,1,2,0,0,3,2,1,1,18,1,1,5,3,0,2,1037826,"2023-11-25T00:00:00.000Z",3547247,6,"Isaac Okoro",1,8,8,5,3,9.6
"19818",8302,10,0,5,6,1,14,4,2,2,27,0,0,11,5,4,0,1037825,"2023-11-25T00:00:00.000Z",334,1,"Dejounte Murray",4,16,26,21,15,44
"19819",8303,0,0,0,0,0,0,0,0,0,0,0,0,0,0,0,0,1037833,"2023-11-26T00:00:00.000Z",666505,15,"Brandon Clarke",0,0,0,0,0,0
"19820",8304,0,0,0,0,0,0,0,0,0,0,0,0,0,0,0,0,1037833,"2023-11-26T00:00:00.000Z",56677830,15,"GG Jackson",0,0,0,0,0,0
"19821",8305,0,0,0,0,0,0,0,0,0,0,0,0,0,0,0,0,1037833,"2023-11-26T00:00:00.000Z",254,15,"Luke Kennard",0,0,0,0,0,0
"19822",8306,0,0,0,0,0,0,0,0,0,0,0,0,0,0,0,0,1037833,"2023-11-26T00:00:00.000Z",38017728,15,"Jake LaRavia",0,0,0,0,0,0
"19823",8307,0,0,0,0,0,0,0,0,0,0,0,0,0,0,0,0,1037833,"2023-11-26T00:00:00.000Z",666786,15,"Ja Morant",0,0,0,0,0,0
"19824",8308,0,0,0,0,0,0,0,0,0,0,0,0,0,0,0,0,1037833,"2023-11-26T00:00:00.000Z",420,15,"Marcus Smart",0,0,0,0,0,0
"19825",8309,0,0,0,0,0,0,0,0,0,0,0,0,0,0,0,0,1037833,"2023-11-26T00:00:00.000Z",3547285,15,"Xavier Tillman",0,0,0,0,0,0
"19826",8310,3,1,5,1,0,7,3,0,0,23,1,3,6,6,0,0,1037833,"2023-11-26T00:00:00.000Z",12,18,"Kyle Anderson",1,12,15,9,9,20.7
"19827",8311,3,0,2,3,1,6,2,2,1,19,0,2,6,2,1,1,1037833,"2023-11-26T00:00:00.000Z",320,18,"Shake Milton",1,8,11,9,5,14.9
"19828",8312,1,0,2,4,2,4,2,0,0,18,2,1,6,4,0,1,1037833,"2023-11-26T00:00:00.000Z",68,18,"Troy Brown Jr.",0,10,11,7,5,11.3
"19829",8313,0,0,0,1,0,2,1,0,0,2,0,0,2,0,0,0,1037833,"2023-11-26T00:00:00.000Z",38017715,18,"Josh Minott",0,2,2,2,0,2
"19830",8314,1,0,2,0,0,1,1,0,0,2,0,0,2,2,0,0,1037833,"2023-11-26T00:00:00.000Z",56677782,18,"Leonard Miller",0,4,5,3,3,5.9
"19831",8315,0,0,0,0,0,0,0,0,0,0,0,0,0,0,0,0,1037827,"2023-11-25T00:00:00.000Z",3547260,19,"Kira Lewis Jr.",0,0,0,0,0,0
"19832",8316,0,0,0,0,0,0,0,0,0,0,0,0,0,0,0,0,1037827,"2023-11-25T00:00:00.000Z",100,29,"Jordan Clarkson",0,0,0,0,0,0
"19833",8317,0,0,0,0,0,0,0,0,0,0,0,0,0,0,0,0,1037827,"2023-11-25T00:00:00.000Z",56677824,29,"Taylor Hendricks",0,0,0,0,0,0
"19834",8318,0,0,0,0,0,0,0,0,0,0,0,0,0,0,0,0,1037827,"2023-11-25T00:00:00.000Z",38017630,29,"Johnny Juzang",0,0,0,0,0,0
"19835",8319,0,0,0,0,0,0,0,0,0,0,0,0,0,0,0,0,1037827,"2023-11-25T00:00:00.000Z",297,29,"Lauri Markkanen",0,0,0,0,0,0
"19836",8320,0,0,0,0,0,0,0,0,0,0,0,0,0,0,0,0,1037827,"2023-11-25T00:00:00.000Z",19465584,29,"Micah Potter",0,0,0,0,0,0
"19837",8321,0,0,0,0,0,0,0,0,0,0,0,0,0,0,0,0,1037827,"2023-11-25T00:00:00.000Z",56677842,29,"Brice Sensabaugh",0,0,0,0,0,0
"19838",8322,1,1,0,4,1,11,6,0,0,26,1,3,13,1,1,1,1037827,"2023-11-25T00:00:00.000Z",17896024,19,"Herbert Jones",2,14,15,14,2,20.7
"19839",8323,8,0,5,4,1,22,10,8,5,37,1,4,26,6,1,1,1037827,"2023-11-25T00:00:00.000Z",227,19,"Brandon Ingram",1,32,40,34,14,47.2
"19840",8324,2,0,2,2,0,10,3,4,2,26,5,2,8,7,1,1,1037827,"2023-11-25T00:00:00.000Z",455,19,"Jonas Valanciunas",1,15,17,10,9,21.4
"19841",8325,3,0,5,12,5,17,8,5,4,40,1,1,25,6,1,4,1037827,"2023-11-25T00:00:00.000Z",56677837,19,"Jordan Hawkins",1,31,34,28,9,35.7
"19842",8326,8,0,13,8,3,31,14,11,7,42,6,3,38,19,2,3,3277503,"2023-11-24T00:00:00.000Z",246,8,"Nikola Jokic",2,57,65,46,27,75.8
"19843",8327,0,0,0,0,0,1,0,0,0,4,0,0,0,0,0,1,3277503,"2023-11-24T00:00:00.000Z",3547268,8,"Zeke Nnaji",0,0,0,0,0,-1
"19844",8328,0,0,0,0,0,0,0,0,0,3,0,0,0,0,0,1,3277503,"2023-11-24T00:00:00.000Z",38017727,8,"Collin Gillespie",0,0,0,0,0,-1
"19845",8329,0,0,0,2,1,2,1,0,0,13,0,2,3,0,1,0,3277503,"2023-11-24T00:00:00.000Z",215,8,"Justin Holiday",1,3,3,3,0,6
"19846",8330,0,0,0,0,0,0,0,0,0,0,0,0,0,0,0,0,3277503,"2023-11-24T00:00:00.000Z",250,8,"DeAndre Jordan",0,0,0,0,0,0
"19847",8331,0,0,0,0,0,0,0,0,0,0,0,0,0,0,0,0,3277503,"2023-11-24T00:00:00.000Z",17896007,8,"Braxton Key",0,0,0,0,0,0
"19848",8332,0,0,0,0,0,0,0,0,0,0,0,0,0,0,0,0,3277503,"2023-11-24T00:00:00.000Z",56677582,8,"Jalen Pickett",0,0,0,0,0,0
"19849",8333,4,0,2,6,1,17,6,2,2,35,3,3,15,5,1,0,3277500,"2023-11-24T00:00:00.000Z",56677785,16,"Jaime Jaquez Jr.",1,20,24,19,9,30
"19850",8334,0,1,1,3,1,7,4,0,0,18,0,0,9,1,0,3,3277505,"2023-11-24T00:00:00.000Z",667378,18,"Naz Reid",1,10,10,9,1,10.2
"19851",8335,0,0,0,0,0,0,0,0,0,0,0,0,0,0,0,0,3277505,"2023-11-24T00:00:00.000Z",38017715,18,"Josh Minott",0,0,0,0,0,0
"19852",8336,0,0,0,0,0,0,0,0,0,0,0,0,0,0,0,0,3277505,"2023-11-24T00:00:00.000Z",17895968,18,"Daishen Nix",0,0,0,0,0,0
"19853",8337,0,0,0,0,0,0,0,0,0,0,0,0,0,0,0,0,3277505,"2023-11-24T00:00:00.000Z",56677851,18,"Jaylen Clark",0,0,0,0,0,0
"19854",8338,0,0,0,0,0,0,0,0,0,0,0,0,0,0,0,0,3277505,"2023-11-24T00:00:00.000Z",17896056,18,"Luka Garza",0,0,0,0,0,0
"19855",8339,0,0,0,0,0,0,0,0,0,0,0,0,0,0,0,0,3277505,"2023-11-24T00:00:00.000Z",3547259,18,"Jaden McDaniels",0,0,0,0,0,0
"19856",8340,0,0,0,0,0,0,0,0,0,0,0,0,0,0,0,0,3277505,"2023-11-24T00:00:00.000Z",666767,18,"Jordan McLaughlin",0,0,0,0,0,0
"19857",8341,0,0,0,0,0,0,0,0,0,0,0,0,0,0,0,0,3277505,"2023-11-24T00:00:00.000Z",38017700,18,"Wendell Moore Jr.",0,0,0,0,0,0
"19858",8342,0,1,0,1,0,3,0,0,0,6,1,1,0,1,0,0,3277503,"2023-11-24T00:00:00.000Z",38017721,8,"Peyton Watson",1,1,1,0,1,4.2
"19859",8343,0,0,0,0,0,0,0,0,0,0,0,0,0,0,0,0,3277503,"2023-11-24T00:00:00.000Z",56677871,8,"Hunter Tyson",0,0,0,0,0,0
"19860",8344,0,0,0,0,0,0,0,0,0,0,0,0,0,0,0,0,3277503,"2023-11-24T00:00:00.000Z",666489,8,"Vlatko Cancar",0,0,0,0,0,0
"19861",8345,0,0,0,0,0,0,0,0,0,0,0,0,0,0,0,0,3277503,"2023-11-24T00:00:00.000Z",17896103,8,"Jay Huff",0,0,0,0,0,0
"19862",8346,0,0,0,0,0,0,0,0,0,0,0,0,0,0,0,0,3277503,"2023-11-24T00:00:00.000Z",335,8,"Jamal Murray",0,0,0,0,0,0
"19863",8347,0,0,0,0,0,0,0,0,0,0,0,0,0,0,0,0,3277504,"2023-11-24T00:00:00.000Z",56677854,17,"Chris Livingston",0,0,0,0,0,0
"19864",8348,0,0,0,0,0,0,0,0,0,0,0,0,0,0,0,0,3277504,"2023-11-24T00:00:00.000Z",284,17,"Robin Lopez",0,0,0,0,0,0
"19865",8349,0,0,0,0,0,0,0,0,0,0,0,0,0,0,0,0,3277504,"2023-11-24T00:00:00.000Z",666960,17,"Lindell Wigginton",0,0,0,0,0,0
"19866",8350,0,0,0,0,0,0,0,0,0,0,0,0,0,0,0,0,3277504,"2023-11-24T00:00:00.000Z",666453,17,"Marques Bolden",0,0,0,0,0,0
"19867",8351,0,0,1,0,0,2,0,0,0,8,2,2,0,3,0,0,1037807,"2023-11-22T00:00:00.000Z",491,19,"Cody Zeller",0,3,3,0,3,3.6
"19868",8352,2,1,2,5,3,7,4,0,0,21,0,4,11,2,1,2,1037808,"2023-11-22T00:00:00.000Z",17895983,5,"Ayo Dosunmu",2,13,15,13,4,20.4
"19869",8353,1,0,4,0,0,3,1,0,0,11,1,2,2,5,0,0,1037808,"2023-11-22T00:00:00.000Z",137,5,"Andre Drummond",0,7,8,3,6,9.5
"19870",8354,0,2,5,1,0,4,2,2,1,20,1,2,5,6,0,0,1037806,"2023-11-22T00:00:00.000Z",108,23,"Robert Covington",2,11,11,5,6,18.2
"19871",8355,3,1,4,4,2,8,4,2,2,28,3,2,12,7,0,2,1037811,"2023-11-22T00:00:00.000Z",56677850,25,"Toumani Camara",1,19,22,15,10,25.9
"19872",8356,4,1,2,6,5,13,10,6,5,32,0,3,30,2,1,2,1037811,"2023-11-22T00:00:00.000Z",182,25,"Jerami Grant",2,32,36,34,6,42.4
"19873",8357,4,1,4,4,2,11,6,0,0,31,0,4,14,4,1,1,1037811,"2023-11-22T00:00:00.000Z",38017690,25,"Shaedon Sharpe",2,18,22,18,8,29.8
"19874",8358,8,0,3,5,1,16,9,1,1,24,1,0,20,4,1,0,1037811,"2023-11-22T00:00:00.000Z",65,25,"Malcolm Brogdon",1,24,32,28,12,39.8
"19875",8359,7,0,2,3,0,7,1,2,1,17,1,4,3,3,0,3,1037811,"2023-11-22T00:00:00.000Z",56677747,25,"Scoot Henderson",0,6,13,10,10,14.1
"19876",8360,0,0,1,0,0,2,1,2,1,6,0,2,3,1,0,0,1037806,"2023-11-22T00:00:00.000Z",3547294,23,"Kenyon Martin Jr.",0,4,4,3,1,4.2
"19877",8361,0,0,1,2,1,2,1,0,0,5,1,0,3,2,1,0,1037806,"2023-11-22T00:00:00.000Z",260,23,"Furkan Korkmaz",1,5,5,3,2,8.4
"19878",8362,0,0,0,0,0,0,0,0,0,0,0,0,0,0,0,0,1037808,"2023-11-22T00:00:00.000Z",268,5,"Zach LaVine",0,0,0,0,0,0
"19879",8363,0,0,0,0,0,0,0,0,0,0,0,0,0,0,0,0,1037808,"2023-11-22T00:00:00.000Z",17896116,5,"Terry Taylor",0,0,0,0,0,0
"19880",8364,0,0,0,0,0,0,0,0,0,0,0,0,0,0,0,0,1037808,"2023-11-22T00:00:00.000Z",56677874,5,"Onuralp Bitim",0,0,0,0,0,0
"19881",8365,0,0,0,0,0,0,0,0,0,0,0,0,0,0,0,0,1037808,"2023-11-22T00:00:00.000Z",45969255,5,"Justin Lewis",0,0,0,0,0,0
"19882",8366,0,0,0,0,0,0,0,0,0,0,0,0,0,0,0,0,1037808,"2023-11-22T00:00:00.000Z",56677857,5,"Julian Phillips",0,0,0,0,0,0
"19883",8367,0,0,0,0,0,0,0,0,0,0,0,0,0,0,0,0,1037808,"2023-11-22T00:00:00.000Z",56677860,5,"Adama Sanogo",0,0,0,0,0,0
"19884",8368,0,0,0,3,0,5,1,1,0,17,2,0,2,2,1,0,1037811,"2023-11-22T00:00:00.000Z",56677791,25,"Kris Murray",1,4,4,2,2,7.4
"19885",8369,0,0,0,0,0,0,0,0,0,0,0,0,0,0,0,0,1037808,"2023-11-22T00:00:00.000Z",38017719,5,"Dalen Terry",0,0,0,0,0,0
"19886",8370,0,1,1,1,0,1,0,0,0,4,0,0,0,1,0,0,1037805,"2023-11-22T00:00:00.000Z",38017731,15,"Vince Williams Jr.",1,1,1,0,1,4.2
"19887",8371,1,0,0,1,0,4,1,1,1,4,1,0,3,1,0,0,1037805,"2023-11-22T00:00:00.000Z",38017732,15,"Kenneth Lofton Jr.",0,4,5,4,2,5.7
"19888",8372,0,0,2,1,0,3,0,0,0,4,1,0,0,3,0,0,1037805,"2023-11-22T00:00:00.000Z",56677830,15,"GG Jackson",0,3,3,0,3,3.6
"19889",8373,0,0,0,0,0,0,0,0,0,0,0,0,0,0,0,0,1037805,"2023-11-22T00:00:00.000Z",3,15,"Steven Adams",0,0,0,0,0,0
"19890",8374,0,0,0,0,0,0,0,0,0,0,0,0,0,0,0,0,1037805,"2023-11-22T00:00:00.000Z",666505,15,"Brandon Clarke",0,0,0,0,0,0
"19891",8375,0,0,0,0,0,1,0,0,0,6,0,0,0,0,0,0,1037811,"2023-11-22T00:00:00.000Z",3547289,25,"Skylar Mays",0,0,0,0,0,0
"19892",8376,0,0,0,1,0,1,0,0,0,1,0,0,0,0,0,0,1037807,"2023-11-22T00:00:00.000Z",17896044,26,"Kessler Edwards",0,0,0,0,0,0
"19893",8377,0,0,0,0,0,0,0,0,0,0,0,0,0,0,0,0,1037806,"2023-11-22T00:00:00.000Z",56913527,23,"Ricky Council IV",0,0,0,0,0,0
"19894",8378,0,0,0,0,0,0,0,0,0,0,0,0,0,0,0,0,1037806,"2023-11-22T00:00:00.000Z",145,23,"Joel Embiid",0,0,0,0,0,0
"19895",8379,0,0,0,0,0,0,0,0,0,0,0,0,0,0,0,0,1037806,"2023-11-22T00:00:00.000Z",360,23,"Kelly Oubre Jr.",0,0,0,0,0,0
"19896",8380,0,0,0,0,0,0,0,0,0,0,0,0,0,0,0,0,1037806,"2023-11-22T00:00:00.000Z",17554001,23,"Javonte Smart",0,0,0,0,0,0
"19897",8381,0,0,0,0,0,0,0,0,0,0,0,0,0,0,0,0,1037806,"2023-11-22T00:00:00.000Z",56677788,23,"Terquavion Smith",0,0,0,0,0,0
"19898",8382,3,0,1,1,0,3,1,0,0,9,0,1,2,1,1,1,1037803,"2023-11-22T00:00:00.000Z",38017662,6,"Isaiah Mobley",1,3,6,5,4,9.7
"19899",8383,0,0,0,0,0,0,0,0,0,0,0,0,0,0,0,0,1037803,"2023-11-22T00:00:00.000Z",666676,6,"Ty Jerome",0,0,0,0,0,0
"19900",8384,5,0,4,6,1,8,2,5,5,26,0,2,10,4,2,2,1037807,"2023-11-22T00:00:00.000Z",324,26,"Malik Monk",2,14,19,15,9,26.3
"19901",8385,2,0,1,0,0,0,0,2,2,10,0,0,2,1,0,0,1037807,"2023-11-22T00:00:00.000Z",17553994,26,"Davion Mitchell",0,3,5,4,3,6.2
"19902",8386,0,0,8,7,3,8,4,1,1,27,0,5,12,8,0,3,1037807,"2023-11-22T00:00:00.000Z",290,26,"Trey Lyles",0,20,20,12,8,18.6
"19903",8387,0,0,1,0,0,0,0,2,0,5,0,0,0,1,0,2,1037807,"2023-11-22T00:00:00.000Z",306,26,"JaVale McGee",0,1,1,0,1,-0.8
"19904",8388,6,1,7,3,2,7,4,1,1,31,1,1,11,8,0,0,1037802,"2023-11-22T00:00:00.000Z",219,2,"Al Horford",1,19,25,17,14,32.6
"19905",8389,0,0,0,0,0,0,0,0,0,0,0,0,0,0,0,0,1037802,"2023-11-22T00:00:00.000Z",666468,2,"Oshae Brissett",0,0,0,0,0,0
"19906",8390,0,0,0,0,0,0,0,0,0,0,0,0,0,0,0,0,1037802,"2023-11-22T00:00:00.000Z",261,2,"Luke Kornet",0,0,0,0,0,0
"19907",8391,0,0,0,0,0,0,0,0,0,0,0,0,0,0,0,0,1037802,"2023-11-22T00:00:00.000Z",338,2,"Svi Mykhailiuk",0,0,0,0,0,0
"19908",8392,0,0,2,4,1,5,1,0,0,10,0,0,3,2,0,2,1037807,"2023-11-22T00:00:00.000Z",4197162,26,"Aleksandar Vezenkov",0,5,5,3,2,3.4
"19909",8393,0,0,0,0,0,0,0,0,0,0,0,0,0,0,0,0,1037807,"2023-11-22T00:00:00.000Z",17895941,26,"Filip Petrusev",0,0,0,0,0,0
"19910",8394,0,0,0,0,0,0,0,0,0,0,0,0,0,0,0,0,1037807,"2023-11-22T00:00:00.000Z",56677862,26,"Jalen Slawson",0,0,0,0,0,0
"19911",8395,4,0,1,9,3,12,4,3,2,29,0,3,13,1,3,2,1037810,"2023-11-22T00:00:00.000Z",178,24,"Eric Gordon",3,14,18,17,5,27.2
"19912",8396,9,1,6,4,2,7,3,12,8,36,0,3,16,6,1,4,1037809,"2023-11-22T00:00:00.000Z",192,13,"James Harden",2,22,31,25,15,38.7
"19913",8397,0,0,0,0,0,0,0,0,0,0,0,0,0,0,0,0,1037805,"2023-11-22T00:00:00.000Z",254,15,"Luke Kennard",0,0,0,0,0,0
"19914",8398,0,0,0,0,0,0,0,0,0,0,0,0,0,0,0,0,1037805,"2023-11-22T00:00:00.000Z",38017728,15,"Jake LaRavia",0,0,0,0,0,0
"19915",8399,1,1,4,4,2,5,3,0,0,20,0,2,8,4,0,1,1037811,"2023-11-22T00:00:00.000Z",56783340,25,"Duop Reath",1,12,13,9,5,16.3
"19916",8400,2,2,0,6,3,9,5,1,0,31,1,2,13,1,3,3,1037811,"2023-11-22T00:00:00.000Z",666923,25,"Matisse Thybulle",5,14,16,15,3,29.2
"19917",8401,0,0,0,0,0,0,0,0,0,0,0,0,0,0,0,0,1037811,"2023-11-22T00:00:00.000Z",39613724,25,"Ibou Badji",0,0,0,0,0,0
"19918",8402,0,0,0,0,0,0,0,0,0,0,0,0,0,0,0,0,1037811,"2023-11-22T00:00:00.000Z",47957121,25,"Justin Minaya",0,0,0,0,0,0
"19919",8403,0,0,0,0,0,0,0,0,0,0,0,0,0,0,0,0,1037811,"2023-11-22T00:00:00.000Z",419,25,"Anfernee Simons",0,0,0,0,0,0
"19920",8404,0,0,0,0,0,0,0,0,0,0,0,0,0,0,0,0,1037811,"2023-11-22T00:00:00.000Z",17896120,25,"Ish Wainright",0,0,0,0,0,0
"19921",8405,0,0,0,0,0,0,0,0,0,0,0,0,0,0,0,0,1037811,"2023-11-22T00:00:00.000Z",476,25,"Robert Williams III",0,0,0,0,0,0
"19922",8406,5,1,6,0,0,5,5,3,3,32,3,1,13,9,1,3,1037811,"2023-11-22T00:00:00.000Z",358,29,"Kelly Olynyk",2,22,27,18,14,34.3
"19923",8407,0,0,5,6,1,18,9,6,5,34,3,2,24,8,3,2,1037811,"2023-11-22T00:00:00.000Z",297,29,"Lauri Markkanen",3,32,32,24,8,40.6
"19924",8408,1,0,5,1,0,12,6,0,0,32,6,0,12,11,0,0,1037811,"2023-11-22T00:00:00.000Z",101,29,"John Collins",0,23,24,13,12,26.7
"19925",8409,5,0,2,4,2,11,5,2,1,32,0,0,13,2,0,7,1037811,"2023-11-22T00:00:00.000Z",100,29,"Jordan Clarkson",0,15,20,18,7,15.9
"19926",8410,7,0,3,6,3,9,3,7,7,34,0,2,16,3,1,0,1037811,"2023-11-22T00:00:00.000Z",56677834,29,"Keyonte George",1,19,26,23,10,33.1
"19927",8411,2,0,1,3,0,5,0,2,1,11,1,2,1,2,1,2,1037811,"2023-11-22T00:00:00.000Z",413,29,"Collin Sexton",1,3,5,3,4,7.4
"19928",8412,1,0,0,2,0,4,1,4,3,14,0,4,5,0,0,3,1037811,"2023-11-22T00:00:00.000Z",666650,29,"Talen Horton-Tucker",0,5,6,6,1,3.5
"19929",8413,1,0,0,6,2,7,3,0,0,16,1,1,8,1,1,1,1037811,"2023-11-22T00:00:00.000Z",38017739,29,"Simone Fontecchio",1,9,10,9,2,12.7
"19930",8414,1,1,0,1,1,4,4,0,0,14,0,0,9,0,0,1,1037811,"2023-11-22T00:00:00.000Z",38017620,29,"Ochai Agbaji",1,9,10,10,1,12.5
"19931",8415,1,0,6,2,1,3,1,0,0,16,0,1,3,6,0,2,1037811,"2023-11-22T00:00:00.000Z",11891374,29,"Omer Yurtseven",0,9,10,4,7,9.7
"19932",8416,1,1,2,0,0,1,0,2,1,5,0,0,1,2,0,0,1037811,"2023-11-22T00:00:00.000Z",139,29,"Kris Dunn",1,3,4,2,3,7.9
"19933",8417,0,0,0,0,0,0,0,0,0,0,0,0,0,0,0,0,1037811,"2023-11-22T00:00:00.000Z",666881,29,"Luka Samanic",0,0,0,0,0,0
"19934",8418,0,0,0,0,0,0,0,0,0,0,0,0,0,0,0,0,1037811,"2023-11-22T00:00:00.000Z",17896023,29,"Josh Christopher",0,0,0,0,0,0
"19935",8419,0,0,0,0,0,0,0,0,0,0,0,0,0,0,0,0,1037811,"2023-11-22T00:00:00.000Z",56677824,29,"Taylor Hendricks",0,0,0,0,0,0
"19936",8420,0,0,0,0,0,0,0,0,0,0,0,0,0,0,0,0,1037811,"2023-11-22T00:00:00.000Z",38017630,29,"Johnny Juzang",0,0,0,0,0,0
"19937",8421,0,0,0,0,0,0,0,0,0,0,0,0,0,0,0,0,1037811,"2023-11-22T00:00:00.000Z",38017705,29,"Walker Kessler",0,0,0,0,0,0
"19938",8422,0,0,0,0,0,0,0,0,0,0,0,0,0,0,0,0,1037811,"2023-11-22T00:00:00.000Z",19465584,29,"Micah Potter",0,0,0,0,0,0
"19939",8423,2,2,8,4,3,14,7,15,15,34,0,2,32,8,0,6,1037810,"2023-11-22T00:00:00.000Z",140,24,"Kevin Durant",2,40,42,34,10,44.6
"19940",8424,0,0,2,1,0,8,4,2,1,17,3,4,9,5,0,0,1037810,"2023-11-22T00:00:00.000Z",349,24,"Jusuf Nurkic",0,14,14,9,5,15
"19941",8425,3,0,2,4,1,4,1,8,6,34,1,5,9,3,1,2,1037810,"2023-11-22T00:00:00.000Z",8,24,"Grayson Allen",1,12,15,12,6,18.1
"19942",8426,0,0,0,0,0,0,0,0,0,0,0,0,0,0,0,0,1037811,"2023-11-22T00:00:00.000Z",17896120,25,"Ish Wainright",0,0,0,0,0,0
"19943",8427,3,0,4,3,0,9,4,2,2,27,1,1,10,5,2,0,1037810,"2023-11-22T00:00:00.000Z",666729,24,"Nassir Little",2,15,18,13,8,26.5
"19944",8428,0,3,5,0,0,4,2,2,2,16,1,1,6,6,0,0,1037810,"2023-11-22T00:00:00.000Z",147,24,"Drew Eubanks",3,12,12,6,6,22.2
"19945",8429,0,0,2,1,1,2,1,2,0,12,1,1,3,3,1,1,1037810,"2023-11-22T00:00:00.000Z",32,24,"Keita Bates-Diop",1,6,6,3,3,8.6
"19946",8430,0,2,2,1,0,3,2,0,0,12,0,2,4,2,0,0,1037810,"2023-11-22T00:00:00.000Z",314,24,"Chimezie Metu",2,6,6,4,2,12.4
"19947",8431,0,0,0,0,0,0,0,0,0,1,0,0,0,0,0,0,1037810,"2023-11-22T00:00:00.000Z",18678058,24,"Jordan Goodwin",0,0,0,0,0,0
"19948",8432,0,0,0,0,0,0,0,0,0,0,0,0,0,0,0,0,1037810,"2023-11-22T00:00:00.000Z",3547095,24,"Udoka Azubuike",0,0,0,0,0,0
"19949",8433,0,0,0,0,0,0,0,0,0,0,0,0,0,0,0,0,1037810,"2023-11-22T00:00:00.000Z",666451,24,"Bol Bol",0,0,0,0,0,0
"19950",8434,0,0,0,0,0,0,0,0,0,0,0,0,0,0,0,0,1037810,"2023-11-22T00:00:00.000Z",3547298,24,"Saben Lee",0,0,0,0,0,0
"19951",8435,0,0,0,0,0,0,0,0,0,0,0,0,0,0,0,0,1037810,"2023-11-22T00:00:00.000Z",37,24,"Bradley Beal",0,0,0,0,0,0
"19952",8436,0,0,0,0,0,0,0,0,0,0,0,0,0,0,0,0,1037810,"2023-11-22T00:00:00.000Z",272,24,"Damion Lee",0,0,0,0,0,0
"19953",8437,0,0,0,0,0,0,0,0,0,0,0,0,0,0,0,0,1037810,"2023-11-22T00:00:00.000Z",470,24,"Yuta Watanabe",0,0,0,0,0,0
"19954",8438,1,1,2,10,6,17,8,1,1,25,1,3,23,3,0,2,1037810,"2023-11-22T00:00:00.000Z",443,10,"Klay Thompson",1,26,27,24,4,29.1
"19955",8439,1,1,2,3,0,11,4,4,3,25,2,1,11,4,0,2,1037810,"2023-11-22T00:00:00.000Z",475,10,"Andrew Wiggins",1,15,16,12,5,18.3
"19956",8440,2,0,5,0,0,5,3,0,0,17,1,4,6,6,1,2,1037810,"2023-11-22T00:00:00.000Z",282,10,"Kevon Looney",1,12,14,8,8,17.2
"19957",8441,6,0,3,8,1,15,6,3,3,28,0,2,16,3,0,2,1037810,"2023-11-22T00:00:00.000Z",115,10,"Stephen Curry",0,19,25,22,9,26.6
"19958",8442,6,0,2,1,0,2,1,4,4,17,0,1,6,2,0,1,1037810,"2023-11-22T00:00:00.000Z",367,10,"Chris Paul",0,8,14,12,8,16.4
"19959",8443,1,1,8,1,0,8,4,1,0,23,1,5,8,9,0,1,1037810,"2023-11-22T00:00:00.000Z",17553992,10,"Moses Moody",1,17,18,9,10,22.3
"19960",8444,4,0,4,3,2,9,6,5,3,22,2,4,17,6,2,1,1037810,"2023-11-22T00:00:00.000Z",407,10,"Dario Saric",2,23,27,21,10,35.2
"19961",8445,2,0,1,1,0,7,3,2,1,21,0,5,7,1,1,0,1037810,"2023-11-22T00:00:00.000Z",17553979,10,"Jonathan Kuminga",1,8,10,9,3,14.2
"19962",8446,2,0,2,3,1,9,4,2,1,23,2,1,10,4,3,0,1037810,"2023-11-22T00:00:00.000Z",56677858,10,"Brandin Podziemski",3,14,16,12,6,26.8
"19963",8447,0,0,2,0,0,3,2,5,2,15,2,3,6,4,1,1,1037810,"2023-11-22T00:00:00.000Z",56677799,10,"Trayce Jackson-Davis",1,10,10,6,4,12.8
"19964",8448,4,0,0,2,0,3,1,2,1,16,0,3,3,0,2,1,1037810,"2023-11-22T00:00:00.000Z",251,10,"Cory Joseph",2,3,7,7,4,14
"19965",8449,0,0,1,0,0,1,1,0,0,8,0,2,2,1,0,2,1037810,"2023-11-22T00:00:00.000Z",57875092,10,"Gui Santos",0,3,3,2,1,1.2
"19966",8450,0,0,0,0,0,0,0,0,0,0,0,0,0,0,0,0,1037810,"2023-11-22T00:00:00.000Z",185,10,"Draymond Green",0,0,0,0,0,0
"19967",8451,0,0,0,0,0,0,0,0,0,0,0,0,0,0,0,0,1037799,"2023-11-22T00:00:00.000Z",403,4,"Terry Rozier",0,0,0,0,0,0
"19968",8452,0,1,1,0,0,3,2,2,0,13,2,1,4,3,0,0,1037803,"2023-11-22T00:00:00.000Z",444,6,"Tristan Thompson",1,7,7,4,3,10.6
"19969",8453,1,0,2,5,3,9,4,0,0,20,1,5,11,3,0,0,1037803,"2023-11-22T00:00:00.000Z",344,6,"Georges Niang",0,14,15,12,4,16.1
"19970",8454,1,0,1,5,3,6,3,0,0,17,0,3,9,1,0,1,1037803,"2023-11-22T00:00:00.000Z",3547299,6,"Sam Merrill",0,10,11,10,2,10.7
"19971",8455,1,0,1,5,1,5,1,0,0,16,0,1,3,1,1,0,1037803,"2023-11-22T00:00:00.000Z",56677847,6,"Emoni Bates",1,4,5,4,2,8.7
"19972",8456,1,1,1,0,0,5,1,0,0,12,2,0,2,3,1,1,1037803,"2023-11-22T00:00:00.000Z",248,6,"Damian Jones",2,5,6,3,4,12.1
"19973",8457,1,0,1,3,1,6,2,3,2,18,1,3,7,2,0,0,1037799,"2023-11-22T00:00:00.000Z",414,30,"Landry Shamet",0,9,10,8,3,10.9
"19974",8458,0,0,0,0,0,0,0,0,0,0,0,0,0,0,0,0,1037799,"2023-11-22T00:00:00.000Z",38124126,30,"John Butler Jr.",0,0,0,0,0,0
"19975",8459,0,0,0,0,0,0,0,0,0,0,0,0,0,0,0,0,1037799,"2023-11-22T00:00:00.000Z",38017712,30,"Ryan Rollins",0,0,0,0,0,0
"19976",8460,0,0,0,0,0,0,0,0,0,0,0,0,0,0,0,0,1037799,"2023-11-22T00:00:00.000Z",487,30,"Delon Wright",0,0,0,0,0,0
"19977",8461,7,0,1,2,2,4,4,2,2,17,0,3,12,1,1,0,1037800,"2023-11-22T00:00:00.000Z",226,22,"Joe Ingles",1,13,20,19,8,26.7
"19978",8462,1,1,4,2,0,6,4,1,1,14,2,1,9,6,1,1,1037800,"2023-11-22T00:00:00.000Z",229,22,"Jonathan Isaac",2,15,16,10,7,22.7
"19979",8463,1,0,2,3,1,7,4,4,3,15,1,1,12,3,1,1,1037800,"2023-11-22T00:00:00.000Z",462,22,"Moritz Wagner",1,15,16,13,4,19.1
"19980",8464,0,0,0,0,0,0,0,0,0,0,0,0,0,0,0,0,1037800,"2023-11-22T00:00:00.000Z",666818,22,"Chuma Okeke",0,0,0,0,0,0
"19981",8465,0,0,0,0,0,0,0,0,0,0,0,0,0,0,0,0,1037800,"2023-11-22T00:00:00.000Z",666885,22,"Admiral Schofield",0,0,0,0,0,0
"19982",8466,0,0,0,0,0,0,0,0,0,0,0,0,0,0,0,0,1037800,"2023-11-22T00:00:00.000Z",85,22,"Wendell Carter Jr.",0,0,0,0,0,0
"19983",8467,0,0,0,0,0,0,0,0,0,0,0,0,0,0,0,0,1037800,"2023-11-22T00:00:00.000Z",165,22,"Markelle Fultz",0,0,0,0,0,0
"19984",8468,5,1,2,12,7,17,12,0,0,35,0,2,31,2,2,1,1037804,"2023-11-22T00:00:00.000Z",210,12,"Buddy Hield",3,33,38,36,7,48.9
"19985",8469,1,0,3,5,2,9,6,2,2,36,0,1,16,3,2,3,1037804,"2023-11-22T00:00:00.000Z",3547243,12,"Obi Toppin",2,19,20,17,4,24.1
"19986",8470,0,2,7,3,2,11,7,2,1,29,1,3,17,8,1,2,1037804,"2023-11-22T00:00:00.000Z",452,12,"Myles Turner",3,25,25,17,8,33.6
"19987",8471,3,0,4,4,1,9,5,3,3,35,0,4,14,4,2,3,1037804,"2023-11-22T00:00:00.000Z",69,12,"Bruce Brown",2,18,21,17,7,26.3
"19988",8472,16,1,2,10,5,22,12,5,4,34,1,3,33,3,0,3,1037804,"2023-11-22T00:00:00.000Z",3547245,12,"Tyrese Haliburton",1,36,52,49,19,60.6
"19989",8473,2,1,0,1,0,7,2,2,1,24,0,1,5,0,1,0,1037804,"2023-11-22T00:00:00.000Z",38017686,12,"Bennedict Mathurin",2,5,7,7,2,14
"19990",8474,5,0,2,1,1,6,3,0,0,14,0,5,7,2,1,0,1037804,"2023-11-22T00:00:00.000Z",304,12,"T.J. McConnell",1,9,14,12,7,19.9
"19991",8475,1,0,1,2,0,5,0,0,0,14,3,3,0,4,1,1,1037804,"2023-11-22T00:00:00.000Z",3547207,12,"Jordan Nwora",1,4,5,1,5,8.3
"19992",8476,0,0,0,0,0,0,0,0,0,0,0,0,0,0,0,0,1037790,"2023-11-20T00:00:00.000Z",666767,18,"Jordan McLaughlin",0,0,0,0,0,0
"19993",8477,8,0,0,2,0,2,0,2,2,19,0,1,2,0,0,1,1037791,"2023-11-20T00:00:00.000Z",17553994,26,"Davion Mitchell",0,2,10,10,8,13
"19994",8478,2,1,7,2,1,7,6,3,3,27,1,5,16,8,0,2,3277483,"2023-11-21T00:00:00.000Z",486,14,"Christian Wood",1,24,26,18,10,29.6
"19995",8479,4,1,5,5,1,8,3,0,0,25,0,2,7,5,1,0,3277483,"2023-11-21T00:00:00.000Z",38017697,14,"Max Christie",2,12,16,11,9,25
"19996",8480,1,1,2,0,0,4,4,3,2,19,0,1,10,2,0,2,3277483,"2023-11-21T00:00:00.000Z",666626,14,"Jaxson Hayes",1,12,13,11,3,14.9
"19997",8481,0,0,0,0,0,0,0,0,0,0,0,0,0,0,0,0,3277483,"2023-11-21T00:00:00.000Z",56677835,14,"Jalen Hood-Schifino",0,0,0,0,0,0
"19998",8482,0,0,0,0,0,0,0,0,0,0,0,0,0,0,0,0,3277483,"2023-11-21T00:00:00.000Z",457,14,"Jarred Vanderbilt",0,0,0,0,0,0
"19999",8483,0,0,0,0,0,0,0,0,0,0,0,0,0,0,0,0,3277483,"2023-11-21T00:00:00.000Z",56677738,14,"Colin Castleton",0,0,0,0,0,0
"20000",8484,0,0,0,0,0,0,0,0,0,0,0,0,0,0,0,0,3277483,"2023-11-21T00:00:00.000Z",56677867,14,"Alex Fudge",0,0,0,0,0,0
"20001",8485,0,0,0,0,0,0,0,0,0,0,0,0,0,0,0,0,3277483,"2023-11-21T00:00:00.000Z",56677868,14,"D'Moi Hodge",0,0,0,0,0,0
"20002",8486,0,0,0,0,0,0,0,0,0,0,0,0,0,0,0,0,3277483,"2023-11-21T00:00:00.000Z",56677836,14,"Maxwell Lewis",0,0,0,0,0,0
"20003",8487,0,0,0,0,0,0,0,0,0,0,0,0,0,0,0,0,3277483,"2023-11-21T00:00:00.000Z",1603383,14,"Gabe Vincent",0,0,0,0,0,0
"20004",8488,1,0,3,2,0,3,0,0,0,9,0,1,0,3,0,1,3277483,"2023-11-21T00:00:00.000Z",666881,29,"Luka Samanic",0,3,4,1,4,4.1
"20005",8489,0,0,0,0,0,0,0,0,0,0,0,0,0,0,0,0,3277483,"2023-11-21T00:00:00.000Z",17896023,29,"Josh Christopher",0,0,0,0,0,0
"20006",8490,0,0,0,0,0,0,0,0,0,0,0,0,0,0,0,0,3277483,"2023-11-21T00:00:00.000Z",56677824,29,"Taylor Hendricks",0,0,0,0,0,0
"20007",8491,0,0,0,0,0,0,0,0,0,0,0,0,0,0,0,0,1037789,"2023-11-20T00:00:00.000Z",56677860,5,"Adama Sanogo",0,0,0,0,0,0
"20008",8492,6,0,3,2,0,11,4,9,8,29,0,2,16,3,1,1,1037789,"2023-11-20T00:00:00.000Z",79,16,"Jimmy Butler",1,19,25,22,9,30.6
"20009",8493,0,0,1,1,0,1,0,0,0,3,0,0,0,1,1,0,1037789,"2023-11-20T00:00:00.000Z",19465585,16,"Dru Smith",1,1,1,0,1,4.2
"20010",8494,0,0,0,0,0,0,0,0,0,2,0,1,0,0,0,0,1037789,"2023-11-20T00:00:00.000Z",39398582,16,"Orlando Robinson",0,0,0,0,0,0
"20011",8495,0,0,0,0,0,0,0,0,0,0,0,0,0,0,0,0,1037789,"2023-11-20T00:00:00.000Z",74,16,"Thomas Bryant",0,0,0,0,0,0
"20012",8496,0,0,0,0,0,0,0,0,0,0,0,0,0,0,0,0,1037789,"2023-11-20T00:00:00.000Z",38017734,16,"Jamal Cain",0,0,0,0,0,0
"20013",8497,0,0,0,0,0,0,0,0,0,0,0,0,0,0,0,0,1037789,"2023-11-20T00:00:00.000Z",3547257,16,"R.J. Hampton",0,0,0,0,0,0
"20014",8498,0,0,0,0,0,0,0,0,0,0,0,0,0,0,0,0,1037789,"2023-11-20T00:00:00.000Z",666633,16,"Tyler Herro",0,0,0,0,0,0
"20015",8499,0,0,0,0,0,0,0,0,0,0,0,0,0,0,0,0,1037789,"2023-11-20T00:00:00.000Z",38017696,16,"Nikola Jovic",0,0,0,0,0,0
"20016",8500,0,0,0,0,0,0,0,0,0,0,0,0,0,0,0,0,1037789,"2023-11-20T00:00:00.000Z",38017736,16,"Cole Swider",0,0,0,0,0,0
"20017",8501,0,0,0,0,0,0,0,0,0,0,0,0,0,0,0,0,1037779,"2023-11-19T00:00:00.000Z",17896007,8,"Braxton Key",0,0,0,0,0,0
"20018",8502,0,0,0,0,0,0,0,0,0,0,0,0,0,0,0,0,1037779,"2023-11-19T00:00:00.000Z",38017721,8,"Peyton Watson",0,0,0,0,0,0
"20019",8503,0,0,0,0,0,0,0,0,0,0,0,0,0,0,0,0,1037779,"2023-11-19T00:00:00.000Z",666489,8,"Vlatko Cancar",0,0,0,0,0,0
"20020",8504,0,0,0,0,0,0,0,0,0,0,0,0,0,0,0,0,1037779,"2023-11-19T00:00:00.000Z",17896103,8,"Jay Huff",0,0,0,0,0,0
"20021",8505,0,0,0,0,0,0,0,0,0,0,0,0,0,0,0,0,1037779,"2023-11-19T00:00:00.000Z",335,8,"Jamal Murray",0,0,0,0,0,0
"20022",8506,1,2,0,4,1,6,2,1,1,23,1,3,6,1,1,0,1037783,"2023-11-19T00:00:00.000Z",32,24,"Keita Bates-Diop",3,7,8,7,2,17.7
"20023",8507,0,0,0,0,0,0,0,0,0,0,0,0,0,0,0,0,1037783,"2023-11-19T00:00:00.000Z",3547095,24,"Udoka Azubuike",0,0,0,0,0,0
"20024",8508,1,1,5,0,0,4,2,2,2,9,2,1,6,7,1,1,1037781,"2023-11-19T00:00:00.000Z",306,26,"JaVale McGee",2,13,14,7,8,20.9
"20025",8509,1,0,0,1,0,3,0,0,0,9,0,0,0,0,0,2,1037781,"2023-11-19T00:00:00.000Z",17553994,26,"Davion Mitchell",0,0,1,1,1,-0.5
"20026",8510,0,0,1,0,0,0,0,0,0,4,0,0,0,1,0,0,1037781,"2023-11-19T00:00:00.000Z",56677862,26,"Jalen Slawson",0,1,1,0,1,1.2
"20027",8511,0,0,0,1,0,1,0,0,0,4,0,2,0,0,0,0,1037781,"2023-11-19T00:00:00.000Z",56677845,26,"Colby Jones",0,0,0,0,0,0
"20028",8512,0,0,0,0,0,0,0,0,0,0,0,0,0,0,0,0,1037781,"2023-11-19T00:00:00.000Z",17895941,26,"Filip Petrusev",0,0,0,0,0,0
"20029",8513,0,0,0,0,0,0,0,0,0,0,0,0,0,0,0,0,1037781,"2023-11-19T00:00:00.000Z",17895990,26,"Jordan Ford",0,0,0,0,0,0
"20030",8514,0,0,0,0,0,0,0,0,0,0,0,0,0,0,0,0,1037781,"2023-11-19T00:00:00.000Z",221,26,"Kevin Huerter",0,0,0,0,0,0
"20031",8515,0,0,0,0,0,0,0,0,0,0,0,0,0,0,0,0,1037781,"2023-11-19T00:00:00.000Z",273,26,"Alex Len",0,0,0,0,0,0
"20032",8516,0,0,0,0,0,0,0,0,0,0,0,0,0,0,0,0,1037783,"2023-11-19T00:00:00.000Z",666451,24,"Bol Bol",0,0,0,0,0,0
"20033",8517,0,1,8,5,3,14,5,2,2,43,4,2,15,12,2,1,1037783,"2023-11-19T00:00:00.000Z",101,29,"John Collins",3,27,27,15,12,37.4
"20034",8518,5,0,4,6,1,23,8,7,5,39,3,5,22,7,2,2,1037783,"2023-11-19T00:00:00.000Z",100,29,"Jordan Clarkson",2,29,34,27,12,41.9
"20035",8519,11,0,3,5,0,12,2,4,3,34,2,2,7,5,1,5,1037783,"2023-11-19T00:00:00.000Z",56677834,29,"Keyonte George",1,12,23,18,16,27.5
"20036",8520,5,0,2,2,0,4,1,4,4,20,3,6,6,5,0,4,1037783,"2023-11-19T00:00:00.000Z",358,29,"Kelly Olynyk",0,11,16,11,10,15.5
"20037",8521,3,0,2,10,4,18,9,3,3,29,2,4,25,4,2,1,1037783,"2023-11-19T00:00:00.000Z",666650,29,"Talen Horton-Tucker",2,29,32,28,7,39.3
"20038",8522,0,1,0,1,1,3,1,0,0,18,1,1,3,1,0,1,1037783,"2023-11-19T00:00:00.000Z",38017739,29,"Simone Fontecchio",1,4,4,3,1,6.2
"20039",8523,0,0,0,0,0,0,0,0,0,0,0,0,0,0,0,0,1037783,"2023-11-19T00:00:00.000Z",139,29,"Kris Dunn",0,0,0,0,0,0
"20040",8524,0,0,0,0,0,0,0,0,0,0,0,0,0,0,0,0,1037783,"2023-11-19T00:00:00.000Z",56677824,29,"Taylor Hendricks",0,0,0,0,0,0
"20041",8525,6,0,2,7,1,11,4,3,3,34,2,1,12,4,1,3,1037781,"2023-11-19T00:00:00.000Z",30,26,"Harrison Barnes",1,16,22,18,10,25.8
"20042",8526,3,0,3,2,1,8,5,6,5,32,2,3,16,5,2,3,1037775,"2023-11-18T00:00:00.000Z",38017699,27,"Jeremy Sochan",2,21,24,19,8,29.5
"20043",8527,3,0,1,3,0,6,2,0,0,18,0,2,4,1,0,2,1037775,"2023-11-18T00:00:00.000Z",38017692,27,"Malaki Branham",0,5,8,7,4,7.7
"20044",8528,0,0,1,0,0,0,0,0,0,4,0,3,0,1,0,1,1037775,"2023-11-18T00:00:00.000Z",17895854,27,"Charles Bassey",0,1,1,0,1,0.2
"20045",8529,0,0,1,0,0,0,0,0,0,3,0,0,0,1,0,0,1037775,"2023-11-18T00:00:00.000Z",38017730,27,"Dominick Barlow",0,1,1,0,1,1.2
"20046",8530,0,0,0,0,0,0,0,0,0,0,0,0,0,0,0,0,1037775,"2023-11-18T00:00:00.000Z",56677817,27,"Sidy Cissoko",0,0,0,0,0,0
"20047",8531,0,0,0,0,0,0,0,0,0,0,0,0,0,0,0,0,1037775,"2023-11-18T00:00:00.000Z",180,27,"Devonte' Graham",0,0,0,0,0,0
"20048",8532,4,0,3,10,5,19,9,0,0,30,0,6,23,3,0,3,1037772,"2023-11-18T00:00:00.000Z",3547238,18,"Anthony Edwards",0,26,30,27,7,29.6
"20049",8533,5,0,3,5,1,8,2,0,0,30,0,1,5,3,1,3,1037772,"2023-11-18T00:00:00.000Z",104,18,"Mike Conley",1,8,13,10,8,16.1
"20050",8534,3,1,1,4,2,7,4,0,0,18,0,2,10,1,1,2,1037772,"2023-11-18T00:00:00.000Z",666400,18,"Nickeil Alexander-Walker",2,11,14,13,4,19.7
"20051",8535,0,1,1,6,2,8,2,2,2,19,0,0,8,1,0,1,1037772,"2023-11-18T00:00:00.000Z",667378,18,"Naz Reid",1,9,9,8,1,11.2
"20052",8536,5,2,4,0,0,7,4,2,1,26,1,0,9,5,1,1,1037772,"2023-11-18T00:00:00.000Z",12,18,"Kyle Anderson",3,14,19,14,10,30.5
"20053",8537,1,0,1,2,0,6,2,4,4,16,0,2,8,1,1,1,1037772,"2023-11-18T00:00:00.000Z",320,18,"Shake Milton",1,9,10,9,2,12.7
"20054",8538,0,0,0,0,0,0,0,0,0,0,0,0,0,0,0,0,1037772,"2023-11-18T00:00:00.000Z",68,18,"Troy Brown Jr.",0,0,0,0,0,0
"20055",8539,0,0,0,0,0,0,0,0,0,0,0,0,0,0,0,0,1037772,"2023-11-18T00:00:00.000Z",38017715,18,"Josh Minott",0,0,0,0,0,0
"20056",8540,0,0,0,0,0,0,0,0,0,0,0,0,0,0,0,0,1037772,"2023-11-18T00:00:00.000Z",17895968,18,"Daishen Nix",0,0,0,0,0,0
"20057",8541,0,0,1,4,1,9,2,0,0,15,1,1,5,2,1,1,1037773,"2023-11-18T00:00:00.000Z",666747,16,"Caleb Martin",1,7,7,5,2,9.4
"20058",8542,0,0,0,0,0,0,0,0,0,0,0,0,0,0,0,0,1037773,"2023-11-18T00:00:00.000Z",74,16,"Thomas Bryant",0,0,0,0,0,0
"20059",8543,2,0,0,0,0,1,0,0,0,12,0,1,0,0,0,0,1037774,"2023-11-18T00:00:00.000Z",56677852,17,"Andre Jackson Jr.",0,0,2,2,2,3
"20060",8544,7,1,12,3,1,26,18,5,3,38,2,3,40,14,2,3,1037774,"2023-11-18T00:00:00.000Z",15,17,"Giannis Antetokounmpo",3,54,61,47,21,73.3
"20061",8545,0,2,3,6,1,8,3,5,5,34,0,1,12,3,1,0,1037774,"2023-11-18T00:00:00.000Z",283,17,"Brook Lopez",3,15,15,12,3,24.6
"20062",8546,0,0,7,6,1,9,3,0,0,34,0,3,7,7,1,0,1037774,"2023-11-18T00:00:00.000Z",38,17,"Malik Beasley",1,14,14,7,7,18.4
"20063",8547,12,0,3,11,4,18,7,10,9,38,0,2,27,3,1,1,1037774,"2023-11-18T00:00:00.000Z",278,17,"Damian Lillard",1,30,42,39,15,50.6
"20064",8548,2,0,6,2,1,10,5,0,0,22,1,0,11,7,0,0,1037774,"2023-11-18T00:00:00.000Z",377,17,"Bobby Portis",0,18,20,13,9,22.4
"20065",8549,3,0,2,9,4,12,6,0,0,34,2,1,16,4,2,1,1037774,"2023-11-18T00:00:00.000Z",105,17,"Pat Connaughton",2,20,23,19,7,30.3
"20066",8550,2,0,2,4,3,5,4,0,0,17,0,4,11,2,1,0,1037774,"2023-11-18T00:00:00.000Z",368,17,"Cameron Payne",1,13,15,13,4,19.4
"20067",8551,0,0,0,0,0,0,0,0,0,0,0,0,0,0,0,0,3277446,"2023-11-17T00:00:00.000Z",666423,20,"RJ Barrett",0,0,0,0,0,0
"20068",8552,5,2,7,5,2,16,11,0,0,37,1,3,24,8,0,1,1037624,"2023-10-28T00:00:00.000Z",17896055,28,"Scottie Barnes",2,32,37,29,13,46.1
"20069",8553,4,1,6,5,2,8,3,4,3,36,1,4,11,7,0,2,1037624,"2023-10-28T00:00:00.000Z",416,28,"Pascal Siakam",1,18,22,15,11,26.4
"20070",8554,3,1,6,0,0,5,2,3,2,25,1,2,6,7,0,2,1037624,"2023-10-28T00:00:00.000Z",373,28,"Jakob Poeltl",1,13,16,9,10,19.9
"20071",8555,0,0,1,5,3,16,6,4,2,33,1,0,17,2,1,1,1037624,"2023-10-28T00:00:00.000Z",3089,28,"Gary Trent Jr.",1,19,19,17,2,21.4
"20072",8556,10,0,1,6,4,14,5,2,1,35,3,1,15,4,2,1,1037624,"2023-10-28T00:00:00.000Z",409,28,"Dennis Schroder",2,19,29,25,14,39.8
"20073",8557,3,1,4,1,0,10,3,0,0,18,3,1,6,7,0,1,1037624,"2023-10-28T00:00:00.000Z",3547249,28,"Precious Achiuwa",1,13,16,9,10,20.9
"20074",8558,1,0,0,6,4,8,5,2,2,28,2,5,16,2,0,1,1037624,"2023-10-28T00:00:00.000Z",56677828,28,"Gradey Dick",0,18,19,17,3,18.9
"20075",8559,0,0,0,0,0,0,0,0,0,0,0,0,0,0,0,0,3277449,"2023-11-17T00:00:00.000Z",489,28,"Thaddeus Young",0,0,0,0,0,0
"20076",8560,4,1,3,5,3,14,9,3,2,36,0,2,23,3,1,3,3277449,"2023-11-17T00:00:00.000Z",70,2,"Jaylen Brown",2,26,30,27,7,35.6
"20077",8561,2,0,6,11,1,22,8,0,0,37,1,3,17,7,1,3,3277449,"2023-11-17T00:00:00.000Z",434,2,"Jayson Tatum",1,24,26,19,9,28.4
"20078",8562,5,3,10,3,0,13,6,2,2,35,2,3,14,12,1,2,3277449,"2023-11-17T00:00:00.000Z",378,2,"Kristaps Porzingis",4,26,31,19,17,45.9
"20079",8563,5,0,4,8,3,10,4,2,2,34,0,1,13,4,0,1,3277449,"2023-11-17T00:00:00.000Z",473,2,"Derrick White",0,17,22,18,9,24.3
"20080",8564,5,0,6,4,2,14,5,2,2,35,2,2,14,8,0,1,3277449,"2023-11-17T00:00:00.000Z",214,2,"Jrue Holiday",0,22,27,19,13,30.1
"20081",8565,3,0,2,6,3,7,4,0,0,23,1,0,11,3,1,0,3277449,"2023-11-17T00:00:00.000Z",17896060,2,"Sam Hauser",1,14,17,14,6,22.1
"20082",8566,2,0,3,4,3,5,4,0,0,23,1,1,11,4,0,0,3277449,"2023-11-17T00:00:00.000Z",219,2,"Al Horford",0,15,17,13,6,18.8
"20083",8567,3,0,2,5,1,7,2,0,0,17,1,1,5,3,1,0,3277449,"2023-11-17T00:00:00.000Z",3547276,2,"Payton Pritchard",1,8,11,8,6,16.1
"20084",8568,0,0,0,0,0,0,0,0,0,0,0,0,0,0,0,0,3277449,"2023-11-17T00:00:00.000Z",17896094,2,"Dalano Banton",0,0,0,0,0,0
"20085",8569,0,0,0,0,0,0,0,0,0,0,0,0,0,0,0,0,3277449,"2023-11-17T00:00:00.000Z",666468,2,"Oshae Brissett",0,0,0,0,0,0
"20086",8570,0,0,0,0,0,0,0,0,0,0,0,0,0,0,0,0,3277449,"2023-11-17T00:00:00.000Z",261,2,"Luke Kornet",0,0,0,0,0,0
"20087",8571,0,0,0,0,0,0,0,0,0,0,0,0,0,0,0,0,3277448,"2023-11-17T00:00:00.000Z",666676,6,"Ty Jerome",0,0,0,0,0,0
"20088",8572,0,0,0,0,0,0,0,0,0,0,0,0,0,0,0,0,3277448,"2023-11-17T00:00:00.000Z",322,6,"Donovan Mitchell",0,0,0,0,0,0
"20089",8573,0,0,0,0,0,0,0,0,0,0,0,0,0,0,0,0,3277448,"2023-11-17T00:00:00.000Z",38017662,6,"Isaiah Mobley",0,0,0,0,0,0
"20090",8574,0,0,0,0,0,0,0,0,0,0,0,0,0,0,0,0,3277446,"2023-11-17T00:00:00.000Z",17896089,20,"Duane Washington Jr.",0,0,0,0,0,0
"20091",8575,0,0,0,0,0,0,0,0,0,0,0,0,0,0,0,0,3277446,"2023-11-17T00:00:00.000Z",666971,20,"Dylan Windler",0,0,0,0,0,0
"20092",8576,0,1,1,1,0,6,1,0,0,9,1,1,2,2,0,1,3277445,"2023-11-17T00:00:00.000Z",56677846,4,"Nick Smith Jr.",1,4,4,2,2,6.4
"20093",8577,0,0,1,0,0,1,1,0,0,5,0,1,2,1,0,0,3277445,"2023-11-17T00:00:00.000Z",18678001,4,"JT Thor",0,3,3,2,1,3.2
"20094",8578,0,0,0,0,0,0,0,0,0,0,0,0,0,0,0,0,3277445,"2023-11-17T00:00:00.000Z",56677848,4,"Amari Bailey",0,0,0,0,0,0
"20095",8579,0,0,0,0,0,0,0,0,0,0,0,0,0,0,0,0,3277446,"2023-11-17T00:00:00.000Z",666423,20,"RJ Barrett",0,0,0,0,0,0
"20096",8580,0,0,0,0,0,0,0,0,0,0,0,0,0,0,0,0,3277446,"2023-11-17T00:00:00.000Z",666474,20,"Charles Brown",0,0,0,0,0,0
"20097",8581,0,0,0,0,0,0,0,0,0,0,0,0,0,0,0,0,3277446,"2023-11-17T00:00:00.000Z",17895858,20,"Quentin Grimes",0,0,0,0,0,0
"20098",8582,0,0,0,0,0,0,0,0,0,0,0,0,0,0,0,0,3277446,"2023-11-17T00:00:00.000Z",56677795,20,"Jacob Toppin",0,0,0,0,0,0
"20099",8583,3,0,1,2,1,6,4,2,2,29,1,3,11,2,1,6,3277448,"2023-11-17T00:00:00.000Z",38017682,9,"Jaden Ivey",1,13,16,14,5,14.9
"20100",8584,0,0,0,3,0,7,2,2,2,15,0,1,6,0,0,0,3277448,"2023-11-17T00:00:00.000Z",56677792,9,"Marcus Sasser",0,6,6,6,0,6
"20101",8585,8,0,2,4,2,19,9,1,1,38,1,3,21,3,1,2,3277452,"2023-11-17T00:00:00.000Z",227,19,"Brandon Ingram",1,24,32,29,11,37.6
"20102",8586,6,2,4,1,1,17,10,11,5,33,0,3,26,4,0,4,3277452,"2023-11-17T00:00:00.000Z",666969,19,"Zion Williamson",2,30,36,32,10,41.8
"20103",8587,3,1,6,3,1,18,10,3,1,34,2,4,22,8,0,0,3277452,"2023-11-17T00:00:00.000Z",455,19,"Jonas Valanciunas",1,30,33,25,11,39.1
"20104",8588,4,1,5,1,0,8,3,2,2,37,0,2,8,5,3,1,3277452,"2023-11-17T00:00:00.000Z",17896024,19,"Herbert Jones",4,13,17,12,9,31
"20105",8589,7,0,7,1,0,6,4,3,2,33,1,1,10,8,3,0,3277452,"2023-11-17T00:00:00.000Z",38017677,19,"Dyson Daniels",3,18,25,17,15,39.1
"20106",8590,2,0,2,2,1,3,1,0,0,15,0,1,3,2,0,0,3277450,"2023-11-17T00:00:00.000Z",359,27,"Cedi Osman",0,5,7,5,4,8.4
"20107",8591,3,0,0,2,1,4,2,2,1,16,0,1,6,0,0,0,3277450,"2023-11-17T00:00:00.000Z",305,27,"Doug McDermott",0,6,9,9,3,10.5
"20108",8592,2,0,2,0,0,2,1,4,4,12,1,1,6,3,0,1,3277450,"2023-11-17T00:00:00.000Z",17896059,27,"Sandro Mamukelashvili",0,9,11,8,5,11.6
"20109",8593,0,0,0,0,0,0,0,0,0,0,0,0,0,0,0,0,3277450,"2023-11-17T00:00:00.000Z",56677870,27,"Sir'Jabari Rice",0,0,0,0,0,0
"20110",8594,1,0,5,5,4,6,4,0,0,18,0,0,12,5,1,2,3277452,"2023-11-17T00:00:00.000Z",3547293,19,"Naji Marshall",1,17,18,13,6,20.5
"20111",8595,1,1,2,0,0,5,3,2,2,16,1,0,8,3,1,1,3277448,"2023-11-17T00:00:00.000Z",24,9,"Marvin Bagley III",2,11,12,9,4,18.1
"20112",8596,0,1,5,3,2,3,2,4,4,17,1,1,10,6,1,0,3277448,"2023-11-17T00:00:00.000Z",44477024,9,"Stanley Umude",2,16,16,10,6,23.2
"20113",8597,0,0,2,0,0,0,0,0,0,4,0,0,0,2,0,0,3277448,"2023-11-17T00:00:00.000Z",3547240,9,"James Wiseman",0,2,2,0,2,2.4
"20114",8598,0,0,0,0,0,0,0,0,0,0,0,0,0,0,0,0,3277448,"2023-11-17T00:00:00.000Z",38017694,9,"Jalen Duren",0,0,0,0,0,0
"20115",8599,0,0,0,0,0,0,0,0,0,0,0,0,0,0,0,0,3277448,"2023-11-17T00:00:00.000Z",17896071,9,"Isaiah Livers",0,0,0,0,0,0
"20116",8600,4,0,5,3,1,7,3,0,0,26,0,0,7,5,0,0,3277452,"2023-11-17T00:00:00.000Z",56677837,19,"Jordan Hawkins",0,12,16,11,9,19
"20117",8601,6,2,4,1,1,17,10,11,5,33,0,3,26,4,0,4,3277452,"2023-11-17T00:00:00.000Z",666969,19,"Zion Williamson",2,30,36,32,10,41.8
"20118",8602,0,0,0,0,0,0,0,0,0,0,0,0,0,0,0,0,3277434,"2023-11-14T00:00:00.000Z",1603383,14,"Gabe Vincent",0,0,0,0,0,0
"20119",8603,5,0,1,6,2,10,5,3,3,27,0,1,15,1,0,2,3277434,"2023-11-14T00:00:00.000Z",3547287,15,"Desmond Bane",0,16,21,20,6,21.7
"20120",8604,3,1,6,3,1,18,10,3,1,34,2,4,22,8,0,0,3277452,"2023-11-17T00:00:00.000Z",455,19,"Jonas Valanciunas",1,30,33,25,11,39.1
"20121",8605,4,1,5,1,0,8,3,2,2,37,0,2,8,5,3,1,3277452,"2023-11-17T00:00:00.000Z",17896024,19,"Herbert Jones",4,13,17,12,9,31
"20122",8606,7,0,7,1,0,6,4,3,2,33,1,1,10,8,3,0,3277452,"2023-11-17T00:00:00.000Z",38017677,19,"Dyson Daniels",3,18,25,17,15,39.1
"20123",8607,2,0,2,2,1,3,1,0,0,15,0,1,3,2,0,0,3277450,"2023-11-17T00:00:00.000Z",359,27,"Cedi Osman",0,5,7,5,4,8.4
"20124",8608,3,0,0,2,1,4,2,2,1,16,0,1,6,0,0,0,3277450,"2023-11-17T00:00:00.000Z",305,27,"Doug McDermott",0,6,9,9,3,10.5
"20125",8609,2,0,2,0,0,2,1,4,4,12,1,1,6,3,0,1,3277450,"2023-11-17T00:00:00.000Z",17896059,27,"Sandro Mamukelashvili",0,9,11,8,5,11.6
"20126",8610,0,0,0,0,0,0,0,0,0,0,0,0,0,0,0,0,3277450,"2023-11-17T00:00:00.000Z",56677870,27,"Sir'Jabari Rice",0,0,0,0,0,0
"20127",8611,1,0,5,5,4,6,4,0,0,18,0,0,12,5,1,2,3277452,"2023-11-17T00:00:00.000Z",3547293,19,"Naji Marshall",1,17,18,13,6,20.5
"20128",8612,1,1,2,0,0,5,3,2,2,16,1,0,8,3,1,1,3277448,"2023-11-17T00:00:00.000Z",24,9,"Marvin Bagley III",2,11,12,9,4,18.1
"20129",8613,0,1,5,3,2,3,2,4,4,17,1,1,10,6,1,0,3277448,"2023-11-17T00:00:00.000Z",44477024,9,"Stanley Umude",2,16,16,10,6,23.2
"20130",8614,0,0,2,0,0,0,0,0,0,4,0,0,0,2,0,0,3277448,"2023-11-17T00:00:00.000Z",3547240,9,"James Wiseman",0,2,2,0,2,2.4
"20131",8615,0,0,0,0,0,0,0,0,0,0,0,0,0,0,0,0,3277448,"2023-11-17T00:00:00.000Z",38017694,9,"Jalen Duren",0,0,0,0,0,0
"20132",8616,0,0,0,0,0,0,0,0,0,0,0,0,0,0,0,0,3277448,"2023-11-17T00:00:00.000Z",17896071,9,"Isaiah Livers",0,0,0,0,0,0
"20133",8617,4,0,5,3,1,7,3,0,0,26,0,0,7,5,0,0,3277452,"2023-11-17T00:00:00.000Z",56677837,19,"Jordan Hawkins",0,12,16,11,9,19
"20134",8618,0,0,0,5,3,7,3,1,0,19,0,0,9,0,0,0,3277452,"2023-11-17T00:00:00.000Z",17896017,19,"Matt Ryan",0,9,9,9,0,9
"20135",8619,0,0,0,0,0,0,0,0,0,1,0,0,0,0,0,0,3277452,"2023-11-17T00:00:00.000Z",17896021,19,"Jeremiah Robinson-Earl",0,0,0,0,0,0
"20136",8620,0,0,0,0,0,0,0,0,0,0,0,0,0,0,0,0,3277452,"2023-11-17T00:00:00.000Z",17896097,19,"Jose Alvarado",0,0,0,0,0,0
"20137",8621,0,0,0,0,0,0,0,0,0,0,0,0,0,0,0,0,3277452,"2023-11-17T00:00:00.000Z",3547260,19,"Kira Lewis Jr.",0,0,0,0,0,0
"20138",8622,0,0,0,0,0,0,0,0,0,0,0,0,0,0,0,0,3277452,"2023-11-17T00:00:00.000Z",250,8,"DeAndre Jordan",0,0,0,0,0,0
"20139",8623,0,0,0,0,0,0,0,0,0,0,0,0,0,0,0,0,3277452,"2023-11-17T00:00:00.000Z",17896007,8,"Braxton Key",0,0,0,0,0,0
